Year,Month,Day,Hour,Forecast_Demand_MWh,Adjusted_Demand_MWh,Adjusted_Generation_MWh,Adjusted_Interchange_MWh
2015,7,1,8,1531,1579,1090,-489
2015,7,1,9,1472,1514,1027,-487
2015,7,1,10,1437,1490,1043,-447
2015,7,1,11,1437,1493,1120,-373
2015,7,1,12,1475,1540,1128,-412
2015,7,1,13,1537,1601,1170,-431
2015,7,1,14,1642,1718,1226,-492
2015,7,1,15,1749,1811,1291,-520
2015,7,1,16,1871,1927,1469,-458
2015,7,1,17,1987,2052,1619,-433
2015,7,1,18,2091,2144,1849,-295
2015,7,1,19,2173,2229,2111,-118
2015,7,1,20,2253,2311,2134,-177
2015,7,1,21,2312,2385,2258,-127
2015,7,1,22,2356,2457,2296,-161
2015,7,1,23,2391,2495,2345,-150
2015,7,2,0,2371,2486,2354,-132
2015,7,2,1,2301,2481,2375,-106
2015,7,2,2,2258,2407,2504,97
2015,7,2,3,2235,2387,2440,53
2015,7,2,4,2153,2274,2340,66
2015,7,2,5,1980,2059,2074,15
2015,7,2,6,1782,1856,2073,217
2015,7,2,7,1643,1730,1943,213
2015,7,2,8,1580,1643,1788,145
2015,7,2,9,1514,1593,1741,148
2015,7,2,10,1479,1556,1679,123
2015,7,2,11,1472,1565,1639,74
2015,7,2,12,1512,1600,1682,82
2015,7,2,13,1566,1663,1663,0
2015,7,2,14,1667,1753,1621,-132
2015,7,2,15,1774,1862,1676,-186
2015,7,2,16,1900,1987,1858,-129
2015,7,2,17,2013,2089,2115,26
2015,7,2,18,2116,2179,2304,125
2015,7,2,19,2196,2263,2448,185
2015,7,2,20,2271,2336,2548,212
2015,7,2,21,2326,2422,2573,151
2015,7,2,22,2356,2446,2604,158
2015,7,2,23,2365,2329,2540,211
2015,7,3,0,2324,2193,2462,269
2015,7,3,1,2245,2095,2047,-48
2015,7,3,2,2182,2042,1890,-152
2015,7,3,3,2164,2060,1915,-145
2015,7,3,4,2102,1999,1934,-65
2015,7,3,5,1943,1890,1834,-56
2015,7,3,6,1785,1710,1768,58
2015,7,3,7,1652,1598,1651,53
2015,7,3,8,1570,1525,1445,-80
2015,7,3,9,1510,1486,1395,-91
2015,7,3,10,1472,1463,1375,-88
2015,7,3,11,1441,1469,1336,-133
2015,7,3,12,1450,1490,1498,8
2015,7,3,13,1474,1500,1519,19
2015,7,3,14,1512,1578,1535,-43
2015,7,3,15,1608,1663,1527,-136
2015,7,3,16,1712,1784,1645,-139
2015,7,3,17,1814,1889,1787,-102
2015,7,3,18,1896,1967,1844,-123
2015,7,3,19,1963,2034,1952,-82
2015,7,3,20,2028,2102,1985,-117
2015,7,3,21,2080,2171,1998,-173
2015,7,3,22,2105,2207,2080,-127
2015,7,3,23,2144,2232,2088,-144
2015,7,4,0,2126,2201,2107,-94
2015,7,4,1,2070,2131,2126,-5
2015,7,4,2,2061,2064,1945,-119
2015,7,4,3,2046,2093,1898,-195
2015,7,4,4,1974,2053,1988,-65
2015,7,4,5,1819,1922,1851,-71
2015,7,4,6,1683,1771,1818,47
2015,7,4,7,1566,1645,1797,152
2015,7,4,8,1478,1572,1581,9
2015,7,4,9,1418,1506,1436,-70
2015,7,4,10,1383,1478,1441,-37
2015,7,4,11,1354,1466,1425,-41
2015,7,4,12,1355,1478,1399,-79
2015,7,4,13,1358,1464,1348,-116
2015,7,4,14,1411,1543,1370,-173
2015,7,4,15,1509,1655,1424,-231
2015,7,4,16,1625,1764,1501,-263
2015,7,4,17,1724,1874,1623,-251
2015,7,4,18,1815,1978,1772,-206
2015,7,4,19,1889,2044,2010,-34
2015,7,4,20,1957,2113,2031,-82
2015,7,4,21,2020,2145,2024,-121
2015,7,4,22,2053,2118,2094,-24
2015,7,4,23,2082,2043,2044,1
2015,7,5,0,2093,1972,2018,46
2015,7,5,1,2042,1915,1962,47
2015,7,5,2,2018,1861,1860,-1
2015,7,5,3,1969,1872,1912,40
2015,7,5,4,1922,1837,1894,57
2015,7,5,5,1812,1773,1840,67
2015,7,5,6,1664,1678,1774,96
2015,7,5,7,1540,1580,1713,133
2015,7,5,8,1479,1500,1709,209
2015,7,5,9,1423,1455,1587,132
2015,7,5,10,1383,1427,1584,157
2015,7,5,11,1369,1417,1595,178
2015,7,5,12,1361,1422,1594,172
2015,7,5,13,1350,1409,1580,171
2015,7,5,14,1401,1488,1625,137
2015,7,5,15,1498,1594,1660,66
2015,7,5,16,1620,1715,1759,44
2015,7,5,17,1731,1805,1938,133
2015,7,5,18,1828,1914,2125,211
2015,7,5,19,1915,1993,2231,238
2015,7,5,20,1987,2075,2217,142
2015,7,5,21,2058,2134,2164,30
2015,7,5,22,2098,2144,2200,56
2015,7,5,23,2131,2121,2106,-15
2015,7,6,0,2135,2078,2070,-8
2015,7,6,1,2091,2025,2040,15
2015,7,6,2,2057,1967,2075,108
2015,7,6,3,2033,1976,2097,121
2015,7,6,4,1980,1926,2240,314
2015,7,6,5,1838,1793,2071,278
2015,7,6,6,1671,1646,1963,317
2015,7,6,7,1545,1550,1905,355
2015,7,6,8,1480,1494,1802,308
2015,7,6,9,1430,1449,1671,222
2015,7,6,10,1399,1441,1626,185
2015,7,6,11,1403,1453,1638,185
2015,7,6,12,1435,1508,1646,138
2015,7,6,13,1493,1564,1555,-9
2015,7,6,14,1598,1670,1495,-175
2015,7,6,15,1699,1764,1510,-254
2015,7,6,16,1808,1877,1614,-263
2015,7,6,17,1913,1970,1825,-145
2015,7,6,18,2005,2058,1988,-70
2015,7,6,19,2088,2132,2165,33
2015,7,6,20,2165,2204,2307,103
2015,7,6,21,2229,2249,2399,150
2015,7,6,22,2269,2278,2448,170
2015,7,6,23,2296,2266,2434,168
2015,7,7,0,2278,2141,2396,255
2015,7,7,1,2228,2058,2340,282
2015,7,7,2,2184,2002,2114,112
2015,7,7,3,2164,2022,2090,68
2015,7,7,4,2095,1995,2086,91
2015,7,7,5,1926,1852,1830,-22
2015,7,7,6,1736,1689,1677,-12
2015,7,7,7,1599,1577,1576,-1
2015,7,7,8,1441,1500,1487,-13
2015,7,7,9,1394,1438,1344,-94
2015,7,7,10,1371,1411,1285,-126
2015,7,7,11,1374,1418,1225,-193
2015,7,7,12,1421,1472,1222,-250
2015,7,7,13,1496,1536,1213,-323
2015,7,7,14,1586,1617,1207,-410
2015,7,7,15,1664,1695,1263,-432
2015,7,7,16,1741,1769,1524,-245
2015,7,7,17,1807,1844,1669,-175
2015,7,7,18,1871,1911,1796,-115
2015,7,7,19,1915,1968,1855,-113
2015,7,7,20,1973,2021,1901,-120
2015,7,7,21,2031,2067,1900,-167
2015,7,7,22,2051,2097,1966,-131
2015,7,7,23,2057,2024,1968,-56
2015,7,8,0,2031,1941,1972,31
2015,7,8,1,1980,1907,1966,59
2015,7,8,2,1943,1883,1894,11
2015,7,8,3,1960,1894,1964,70
2015,7,8,4,1907,1859,2003,144
2015,7,8,5,1770,1715,1771,56
2015,7,8,6,1603,1562,1632,70
2015,7,8,7,1486,1448,1457,9
2015,7,8,8,1427,1389,1274,-115
2015,7,8,9,1379,1350,1089,-261
2015,7,8,10,1353,1337,1059,-278
2015,7,8,11,1358,1341,1106,-235
2015,7,8,12,1406,1399,1184,-215
2015,7,8,13,1473,1443,1201,-242
2015,7,8,14,1568,1524,1230,-294
2015,7,8,15,1653,1630,1300,-330
2015,7,8,16,1746,1704,1448,-256
2015,7,8,17,1831,1777,1705,-72
2015,7,8,18,1905,1841,1889,48
2015,7,8,19,1966,1905,1878,-27
2015,7,8,20,2030,1960,1936,-24
2015,7,8,21,2090,1988,1965,-23
2015,7,8,22,2125,1980,1915,-65
2015,7,8,23,2146,1960,1913,-47
2015,7,9,0,2106,1949,1945,-4
2015,7,9,1,2047,1920,1976,56
2015,7,9,2,1998,1876,1859,-17
2015,7,9,3,2004,1899,1830,-69
2015,7,9,4,1960,1875,1875,0
2015,7,9,5,1825,1716,1779,63
2015,7,9,6,1648,1576,1581,5
2015,7,9,7,1522,1465,1379,-86
2015,7,9,8,1417,1399,1311,-88
2015,7,9,9,1371,1364,1192,-172
2015,7,9,10,1345,1344,1162,-182
2015,7,9,11,1348,1347,1155,-192
2015,7,9,12,1390,1398,1178,-220
2015,7,9,13,1455,1453,1098,-355
2015,7,9,14,1549,1544,1144,-400
2015,7,9,15,1636,1622,1203,-419
2015,7,9,16,1726,1673,1396,-277
2015,7,9,17,1812,1758,1414,-344
2015,7,9,18,1886,1805,1579,-226
2015,7,9,19,1947,1835,1596,-239
2015,7,9,20,2004,1861,1616,-245
2015,7,9,21,2053,1886,1664,-222
2015,7,9,22,2075,1895,1703,-192
2015,7,9,23,2055,1826,1672,-154
2015,7,10,0,2002,1772,1696,-76
2015,7,10,1,1949,1727,1671,-56
2015,7,10,2,1915,1702,1638,-64
2015,7,10,3,1915,1755,1690,-65
2015,7,10,4,1881,1748,1586,-162
2015,7,10,5,1758,1619,1489,-130
2015,7,10,6,1600,1494,1386,-108
2015,7,10,7,1478,1401,1294,-107
2015,7,10,8,1366,1351,1191,-160
2015,7,10,9,1325,1321,1113,-208
2015,7,10,10,1304,1314,1136,-178
2015,7,10,11,1307,1322,1146,-176
2015,7,10,12,1353,1371,1155,-216
2015,7,10,13,1414,1435,1170,-265
2015,7,10,14,1502,1511,1161,-350
2015,7,10,15,1585,1586,1161,-425
2015,7,10,16,1664,1675,1277,-398
2015,7,10,17,1730,1745,1453,-292
2015,7,10,18,1792,1800,1739,-61
2015,7,10,19,1843,1829,1760,-69
2015,7,10,20,1874,1867,1723,-144
2015,7,10,21,1928,1900,1809,-91
2015,7,10,22,1949,1897,1863,-34
2015,7,10,23,1951,1863,1815,-48
2015,7,11,0,1948,1797,1737,-60
2015,7,11,1,1900,1717,1634,-83
2015,7,11,2,1852,1693,1425,-268
2015,7,11,3,1857,1739,1437,-302
2015,7,11,4,1838,1745,1466,-279
2015,7,11,5,1730,1643,1377,-266
2015,7,11,6,1588,1523,1303,-220
2015,7,11,7,1469,1424,1192,-232
2015,7,11,8,1378,1364,1104,-260
2015,7,11,9,1329,1320,1050,-270
2015,7,11,10,1314,1305,1064,-241
2015,7,11,11,1306,1298,1002,-296
2015,7,11,12,1307,1314,1001,-313
2015,7,11,13,1307,1321,993,-328
2015,7,11,14,1363,1388,979,-409
2015,7,11,15,1468,1486,1090,-396
2015,7,11,16,1571,1571,1281,-290
2015,7,11,17,1660,1662,1405,-257
2015,7,11,18,1729,1740,1622,-118
2015,7,11,19,1790,1811,1687,-124
2015,7,11,20,1841,1869,1723,-146
2015,7,11,21,1899,1924,1756,-168
2015,7,11,22,1927,1946,1710,-236
2015,7,11,23,1933,1919,1642,-277
2015,7,12,0,1931,1873,1618,-255
2015,7,12,1,1896,1836,1635,-201
2015,7,12,2,1858,1797,1620,-177
2015,7,12,3,1849,1687,1447,-240
2015,7,12,4,1824,1804,1652,-152
2015,7,12,5,1720,1691,1596,-95
2015,7,12,6,1585,1560,1534,-26
2015,7,12,7,1470,1469,1423,-46
2015,7,12,8,1390,1406,1265,-141
2015,7,12,9,1341,1362,1051,-311
2015,7,12,10,1323,1343,1080,-263
2015,7,12,11,1312,1336,1073,-263
2015,7,12,12,1310,1346,1066,-280
2015,7,12,13,1297,1329,1124,-205
2015,7,12,14,1343,1390,1163,-227
2015,7,12,15,1445,1491,1192,-299
2015,7,12,16,1554,1599,1392,-207
2015,7,12,17,1652,1714,1592,-122
2015,7,12,18,1739,1810,1848,38
2015,7,12,19,1817,1911,1952,41
2015,7,12,20,1880,1997,1979,-18
2015,7,12,21,1949,2083,1963,-120
2015,7,12,22,1990,2130,1866,-264
2015,7,12,23,2000,2125,1821,-304
2015,7,13,0,2007,2104,1681,-423
2015,7,13,1,1978,2043,1617,-426
2015,7,13,2,1936,1941,1530,-411
2015,7,13,3,1923,1895,1509,-386
2015,7,13,4,1885,1836,1562,-274
2015,7,13,5,1754,1702,1520,-182
2015,7,13,6,1602,1564,1429,-135
2015,7,13,7,1483,1467,1299,-168
2015,7,13,8,1419,1393,1151,-242
2015,7,13,9,1372,1362,947,-415
2015,7,13,10,1361,1339,930,-409
2015,7,13,11,1364,1361,973,-388
2015,7,13,12,1398,1411,984,-427
2015,7,13,13,1450,1471,1050,-421
2015,7,13,14,1526,1570,1093,-477
2015,7,13,15,1628,1671,1208,-463
2015,7,13,16,1733,1774,1329,-445
2015,7,13,17,1840,1864,1556,-308
2015,7,13,18,1917,1954,1723,-231
2015,7,13,19,1999,2023,1811,-212
2015,7,13,20,2072,2094,1850,-244
2015,7,13,21,2144,2161,1990,-171
2015,7,13,22,2185,2231,2100,-131
2015,7,13,23,2190,2256,2091,-165
2015,7,14,0,2161,2223,2068,-155
2015,7,14,1,2114,2112,1978,-134
2015,7,14,2,2068,2007,1857,-150
2015,7,14,3,2064,1995,1842,-153
2015,7,14,4,2008,1946,1795,-151
2015,7,14,5,1847,1773,1630,-143
2015,7,14,6,1669,1617,1577,-40
2015,7,14,7,1537,1508,1456,-52
2015,7,14,8,1446,1439,1124,-315
2015,7,14,9,1398,1399,1116,-283
2015,7,14,10,1375,1376,975,-401
2015,7,14,11,1372,1386,923,-463
2015,7,14,12,1421,1439,969,-470
2015,7,14,13,1487,1498,1029,-469
2015,7,14,14,1577,1600,1138,-462
2015,7,14,15,1671,1697,1232,-465
2015,7,14,16,1773,1788,1322,-466
2015,7,14,17,1874,1882,1495,-387
2015,7,14,18,1953,1972,1659,-313
2015,7,14,19,2024,2041,1802,-239
2015,7,14,20,2095,2124,1934,-190
2015,7,14,21,2154,2185,1978,-207
2015,7,14,22,2173,2238,1979,-259
2015,7,14,23,2158,2249,2072,-177
2015,7,15,0,2107,2146,1984,-162
2015,7,15,1,2037,2063,1816,-247
2015,7,15,2,1983,1993,1658,-335
2015,7,15,3,1996,2015,1704,-311
2015,7,15,4,1950,1977,1725,-252
2015,7,15,5,1800,1809,1628,-181
2015,7,15,6,1627,1643,1505,-138
2015,7,15,7,1508,1526,1409,-117
2015,7,15,8,1423,1470,1326,-144
2015,7,15,9,1373,1416,1240,-176
2015,7,15,10,1350,1399,1256,-143
2015,7,15,11,1353,1407,1249,-158
2015,7,15,12,1400,1454,1237,-217
2015,7,15,13,1480,1496,1246,-250
2015,7,15,14,1570,1605,1218,-387
2015,7,15,15,1660,1705,1249,-456
2015,7,15,16,1759,1791,1397,-394
2015,7,15,17,1864,1899,1531,-368
2015,7,15,18,1949,1981,1685,-296
2015,7,15,19,2017,2049,1769,-280
2015,7,15,20,2088,2122,1891,-231
2015,7,15,21,2163,2163,2005,-158
2015,7,15,22,2195,2198,1942,-256
2015,7,15,23,2205,2129,1826,-303
2015,7,16,0,2145,2047,1848,-199
2015,7,16,1,2061,1968,1843,-125
2015,7,16,2,1989,1918,1768,-150
2015,7,16,3,1999,1958,1663,-295
2015,7,16,4,1951,1922,1722,-200
2015,7,16,5,1802,1771,1653,-118
2015,7,16,6,1627,1610,1730,120
2015,7,16,7,1508,1508,1662,154
2015,7,16,8,1443,1446,1661,215
2015,7,16,9,1395,1403,1488,85
2015,7,16,10,1366,1378,1475,97
2015,7,16,11,1366,1377,1480,103
2015,7,16,12,1406,1426,1468,42
2015,7,16,13,1467,1481,1472,-9
2015,7,16,14,1560,1576,1438,-138
2015,7,16,15,1659,1676,1416,-260
2015,7,16,16,1765,1784,1623,-161
2015,7,16,17,1871,2056,1964,-92
2015,7,16,18,1970,1962,1926,-36
2015,7,16,19,2051,2052,2034,-18
2015,7,16,20,2134,2141,2113,-28
2015,7,16,21,2205,2199,2239,40
2015,7,16,22,2245,2248,2252,4
2015,7,16,23,2256,2285,2258,-27
2015,7,17,0,2217,2269,2261,-8
2015,7,17,1,2147,2169,2177,8
2015,7,17,2,2075,2099,2112,13
2015,7,17,3,2065,2105,2109,4
2015,7,17,4,2011,2056,2083,27
2015,7,17,5,1861,1884,1924,40
2015,7,17,6,1683,1698,1835,137
2015,7,17,7,1553,1577,1633,56
2015,7,17,8,1464,1497,1385,-112
2015,7,17,9,1406,1463,1227,-236
2015,7,17,10,1381,1431,1293,-138
2015,7,17,11,1378,1434,1286,-148
2015,7,17,12,1416,1481,1313,-168
2015,7,17,13,1472,1540,1317,-223
2015,7,17,14,1572,1627,1280,-347
2015,7,17,15,1681,1699,1284,-415
2015,7,17,16,1785,1764,1506,-258
2015,7,17,17,1892,1831,1644,-187
2015,7,17,18,1981,1863,1790,-73
2015,7,17,19,2052,1873,1896,23
2015,7,17,20,2127,1905,1997,92
2015,7,17,21,2192,1951,2051,100
2015,7,17,22,2224,1971,2048,77
2015,7,17,23,2204,2008,2008,0
2015,7,18,0,2144,1986,1971,-15
2015,7,18,1,2056,1935,2074,139
2015,7,18,2,1992,1888,1957,69
2015,7,18,3,1996,1942,1963,21
2015,7,18,4,1955,1935,1956,21
2015,7,18,5,1832,1802,1816,14
2015,7,18,6,1674,1664,1627,-37
2015,7,18,7,1552,1558,1494,-64
2015,7,18,8,1479,1483,1459,-24
2015,7,18,9,1420,1453,1307,-146
2015,7,18,10,1387,1417,1259,-158
2015,7,18,11,1372,1401,1243,-158
2015,7,18,12,1381,1420,1265,-155
2015,7,18,13,1383,1427,1236,-191
2015,7,18,14,1454,1483,1188,-295
2015,7,18,15,1579,1598,1265,-333
2015,7,18,16,1689,1713,1342,-371
2015,7,18,17,1795,1821,1515,-306
2015,7,18,18,1893,1916,1794,-122
2015,7,18,19,1974,1988,1896,-92
2015,7,18,20,2046,2066,1943,-123
2015,7,18,21,2107,2128,2025,-103
2015,7,18,22,2145,2181,2035,-146
2015,7,18,23,2129,2232,2012,-220
2015,7,19,0,2091,2240,2016,-224
2015,7,19,1,2020,2208,1994,-214
2015,7,19,2,1961,2147,1875,-272
2015,7,19,3,1948,2134,1814,-320
2015,7,19,4,1908,2059,1845,-214
2015,7,19,5,1800,1891,1691,-200
2015,7,19,6,1654,1731,1723,-8
2015,7,19,7,1538,1607,1614,7
2015,7,19,8,1466,1540,1555,15
2015,7,19,9,1408,1484,1428,-56
2015,7,19,10,1374,1444,1412,-32
2015,7,19,11,1362,1429,1327,-102
2015,7,19,12,1363,1428,1288,-140
2015,7,19,13,1350,1414,1268,-146
2015,7,19,14,1397,1474,1249,-225
2015,7,19,15,1509,1589,1288,-301
2015,7,19,16,1623,1691,1387,-304
2015,7,19,17,1729,1785,1564,-221
2015,7,19,18,1827,1867,1709,-158
2015,7,19,19,1909,1952,1867,-85
2015,7,19,20,1979,2007,1877,-130
2015,7,19,21,2054,2077,1938,-139
2015,7,19,22,2110,2120,2000,-120
2015,7,19,23,2121,2163,1986,-177
2015,7,20,0,2106,2158,2061,-97
2015,7,20,1,2054,2078,2027,-51
2015,7,20,2,1996,2004,1949,-55
2015,7,20,3,1986,1982,1942,-40
2015,7,20,4,1937,1956,1950,-6
2015,7,20,5,1807,1817,1715,-102
2015,7,20,6,1646,1670,1614,-56
2015,7,20,7,1529,1564,1539,-25
2015,7,20,8,1442,1508,1434,-74
2015,7,20,9,1388,1461,1243,-218
2015,7,20,10,1364,1439,1255,-184
2015,7,20,11,1367,1455,1257,-198
2015,7,20,12,1405,1515,1273,-242
2015,7,20,13,1447,1564,1303,-261
2015,7,20,14,1534,1657,1322,-335
2015,7,20,15,1644,1766,1395,-371
2015,7,20,16,1748,1876,1514,-362
2015,7,20,17,1853,1970,1580,-390
2015,7,20,18,1951,2061,1462,-599
2015,7,20,19,2038,2141,1520,-621
2015,7,20,20,2124,2219,1711,-508
2015,7,20,21,2194,2278,1797,-481
2015,7,20,22,2241,2320,1945,-375
2015,7,20,23,2226,2340,2034,-306
2015,7,21,0,2175,2324,2064,-260
2015,7,21,1,2103,2218,1977,-241
2015,7,21,2,2033,2101,1931,-170
2015,7,21,3,2032,2099,1857,-242
2015,7,21,4,1977,2030,1780,-250
2015,7,21,5,1833,1848,1693,-155
2015,7,21,6,1658,1689,1646,-43
2015,7,21,7,1534,1576,1647,71
2015,7,21,8,1454,1497,1609,112
2015,7,21,9,1406,1455,1489,34
2015,7,21,10,1381,1466,1500,34
2015,7,21,11,1390,1456,1506,50
2015,7,21,12,1433,1502,1525,23
2015,7,21,13,1503,1553,1564,11
2015,7,21,14,1604,1645,1511,-134
2015,7,21,15,1718,1749,1486,-263
2015,7,21,16,1817,1832,1775,-57
2015,7,21,17,1927,1916,1858,-58
2015,7,21,18,2020,1976,1980,4
2015,7,21,19,2098,2036,2072,36
2015,7,21,20,2138,2107,2199,92
2015,7,21,21,2192,2094,2238,144
2015,7,21,22,2236,2194,2406,212
2015,7,21,23,2259,2291,2507,216
2015,7,22,0,2230,2297,2528,231
2015,7,22,1,2137,2252,2508,256
2015,7,22,2,2061,2207,2447,240
2015,7,22,3,2058,2158,2458,300
2015,7,22,4,2012,2104,2351,247
2015,7,22,5,1867,1910,2195,285
2015,7,22,6,1692,1723,2141,418
2015,7,22,7,1562,1612,2115,503
2015,7,22,8,1480,1534,2027,493
2015,7,22,9,1429,1492,1857,365
2015,7,22,10,1412,1466,1869,403
2015,7,22,11,1402,1463,1863,400
2015,7,22,12,1448,1520,1884,364
2015,7,22,13,1514,1573,1861,288
2015,7,22,14,1605,1664,1851,187
2015,7,22,15,1708,1771,1809,38
2015,7,22,16,1821,1877,1893,16
2015,7,22,17,1925,1978,2141,163
2015,7,22,18,2023,2063,2265,202
2015,7,22,19,2104,2152,2264,112
2015,7,22,20,2182,2209,2332,123
2015,7,22,21,2246,2262,2479,217
2015,7,22,22,2289,2328,2583,255
2015,7,22,23,2306,2365,2636,271
2015,7,23,0,2279,2358,2638,280
2015,7,23,1,2202,2299,2581,282
2015,7,23,2,2125,2223,2511,288
2015,7,23,3,2121,2219,2494,275
2015,7,23,4,2059,2151,2467,316
2015,7,23,5,1899,1962,2274,312
2015,7,23,6,1715,1778,2262,484
2015,7,23,7,1586,1642,2119,477
2015,7,23,8,1500,1557,1988,431
2015,7,23,9,1448,1506,1822,316
2015,7,23,10,1418,1486,1791,305
2015,7,23,11,1415,1480,1788,308
2015,7,23,12,1457,1519,1891,372
2015,7,23,13,1519,1575,1880,305
2015,7,23,14,1616,1671,1811,140
2015,7,23,15,1725,1777,1799,22
2015,7,23,16,1838,1890,1902,12
2015,7,23,17,1951,1991,2054,63
2015,7,23,18,2036,2107,2183,76
2015,7,23,19,2118,2216,2355,139
2015,7,23,20,2201,2298,2501,203
2015,7,23,21,2250,2373,2518,145
2015,7,23,22,2303,2428,2644,216
2015,7,23,23,2329,2437,2599,162
2015,7,24,0,2287,2412,2499,87
2015,7,24,1,2212,2352,2444,92
2015,7,24,2,2148,2284,2473,189
2015,7,24,3,2121,2296,2429,133
2015,7,24,4,2064,2221,2364,143
2015,7,24,5,1912,2039,2192,153
2015,7,24,6,1728,1845,2122,277
2015,7,24,7,1601,1714,2008,294
2015,7,24,8,1531,1622,1891,269
2015,7,24,9,1471,1568,1699,131
2015,7,24,10,1442,1523,1660,137
2015,7,24,11,1436,1518,1636,118
2015,7,24,12,1476,1568,1597,29
2015,7,24,13,1527,1629,1608,-21
2015,7,24,14,1632,1721,1554,-167
2015,7,24,15,1750,1850,1596,-254
2015,7,24,16,1870,1965,1712,-253
2015,7,24,17,1982,2091,1976,-115
2015,7,24,18,2074,2189,2153,-36
2015,7,24,19,2164,2273,2215,-58
2015,7,24,20,2239,2355,2386,31
2015,7,24,21,2305,2416,2587,171
2015,7,24,22,2356,2477,2671,194
2015,7,24,23,2372,2520,2732,212
2015,7,25,0,2338,2451,2726,275
2015,7,25,1,2260,2314,2642,328
2015,7,25,2,2175,2166,2501,335
2015,7,25,3,2157,2169,2466,297
2015,7,25,4,2114,2111,2554,443
2015,7,25,5,1980,1956,2439,483
2015,7,25,6,1804,1793,2309,516
2015,7,25,7,1661,1668,2161,493
2015,7,25,8,1581,1594,1809,215
2015,7,25,9,1512,1533,1773,240
2015,7,25,10,1469,1489,1787,298
2015,7,25,11,1449,1473,1747,274
2015,7,25,12,1455,1481,1719,238
2015,7,25,13,1454,1479,1718,239
2015,7,25,14,1518,1553,1670,117
2015,7,25,15,1659,1686,1673,-13
2015,7,25,16,1791,1812,1811,-1
2015,7,25,17,1921,1936,1969,33
2015,7,25,18,2036,2034,2041,7
2015,7,25,19,2132,2119,2117,-2
2015,7,25,20,2227,2196,2178,-18
2015,7,25,21,2293,2256,2247,-9
2015,7,25,22,2362,2310,2260,-50
2015,7,25,23,2378,2353,2239,-114
2015,7,26,0,2356,2363,2146,-217
2015,7,26,1,2297,2344,1987,-357
2015,7,26,2,2239,2268,1877,-391
2015,7,26,3,2228,2219,1877,-342
2015,7,26,4,2159,2152,1865,-287
2015,7,26,5,2004,2001,1692,-309
2015,7,26,6,1816,1837,1697,-140
2015,7,26,7,1666,1705,1711,6
2015,7,26,8,1568,1620,1509,-111
2015,7,26,9,1502,1566,1424,-142
2015,7,26,10,1456,1521,1347,-174
2015,7,26,11,1434,1504,1370,-134
2015,7,26,12,1434,1500,1374,-126
2015,7,26,13,1422,1484,1383,-101
2015,7,26,14,1475,1547,1323,-224
2015,7,26,15,1608,1668,1427,-241
2015,7,26,16,1741,1802,1530,-272
2015,7,26,17,1868,1932,1790,-142
2015,7,26,18,1982,2050,1821,-229
2015,7,26,19,2102,2162,1868,-294
2015,7,26,20,2190,2234,1990,-244
2015,7,26,21,2259,2307,2060,-247
2015,7,26,22,2318,2371,2194,-177
2015,7,26,23,2354,2389,2306,-83
2015,7,27,0,2339,2390,2354,-36
2015,7,27,1,2299,2293,2266,-27
2015,7,27,2,2243,2136,2152,16
2015,7,27,3,2222,2100,2050,-50
2015,7,27,4,2153,2025,2032,7
2015,7,27,5,1997,1872,1843,-29
2015,7,27,6,1809,1707,1821,114
2015,7,27,7,1659,1592,1688,96
2015,7,27,8,1542,1532,1676,144
2015,7,27,9,1485,1488,1606,118
2015,7,27,10,1451,1474,1537,63
2015,7,27,11,1449,1481,1440,-41
2015,7,27,12,1483,1537,1477,-60
2015,7,27,13,1534,1591,1521,-70
2015,7,27,14,1619,1692,1550,-142
2015,7,27,15,1743,1802,1719,-83
2015,7,27,16,1866,1908,1805,-103
2015,7,27,17,1982,2013,2057,44
2015,7,27,18,2086,2108,2153,45
2015,7,27,19,2178,2193,2253,60
2015,7,27,20,2263,2256,2386,130
2015,7,27,21,2326,2325,2457,132
2015,7,27,22,2364,2372,2451,79
2015,7,27,23,2386,2397,2476,79
2015,7,28,0,2380,2389,2443,54
2015,7,28,1,2356,2365,2399,34
2015,7,28,2,2287,2280,2333,53
2015,7,28,3,2278,2295,2240,-55
2015,7,28,4,2213,2224,2179,-45
2015,7,28,5,2055,2011,2026,15
2015,7,28,6,1862,1809,1797,-12
2015,7,28,7,1710,1703,1725,22
2015,7,28,8,1516,1614,1695,81
2015,7,28,9,1463,1571,1640,69
2015,7,28,10,1434,1542,1635,93
2015,7,28,11,1430,1547,1544,-3
2015,7,28,12,1471,1605,1610,5
2015,7,28,13,1532,1671,1696,25
2015,7,28,14,1633,1767,1645,-122
2015,7,28,15,1741,1867,1677,-190
2015,7,28,16,1858,1983,1821,-162
2015,7,28,17,1972,2099,2004,-95
2015,7,28,18,2072,2212,2073,-139
2015,7,28,19,2162,2290,2168,-122
2015,7,28,20,2239,2364,2350,-14
2015,7,28,21,2301,2416,2439,23
2015,7,28,22,2340,2456,2539,83
2015,7,28,23,2362,2475,2602,127
2015,7,29,0,2330,2401,2495,94
2015,7,29,1,2244,2317,2411,94
2015,7,29,2,2153,2216,2343,127
2015,7,29,3,2143,2206,2476,270
2015,7,29,4,2080,2124,2488,364
2015,7,29,5,1923,1958,2270,312
2015,7,29,6,1739,1790,2157,367
2015,7,29,7,1607,1675,2034,359
2015,7,29,8,1515,1600,1917,317
2015,7,29,9,1468,1553,1668,115
2015,7,29,10,1435,1545,1641,96
2015,7,29,11,1440,1549,1660,111
2015,7,29,12,1485,1610,1655,45
2015,7,29,13,1557,1687,1668,-19
2015,7,29,14,1650,1746,1663,-83
2015,7,29,15,1741,1807,1651,-156
2015,7,29,16,1834,1878,1761,-117
2015,7,29,17,1927,1934,1917,-17
2015,7,29,18,2011,1997,2087,90
2015,7,29,19,2070,2033,2148,115
2015,7,29,20,2121,2101,2246,145
2015,7,29,21,2145,2138,2258,120
2015,7,29,22,2159,2102,2261,159
2015,7,29,23,2136,2050,2292,242
2015,7,30,0,2073,2003,2276,273
2015,7,30,1,2006,1958,2275,317
2015,7,30,2,1945,1919,2264,345
2015,7,30,3,1962,1968,2313,345
2015,7,30,4,1917,1933,2246,313
2015,7,30,5,1776,1795,2023,228
2015,7,30,6,1610,1633,1939,306
2015,7,30,7,1506,1545,1890,345
2015,7,30,8,1422,1485,1802,317
2015,7,30,9,1382,1437,1546,109
2015,7,30,10,1364,1412,1591,179
2015,7,30,11,1367,1413,1587,174
2015,7,30,12,1418,1477,1580,103
2015,7,30,13,1499,1564,1563,-1
2015,7,30,14,1581,1641,1510,-131
2015,7,30,15,1659,1710,1592,-118
2015,7,30,16,1739,1779,1702,-77
2015,7,30,17,1824,1833,1992,159
2015,7,30,18,1900,1882,2155,273
2015,7,30,19,1958,1937,2273,336
2015,7,30,20,2015,2003,2366,363
2015,7,30,21,2057,2052,2418,366
2015,7,30,22,2090,2085,2411,326
2015,7,30,23,2102,2142,2441,299
2015,7,31,0,2068,2106,2471,365
2015,7,31,1,2007,2030,2411,381
2015,7,31,2,1957,1987,2337,350
2015,7,31,3,1944,2015,2329,314
2015,7,31,4,1891,1959,2319,360
2015,7,31,5,1762,1803,2153,350
2015,7,31,6,1605,1661,2041,380
2015,7,31,7,1491,1575,1893,318
2015,7,31,8,1402,1510,1786,276
2015,7,31,9,1359,1461,1589,128
2015,7,31,10,1337,1440,1498,58
2015,7,31,11,1342,1452,1486,34
2015,7,31,12,1392,1508,1478,-30
2015,7,31,13,1480,1570,1466,-104
2015,7,31,14,1558,1637,1432,-205
2015,7,31,15,1629,1729,1504,-225
2015,7,31,16,1707,1834,1700,-134
2015,7,31,17,1782,1914,1966,52
2015,7,31,18,1862,1959,2172,213
2015,7,31,19,1903,2014,2174,160
2015,7,31,20,1963,2071,2102,31
2015,7,31,21,2017,2119,2122,3
2015,7,31,22,2034,2149,2130,-19
2015,7,31,23,2036,2095,2043,-52
2015,8,1,0,2005,2042,2035,-7
2015,8,1,1,1937,1970,2020,50
2015,8,1,2,1884,1916,1950,34
2015,8,1,3,1885,1963,1992,29
2015,8,1,4,1841,1914,1993,79
2015,8,1,5,1729,1799,1930,131
2015,8,1,6,1583,1670,1878,208
2015,8,1,7,1476,1563,1765,202
2015,8,1,8,1433,1503,1630,127
2015,8,1,9,1383,1460,1449,-11
2015,8,1,10,1351,1435,1414,-21
2015,8,1,11,1340,1426,1425,-1
2015,8,1,12,1355,1448,1409,-39
2015,8,1,13,1372,1458,1411,-47
2015,8,1,14,1422,1520,1405,-115
2015,8,1,15,1522,1627,1452,-175
2015,8,1,16,1623,1736,1543,-193
2015,8,1,17,1714,1829,1682,-147
2015,8,1,18,1798,1924,1795,-129
2015,8,1,19,1855,1997,1977,-20
2015,8,1,20,1908,2065,2071,6
2015,8,1,21,1950,2114,1904,-210
2015,8,1,22,1975,2133,1762,-371
2015,8,1,23,1992,2163,1720,-443
2015,8,2,0,1979,2129,1758,-371
2015,8,2,1,1919,2040,1618,-422
2015,8,2,2,1871,1978,1521,-457
2015,8,2,3,1856,2001,1527,-474
2015,8,2,4,1822,1925,1465,-460
2015,8,2,5,1719,1797,1445,-352
2015,8,2,6,1589,1658,1415,-243
2015,8,2,7,1485,1561,1341,-220
2015,8,2,8,1422,1480,1157,-323
2015,8,2,9,1372,1438,956,-482
2015,8,2,10,1339,1410,955,-455
2015,8,2,11,1326,1405,967,-438
2015,8,2,12,1332,1412,956,-456
2015,8,2,13,1333,1412,945,-467
2015,8,2,14,1370,1459,925,-534
2015,8,2,15,1461,1540,961,-579
2015,8,2,16,1565,1654,1066,-588
2015,8,2,17,1659,1756,1249,-507
2015,8,2,18,1743,1854,1500,-354
2015,8,2,19,1813,1925,1661,-264
2015,8,2,20,1874,1999,1718,-281
2015,8,2,21,1916,2054,1772,-282
2015,8,2,22,1948,2050,1776,-274
2015,8,2,23,1978,2027,1833,-194
2015,8,3,0,1981,2021,1892,-129
2015,8,3,1,1937,1966,1876,-90
2015,8,3,2,1893,1930,1821,-109
2015,8,3,3,1879,1965,1887,-78
2015,8,3,4,1838,1928,1956,28
2015,8,3,5,1716,1783,1912,129
2015,8,3,6,1570,1642,1859,217
2015,8,3,7,1469,1541,1726,185
2015,8,3,8,1403,1477,1636,159
2015,8,3,9,1357,1443,1443,0
2015,8,3,10,1336,1426,1435,9
2015,8,3,11,1342,1437,1438,1
2015,8,3,12,1388,1490,1451,-39
2015,8,3,13,1455,1543,1440,-103
2015,8,3,14,1526,1629,1416,-213
2015,8,3,15,1603,1744,1470,-274
2015,8,3,16,1697,1840,1578,-262
2015,8,3,17,1794,1928,1737,-191
2015,8,3,18,1875,2013,1994,-19
2015,8,3,19,1938,2084,2032,-52
2015,8,3,20,2008,2146,2092,-54
2015,8,3,21,2058,2214,2122,-92
2015,8,3,22,2091,2265,2154,-111
2015,8,3,23,2116,2299,2229,-70
2015,8,4,0,2096,2296,2290,-6
2015,8,4,1,2039,2239,2231,-8
2015,8,4,2,1986,2160,2200,40
2015,8,4,3,1988,2162,2206,44
2015,8,4,4,1927,2078,2104,26
2015,8,4,5,1779,1884,1948,64
2015,8,4,6,1614,1695,1821,126
2015,8,4,7,1503,1522,1656,134
2015,8,4,8,1453,1457,1428,-29
2015,8,4,9,1405,1423,1408,-15
2015,8,4,10,1379,1401,1381,-20
2015,8,4,11,1378,1391,1337,-54
2015,8,4,12,1423,1451,1314,-137
2015,8,4,13,1493,1527,1372,-155
2015,8,4,14,1587,1639,1418,-221
2015,8,4,15,1673,1729,1469,-260
2015,8,4,16,1778,1835,1599,-236
2015,8,4,17,1883,1950,1748,-202
2015,8,4,18,1976,2063,1869,-194
2015,8,4,19,2051,2142,2045,-97
2015,8,4,20,2136,2241,2153,-88
2015,8,4,21,2204,2315,2273,-42
2015,8,4,22,2246,2362,2258,-104
2015,8,4,23,2263,2394,2238,-156
2015,8,5,0,2242,2396,2240,-156
2015,8,5,1,2177,2341,2203,-138
2015,8,5,2,2096,2270,2201,-69
2015,8,5,3,2086,2264,2158,-106
2015,8,5,4,2022,2163,2104,-59
2015,8,5,5,1861,1955,1920,-35
2015,8,5,6,1680,1749,1818,69
2015,8,5,7,1551,1623,1737,114
2015,8,5,8,1451,1539,1645,106
2015,8,5,9,1398,1499,1498,-1
2015,8,5,10,1373,1459,1463,4
2015,8,5,11,1366,1455,1457,2
2015,8,5,12,1421,1506,1460,-46
2015,8,5,13,1491,1550,1512,-38
2015,8,5,14,1590,1639,1510,-129
2015,8,5,15,1694,1743,1577,-166
2015,8,5,16,1820,1852,1801,-51
2015,8,5,17,1928,2141,2134,-7
2015,8,5,18,2050,2080,2200,120
2015,8,5,19,2139,2195,2409,214
2015,8,5,20,2207,2303,2482,179
2015,8,5,21,2266,2388,2613,225
2015,8,5,22,2336,2461,2604,143
2015,8,5,23,2373,2498,2615,117
2015,8,6,0,2362,2494,2599,105
2015,8,6,1,2284,2415,2369,-46
2015,8,6,2,2194,2324,2245,-79
2015,8,6,3,2167,2316,2264,-52
2015,8,6,4,2092,2198,2239,41
2015,8,6,5,1918,1989,2071,82
2015,8,6,6,1708,1772,1959,187
2015,8,6,7,1572,1632,1934,302
2015,8,6,8,1510,1540,1836,296
2015,8,6,9,1450,1484,1688,204
2015,8,6,10,1417,1451,1693,242
2015,8,6,11,1412,1445,1708,263
2015,8,6,12,1462,1490,1694,204
2015,8,6,13,1514,1561,1705,144
2015,8,6,14,1612,1635,1674,39
2015,8,6,15,1720,1735,1680,-55
2015,8,6,16,1845,1871,1745,-126
2015,8,6,17,1963,1990,1951,-39
2015,8,6,18,2110,2099,2043,-56
2015,8,6,19,2255,2206,2147,-59
2015,8,6,20,2320,2317,2225,-92
2015,8,6,21,2375,2362,2254,-108
2015,8,6,22,2385,2404,2324,-80
2015,8,6,23,2402,2424,2363,-61
2015,8,7,0,2391,2398,2391,-7
2015,8,7,1,2304,2372,2382,10
2015,8,7,2,2202,2289,2346,57
2015,8,7,3,2201,2283,2349,66
2015,8,7,4,2121,2176,2408,232
2015,8,7,5,1946,1993,2330,337
2015,8,7,6,1752,1803,2156,353
2015,8,7,7,1618,1687,2061,374
2015,8,7,8,1537,1602,1902,300
2015,8,7,9,1476,1531,1728,197
2015,8,7,10,1444,1492,1669,177
2015,8,7,11,1442,1485,1666,181
2015,8,7,12,1480,1533,1848,315
2015,8,7,13,1549,1608,2006,398
2015,8,7,14,1651,1677,2020,343
2015,8,7,15,1769,1770,1985,215
2015,8,7,16,1890,1859,2085,226
2015,8,7,17,2012,1982,2141,159
2015,8,7,18,2112,2076,2282,206
2015,8,7,19,2207,2165,2450,285
2015,8,7,20,2293,2230,2447,217
2015,8,7,21,2373,2296,2531,235
2015,8,7,22,2397,2366,2618,252
2015,8,7,23,2425,2378,2618,240
2015,8,8,0,2410,2343,2547,204
2015,8,8,1,2324,2252,2434,182
2015,8,8,2,2227,2135,2324,189
2015,8,8,3,2219,2162,2352,190
2015,8,8,4,2118,2061,2375,314
2015,8,8,5,1956,1912,2182,270
2015,8,8,6,1734,1746,2029,283
2015,8,8,7,1603,1627,1772,145
2015,8,8,8,1514,1545,1467,-78
2015,8,8,9,1457,1493,1283,-210
2015,8,8,10,1420,1456,1257,-199
2015,8,8,11,1390,1440,1218,-222
2015,8,8,12,1407,1457,1235,-222
2015,8,8,13,1431,1462,1249,-213
2015,8,8,14,1492,1517,1265,-252
2015,8,8,15,1601,1628,1293,-335
2015,8,8,16,1725,1739,1449,-290
2015,8,8,17,1804,1828,1656,-172
2015,8,8,18,1878,1893,1796,-97
2015,8,8,19,1964,1965,1937,-28
2015,8,8,20,1999,2013,1985,-28
2015,8,8,21,2062,2060,1953,-107
2015,8,8,22,2151,2104,2010,-94
2015,8,8,23,2180,2076,2050,-26
2015,8,9,0,2175,1959,2008,49
2015,8,9,1,2129,1896,1950,54
2015,8,9,2,2043,1866,1914,48
2015,8,9,3,1974,1923,1854,-69
2015,8,9,4,1914,1879,1931,52
2015,8,9,5,1794,1762,1880,118
2015,8,9,6,1650,1635,1755,120
2015,8,9,7,1534,1531,1614,83
2015,8,9,8,1453,1467,1477,10
2015,8,9,9,1400,1425,1204,-221
2015,8,9,10,1367,1395,1193,-202
2015,8,9,11,1347,1385,1204,-181
2015,8,9,12,1350,1395,1213,-182
2015,8,9,13,1353,1390,1254,-136
2015,8,9,14,1394,1440,1259,-181
2015,8,9,15,1490,1549,1352,-197
2015,8,9,16,1604,1647,1514,-133
2015,8,9,17,1708,1746,1667,-79
2015,8,9,18,1802,1835,1870,35
2015,8,9,19,1883,1923,1993,70
2015,8,9,20,1955,2007,1994,-13
2015,8,9,21,2025,2073,2053,-20
2015,8,9,22,2064,2143,2116,-27
2015,8,9,23,2090,2207,2116,-91
2015,8,10,0,2097,2235,2116,-119
2015,8,10,1,2046,2218,2126,-92
2015,8,10,2,1995,2168,2044,-124
2015,8,10,3,1975,2159,1946,-213
2015,8,10,4,1921,2051,1877,-174
2015,8,10,5,1792,1864,1721,-143
2015,8,10,6,1637,1679,1666,-13
2015,8,10,7,1522,1565,1641,76
2015,8,10,8,1441,1495,1515,20
2015,8,10,9,1393,1451,1455,4
2015,8,10,10,1370,1426,1397,-29
2015,8,10,11,1370,1435,1229,-206
2015,8,10,12,1411,1489,1256,-233
2015,8,10,13,1478,1565,1275,-290
2015,8,10,14,1552,1646,1365,-281
2015,8,10,15,1639,1756,1450,-306
2015,8,10,16,1749,1857,1644,-213
2015,8,10,17,1855,1959,1769,-190
2015,8,10,18,1948,2045,2057,12
2015,8,10,19,2027,2123,2247,124
2015,8,10,20,2105,2205,2342,137
2015,8,10,21,2166,2286,2360,74
2015,8,10,22,2186,2318,2373,55
2015,8,10,23,2182,2310,2346,36
2015,8,11,0,2139,2236,2241,5
2015,8,11,1,2065,2120,2102,-18
2015,8,11,2,2002,2058,1930,-128
2015,8,11,3,2004,2091,1953,-138
2015,8,11,4,1945,1988,1918,-70
2015,8,11,5,1802,1812,1785,-27
2015,8,11,6,1638,1667,1707,40
2015,8,11,7,1522,1558,1561,3
2015,8,11,8,1434,1499,1517,18
2015,8,11,9,1378,1461,1404,-57
2015,8,11,10,1357,1447,1410,-37
2015,8,11,11,1353,1453,1431,-22
2015,8,11,12,1399,1517,1493,-24
2015,8,11,13,1484,1598,1560,-38
2015,8,11,14,1579,1673,1579,-94
2015,8,11,15,1667,1767,1632,-135
2015,8,11,16,1773,1854,1819,-35
2015,8,11,17,1876,1960,2062,102
2015,8,11,18,2004,2058,2219,161
2015,8,11,19,2133,2132,2329,197
2015,8,11,20,2206,2207,2471,264
2015,8,11,21,2260,2279,2561,282
2015,8,11,22,2301,2315,2616,301
2015,8,11,23,2316,2333,2637,304
2015,8,12,0,2303,2316,2578,262
2015,8,12,1,2244,2260,2534,274
2015,8,12,2,2175,2191,2414,223
2015,8,12,3,2173,2215,2317,102
2015,8,12,4,2081,2120,2221,101
2015,8,12,5,1893,1925,2164,239
2015,8,12,6,1694,1755,2034,279
2015,8,12,7,1550,1632,1862,230
2015,8,12,8,1439,1562,1786,224
2015,8,12,9,1393,1514,1632,118
2015,8,12,10,1367,1491,1559,68
2015,8,12,11,1365,1495,1578,83
2015,8,12,12,1415,1544,1568,24
2015,8,12,13,1487,1618,1624,6
2015,8,12,14,1576,1694,1599,-95
2015,8,12,15,1668,1811,1675,-136
2015,8,12,16,1769,1921,1752,-169
2015,8,12,17,1871,2025,2047,22
2015,8,12,18,1966,2113,2165,52
2015,8,12,19,2047,2173,2198,25
2015,8,12,20,2133,2246,2240,-6
2015,8,12,21,2205,2309,2264,-45
2015,8,12,22,2263,2368,2383,15
2015,8,12,23,2298,2388,2420,32
2015,8,13,0,2279,2385,2418,33
2015,8,13,1,2215,2333,2413,80
2015,8,13,2,2141,2249,2406,157
2015,8,13,3,2136,2251,2403,152
2015,8,13,4,2051,2133,2319,186
2015,8,13,5,1877,1922,2127,205
2015,8,13,6,1690,1730,2064,334
2015,8,13,7,1561,1610,2008,398
2015,8,13,8,1452,1528,1767,239
2015,8,13,9,1403,1475,1573,98
2015,8,13,10,1372,1450,1541,91
2015,8,13,11,1370,1457,1556,99
2015,8,13,12,1419,1514,1623,109
2015,8,13,13,1490,1608,1673,65
2015,8,13,14,1579,1662,1686,24
2015,8,13,15,1671,1757,1760,3
2015,8,13,16,1772,1849,1993,144
2015,8,13,17,1879,1981,2237,256
2015,8,13,18,1990,2089,2287,198
2015,8,13,19,2077,2186,2369,183
2015,8,13,20,2159,2288,2404,116
2015,8,13,21,2241,2334,2464,130
2015,8,13,22,2308,2398,2511,113
2015,8,13,23,2343,2424,2514,90
2015,8,14,0,2332,2417,2489,72
2015,8,14,1,2263,2403,2491,88
2015,8,14,2,2186,2342,2431,89
2015,8,14,3,2173,2335,2404,69
2015,8,14,4,2091,2203,2354,151
2015,8,14,5,1915,1971,2206,235
2015,8,14,6,1728,1772,2085,313
2015,8,14,7,1591,1648,1807,159
2015,8,14,8,1496,1570,1631,61
2015,8,14,9,1441,1516,1593,77
2015,8,14,10,1408,1476,1565,89
2015,8,14,11,1404,1472,1567,95
2015,8,14,12,1444,1523,1584,61
2015,8,14,13,1508,1612,1616,4
2015,8,14,14,1601,1690,1711,21
2015,8,14,15,1708,1808,1883,75
2015,8,14,16,1818,1933,2068,135
2015,8,14,17,1935,2050,2138,88
2015,8,14,18,2037,2172,2229,57
2015,8,14,19,2120,2273,2352,79
2015,8,14,20,2205,2370,2416,46
2015,8,14,21,2271,2407,2491,84
2015,8,14,22,2327,2447,2538,91
2015,8,14,23,2341,2458,2545,87
2015,8,15,0,2312,2424,2529,105
2015,8,15,1,2244,2397,2520,123
2015,8,15,2,2160,2323,2485,162
2015,8,15,3,2145,2342,2419,77
2015,8,15,4,2083,2267,2372,105
2015,8,15,5,1931,2080,2346,266
2015,8,15,6,1754,1904,2250,346
2015,8,15,7,1619,1781,2040,259
2015,8,15,8,1536,1694,1870,176
2015,8,15,9,1477,1629,1833,204
2015,8,15,10,1434,1582,1800,218
2015,8,15,11,1410,1558,1768,210
2015,8,15,12,1419,1562,1771,209
2015,8,15,13,1433,1570,1806,236
2015,8,15,14,1486,1624,1953,329
2015,8,15,15,1598,1754,2159,405
2015,8,15,16,1727,1910,2368,458
2015,8,15,17,1864,2047,2379,332
2015,8,15,18,1972,2164,2413,249
2015,8,15,19,2073,2267,2524,257
2015,8,15,20,2168,2347,2538,191
2015,8,15,21,2251,2400,2618,218
2015,8,15,22,2305,2431,2640,209
2015,8,15,23,2331,2395,2623,228
2015,8,16,0,2319,2305,2577,272
2015,8,16,1,2225,2225,2592,367
2015,8,16,2,2162,2162,2471,309
2015,8,16,3,2143,2149,2466,317
2015,8,16,4,2085,2050,2485,435
2015,8,16,5,1928,1906,2352,446
2015,8,16,6,1747,1749,2311,562
2015,8,16,7,1623,1643,1885,242
2015,8,16,8,1524,1567,1631,64
2015,8,16,9,1465,1518,1600,82
2015,8,16,10,1424,1483,1584,101
2015,8,16,11,1402,1468,1597,129
2015,8,16,12,1404,1468,1607,139
2015,8,16,13,1406,1475,1580,105
2015,8,16,14,1448,1516,1563,47
2015,8,16,15,1555,1615,1687,72
2015,8,16,16,1679,1739,1803,64
2015,8,16,17,1812,1864,1906,42
2015,8,16,18,1932,1981,2078,97
2015,8,16,19,2042,2089,2175,86
2015,8,16,20,2147,2186,2220,34
2015,8,16,21,2218,2266,2270,4
2015,8,16,22,2285,2333,2338,5
2015,8,16,23,2311,2387,2364,-23
2015,8,17,0,2304,2383,2401,18
2015,8,17,1,2219,2267,2270,3
2015,8,17,2,2167,2206,2207,1
2015,8,17,3,2156,2242,2208,-34
2015,8,17,4,2091,2131,2223,92
2015,8,17,5,1920,1944,2042,98
2015,8,17,6,1732,1752,2012,260
2015,8,17,7,1599,1643,1801,158
2015,8,17,8,1497,1568,1658,90
2015,8,17,9,1441,1519,1650,131
2015,8,17,10,1408,1500,1645,145
2015,8,17,11,1402,1519,1642,123
2015,8,17,12,1449,1576,1634,58
2015,8,17,13,1520,1674,1697,23
2015,8,17,14,1592,1769,1747,-22
2015,8,17,15,1680,1869,1911,42
2015,8,17,16,1786,1986,1950,-36
2015,8,17,17,1909,2100,2111,11
2015,8,17,18,2013,2207,2256,49
2015,8,17,19,2106,2301,2299,-2
2015,8,17,20,2200,2379,2401,22
2015,8,17,21,2271,2442,2495,53
2015,8,17,22,2333,2458,2497,39
2015,8,17,23,2350,2420,2516,96
2015,8,18,0,2320,2387,2340,-47
2015,8,18,1,2254,2316,2316,0
2015,8,18,2,2186,2268,2204,-64
2015,8,18,3,2181,2299,2241,-58
2015,8,18,4,2083,2178,2200,22
2015,8,18,5,1903,1962,2072,110
2015,8,18,6,1720,1765,2002,237
2015,8,18,7,1591,1642,1898,256
2015,8,18,8,1514,1581,1660,79
2015,8,18,9,1458,1534,1649,115
2015,8,18,10,1430,1508,1698,190
2015,8,18,11,1423,1513,1666,153
2015,8,18,12,1471,1574,1661,87
2015,8,18,13,1551,1671,1679,8
2015,8,18,14,1640,1744,1742,-2
2015,8,18,15,1736,1843,1796,-47
2015,8,18,16,1852,1927,1947,20
2015,8,18,17,1970,2067,2059,-8
2015,8,18,18,2080,2173,2122,-51
2015,8,18,19,2175,2269,2196,-73
2015,8,18,20,2270,2373,2274,-99
2015,8,18,21,2336,2406,2326,-80
2015,8,18,22,2397,2461,2400,-61
2015,8,18,23,2427,2483,2467,-16
2015,8,19,0,2392,2458,2511,53
2015,8,19,1,2313,2424,2463,39
2015,8,19,2,2233,2343,2408,65
2015,8,19,3,2228,2340,2411,71
2015,8,19,4,2124,2208,2304,96
2015,8,19,5,1938,1963,2103,140
2015,8,19,6,1744,1763,2031,268
2015,8,19,7,1610,1633,1934,301
2015,8,19,8,1472,1532,1846,314
2015,8,19,9,1416,1508,1846,338
2015,8,19,10,1392,1460,1836,376
2015,8,19,11,1387,1472,1868,396
2015,8,19,12,1444,1534,1934,400
2015,8,19,13,1531,1595,1966,371
2015,8,19,14,1614,1691,2142,451
2015,8,19,15,1690,1721,2208,487
2015,8,19,16,1763,1810,2258,448
2015,8,19,17,1850,1898,2331,433
2015,8,19,18,1921,1963,2409,446
2015,8,19,19,1995,2025,2460,435
2015,8,19,20,2066,2101,2538,437
2015,8,19,21,2131,2184,2584,400
2015,8,19,22,2186,2267,2609,342
2015,8,19,23,2225,2317,2529,212
2015,8,20,0,2199,2315,2513,198
2015,8,20,1,2137,2252,2482,230
2015,8,20,2,2065,2189,2378,189
2015,8,20,3,2064,2209,2415,206
2015,8,20,4,1969,2071,2312,241
2015,8,20,5,1807,1857,2150,293
2015,8,20,6,1637,1679,2078,399
2015,8,20,7,1505,1583,1876,293
2015,8,20,8,1419,1515,1823,308
2015,8,20,9,1377,1468,1766,298
2015,8,20,10,1347,1441,1763,322
2015,8,20,11,1350,1445,1749,304
2015,8,20,12,1400,1508,1729,221
2015,8,20,13,1490,1618,1769,151
2015,8,20,14,1569,1668,1845,177
2015,8,20,15,1637,1742,1856,114
2015,8,20,16,1724,1824,1944,120
2015,8,20,17,1815,1904,2036,132
2015,8,20,18,1900,1989,2127,138
2015,8,20,19,1985,2065,2112,47
2015,8,20,20,2074,2162,2190,28
2015,8,20,21,2159,2248,2279,31
2015,8,20,22,2222,2322,2433,111
2015,8,20,23,2272,2358,2448,90
2015,8,21,0,2251,2338,2378,40
2015,8,21,1,2195,2272,2240,-32
2015,8,21,2,2124,2194,2193,-1
2015,8,21,3,2113,2207,2162,-45
2015,8,21,4,2020,2071,2236,165
2015,8,21,5,1845,1877,2046,169
2015,8,21,6,1659,1706,1895,189
2015,8,21,7,1531,1596,1799,203
2015,8,21,8,1464,1528,1545,17
2015,8,21,9,1414,1483,1512,29
2015,8,21,10,1386,1463,1492,29
2015,8,21,11,1386,1474,1506,32
2015,8,21,12,1435,1541,1519,-22
2015,8,21,13,1511,1659,1567,-92
2015,8,21,14,1605,1721,1665,-56
2015,8,21,15,1693,1794,1829,35
2015,8,21,16,1794,1883,1830,-53
2015,8,21,17,1897,1996,1907,-89
2015,8,21,18,1987,2071,2081,10
2015,8,21,19,2069,2166,2170,4
2015,8,21,20,2148,2238,2179,-59
2015,8,21,21,2208,2225,2256,31
2015,8,21,22,2245,2281,2319,38
2015,8,21,23,2254,2277,2383,106
2015,8,22,0,2208,2213,2325,112
2015,8,22,1,2140,2122,2283,161
2015,8,22,2,2067,2061,2349,288
2015,8,22,3,2067,2101,2279,178
2015,8,22,4,1995,2021,2233,212
2015,8,22,5,1847,1883,2100,217
2015,8,22,6,1680,1721,2095,374
2015,8,22,7,1557,1613,2014,401
2015,8,22,8,1509,1545,1875,330
2015,8,22,9,1452,1503,1792,289
2015,8,22,10,1408,1468,1765,297
2015,8,22,11,1395,1451,1737,286
2015,8,22,12,1404,1470,1776,306
2015,8,22,13,1430,1488,1896,408
2015,8,22,14,1478,1518,2006,488
2015,8,22,15,1576,1619,2106,487
2015,8,22,16,1701,1741,2206,465
2015,8,22,17,1810,1861,2327,466
2015,8,22,18,1916,1971,2381,410
2015,8,22,19,2004,2063,2523,460
2015,8,22,20,2083,2162,2573,411
2015,8,22,21,2137,2236,2614,378
2015,8,22,22,2195,2273,2583,310
2015,8,22,23,2202,2294,2582,288
2015,8,23,0,2171,2286,2466,180
2015,8,23,1,2105,2239,2451,212
2015,8,23,2,2056,2191,2302,111
2015,8,23,3,2049,2183,2331,148
2015,8,23,4,1978,2072,2353,281
2015,8,23,5,1831,1894,2307,413
2015,8,23,6,1673,1739,2176,437
2015,8,23,7,1559,1629,2064,435
2015,8,23,8,1474,1550,1990,440
2015,8,23,9,1417,1501,1833,332
2015,8,23,10,1378,1467,1840,373
2015,8,23,11,1363,1462,1872,410
2015,8,23,12,1373,1467,1838,371
2015,8,23,13,1385,1485,1881,396
2015,8,23,14,1422,1501,1897,396
2015,8,23,15,1511,1568,1963,395
2015,8,23,16,1618,1650,2048,398
2015,8,23,17,1725,1726,2245,519
2015,8,23,18,1817,1799,2401,602
2015,8,23,19,1902,1859,2529,670
2015,8,23,20,1976,1904,2469,565
2015,8,23,21,2036,1937,2439,502
2015,8,23,22,2084,2000,2437,437
2015,8,23,23,2102,2032,2452,420
2015,8,24,0,2089,2069,2440,371
2015,8,24,1,2036,2073,2373,300
2015,8,24,2,1993,2045,2471,426
2015,8,24,3,1983,2082,2467,385
2015,8,24,4,1911,1977,2370,393
2015,8,24,5,1762,1812,2192,380
2015,8,24,6,1600,1655,2079,424
2015,8,24,7,1487,1565,1911,346
2015,8,24,8,1398,1505,1721,216
2015,8,24,9,1355,1468,1695,227
2015,8,24,10,1335,1453,1673,220
2015,8,24,11,1341,1453,1651,198
2015,8,24,12,1386,1511,1647,136
2015,8,24,13,1470,1620,1776,156
2015,8,24,14,1537,1666,1847,181
2015,8,24,15,1608,1740,1943,203
2015,8,24,16,1698,1834,2032,198
2015,8,24,17,1803,1924,2141,217
2015,8,24,18,1886,1997,2384,387
2015,8,24,19,1964,2075,2428,353
2015,8,24,20,2037,2339,2690,351
2015,8,24,21,2098,2254,2652,398
2015,8,24,22,2140,2313,2751,438
2015,8,24,23,2147,2340,2727,387
2015,8,25,0,2124,2342,2675,333
2015,8,25,1,2062,2273,2623,350
2015,8,25,2,2015,2197,2550,353
2015,8,25,3,2034,2221,2551,330
2015,8,25,4,1943,2093,2478,385
2015,8,25,5,1787,1891,2198,307
2015,8,25,6,1626,1715,2111,396
2015,8,25,7,1506,1622,1914,292
2015,8,25,8,1426,1551,1715,164
2015,8,25,9,1382,1499,1698,199
2015,8,25,10,1357,1472,1715,243
2015,8,25,11,1360,1476,1735,259
2015,8,25,12,1411,1545,1756,211
2015,8,25,13,1502,1649,1852,203
2015,8,25,14,1592,1711,1921,210
2015,8,25,15,1665,1807,2050,243
2015,8,25,16,1752,1901,2109,208
2015,8,25,17,1855,1999,2166,167
2015,8,25,18,1940,2092,2332,240
2015,8,25,19,2014,2184,2377,193
2015,8,25,20,2088,2263,2548,285
2015,8,25,21,2150,2331,2603,272
2015,8,25,22,2197,2366,2641,275
2015,8,25,23,2207,2368,2605,237
2015,8,26,0,2168,2323,2521,198
2015,8,26,1,2111,2206,2392,186
2015,8,26,2,2052,2132,2358,226
2015,8,26,3,2067,2144,2332,188
2015,8,26,4,1991,2014,2373,359
2015,8,26,5,1816,1823,2262,439
2015,8,26,6,1642,1656,2286,630
2015,8,26,7,1520,1557,1984,427
2015,8,26,8,1445,1502,1857,355
2015,8,26,9,1401,1457,1867,410
2015,8,26,10,1377,1445,1859,414
2015,8,26,11,1379,1455,1853,398
2015,8,26,12,1432,1520,1844,324
2015,8,26,13,1529,1645,1909,264
2015,8,26,14,1607,1699,1912,213
2015,8,26,15,1681,1754,1922,168
2015,8,26,16,1760,1823,2003,180
2015,8,26,17,1850,1897,2098,201
2015,8,26,18,1926,1886,2203,317
2015,8,26,19,1993,1978,2301,323
2015,8,26,20,2066,2030,2425,395
2015,8,26,21,2108,2081,2489,408
2015,8,26,22,2138,2108,2536,428
2015,8,26,23,2134,2125,2605,480
2015,8,27,0,2093,2086,2576,490
2015,8,27,1,2025,2025,2553,528
2015,8,27,2,1986,1994,2499,505
2015,8,27,3,2002,2021,2474,453
2015,8,27,4,1927,1935,2383,448
2015,8,27,5,1762,1775,2293,518
2015,8,27,6,1596,1626,2233,607
2015,8,27,7,1489,1536,1985,449
2015,8,27,8,1420,1487,1789,302
2015,8,27,9,1377,1455,1774,319
2015,8,27,10,1357,1434,1751,317
2015,8,27,11,1361,1450,1767,317
2015,8,27,12,1416,1517,1781,264
2015,8,27,13,1515,1626,1865,239
2015,8,27,14,1594,1685,1888,203
2015,8,27,15,1656,1773,1967,194
2015,8,27,16,1743,1860,2061,201
2015,8,27,17,1830,1930,2197,267
2015,8,27,18,1912,1996,2507,511
2015,8,27,19,1984,2046,2622,576
2015,8,27,20,2050,2109,2659,550
2015,8,27,21,2104,2167,2733,566
2015,8,27,22,2139,2194,2801,607
2015,8,27,23,2145,2221,2789,568
2015,8,28,0,2106,2196,2777,581
2015,8,28,1,2040,2122,2700,578
2015,8,28,2,1993,2091,2613,522
2015,8,28,3,2013,2137,2575,438
2015,8,28,4,1941,2028,2567,539
2015,8,28,5,1776,1853,2243,390
2015,8,28,6,1605,1677,2166,489
2015,8,28,7,1492,1569,2051,482
2015,8,28,8,1419,1507,1889,382
2015,8,28,9,1381,1477,1850,373
2015,8,28,10,1354,1453,1806,353
2015,8,28,11,1362,1462,1801,339
2015,8,28,12,1413,1519,1813,294
2015,8,28,13,1506,1604,1858,254
2015,8,28,14,1590,1648,1897,249
2015,8,28,15,1654,1765,2053,288
2015,8,28,16,1744,1848,2146,298
2015,8,28,17,1836,1940,2264,324
2015,8,28,18,1917,2014,2475,461
2015,8,28,19,1984,2085,2523,438
2015,8,28,20,2058,2187,2579,392
2015,8,28,21,2119,2256,2701,445
2015,8,28,22,2149,2286,2769,483
2015,8,28,23,2146,2285,2788,503
2015,8,29,0,2115,2230,2761,531
2015,8,29,1,2053,2103,2637,534
2015,8,29,2,1995,2018,2488,470
2015,8,29,3,2008,2042,2536,494
2015,8,29,4,1941,1955,2407,452
2015,8,29,5,1792,1830,2209,379
2015,8,29,6,1630,1710,2180,470
2015,8,29,7,1511,1614,2014,400
2015,8,29,8,1444,1546,1748,202
2015,8,29,9,1396,1501,1725,224
2015,8,29,10,1361,1464,1731,267
2015,8,29,11,1352,1448,1740,292
2015,8,29,12,1369,1458,1808,350
2015,8,29,13,1398,1482,1857,375
2015,8,29,14,1442,1496,1875,379
2015,8,29,15,1532,1607,1912,305
2015,8,29,16,1640,1731,2055,324
2015,8,29,17,1741,1840,2176,336
2015,8,29,18,1826,1931,2488,557
2015,8,29,19,1897,2016,2602,586
2015,8,29,20,1966,2105,2618,513
2015,8,29,21,2019,2159,2740,581
2015,8,29,22,2056,2161,2695,534
2015,8,29,23,2076,2152,2656,504
2015,8,30,0,2067,2121,2641,520
2015,8,30,1,2016,2074,2624,550
2015,8,30,2,1969,2037,2578,541
2015,8,30,3,1967,2055,2517,462
2015,8,30,4,1898,1958,2383,425
2015,8,30,5,1766,1827,2139,312
2015,8,30,6,1617,1681,2118,437
2015,8,30,7,1507,1572,2016,444
2015,8,30,8,1435,1502,1769,267
2015,8,30,9,1388,1458,1715,257
2015,8,30,10,1352,1423,1690,267
2015,8,30,11,1339,1409,1696,287
2015,8,30,12,1350,1417,1695,278
2015,8,30,13,1365,1427,1730,303
2015,8,30,14,1396,1449,1781,332
2015,8,30,15,1485,1546,1938,392
2015,8,30,16,1592,1661,2024,363
2015,8,30,17,1697,1778,2096,318
2015,8,30,18,1788,1880,2290,410
2015,8,30,19,1872,1986,2473,487
2015,8,30,20,1950,2076,2498,422
2015,8,30,21,2006,2155,2562,407
2015,8,30,22,2062,2230,2602,372
2015,8,30,23,2085,2244,2679,435
2015,8,31,0,2098,2295,2709,414
2015,8,31,1,2054,2260,2643,383
2015,8,31,2,2005,2213,2585,372
2015,8,31,3,2007,2207,2627,420
2015,8,31,4,1932,2069,2478,409
2015,8,31,5,1781,1881,2248,367
2015,8,31,6,1623,1718,2273,555
2015,8,31,7,1507,1602,2027,425
2015,8,31,8,1427,1523,1864,341
2015,8,31,9,1384,1479,1837,358
2015,8,31,10,1360,1454,1884,430
2015,8,31,11,1364,1465,1857,392
2015,8,31,12,1413,1516,1900,384
2015,8,31,13,1503,1633,2039,406
2015,8,31,14,1567,1699,2080,381
2015,8,31,15,1633,1790,2096,306
2015,8,31,16,1728,1889,2263,374
2015,8,31,17,1828,1992,2394,402
2015,8,31,18,1908,2086,2484,398
2015,8,31,19,1980,2176,2565,389
2015,8,31,20,2057,2273,2563,290
2015,8,31,21,2123,2332,2640,308
2015,8,31,22,2171,2359,2609,250
2015,8,31,23,2191,2364,2513,149
2015,9,1,0,2157,2275,2596,321
2015,9,1,1,2098,2166,2545,379
2015,9,1,2,2046,2124,2560,436
2015,9,1,3,2061,2146,2590,444
2015,9,1,4,1980,2021,2460,439
2015,9,1,5,1810,1842,2227,385
2015,9,1,6,1632,1680,2079,399
2015,9,1,7,1515,1588,1994,406
2015,9,1,8,1467,1526,1842,316
2015,9,1,9,1418,1493,1755,262
2015,9,1,10,1390,1479,1734,255
2015,9,1,11,1390,1480,1726,246
2015,9,1,12,1439,1536,1770,234
2015,9,1,13,1528,1656,1839,183
2015,9,1,14,1603,1717,1905,188
2015,9,1,15,1676,1800,2003,203
2015,9,1,16,1770,1884,2120,236
2015,9,1,17,1865,1978,2218,240
2015,9,1,18,1943,2060,2464,404
2015,9,1,19,2025,2149,2514,365
2015,9,1,20,2108,2225,2574,349
2015,9,1,21,2165,2261,2574,313
2015,9,1,22,2211,2277,2599,322
2015,9,1,23,2219,2278,2599,321
2015,9,2,0,2192,2209,2549,340
2015,9,2,1,2128,2158,2481,323
2015,9,2,2,2071,2133,2400,267
2015,9,2,3,2086,2184,2341,157
2015,9,2,4,1995,2053,2337,284
2015,9,2,5,1823,1863,2147,284
2015,9,2,6,1649,1688,2057,369
2015,9,2,7,1526,1579,1937,358
2015,9,2,8,1453,1517,1772,255
2015,9,2,9,1406,1482,1675,193
2015,9,2,10,1385,1459,1635,176
2015,9,2,11,1387,1465,1633,168
2015,9,2,12,1441,1523,1651,128
2015,9,2,13,1545,1650,1725,75
2015,9,2,14,1618,1690,1755,65
2015,9,2,15,1691,1773,1799,26
2015,9,2,16,1781,1858,1855,-3
2015,9,2,17,1875,1925,2060,135
2015,9,2,18,1954,2026,2221,195
2015,9,2,19,2028,2115,2338,223
2015,9,2,20,2111,2193,2359,166
2015,9,2,21,2168,2267,2446,179
2015,9,2,22,2209,2328,2491,163
2015,9,2,23,2214,2337,2513,176
2015,9,3,0,2171,2219,2449,230
2015,9,3,1,2097,2088,2329,241
2015,9,3,2,2045,2072,2215,143
2015,9,3,3,2058,2090,2215,125
2015,9,3,4,1983,1987,2125,138
2015,9,3,5,1807,1803,1931,128
2015,9,3,6,1632,1633,1907,274
2015,9,3,7,1517,1544,1841,297
2015,9,3,8,1434,1485,1664,179
2015,9,3,9,1391,1453,1713,260
2015,9,3,10,1366,1431,1668,237
2015,9,3,11,1368,1445,1704,259
2015,9,3,12,1423,1512,1726,214
2015,9,3,13,1526,1639,1864,225
2015,9,3,14,1602,1684,2036,352
2015,9,3,15,1666,1736,2088,352
2015,9,3,16,1736,1789,2167,378
2015,9,3,17,1807,1885,2289,404
2015,9,3,18,1873,1950,2486,536
2015,9,3,19,1923,2024,2468,444
2015,9,3,20,1984,2100,2485,385
2015,9,3,21,2024,2180,2537,357
2015,9,3,22,2051,2236,2577,341
2015,9,3,23,2062,2268,2589,321
2015,9,4,0,2019,2248,2527,279
2015,9,4,1,1956,2182,2381,199
2015,9,4,2,1928,2162,2349,187
2015,9,4,3,1953,2195,2330,135
2015,9,4,4,1890,2063,2332,269
2015,9,4,5,1730,1871,2268,397
2015,9,4,6,1572,1709,2103,394
2015,9,4,7,1467,1601,1907,306
2015,9,4,8,1394,1540,1742,202
2015,9,4,9,1356,1501,1749,248
2015,9,4,10,1338,1475,1718,243
2015,9,4,11,1343,1477,1698,221
2015,9,4,12,1402,1540,1718,178
2015,9,4,13,1509,1657,1786,129
2015,9,4,14,1581,1719,1946,227
2015,9,4,15,1637,1772,2007,235
2015,9,4,16,1707,1840,2078,238
2015,9,4,17,1770,1877,2193,316
2015,9,4,18,1824,1910,2345,435
2015,9,4,19,1873,1958,2370,412
2015,9,4,20,1927,1969,2415,446
2015,9,4,21,1966,1933,2437,504
2015,9,4,22,1987,1899,2310,411
2015,9,4,23,1973,1870,2309,439
2015,9,5,0,1918,1829,2346,517
2015,9,5,1,1848,1797,2240,443
2015,9,5,2,1829,1853,2214,361
2015,9,5,3,1851,1879,2273,394
2015,9,5,4,1793,1824,2239,415
2015,9,5,5,1664,1725,2110,385
2015,9,5,6,1523,1607,2072,465
2015,9,5,7,1427,1519,1892,373
2015,9,5,8,1396,1473,1663,190
2015,9,5,9,1348,1422,1599,177
2015,9,5,10,1317,1410,1591,181
2015,9,5,11,1309,1403,1587,184
2015,9,5,12,1328,1427,1602,175
2015,9,5,13,1365,1465,1661,196
2015,9,5,14,1400,1481,1757,276
2015,9,5,15,1477,1566,1822,256
2015,9,5,16,1571,1656,1933,277
2015,9,5,17,1649,1721,2064,343
2015,9,5,18,1711,1785,2093,308
2015,9,5,19,1767,1852,2106,254
2015,9,5,20,1815,1900,2109,209
2015,9,5,21,1853,1937,2133,196
2015,9,5,22,1885,1946,2081,135
2015,9,5,23,1901,1926,1961,35
2015,9,6,0,1897,1916,1923,7
2015,9,6,1,1852,1865,1877,12
2015,9,6,2,1835,1872,1672,-200
2015,9,6,3,1844,1893,1656,-237
2015,9,6,4,1792,1823,1601,-222
2015,9,6,5,1668,1698,1555,-143
2015,9,6,6,1531,1580,1498,-82
2015,9,6,7,1435,1478,1430,-48
2015,9,6,8,1398,1423,1309,-114
2015,9,6,9,1355,1385,1253,-132
2015,9,6,10,1326,1359,1263,-96
2015,9,6,11,1314,1355,1282,-73
2015,9,6,12,1330,1364,1277,-87
2015,9,6,13,1358,1394,1348,-46
2015,9,6,14,1381,1400,1435,35
2015,9,6,15,1453,1486,1480,-6
2015,9,6,16,1542,1567,1471,-96
2015,9,6,17,1634,1629,1524,-105
2015,9,6,18,1709,1694,1690,-4
2015,9,6,19,1786,1757,1765,8
2015,9,6,20,1854,1829,1823,-6
2015,9,6,21,1918,1898,1831,-67
2015,9,6,22,1961,1950,1875,-75
2015,9,6,23,1991,2008,1929,-79
2015,9,7,0,1995,2052,1899,-153
2015,9,7,1,1958,2008,1887,-121
2015,9,7,2,1932,2004,1900,-104
2015,9,7,3,1937,2012,1871,-141
2015,9,7,4,1851,1930,1750,-180
2015,9,7,5,1704,1790,1580,-210
2015,9,7,6,1564,1662,1507,-155
2015,9,7,7,1462,1546,1306,-240
2015,9,7,8,1406,1475,1137,-338
2015,9,7,9,1359,1416,1130,-286
2015,9,7,10,1334,1398,1149,-249
2015,9,7,11,1313,1396,1166,-230
2015,9,7,12,1328,1418,1176,-242
2015,9,7,13,1359,1439,1228,-211
2015,9,7,14,1372,1445,1304,-141
2015,9,7,15,1447,1524,1371,-153
2015,9,7,16,1548,1634,1528,-106
2015,9,7,17,1642,1754,1676,-78
2015,9,7,18,1725,1855,1726,-129
2015,9,7,19,1812,1953,1801,-152
2015,9,7,20,1895,2038,1852,-186
2015,9,7,21,1968,2107,1868,-239
2015,9,7,22,2021,2129,1930,-199
2015,9,7,23,2058,2135,1961,-174
2015,9,8,0,2060,2108,2140,32
2015,9,8,1,2024,2020,2123,103
2015,9,8,2,1986,2019,2125,106
2015,9,8,3,1971,2014,2153,139
2015,9,8,4,1881,1892,2141,249
2015,9,8,5,1728,1730,2043,313
2015,9,8,6,1592,1580,1862,282
2015,9,8,7,1486,1501,1677,176
2015,9,8,8,1421,1449,1541,92
2015,9,8,9,1379,1405,1496,91
2015,9,8,10,1361,1399,1501,102
2015,9,8,11,1359,1413,1479,66
2015,9,8,12,1412,1477,1492,15
2015,9,8,13,1515,1602,1532,-70
2015,9,8,14,1569,1648,1625,-23
2015,9,8,15,1634,1710,1690,-20
2015,9,8,16,1726,1788,1749,-39
2015,9,8,17,1822,1850,1881,31
2015,9,8,18,1899,1920,2031,111
2015,9,8,19,1974,1981,2161,180
2015,9,8,20,2052,2063,2171,108
2015,9,8,21,2116,2135,2244,109
2015,9,8,22,2162,2188,2223,35
2015,9,8,23,2171,2213,2178,-35
2015,9,9,0,2135,2192,2233,41
2015,9,9,1,2069,2139,2208,69
2015,9,9,2,2029,2117,2245,128
2015,9,9,3,2040,2125,2262,137
2015,9,9,4,1942,1980,2233,253
2015,9,9,5,1763,1790,2089,299
2015,9,9,6,1602,1623,1952,329
2015,9,9,7,1500,1523,1837,314
2015,9,9,8,1504,1461,1649,188
2015,9,9,9,1463,1435,1554,119
2015,9,9,10,1439,1422,1520,98
2015,9,9,11,1444,1433,1513,80
2015,9,9,12,1506,1499,1588,89
2015,9,9,13,1611,1612,1676,64
2015,9,9,14,1677,1643,1728,85
2015,9,9,15,1737,1715,1882,167
2015,9,9,16,1814,1799,1997,198
2015,9,9,17,1893,1899,2078,179
2015,9,9,18,1960,1991,2190,199
2015,9,9,19,2026,2064,2180,116
2015,9,9,20,2097,2128,2258,130
2015,9,9,21,2160,2194,2378,184
2015,9,9,22,2188,2219,2448,229
2015,9,9,23,2203,2240,2543,303
2015,9,10,0,2174,2196,2580,384
2015,9,10,1,2108,2110,2531,421
2015,9,10,2,2078,2095,2480,385
2015,9,10,3,2099,2091,2522,431
2015,9,10,4,2004,1971,2445,474
2015,9,10,5,1831,1800,2253,453
2015,9,10,6,1662,1628,2112,484
2015,9,10,7,1555,1533,1926,393
2015,9,10,8,1419,1474,1682,208
2015,9,10,9,1376,1437,1630,193
2015,9,10,10,1354,1410,1619,209
2015,9,10,11,1356,1415,1638,223
2015,9,10,12,1410,1481,1721,240
2015,9,10,13,1508,1597,1782,185
2015,9,10,14,1585,1649,1862,213
2015,9,10,15,1650,1693,1891,198
2015,9,10,16,1736,1747,2032,285
2015,9,10,17,1820,1844,2158,314
2015,9,10,18,1903,1917,2292,375
2015,9,10,19,1981,1981,2338,357
2015,9,10,20,2060,2065,2387,322
2015,9,10,21,2131,2124,2434,310
2015,9,10,22,2165,2169,2415,246
2015,9,10,23,2196,2209,2506,297
2015,9,11,0,2155,2201,2532,331
2015,9,11,1,2088,2136,2522,386
2015,9,11,2,2034,2110,2461,351
2015,9,11,3,2044,2098,2497,399
2015,9,11,4,1959,1960,2366,406
2015,9,11,5,1790,1791,2155,364
2015,9,11,6,1618,1623,2050,427
2015,9,11,7,1502,1526,1839,313
2015,9,11,8,1407,1462,1622,160
2015,9,11,9,1365,1410,1605,195
2015,9,11,10,1341,1381,1568,187
2015,9,11,11,1344,1395,1571,176
2015,9,11,12,1396,1447,1625,178
2015,9,11,13,1490,1561,1775,214
2015,9,11,14,1563,1591,1849,258
2015,9,11,15,1630,1649,2055,406
2015,9,11,16,1707,1727,2291,564
2015,9,11,17,1784,1805,2411,606
2015,9,11,18,1856,1880,2511,631
2015,9,11,19,1915,1957,2602,645
2015,9,11,20,1955,2038,2538,500
2015,9,11,21,1999,2105,2559,454
2015,9,11,22,2020,2140,2600,460
2015,9,11,23,2020,2173,2629,456
2015,9,12,0,1996,2150,2616,466
2015,9,12,1,1918,2086,2305,219
2015,9,12,2,1877,2052,2319,267
2015,9,12,3,1894,2049,2342,293
2015,9,12,4,1837,1938,2238,300
2015,9,12,5,1707,1803,2156,353
2015,9,12,6,1564,1660,2142,482
2015,9,12,7,1464,1541,2106,565
2015,9,12,8,1399,1478,1883,405
2015,9,12,9,1352,1430,1759,329
2015,9,12,10,1326,1403,1744,341
2015,9,12,11,1316,1395,1739,344
2015,9,12,12,1331,1415,1721,306
2015,9,12,13,1363,1454,1787,333
2015,9,12,14,1404,1473,1853,380
2015,9,12,15,1480,1558,1935,377
2015,9,12,16,1573,1638,2039,401
2015,9,12,17,1655,1716,2240,524
2015,9,12,18,1717,1803,2382,579
2015,9,12,19,1782,1871,2443,572
2015,9,12,20,1840,1952,2476,524
2015,9,12,21,1899,2030,2622,592
2015,9,12,22,1938,2089,2673,584
2015,9,12,23,1963,2122,2662,540
2015,9,13,0,1964,2138,2658,520
2015,9,13,1,1925,2089,2606,517
2015,9,13,2,1886,2057,2552,495
2015,9,13,3,1890,2040,2473,433
2015,9,13,4,1834,1942,2560,618
2015,9,13,5,1712,1784,2435,651
2015,9,13,6,1579,1648,2353,705
2015,9,13,7,1478,1536,2211,675
2015,9,13,8,1406,1465,1904,439
2015,9,13,9,1360,1415,1845,430
2015,9,13,10,1329,1387,1849,462
2015,9,13,11,1314,1371,1811,440
2015,9,13,12,1323,1382,1853,471
2015,9,13,13,1345,1394,1927,533
2015,9,13,14,1376,1397,1965,568
2015,9,13,15,1450,1478,2044,566
2015,9,13,16,1547,1580,2082,502
2015,9,13,17,1633,1674,2195,521
2015,9,13,18,1708,1776,2281,505
2015,9,13,19,1791,1887,2292,405
2015,9,13,20,1861,1961,2342,381
2015,9,13,21,1932,2039,2453,414
2015,9,13,22,1979,2098,2536,438
2015,9,13,23,2004,2131,2614,483
2015,9,14,0,2004,2128,2532,404
2015,9,14,1,1963,2081,2498,417
2015,9,14,2,1948,2065,2554,489
2015,9,14,3,1940,2040,2593,553
2015,9,14,4,1869,1918,2494,576
2015,9,14,5,1723,1746,2343,597
2015,9,14,6,1576,1599,2067,468
2015,9,14,7,1469,1494,1957,463
2015,9,14,8,1394,1433,1723,290
2015,9,14,9,1353,1391,1641,250
2015,9,14,10,1331,1375,1622,247
2015,9,14,11,1334,1386,1618,232
2015,9,14,12,1385,1453,1643,190
2015,9,14,13,1479,1571,1698,127
2015,9,14,14,1539,1621,1803,182
2015,9,14,15,1597,1680,1801,121
2015,9,14,16,1676,1764,1803,39
2015,9,14,17,1767,1827,1921,94
2015,9,14,18,1834,1888,2009,121
2015,9,14,19,1906,1967,2131,164
2015,9,14,20,1973,2045,2186,141
2015,9,14,21,2029,2081,2249,168
2015,9,14,22,2059,2123,2387,264
2015,9,14,23,2065,2112,2395,283
2015,9,15,0,2028,2096,2378,282
2015,9,15,1,1972,2054,2382,328
2015,9,15,2,1955,2080,2370,290
2015,9,15,3,1975,2082,2286,204
2015,9,15,4,1895,1952,2182,230
2015,9,15,5,1732,1787,2074,287
2015,9,15,6,1576,1628,1928,300
2015,9,15,7,1463,1530,1818,288
2015,9,15,8,1383,1460,1700,240
2015,9,15,9,1342,1425,1670,245
2015,9,15,10,1323,1397,1655,258
2015,9,15,11,1322,1402,1589,187
2015,9,15,12,1377,1467,1599,132
2015,9,15,13,1481,1598,1679,81
2015,9,15,14,1550,1646,1771,125
2015,9,15,15,1610,1706,1780,74
2015,9,15,16,1687,1778,1798,20
2015,9,15,17,1761,1862,1990,128
2015,9,15,18,1826,1937,2085,148
2015,9,15,19,1896,1998,2150,152
2015,9,15,20,1958,2007,2116,109
2015,9,15,21,2028,2038,2259,221
2015,9,15,22,2056,2082,2373,291
2015,9,15,23,2086,2107,2412,305
2015,9,16,0,2058,2098,2415,317
2015,9,16,1,1992,2047,2355,308
2015,9,16,2,1965,2066,2348,282
2015,9,16,3,1985,2066,2330,264
2015,9,16,4,1899,1955,2107,152
2015,9,16,5,1733,1776,2118,342
2015,9,16,6,1569,1621,2092,471
2015,9,16,7,1456,1519,1934,415
2015,9,16,8,1385,1459,1707,248
2015,9,16,9,1339,1416,1663,247
2015,9,16,10,1324,1404,1610,206
2015,9,16,11,1328,1406,1562,156
2015,9,16,12,1381,1468,1563,95
2015,9,16,13,1492,1586,1572,-14
2015,9,16,14,1557,1635,1572,-63
2015,9,16,15,1614,1703,1576,-127
2015,9,16,16,1688,1773,1640,-133
2015,9,16,17,1757,1852,1889,37
2015,9,16,18,1831,1909,2104,195
2015,9,16,19,1896,1962,2330,368
2015,9,16,20,1970,2051,2404,353
2015,9,16,21,2038,2116,2437,321
2015,9,16,22,2080,2179,2472,293
2015,9,16,23,2112,2213,2469,256
2015,9,17,0,2089,2203,2441,238
2015,9,17,1,2017,2142,2417,275
2015,9,17,2,1996,2118,2387,269
2015,9,17,3,2011,2087,2329,242
2015,9,17,4,1914,1964,2267,303
2015,9,17,5,1746,1785,2115,330
2015,9,17,6,1577,1625,1821,196
2015,9,17,7,1465,1517,1503,-14
2015,9,17,8,1386,1462,1421,-41
2015,9,17,9,1340,1415,1381,-34
2015,9,17,10,1322,1393,1348,-45
2015,9,17,11,1325,1396,1347,-49
2015,9,17,12,1377,1458,1331,-127
2015,9,17,13,1483,1579,1392,-187
2015,9,17,14,1552,1616,1489,-127
2015,9,17,15,1605,1676,1446,-230
2015,9,17,16,1675,1753,1542,-211
2015,9,17,17,1744,1839,1748,-91
2015,9,17,18,1810,1896,1802,-94
2015,9,17,19,1874,1952,1821,-131
2015,9,17,20,1935,2033,1827,-206
2015,9,17,21,1997,2110,1933,-177
2015,9,17,22,2046,2164,2043,-121
2015,9,17,23,2076,2193,2141,-52
2015,9,18,0,2058,2191,2105,-86
2015,9,18,1,1994,2140,2071,-69
2015,9,18,2,1969,2138,1990,-148
2015,9,18,3,1985,2116,1955,-161
2015,9,18,4,1898,1987,1891,-96
2015,9,18,5,1737,1792,1835,43
2015,9,18,6,1572,1633,1646,13
2015,9,18,7,1462,1523,1382,-141
2015,9,18,8,1381,1455,1377,-78
2015,9,18,9,1332,1411,1403,-8
2015,9,18,10,1314,1390,1385,-5
2015,9,18,11,1314,1387,1370,-17
2015,9,18,12,1363,1444,1352,-92
2015,9,18,13,1461,1562,1393,-169
2015,9,18,14,1532,1613,1477,-136
2015,9,18,15,1590,1659,1493,-166
2015,9,18,16,1666,1724,1675,-49
2015,9,18,17,1731,1803,1777,-26
2015,9,18,18,1794,1866,1857,-9
2015,9,18,19,1857,1925,1943,18
2015,9,18,20,1924,1992,1966,-26
2015,9,18,21,1987,2071,1970,-101
2015,9,18,22,2033,2133,1937,-196
2015,9,18,23,2057,2166,1973,-193
2015,9,19,0,2048,2135,1938,-197
2015,9,19,1,1976,2062,1872,-190
2015,9,19,2,1937,2054,1868,-186
2015,9,19,3,1944,2029,1965,-64
2015,9,19,4,1874,1915,1859,-56
2015,9,19,5,1737,1773,1752,-21
2015,9,19,6,1585,1625,1619,-6
2015,9,19,7,1469,1535,1427,-108
2015,9,19,8,1388,1453,1358,-95
2015,9,19,9,1345,1409,1400,-9
2015,9,19,10,1317,1382,1380,-2
2015,9,19,11,1298,1375,1354,-21
2015,9,19,12,1315,1392,1359,-33
2015,9,19,13,1349,1432,1399,-33
2015,9,19,14,1384,1436,1361,-75
2015,9,19,15,1458,1519,1446,-73
2015,9,19,16,1542,1584,1540,-44
2015,9,19,17,1617,1645,1559,-86
2015,9,19,18,1675,1710,1642,-68
2015,9,19,19,1725,1736,1677,-59
2015,9,19,20,1778,1794,1720,-74
2015,9,19,21,1825,1844,1736,-108
2015,9,19,22,1862,1849,1784,-65
2015,9,19,23,1885,1853,1785,-68
2015,9,20,0,1896,1858,1877,19
2015,9,20,1,1856,1818,1927,109
2015,9,20,2,1840,1851,1971,120
2015,9,20,3,1841,1843,1983,140
2015,9,20,4,1784,1776,1936,160
2015,9,20,5,1659,1669,1759,90
2015,9,20,6,1530,1559,1580,21
2015,9,20,7,1430,1482,1372,-110
2015,9,20,8,1368,1418,1307,-111
2015,9,20,9,1326,1391,1327,-64
2015,9,20,10,1298,1353,1326,-27
2015,9,20,11,1284,1345,1439,94
2015,9,20,12,1294,1364,1461,97
2015,9,20,13,1321,1385,1514,129
2015,9,20,14,1345,1395,1562,167
2015,9,20,15,1415,1478,1643,165
2015,9,20,16,1505,1561,1689,128
2015,9,20,17,1588,1638,1831,193
2015,9,20,18,1657,1711,1928,217
2015,9,20,19,1731,1780,2050,270
2015,9,20,20,1795,1866,2129,263
2015,9,20,21,1862,1933,2150,217
2015,9,20,22,1918,1993,2217,224
2015,9,20,23,1951,2031,2249,218
2015,9,21,0,1975,2051,2286,235
2015,9,21,1,1945,2019,2303,284
2015,9,21,2,1934,2022,2348,326
2015,9,21,3,1919,1969,2359,390
2015,9,21,4,1836,1835,2279,444
2015,9,21,5,1686,1679,2009,330
2015,9,21,6,1537,1528,1775,247
2015,9,21,7,1428,1430,1597,167
2015,9,21,8,1365,1380,1557,177
2015,9,21,9,1325,1352,1510,158
2015,9,21,10,1307,1336,1509,173
2015,9,21,11,1312,1357,1537,180
2015,9,21,12,1359,1427,1547,120
2015,9,21,13,1455,1564,1582,18
2015,9,21,14,1509,1597,1569,-28
2015,9,21,15,1558,1629,1591,-38
2015,9,21,16,1638,1701,1729,28
2015,9,21,17,1721,1760,1853,93
2015,9,21,18,1789,1819,1970,151
2015,9,21,19,1862,1864,2088,224
2015,9,21,20,1938,1917,2108,191
2015,9,21,21,2003,1932,2111,179
2015,9,21,22,2052,1936,2128,192
2015,9,21,23,2072,1937,2198,261
2015,9,22,0,2060,1901,2198,297
2015,9,22,1,2003,1866,2158,292
2015,9,22,2,1980,1919,2253,334
2015,9,22,3,1984,1892,2213,321
2015,9,22,4,1891,1789,2086,297
2015,9,22,5,1735,1628,1890,262
2015,9,22,6,1576,1494,1741,247
2015,9,22,7,1461,1406,1549,143
2015,9,22,8,1347,1362,1587,225
2015,9,22,9,1310,1334,1632,298
2015,9,22,10,1297,1322,1629,307
2015,9,22,11,1303,1343,1680,337
2015,9,22,12,1362,1403,1709,306
2015,9,22,13,1484,1533,1776,243
2015,9,22,14,1551,1596,1866,270
2015,9,22,15,1592,1637,1908,271
2015,9,22,16,1645,1678,2059,381
2015,9,22,17,1697,1708,2104,396
2015,9,22,18,1732,1747,2159,412
2015,9,22,19,1773,1792,2125,333
2015,9,22,20,1821,1844,2191,347
2015,9,22,21,1858,1869,2243,374
2015,9,22,22,1875,1821,2234,413
2015,9,22,23,1878,1790,2299,509
2015,9,23,0,1840,1763,2294,531
2015,9,23,1,1804,1768,2285,517
2015,9,23,2,1813,1835,2353,518
2015,9,23,3,1832,1833,2329,496
2015,9,23,4,1757,1746,2169,423
2015,9,23,5,1615,1596,2104,508
2015,9,23,6,1474,1462,1971,509
2015,9,23,7,1375,1376,1800,424
2015,9,23,8,1310,1334,1798,464
2015,9,23,9,1276,1302,1785,483
2015,9,23,10,1264,1295,1753,458
2015,9,23,11,1268,1300,1780,480
2015,9,23,12,1328,1373,1726,353
2015,9,23,13,1446,1512,1776,264
2015,9,23,14,1514,1547,1861,314
2015,9,23,15,1548,1586,1912,326
2015,9,23,16,1596,1630,2023,393
2015,9,23,17,1653,1682,2188,506
2015,9,23,18,1696,1703,2174,471
2015,9,23,19,1739,1742,2110,368
2015,9,23,20,1785,1799,1886,87
2015,9,23,21,1832,1854,1796,-58
2015,9,23,22,1859,1898,1855,-43
2015,9,23,23,1867,1901,1882,-19
2015,9,24,0,1852,1882,1924,42
2015,9,24,1,1821,1857,1980,123
2015,9,24,2,1823,1904,2014,110
2015,9,24,3,1837,1887,2001,114
2015,9,24,4,1760,1770,1900,130
2015,9,24,5,1612,1621,1842,221
2015,9,24,6,1466,1480,1795,315
2015,9,24,7,1369,1401,1340,-61
2015,9,24,8,1309,1350,1142,-208
2015,9,24,9,1276,1312,1092,-220
2015,9,24,10,1264,1302,1089,-213
2015,9,24,11,1270,1313,1193,-120
2015,9,24,12,1330,1378,1239,-139
2015,9,24,13,1440,1510,1404,-106
2015,9,24,14,1509,1542,1443,-99
2015,9,24,15,1552,1589,1519,-70
2015,9,24,16,1605,1632,1667,35
2015,9,24,17,1665,1698,1762,64
2015,9,24,18,1719,1755,1914,159
2015,9,24,19,1777,1795,2014,219
2015,9,24,20,1838,1873,2136,263
2015,9,24,21,1897,1928,2146,218
2015,9,24,22,1927,1939,2101,162
2015,9,24,23,1937,1942,2044,102
2015,9,25,0,1913,1921,2020,99
2015,9,25,1,1876,1876,2024,148
2015,9,25,2,1863,1911,1996,85
2015,9,25,3,1866,1887,1950,63
2015,9,25,4,1779,1779,1818,39
2015,9,25,5,1633,1624,1708,84
2015,9,25,6,1505,1486,1665,179
2015,9,25,7,1384,1407,1412,5
2015,9,25,8,1318,1357,1198,-159
2015,9,25,9,1281,1319,1179,-140
2015,9,25,10,1265,1306,1178,-128
2015,9,25,11,1268,1320,1173,-147
2015,9,25,12,1326,1378,1170,-208
2015,9,25,13,1431,1513,1191,-322
2015,9,25,14,1505,1540,1200,-340
2015,9,25,15,1546,1579,1313,-266
2015,9,25,16,1601,1631,1557,-74
2015,9,25,17,1657,1688,1638,-50
2015,9,25,18,1702,1725,1763,38
2015,9,25,19,1749,1771,1834,63
2015,9,25,20,1804,1831,1932,101
2015,9,25,21,1847,1891,1915,24
2015,9,25,22,1877,1940,1854,-86
2015,9,25,23,1907,1976,1822,-154
2015,9,26,0,1883,1945,1861,-84
2015,9,26,1,1836,1883,1890,7
2015,9,26,2,1826,1883,1925,42
2015,9,26,3,1830,1843,1929,86
2015,9,26,4,1752,1749,1828,79
2015,9,26,5,1623,1611,1649,38
2015,9,26,6,1486,1489,1597,108
2015,9,26,7,1385,1403,1462,59
2015,9,26,8,1331,1342,1324,-18
2015,9,26,9,1289,1303,1240,-63
2015,9,26,10,1263,1282,1229,-53
2015,9,26,11,1251,1279,1257,-22
2015,9,26,12,1270,1306,1228,-78
2015,9,26,13,1306,1345,1227,-118
2015,9,26,14,1340,1368,1190,-178
2015,9,26,15,1413,1435,1257,-178
2015,9,26,16,1493,1496,1360,-136
2015,9,26,17,1566,1553,1507,-46
2015,9,26,18,1625,1610,1675,65
2015,9,26,19,1682,1668,1776,108
2015,9,26,20,1743,1733,1873,140
2015,9,26,21,1791,1800,1907,107
2015,9,26,22,1831,1852,1973,121
2015,9,26,23,1856,1909,2000,91
2015,9,27,0,1872,1922,1974,52
2015,9,27,1,1846,1884,1935,51
2015,9,27,2,1842,1901,1906,5
2015,9,27,3,1818,1841,1826,-15
2015,9,27,4,1751,1751,1708,-43
2015,9,27,5,1624,1621,1650,29
2015,9,27,6,1490,1488,1568,80
2015,9,27,7,1395,1402,1439,37
2015,9,27,8,1339,1349,1299,-50
2015,9,27,9,1293,1304,1284,-20
2015,9,27,10,1266,1278,1273,-5
2015,9,27,11,1251,1279,1261,-18
2015,9,27,12,1261,1288,1248,-40
2015,9,27,13,1284,1316,1256,-60
2015,9,27,14,1308,1332,1245,-87
2015,9,27,15,1378,1407,1316,-91
2015,9,27,16,1459,1474,1408,-66
2015,9,27,17,1538,1556,1501,-55
2015,9,27,18,1606,1627,1666,39
2015,9,27,19,1676,1710,1680,-30
2015,9,27,20,1751,1799,1700,-99
2015,9,27,21,1814,1870,1765,-105
2015,9,27,22,1875,1943,1839,-104
2015,9,27,23,1910,1999,1918,-81
2015,9,28,0,1936,2027,1906,-121
2015,9,28,1,1914,1996,1783,-213
2015,9,28,2,1900,1981,1798,-183
2015,9,28,3,1873,1919,1695,-224
2015,9,28,4,1783,1797,1701,-96
2015,9,28,5,1640,1648,1588,-60
2015,9,28,6,1493,1496,1540,44
2015,9,28,7,1395,1402,1374,-28
2015,9,28,8,1338,1348,1285,-63
2015,9,28,9,1296,1312,1276,-36
2015,9,28,10,1281,1287,1267,-20
2015,9,28,11,1280,1303,1225,-78
2015,9,28,12,1324,1369,1253,-116
2015,9,28,13,1419,1491,1251,-240
2015,9,28,14,1476,1536,1186,-350
2015,9,28,15,1530,1586,1281,-305
2015,9,28,16,1608,1668,1413,-255
2015,9,28,17,1692,1743,1509,-234
2015,9,28,18,1767,1815,1632,-183
2015,9,28,19,1839,1882,1684,-198
2015,9,28,20,1931,1964,1706,-258
2015,9,28,21,1998,2036,1729,-307
2015,9,28,22,2052,2086,1852,-234
2015,9,28,23,2071,2122,1939,-183
2015,9,29,0,2065,2109,1907,-202
2015,9,29,1,2001,2053,1839,-214
2015,9,29,2,1976,2064,1849,-215
2015,9,29,3,1966,1996,1730,-266
2015,9,29,4,1865,1863,1625,-238
2015,9,29,5,1706,1681,1570,-111
2015,9,29,6,1542,1519,1441,-78
2015,9,29,7,1433,1425,1325,-100
2015,9,29,8,1361,1373,1319,-54
2015,9,29,9,1319,1344,1291,-53
2015,9,29,10,1298,1319,1290,-29
2015,9,29,11,1305,1332,1277,-55
2015,9,29,12,1356,1390,1255,-135
2015,9,29,13,1464,1525,1241,-284
2015,9,29,14,1535,1560,1216,-344
2015,9,29,15,1591,1594,1252,-342
2015,9,29,16,1657,1668,1317,-351
2015,9,29,17,1728,1734,1396,-338
2015,9,29,18,1810,1803,1529,-274
2015,9,29,19,1885,1874,1631,-243
2015,9,29,20,1960,1948,1733,-215
2015,9,29,21,2022,2025,1815,-210
2015,9,29,22,2073,2097,1918,-179
2015,9,29,23,2114,2135,2001,-134
2015,9,30,0,2079,2134,1965,-169
2015,9,30,1,2027,2065,1888,-177
2015,9,30,2,1994,2084,1876,-208
2015,9,30,3,1991,2026,1802,-224
2015,9,30,4,1881,1889,1736,-153
2015,9,30,5,1713,1714,1628,-86
2015,9,30,6,1548,1565,1414,-151
2015,9,30,7,1429,1471,1338,-133
2015,9,30,8,1354,1409,1292,-117
2015,9,30,9,1315,1362,1293,-69
2015,9,30,10,1285,1352,1312,-40
2015,9,30,11,1308,1358,1262,-96
2015,9,30,12,1349,1425,1240,-185
2015,9,30,13,1459,1555,1329,-226
2015,9,30,14,1528,1600,1356,-244
2015,9,30,15,1591,1648,1332,-316
2015,9,30,16,1647,1707,1432,-275
2015,9,30,17,1709,1779,1568,-211
2015,9,30,18,1792,1834,1748,-86
2015,9,30,19,1867,1879,1835,-44
2015,9,30,20,1943,1927,1958,31
2015,9,30,21,2017,2030,1990,-40
2015,9,30,22,2080,2085,2013,-72
2015,9,30,23,2113,2116,2029,-87
2015,10,1,0,2097,2084,2030,-54
2015,10,1,1,2035,2028,1980,-48
2015,10,1,2,2001,2061,2039,-22
2015,10,1,3,2001,2001,2020,19
2015,10,1,4,1879,1878,1973,95
2015,10,1,5,1712,1702,1897,195
2015,10,1,6,1556,1554,1877,323
2015,10,1,7,1440,1465,1741,276
2015,10,1,8,1369,1406,1544,138
2015,10,1,9,1333,1379,1532,153
2015,10,1,10,1312,1357,1525,168
2015,10,1,11,1300,1369,1559,190
2015,10,1,12,1353,1442,1559,117
2015,10,1,13,1459,1566,1545,-21
2015,10,1,14,1528,1596,1532,-64
2015,10,1,15,1588,1647,1682,35
2015,10,1,16,1661,1710,1833,123
2015,10,1,17,1755,1783,2051,268
2015,10,1,18,1833,1836,2215,379
2015,10,1,19,1916,1911,2331,420
2015,10,1,20,2002,2006,2351,345
2015,10,1,21,2074,2075,2434,359
2015,10,1,22,2121,2114,2448,334
2015,10,1,23,2149,2157,2494,337
2015,10,2,0,2131,2156,2465,309
2015,10,2,1,2066,2082,2400,318
2015,10,2,2,2034,2105,2322,217
2015,10,2,3,2007,2040,2318,278
2015,10,2,4,1892,1910,2317,407
2015,10,2,5,1728,1748,2245,497
2015,10,2,6,1561,1586,2204,618
2015,10,2,7,1451,1487,2033,546
2015,10,2,8,1363,1417,1834,417
2015,10,2,9,1316,1383,1480,97
2015,10,2,10,1289,1355,1545,190
2015,10,2,11,1300,1367,1537,170
2015,10,2,12,1342,1431,1553,122
2015,10,2,13,1448,1559,1621,62
2015,10,2,14,1512,1589,1593,4
2015,10,2,15,1563,1641,1594,-47
2015,10,2,16,1632,1714,1692,-22
2015,10,2,17,1713,1792,1812,20
2015,10,2,18,1789,1842,1799,-43
2015,10,2,19,1857,1890,1902,12
2015,10,2,20,1937,2120,2164,44
2015,10,2,21,2002,1995,2141,146
2015,10,2,22,2041,2005,2204,199
2015,10,2,23,2050,1964,2258,294
2015,10,3,0,2012,1910,2210,300
2015,10,3,1,1925,1876,2167,291
2015,10,3,2,1905,1930,2238,308
2015,10,3,3,1902,1893,2184,291
2015,10,3,4,1817,1816,2041,225
2015,10,3,5,1667,1693,1841,148
2015,10,3,6,1521,1554,1807,253
2015,10,3,7,1410,1456,1615,159
2015,10,3,8,1338,1400,1346,-54
2015,10,3,9,1294,1361,1214,-147
2015,10,3,10,1261,1334,1186,-148
2015,10,3,11,1253,1336,1151,-185
2015,10,3,12,1268,1363,1186,-177
2015,10,3,13,1310,1408,1250,-158
2015,10,3,14,1348,1417,1273,-144
2015,10,3,15,1412,1478,1333,-145
2015,10,3,16,1481,1543,1403,-140
2015,10,3,17,1550,1597,1524,-73
2015,10,3,18,1602,1624,1642,18
2015,10,3,19,1647,1626,1688,62
2015,10,3,20,1694,1594,1683,89
2015,10,3,21,1752,1612,1812,200
2015,10,3,22,1762,1647,1818,171
2015,10,3,23,1787,1676,1831,155
2015,10,4,0,1782,1676,1851,175
2015,10,4,1,1753,1670,1862,192
2015,10,4,2,1768,1725,1870,145
2015,10,4,3,1749,1693,1876,183
2015,10,4,4,1682,1625,1760,135
2015,10,4,5,1566,1533,1608,75
2015,10,4,6,1448,1432,1491,59
2015,10,4,7,1352,1370,1348,-22
2015,10,4,8,1301,1323,1039,-284
2015,10,4,9,1260,1293,976,-317
2015,10,4,10,1235,1275,964,-311
2015,10,4,11,1225,1280,959,-321
2015,10,4,12,1246,1300,947,-353
2015,10,4,13,1276,1344,935,-409
2015,10,4,14,1298,1354,928,-426
2015,10,4,15,1356,1420,1008,-412
2015,10,4,16,1416,1485,1180,-305
2015,10,4,17,1481,1525,1344,-181
2015,10,4,18,1525,1549,1357,-192
2015,10,4,19,1564,1550,1347,-203
2015,10,4,20,1615,1560,1479,-81
2015,10,4,21,1635,1553,1531,-22
2015,10,4,22,1650,1560,1521,-39
2015,10,4,23,1654,1579,1515,-64
2015,10,5,0,1663,1605,1541,-64
2015,10,5,1,1642,1639,1613,-26
2015,10,5,2,1690,1719,1715,-4
2015,10,5,3,1696,1695,1667,-28
2015,10,5,4,1639,1618,1526,-92
2015,10,5,5,1514,1497,1430,-67
2015,10,5,6,1391,1391,1331,-60
2015,10,5,7,1300,1341,1159,-182
2015,10,5,8,1256,1298,927,-371
2015,10,5,9,1220,1277,910,-367
2015,10,5,10,1215,1279,929,-350
2015,10,5,11,1223,1300,918,-382
2015,10,5,12,1279,1367,923,-444
2015,10,5,13,1385,1494,1076,-418
2015,10,5,14,1443,1538,1235,-303
2015,10,5,15,1466,1575,1292,-283
2015,10,5,16,1506,1596,1477,-119
2015,10,5,17,1540,1612,1545,-67
2015,10,5,18,1549,1634,1656,22
2015,10,5,19,1577,1639,1710,71
2015,10,5,20,1614,1645,1641,-4
2015,10,5,21,1629,1649,1609,-40
2015,10,5,22,1636,1652,1752,100
2015,10,5,23,1635,1673,1828,155
2015,10,6,0,1632,1679,1911,232
2015,10,6,1,1622,1700,1783,83
2015,10,6,2,1662,1784,1748,-36
2015,10,6,3,1691,1757,1651,-106
2015,10,6,4,1629,1657,1443,-214
2015,10,6,5,1511,1523,1419,-104
2015,10,6,6,1372,1407,1063,-344
2015,10,6,7,1303,1345,863,-482
2015,10,6,8,1241,1306,800,-506
2015,10,6,9,1211,1283,761,-522
2015,10,6,10,1203,1279,759,-520
2015,10,6,11,1215,1297,745,-552
2015,10,6,12,1277,1361,768,-593
2015,10,6,13,1399,1491,912,-579
2015,10,6,14,1469,1531,1099,-432
2015,10,6,15,1486,1541,1090,-451
2015,10,6,16,1510,1565,1166,-399
2015,10,6,17,1541,1595,1234,-361
2015,10,6,18,1561,1615,1341,-274
2015,10,6,19,1580,1657,1354,-303
2015,10,6,20,1598,1645,1390,-255
2015,10,6,21,1615,1712,1483,-229
2015,10,6,22,1626,1709,1479,-230
2015,10,6,23,1622,1683,1518,-165
2015,10,7,0,1612,1651,1418,-233
2015,10,7,1,1616,1668,1400,-268
2015,10,7,2,1656,1724,1445,-279
2015,10,7,3,1688,1702,1424,-278
2015,10,7,4,1622,1608,1388,-220
2015,10,7,5,1492,1475,1298,-177
2015,10,7,6,1368,1363,1082,-281
2015,10,7,7,1287,1306,852,-454
2015,10,7,8,1233,1266,824,-442
2015,10,7,9,1207,1255,806,-449
2015,10,7,10,1201,1250,781,-469
2015,10,7,11,1218,1262,720,-542
2015,10,7,12,1280,1326,820,-506
2015,10,7,13,1401,1454,981,-473
2015,10,7,14,1484,1497,1107,-390
2015,10,7,15,1495,1509,1158,-351
2015,10,7,16,1510,1521,1231,-290
2015,10,7,17,1527,1562,1303,-259
2015,10,7,18,1534,1563,1280,-283
2015,10,7,19,1540,1578,1320,-258
2015,10,7,20,1545,1579,1385,-194
2015,10,7,21,1565,1584,1408,-176
2015,10,7,22,1570,1600,1482,-118
2015,10,7,23,1561,1593,1513,-80
2015,10,8,0,1568,1585,1487,-98
2015,10,8,1,1589,1619,1522,-97
2015,10,8,2,1622,1707,1583,-124
2015,10,8,3,1652,1691,1541,-150
2015,10,8,4,1600,1603,1446,-157
2015,10,8,5,1486,1476,1293,-183
2015,10,8,6,1366,1365,1055,-310
2015,10,8,7,1290,1310,857,-453
2015,10,8,8,1236,1258,756,-502
2015,10,8,9,1208,1244,740,-504
2015,10,8,10,1196,1233,693,-540
2015,10,8,11,1213,1257,726,-531
2015,10,8,12,1277,1324,736,-588
2015,10,8,13,1393,1430,895,-535
2015,10,8,14,1466,1487,1151,-336
2015,10,8,15,1479,1511,1266,-245
2015,10,8,16,1499,1542,1398,-144
2015,10,8,17,1521,1576,1501,-75
2015,10,8,18,1533,1578,1532,-46
2015,10,8,19,1549,1557,1511,-46
2015,10,8,20,1552,1594,1609,15
2015,10,8,21,1576,1600,1705,105
2015,10,8,22,1579,1617,1790,173
2015,10,8,23,1572,1615,1763,148
2015,10,9,0,1569,1618,1753,135
2015,10,9,1,1581,1633,1697,64
2015,10,9,2,1612,1717,1771,54
2015,10,9,3,1660,1711,1770,59
2015,10,9,4,1605,1641,1705,64
2015,10,9,5,1477,1517,1571,54
2015,10,9,6,1355,1405,1215,-190
2015,10,9,7,1281,1331,1092,-239
2015,10,9,8,1238,1285,773,-512
2015,10,9,9,1208,1264,764,-500
2015,10,9,10,1194,1252,766,-486
2015,10,9,11,1211,1270,793,-477
2015,10,9,12,1269,1332,857,-475
2015,10,9,13,1377,1447,1040,-407
2015,10,9,14,1451,1475,1117,-358
2015,10,9,15,1473,1524,1273,-251
2015,10,9,16,1502,1587,1558,-29
2015,10,9,17,1533,1620,1789,169
2015,10,9,18,1546,1644,1798,154
2015,10,9,19,1562,1651,1882,231
2015,10,9,20,1561,1692,1998,306
2015,10,9,21,1582,1714,2107,393
2015,10,9,22,1582,1730,2042,312
2015,10,9,23,1577,1709,1921,212
2015,10,10,0,1573,1683,1808,125
2015,10,10,1,1573,1686,1822,136
2015,10,10,2,1600,1769,1912,143
2015,10,10,3,1630,1755,1884,129
2015,10,10,4,1588,1689,1865,176
2015,10,10,5,1484,1496,1731,235
2015,10,10,6,1370,1422,1451,29
2015,10,10,7,1295,1349,1279,-70
2015,10,10,8,1244,1300,1158,-142
2015,10,10,9,1211,1276,1147,-129
2015,10,10,10,1191,1261,1159,-102
2015,10,10,11,1194,1268,1177,-91
2015,10,10,12,1216,1298,1213,-85
2015,10,10,13,1258,1347,1265,-82
2015,10,10,14,1293,1349,1238,-111
2015,10,10,15,1339,1392,1286,-106
2015,10,10,16,1398,1435,1409,-26
2015,10,10,17,1433,1449,1584,135
2015,10,10,18,1449,1466,1665,199
2015,10,10,19,1460,1473,1759,286
2015,10,10,20,1465,1492,1840,348
2015,10,10,21,1494,1527,1909,382
2015,10,10,22,1500,1553,1911,358
2015,10,10,23,1526,1588,1955,367
2015,10,11,0,1542,1600,1959,359
2015,10,11,1,1584,1612,1929,317
2015,10,11,2,1617,1668,1956,288
2015,10,11,3,1613,1644,1933,289
2015,10,11,4,1562,1591,1863,272
2015,10,11,5,1458,1497,1744,247
2015,10,11,6,1358,1417,1545,128
2015,10,11,7,1283,1339,1333,-6
2015,10,11,8,1252,1285,1310,25
2015,10,11,9,1215,1260,1300,40
2015,10,11,10,1195,1240,1276,36
2015,10,11,11,1194,1239,1243,4
2015,10,11,12,1208,1262,1234,-28
2015,10,11,13,1237,1303,1277,-26
2015,10,11,14,1260,1294,1308,14
2015,10,11,15,1313,1342,1353,11
2015,10,11,16,1373,1416,1510,94
2015,10,11,17,1425,1437,1676,239
2015,10,11,18,1453,1463,1825,362
2015,10,11,19,1490,1495,2013,518
2015,10,11,20,1519,1547,2094,547
2015,10,11,21,1553,1592,2069,477
2015,10,11,22,1592,1636,2097,461
2015,10,11,23,1616,1673,2093,420
2015,10,12,0,1639,1693,2031,338
2015,10,12,1,1651,1703,1943,240
2015,10,12,2,1680,1769,1981,212
2015,10,12,3,1683,1716,1966,250
2015,10,12,4,1617,1638,1928,290
2015,10,12,5,1488,1504,1867,363
2015,10,12,6,1365,1391,1516,125
2015,10,12,7,1284,1326,1266,-60
2015,10,12,8,1227,1277,1159,-118
2015,10,12,9,1207,1260,1196,-64
2015,10,12,10,1195,1256,1209,-47
2015,10,12,11,1204,1274,1244,-30
2015,10,12,12,1256,1325,1360,35
2015,10,12,13,1347,1436,1472,36
2015,10,12,14,1411,1477,1563,86
2015,10,12,15,1440,1523,1668,145
2015,10,12,16,1491,1565,1828,263
2015,10,12,17,1543,1609,1963,354
2015,10,12,18,1572,1656,2092,436
2015,10,12,19,1602,1696,2096,400
2015,10,12,20,1622,1749,2148,399
2015,10,12,21,1668,1793,2173,380
2015,10,12,22,1682,1845,2161,316
2015,10,12,23,1685,1881,2100,219
2015,10,13,0,1667,1874,2044,170
2015,10,13,1,1664,1844,2031,187
2015,10,13,2,1682,1874,2047,173
2015,10,13,3,1707,1818,2042,224
2015,10,13,4,1630,1704,2030,326
2015,10,13,5,1500,1553,1876,323
2015,10,13,6,1370,1432,1523,91
2015,10,13,7,1292,1362,1203,-159
2015,10,13,8,1237,1316,1187,-129
2015,10,13,9,1207,1286,1185,-101
2015,10,13,10,1200,1277,1201,-76
2015,10,13,11,1207,1287,1229,-58
2015,10,13,12,1267,1356,1234,-122
2015,10,13,13,1376,1491,1444,-47
2015,10,13,14,1450,1530,1568,38
2015,10,13,15,1472,1540,1556,16
2015,10,13,16,1513,1556,1560,4
2015,10,13,17,1540,1608,1739,131
2015,10,13,18,1580,1631,1861,230
2015,10,13,19,1609,1626,1864,238
2015,10,13,20,1645,1715,1934,219
2015,10,13,21,1686,1773,1990,217
2015,10,13,22,1722,1819,2095,276
2015,10,13,23,1738,1848,2087,239
2015,10,14,0,1727,1843,2040,197
2015,10,14,1,1707,1823,2009,186
2015,10,14,2,1739,1859,2027,168
2015,10,14,3,1756,1798,1956,158
2015,10,14,4,1656,1687,1942,255
2015,10,14,5,1512,1540,1828,288
2015,10,14,6,1386,1414,1538,124
2015,10,14,7,1293,1342,1330,-12
2015,10,14,8,1241,1307,1159,-148
2015,10,14,9,1212,1285,1154,-131
2015,10,14,10,1205,1283,1127,-156
2015,10,14,11,1216,1298,1110,-188
2015,10,14,12,1272,1370,1153,-217
2015,10,14,13,1384,1500,1325,-175
2015,10,14,14,1461,1536,1485,-51
2015,10,14,15,1482,1532,1548,16
2015,10,14,16,1519,1548,1695,147
2015,10,14,17,1549,1584,1802,218
2015,10,14,18,1595,1618,1917,299
2015,10,14,19,1627,1642,2047,405
2015,10,14,20,1666,1692,2137,445
2015,10,14,21,1706,1747,2211,464
2015,10,14,22,1737,1801,2200,399
2015,10,14,23,1752,1832,2257,425
2015,10,15,0,1741,1821,2277,456
2015,10,15,1,1729,1812,2257,445
2015,10,15,2,1751,1853,2292,439
2015,10,15,3,1759,1800,2178,378
2015,10,15,4,1660,1700,2110,410
2015,10,15,5,1518,1557,1882,325
2015,10,15,6,1404,1437,1670,233
2015,10,15,7,1311,1357,1392,35
2015,10,15,8,1241,1319,1312,-7
2015,10,15,9,1215,1279,1299,20
2015,10,15,10,1208,1269,1272,3
2015,10,15,11,1217,1288,1266,-22
2015,10,15,12,1274,1357,1297,-60
2015,10,15,13,1385,1503,1452,-51
2015,10,15,14,1458,1544,1498,-46
2015,10,15,15,1485,1543,1505,-38
2015,10,15,16,1517,1575,1644,69
2015,10,15,17,1559,1591,1777,186
2015,10,15,18,1599,1639,1838,199
2015,10,15,19,1624,1659,1829,170
2015,10,15,20,1675,1700,1905,205
2015,10,15,21,1710,1750,1882,132
2015,10,15,22,1751,1796,1907,111
2015,10,15,23,1760,1810,1913,103
2015,10,16,0,1748,1796,1742,-54
2015,10,16,1,1716,1803,1708,-95
2015,10,16,2,1744,1829,1798,-31
2015,10,16,3,1744,1801,1777,-24
2015,10,16,4,1668,1713,1719,6
2015,10,16,5,1534,1564,1649,85
2015,10,16,6,1404,1452,1532,80
2015,10,16,7,1316,1378,1336,-42
2015,10,16,8,1257,1329,1258,-71
2015,10,16,9,1225,1308,1132,-176
2015,10,16,10,1209,1295,1150,-145
2015,10,16,11,1222,1314,1110,-204
2015,10,16,12,1277,1375,1096,-279
2015,10,16,13,1389,1498,1176,-322
2015,10,16,14,1462,1517,1311,-206
2015,10,16,15,1491,1548,1374,-174
2015,10,16,16,1525,1577,1518,-59
2015,10,16,17,1551,1597,1512,-85
2015,10,16,18,1556,1607,1601,-6
2015,10,16,19,1549,1604,1680,76
2015,10,16,20,1564,1598,1764,166
2015,10,16,21,1571,1602,1771,169
2015,10,16,22,1578,1612,1797,185
2015,10,16,23,1572,1617,1771,154
2015,10,17,0,1552,1604,1723,119
2015,10,17,1,1559,1638,1704,66
2015,10,17,2,1609,1691,1744,53
2015,10,17,3,1629,1679,1699,20
2015,10,17,4,1582,1629,1541,-88
2015,10,17,5,1474,1534,1495,-39
2015,10,17,6,1368,1429,1421,-8
2015,10,17,7,1295,1350,1139,-211
2015,10,17,8,1248,1307,1000,-307
2015,10,17,9,1216,1282,1002,-280
2015,10,17,10,1200,1269,1006,-263
2015,10,17,11,1202,1273,1008,-265
2015,10,17,12,1229,1301,1025,-276
2015,10,17,13,1278,1365,1035,-330
2015,10,17,14,1315,1400,1031,-369
2015,10,17,15,1359,1448,1180,-268
2015,10,17,16,1414,1478,1303,-175
2015,10,17,17,1445,1501,1390,-111
2015,10,17,18,1459,1512,1475,-37
2015,10,17,19,1456,1519,1483,-36
2015,10,17,20,1462,1524,1563,39
2015,10,17,21,1473,1539,1548,9
2015,10,17,22,1487,1558,1544,-14
2015,10,17,23,1499,1567,1615,48
2015,10,18,0,1514,1580,1768,188
2015,10,18,1,1548,1629,1814,185
2015,10,18,2,1583,1681,1858,177
2015,10,18,3,1586,1652,1772,120
2015,10,18,4,1534,1594,1698,104
2015,10,18,5,1445,1501,1602,101
2015,10,18,6,1349,1408,1489,81
2015,10,18,7,1282,1349,1208,-141
2015,10,18,8,1237,1306,991,-315
2015,10,18,9,1206,1279,970,-309
2015,10,18,10,1189,1264,942,-322
2015,10,18,11,1190,1276,888,-388
2015,10,18,12,1210,1294,878,-416
2015,10,18,13,1247,1333,862,-471
2015,10,18,14,1272,1368,869,-499
2015,10,18,15,1312,1418,969,-449
2015,10,18,16,1367,1458,1125,-333
2015,10,18,17,1397,1502,1244,-258
2015,10,18,18,1414,1528,1342,-186
2015,10,18,19,1421,1551,1432,-119
2015,10,18,20,1436,1572,1353,-219
2015,10,18,21,1452,1588,1236,-352
2015,10,18,22,1476,1599,1225,-374
2015,10,18,23,1494,1613,1301,-312
2015,10,19,0,1513,1629,1441,-188
2015,10,19,1,1555,1701,1487,-214
2015,10,19,2,1601,1733,1519,-214
2015,10,19,3,1607,1694,1510,-184
2015,10,19,4,1552,1617,1418,-199
2015,10,19,5,1446,1499,1340,-159
2015,10,19,6,1342,1390,1224,-166
2015,10,19,7,1263,1322,1074,-248
2015,10,19,8,1226,1294,992,-302
2015,10,19,9,1202,1274,970,-304
2015,10,19,10,1193,1272,950,-322
2015,10,19,11,1209,1295,969,-326
2015,10,19,12,1264,1363,982,-381
2015,10,19,13,1364,1501,1100,-401
2015,10,19,14,1419,1564,1330,-234
2015,10,19,15,1442,1574,1319,-255
2015,10,19,16,1483,1595,1555,-40
2015,10,19,17,1515,1609,1629,20
2015,10,19,18,1534,1627,1673,46
2015,10,19,19,1544,1642,1715,73
2015,10,19,20,1558,1652,1789,137
2015,10,19,21,1583,1673,1788,115
2015,10,19,22,1594,1662,1796,134
2015,10,19,23,1597,1673,1832,159
2015,10,20,0,1590,1675,1781,106
2015,10,20,1,1599,1724,1791,67
2015,10,20,2,1643,1761,1833,72
2015,10,20,3,1668,1718,1784,66
2015,10,20,4,1605,1627,1641,14
2015,10,20,5,1470,1499,1471,-28
2015,10,20,6,1356,1395,1324,-71
2015,10,20,7,1278,1335,1087,-248
2015,10,20,8,1230,1299,881,-418
2015,10,20,9,1203,1277,915,-362
2015,10,20,10,1197,1267,962,-305
2015,10,20,11,1213,1284,973,-311
2015,10,20,12,1273,1354,976,-378
2015,10,20,13,1392,1489,1084,-405
2015,10,20,14,1466,1559,1243,-316
2015,10,20,15,1488,1552,1268,-284
2015,10,20,16,1510,1580,1361,-219
2015,10,20,17,1533,1562,1417,-145
2015,10,20,18,1549,1612,1462,-150
2015,10,20,19,1561,1586,1479,-107
2015,10,20,20,1568,1651,1609,-42
2015,10,20,21,1592,1657,1598,-59
2015,10,20,22,1596,1644,1655,11
2015,10,20,23,1596,1635,1590,-45
2015,10,21,0,1579,1639,1575,-64
2015,10,21,1,1600,1667,1591,-76
2015,10,21,2,1654,1692,1707,15
2015,10,21,3,1664,1648,1612,-36
2015,10,21,4,1602,1563,1541,-22
2015,10,21,5,1476,1453,1464,11
2015,10,21,6,1358,1360,1242,-118
2015,10,21,7,1279,1317,965,-352
2015,10,21,8,1237,1282,879,-403
2015,10,21,9,1212,1261,839,-422
2015,10,21,10,1205,1258,869,-389
2015,10,21,11,1222,1276,850,-426
2015,10,21,12,1284,1357,861,-496
2015,10,21,13,1409,1480,1064,-416
2015,10,21,14,1491,1568,1282,-286
2015,10,21,15,1503,1604,1343,-261
2015,10,21,16,1519,1636,1377,-259
2015,10,21,17,1537,1631,1389,-242
2015,10,21,18,1540,1626,1452,-174
2015,10,21,19,1543,1630,1477,-153
2015,10,21,20,1540,1619,1540,-79
2015,10,21,21,1546,1631,1578,-53
2015,10,21,22,1547,1613,1583,-30
2015,10,21,23,1537,1632,1617,-15
2015,10,22,0,1536,1634,1624,-10
2015,10,22,1,1574,1709,1705,-4
2015,10,22,2,1616,1733,1731,-2
2015,10,22,3,1635,1697,1698,1
2015,10,22,4,1589,1599,1593,-6
2015,10,22,5,1474,1476,1438,-38
2015,10,22,6,1364,1379,1177,-202
2015,10,22,7,1291,1325,944,-381
2015,10,22,8,1244,1287,887,-400
2015,10,22,9,1220,1272,851,-421
2015,10,22,10,1214,1270,848,-422
2015,10,22,11,1238,1288,878,-410
2015,10,22,12,1297,1373,899,-474
2015,10,22,13,1435,1536,1066,-470
2015,10,22,14,1512,1595,1216,-379
2015,10,22,15,1516,1575,1227,-348
2015,10,22,16,1527,1561,1280,-281
2015,10,22,17,1541,1572,1408,-164
2015,10,22,18,1545,1560,1423,-137
2015,10,22,19,1524,1544,1426,-118
2015,10,22,20,1527,1529,1589,60
2015,10,22,21,1529,1540,1610,70
2015,10,22,22,1525,1544,1676,132
2015,10,22,23,1523,1534,1654,120
2015,10,23,0,1513,1528,1614,86
2015,10,23,1,1560,1624,1651,27
2015,10,23,2,1616,1693,1759,66
2015,10,23,3,1641,1672,1779,107
2015,10,23,4,1581,1600,1653,53
2015,10,23,5,1474,1485,1481,-4
2015,10,23,6,1366,1391,1201,-190
2015,10,23,7,1295,1347,995,-352
2015,10,23,8,1263,1322,940,-382
2015,10,23,9,1239,1299,949,-350
2015,10,23,10,1231,1286,961,-325
2015,10,23,11,1249,1313,983,-330
2015,10,23,12,1311,1388,1055,-333
2015,10,23,13,1444,1522,1250,-272
2015,10,23,14,1521,1591,1521,-70
2015,10,23,15,1528,1587,1489,-98
2015,10,23,16,1540,1570,1420,-150
2015,10,23,17,1541,1552,1390,-162
2015,10,23,18,1534,1515,1393,-122
2015,10,23,19,1517,1530,1435,-95
2015,10,23,20,1517,1534,1498,-36
2015,10,23,21,1525,1534,1494,-40
2015,10,23,22,1522,1531,1494,-37
2015,10,23,23,1516,1541,1487,-54
2015,10,24,0,1512,1542,1527,-15
2015,10,24,1,1559,1596,1513,-83
2015,10,24,2,1605,1646,1596,-50
2015,10,24,3,1626,1637,1597,-40
2015,10,24,4,1575,1581,1551,-30
2015,10,24,5,1480,1507,1607,100
2015,10,24,6,1386,1416,1425,9
2015,10,24,7,1316,1344,1309,-35
2015,10,24,8,1279,1299,1200,-99
2015,10,24,9,1248,1278,1216,-62
2015,10,24,10,1232,1285,1205,-80
2015,10,24,11,1241,1305,1176,-129
2015,10,24,12,1273,1307,1167,-140
2015,10,24,13,1338,1341,1258,-83
2015,10,24,14,1372,1417,1533,116
2015,10,24,15,1408,1452,1623,171
2015,10,24,16,1450,1483,1645,162
2015,10,24,17,1470,1495,1380,-115
2015,10,24,18,1469,1486,1473,-13
2015,10,24,19,1461,1471,1421,-50
2015,10,24,20,1450,1465,1416,-49
2015,10,24,21,1446,1457,1410,-47
2015,10,24,22,1443,1463,1421,-42
2015,10,24,23,1448,1477,1390,-87
2015,10,25,0,1466,1503,1387,-116
2015,10,25,1,1523,1582,1420,-162
2015,10,25,2,1574,1630,1435,-195
2015,10,25,3,1584,1608,1375,-233
2015,10,25,4,1543,1553,1377,-176
2015,10,25,5,1462,1467,1350,-117
2015,10,25,6,1378,1384,1145,-239
2015,10,25,7,1314,1331,884,-447
2015,10,25,8,1271,1292,825,-467
2015,10,25,9,1243,1274,849,-425
2015,10,25,10,1230,1268,886,-382
2015,10,25,11,1235,1274,936,-338
2015,10,25,12,1262,1300,994,-306
2015,10,25,13,1310,1348,1067,-281
2015,10,25,14,1339,1393,1216,-177
2015,10,25,15,1371,1424,1285,-139
2015,10,25,16,1405,1441,1449,8
2015,10,25,17,1423,1440,1529,89
2015,10,25,18,1429,1444,1617,173
2015,10,25,19,1422,1445,1626,181
2015,10,25,20,1416,1442,1624,182
2015,10,25,21,1423,1445,1649,204
2015,10,25,22,1422,1449,1770,321
2015,10,25,23,1429,1480,1791,311
2015,10,26,0,1451,1525,1804,279
2015,10,26,1,1507,1641,1886,245
2015,10,26,2,1572,1680,1874,194
2015,10,26,3,1596,1647,1827,180
2015,10,26,4,1552,1581,1824,243
2015,10,26,5,1453,1474,1788,314
2015,10,26,6,1354,1363,1519,156
2015,10,26,7,1291,1305,1408,103
2015,10,26,8,1249,1275,1251,-24
2015,10,26,9,1225,1256,1236,-20
2015,10,26,10,1219,1257,1244,-13
2015,10,26,11,1238,1281,1258,-23
2015,10,26,12,1299,1357,1303,-54
2015,10,26,13,1408,1505,1496,-9
2015,10,26,14,1468,1581,1690,109
2015,10,26,15,1477,1565,1712,147
2015,10,26,16,1499,1566,1767,201
2015,10,26,17,1515,1553,1858,305
2015,10,26,18,1514,1553,1953,400
2015,10,26,19,1511,1554,1933,379
2015,10,26,20,1518,1566,1888,322
2015,10,26,21,1532,1569,1976,407
2015,10,26,22,1528,1578,1955,377
2015,10,26,23,1526,1593,1924,331
2015,10,27,0,1523,1585,1882,297
2015,10,27,1,1563,1657,1946,289
2015,10,27,2,1622,1702,1974,272
2015,10,27,3,1654,1688,1928,240
2015,10,27,4,1598,1611,1900,289
2015,10,27,5,1485,1486,1824,338
2015,10,27,6,1373,1386,1544,158
2015,10,27,7,1297,1329,1368,39
2015,10,27,8,1238,1290,1382,92
2015,10,27,9,1213,1276,1404,128
2015,10,27,10,1210,1272,1381,109
2015,10,27,11,1227,1304,1378,74
2015,10,27,12,1295,1384,1408,24
2015,10,27,13,1424,1546,1574,28
2015,10,27,14,1511,1604,1730,126
2015,10,27,15,1517,1570,1718,148
2015,10,27,16,1519,1552,1748,196
2015,10,27,17,1523,1516,1810,294
2015,10,27,18,1518,1544,1901,357
2015,10,27,19,1515,1494,1852,358
2015,10,27,20,1522,1551,1990,439
2015,10,27,21,1532,1565,2037,472
2015,10,27,22,1536,1568,2052,484
2015,10,27,23,1537,1574,2086,512
2015,10,28,0,1533,1589,2054,465
2015,10,28,1,1575,1677,1992,315
2015,10,28,2,1625,1720,2000,280
2015,10,28,3,1641,1702,1964,262
2015,10,28,4,1579,1622,1981,359
2015,10,28,5,1465,1503,1796,293
2015,10,28,6,1355,1380,1576,196
2015,10,28,7,1286,1329,1397,68
2015,10,28,8,1245,1292,1397,105
2015,10,28,9,1223,1277,1390,113
2015,10,28,10,1218,1277,1369,92
2015,10,28,11,1237,1305,1365,60
2015,10,28,12,1305,1392,1477,85
2015,10,28,13,1436,1549,1615,66
2015,10,28,14,1524,1609,1745,136
2015,10,28,15,1535,1586,1732,146
2015,10,28,16,1534,1584,1690,106
2015,10,28,17,1529,1567,1696,129
2015,10,28,18,1517,1564,1710,146
2015,10,28,19,1503,1554,1737,183
2015,10,28,20,1498,1551,1774,223
2015,10,28,21,1508,1539,1815,276
2015,10,28,22,1507,1538,1857,319
2015,10,28,23,1510,1550,1892,342
2015,10,29,0,1514,1563,1910,347
2015,10,29,1,1568,1670,1959,289
2015,10,29,2,1610,1710,2018,308
2015,10,29,3,1635,1694,1956,262
2015,10,29,4,1585,1623,1929,306
2015,10,29,5,1475,1508,1860,352
2015,10,29,6,1364,1394,1663,269
2015,10,29,7,1290,1342,1469,127
2015,10,29,8,1237,1302,1451,149
2015,10,29,9,1216,1281,1461,180
2015,10,29,10,1211,1285,1443,158
2015,10,29,11,1231,1313,1413,100
2015,10,29,12,1296,1397,1444,47
2015,10,29,13,1436,1553,1579,26
2015,10,29,14,1513,1636,1759,123
2015,10,29,15,1519,1614,1770,156
2015,10,29,16,1524,1626,1763,137
2015,10,29,17,1527,1632,1758,126
2015,10,29,18,1526,1618,1756,138
2015,10,29,19,1519,1613,1760,147
2015,10,29,20,1521,1600,1793,193
2015,10,29,21,1520,1607,1791,184
2015,10,29,22,1517,1588,1823,235
2015,10,29,23,1510,1603,1842,239
2015,10,30,0,1508,1635,1816,181
2015,10,30,1,1559,1742,1819,77
2015,10,30,2,1623,1755,1820,65
2015,10,30,3,1643,1738,1722,-16
2015,10,30,4,1585,1664,1621,-43
2015,10,30,5,1470,1541,1543,2
2015,10,30,6,1363,1429,1393,-36
2015,10,30,7,1290,1365,1288,-77
2015,10,30,8,1253,1328,1286,-42
2015,10,30,9,1226,1308,1284,-24
2015,10,30,10,1221,1304,1307,3
2015,10,30,11,1238,1321,1322,1
2015,10,30,12,1298,1395,1350,-45
2015,10,30,13,1426,1541,1481,-60
2015,10,30,14,1518,1628,1717,89
2015,10,30,15,1532,1631,1691,60
2015,10,30,16,1542,1647,1745,98
2015,10,30,17,1539,1648,1765,117
2015,10,30,18,1532,1631,1776,145
2015,10,30,19,1515,1607,1695,88
2015,10,30,20,1513,1602,1681,79
2015,10,30,21,1510,1601,1710,109
2015,10,30,22,1504,1601,1697,96
2015,10,30,23,1504,1612,1768,156
2015,10,31,0,1504,1627,1803,176
2015,10,31,1,1560,1705,1871,166
2015,10,31,2,1605,1715,1833,118
2015,10,31,3,1624,1698,1828,130
2015,10,31,4,1577,1659,1773,114
2015,10,31,5,1485,1563,1717,154
2015,10,31,6,1392,1475,1437,-38
2015,10,31,7,1327,1424,1209,-215
2015,10,31,8,1305,1380,1180,-200
2015,10,31,9,1274,1354,1198,-156
2015,10,31,10,1262,1346,1207,-139
2015,10,31,11,1268,1355,1258,-97
2015,10,31,12,1305,1391,1274,-117
2015,10,31,13,1369,1460,1383,-77
2015,10,31,14,1409,1518,1621,103
2015,10,31,15,1444,1545,1625,80
2015,10,31,16,1485,1552,1605,53
2015,10,31,17,1493,1542,1647,105
2015,10,31,18,1476,1513,1632,119
2015,10,31,19,1451,1493,1612,119
2015,10,31,20,1441,1470,1576,106
2015,10,31,21,1431,1466,1544,78
2015,10,31,22,1426,1469,1577,108
2015,10,31,23,1437,1495,1587,92
2015,11,1,0,1465,1524,1610,86
2015,11,1,1,1545,1598,1634,36
2015,11,1,2,1599,1622,1580,-42
2015,11,1,3,1601,1602,1550,-52
2015,11,1,4,1558,1571,1626,55
2015,11,1,5,1483,1512,1572,60
2015,11,1,6,1395,1436,1423,-13
2015,11,1,7,1330,1385,1244,-141
2015,11,1,8,1280,1340,1191,-149
2015,11,1,9,1254,1325,1162,-163
2015,11,1,10,1241,1313,1178,-135
2015,11,1,11,1246,1319,1178,-141
2015,11,1,12,1278,1336,1137,-199
2015,11,1,13,1338,1379,1195,-184
2015,11,1,14,1377,1414,1437,23
2015,11,1,15,1399,1448,1543,95
2015,11,1,16,1434,1466,1594,128
2015,11,1,17,1440,1475,1591,116
2015,11,1,18,1432,1464,1613,149
2015,11,1,19,1419,1461,1633,172
2015,11,1,20,1417,1469,1612,143
2015,11,1,21,1422,1471,1638,167
2015,11,1,22,1428,1478,1656,178
2015,11,1,23,1469,1507,1659,152
2015,11,2,0,1559,1552,1649,97
2015,11,2,1,1606,1673,1772,99
2015,11,2,2,1602,1728,1849,121
2015,11,2,3,1559,1702,1825,123
2015,11,2,4,1476,1652,1829,177
2015,11,2,5,1429,1569,1787,218
2015,11,2,6,1375,1466,1601,135
2015,11,2,7,1303,1374,1413,39
2015,11,2,8,1256,1332,1330,-2
2015,11,2,9,1234,1301,1332,31
2015,11,2,10,1225,1299,1315,16
2015,11,2,11,1240,1305,1315,10
2015,11,2,12,1291,1353,1301,-52
2015,11,2,13,1403,1448,1303,-145
2015,11,2,14,1483,1579,1463,-116
2015,11,2,15,1487,1598,1585,-13
2015,11,2,16,1495,1591,1647,56
2015,11,2,17,1498,1580,1736,156
2015,11,2,18,1497,1568,1715,147
2015,11,2,19,1493,1572,1766,194
2015,11,2,20,1495,1577,1775,198
2015,11,2,21,1502,1580,1815,235
2015,11,2,22,1507,1583,1876,293
2015,11,2,23,1533,1594,1891,297
2015,11,3,0,1616,1611,1853,242
2015,11,3,1,1659,1713,1836,123
2015,11,3,2,1650,1772,1869,97
2015,11,3,3,1606,1733,1721,-12
2015,11,3,4,1502,1705,1734,29
2015,11,3,5,1449,1608,1701,93
2015,11,3,6,1392,1490,1472,-18
2015,11,3,7,1316,1403,1253,-150
2015,11,3,8,1281,1340,1266,-74
2015,11,3,9,1246,1316,1280,-36
2015,11,3,10,1238,1309,1290,-19
2015,11,3,11,1245,1310,1268,-42
2015,11,3,12,1295,1339,1282,-57
2015,11,3,13,1398,1429,1375,-54
2015,11,3,14,1517,1542,1537,-5
2015,11,3,15,1541,1554,1613,59
2015,11,3,16,1539,1544,1573,29
2015,11,3,17,1539,1526,1623,97
2015,11,3,18,1538,1525,1729,204
2015,11,3,19,1528,1532,1793,261
2015,11,3,20,1533,1540,1810,270
2015,11,3,21,1537,1537,1779,242
2015,11,3,22,1539,1550,1802,252
2015,11,3,23,1549,1566,1782,216
2015,11,4,0,1562,1587,1738,151
2015,11,4,1,1635,1693,1791,98
2015,11,4,2,1663,1735,1803,68
2015,11,4,3,1661,1702,1791,89
2015,11,4,4,1621,1678,1875,197
2015,11,4,5,1529,1593,1869,276
2015,11,4,6,1416,1465,1714,249
2015,11,4,7,1326,1389,1468,79
2015,11,4,8,1281,1327,1349,22
2015,11,4,9,1254,1297,1344,47
2015,11,4,10,1246,1281,1321,40
2015,11,4,11,1249,1282,1249,-33
2015,11,4,12,1279,1324,1248,-76
2015,11,4,13,1375,1419,1323,-96
2015,11,4,14,1525,1541,1465,-76
2015,11,4,15,1556,1570,1601,31
2015,11,4,16,1560,1564,1676,112
2015,11,4,17,1561,1580,1707,127
2015,11,4,18,1548,1589,1811,222
2015,11,4,19,1560,1606,1946,340
2015,11,4,20,1560,1594,1974,380
2015,11,4,21,1580,1601,2035,434
2015,11,4,22,1544,1601,2023,422
2015,11,4,23,1560,1628,2066,438
2015,11,5,0,1574,1660,2005,345
2015,11,5,1,1663,1768,1971,203
2015,11,5,2,1719,1799,1966,167
2015,11,5,3,1690,1780,1882,102
2015,11,5,4,1675,1737,1825,88
2015,11,5,5,1596,1651,1776,125
2015,11,5,6,1465,1527,1639,112
2015,11,5,7,1376,1436,1372,-64
2015,11,5,8,1350,1379,1294,-85
2015,11,5,9,1322,1348,1230,-118
2015,11,5,10,1310,1327,1171,-156
2015,11,5,11,1318,1348,1153,-195
2015,11,5,12,1366,1392,1228,-164
2015,11,5,13,1467,1494,1380,-114
2015,11,5,14,1606,1617,1575,-42
2015,11,5,15,1626,1685,1678,-7
2015,11,5,16,1622,1688,1693,5
2015,11,5,17,1599,1684,1701,17
2015,11,5,18,1591,1667,1748,81
2015,11,5,19,1598,1649,1824,175
2015,11,5,20,1583,1615,1809,194
2015,11,5,21,1563,1602,1830,228
2015,11,5,22,1552,1592,1792,200
2015,11,5,23,1563,1594,1777,183
2015,11,6,0,1587,1631,1814,183
2015,11,6,1,1690,1784,1876,92
2015,11,6,2,1737,1836,1955,119
2015,11,6,3,1709,1819,1936,117
2015,11,6,4,1704,1802,1863,61
2015,11,6,5,1643,1725,1819,94
2015,11,6,6,1510,1612,1644,32
2015,11,6,7,1429,1521,1461,-60
2015,11,6,8,1377,1472,1286,-186
2015,11,6,9,1347,1438,1314,-124
2015,11,6,10,1335,1431,1331,-100
2015,11,6,11,1348,1438,1334,-104
2015,11,6,12,1392,1471,1329,-142
2015,11,6,13,1488,1559,1386,-173
2015,11,6,14,1624,1686,1483,-203
2015,11,6,15,1647,1708,1642,-66
2015,11,6,16,1625,1680,1642,-38
2015,11,6,17,1606,1652,1700,48
2015,11,6,18,1582,1613,1780,167
2015,11,6,19,1561,1599,1824,225
2015,11,6,20,1541,1573,1804,231
2015,11,6,21,1534,1545,1807,262
2015,11,6,22,1525,1534,1774,240
2015,11,6,23,1534,1556,1769,213
2015,11,7,0,1559,1589,1808,219
2015,11,7,1,1659,1726,1834,108
2015,11,7,2,1703,1772,1868,96
2015,11,7,3,1699,1757,1868,111
2015,11,7,4,1682,1754,1890,136
2015,11,7,5,1626,1688,1825,137
2015,11,7,6,1530,1602,1725,123
2015,11,7,7,1428,1530,1523,-7
2015,11,7,8,1408,1459,1405,-54
2015,11,7,9,1369,1434,1378,-56
2015,11,7,10,1353,1422,1393,-29
2015,11,7,11,1354,1422,1369,-53
2015,11,7,12,1372,1431,1240,-191
2015,11,7,13,1422,1482,1260,-222
2015,11,7,14,1487,1545,1386,-159
2015,11,7,15,1538,1559,1383,-176
2015,11,7,16,1571,1596,1392,-204
2015,11,7,17,1580,1600,1413,-187
2015,11,7,18,1566,1578,1384,-194
2015,11,7,19,1549,1558,1360,-198
2015,11,7,20,1533,1543,1387,-156
2015,11,7,21,1517,1525,1384,-141
2015,11,7,22,1510,1522,1426,-96
2015,11,7,23,1523,1539,1602,63
2015,11,8,0,1557,1583,1590,7
2015,11,8,1,1677,1739,1640,-99
2015,11,8,2,1729,1774,1620,-154
2015,11,8,3,1716,1772,1568,-204
2015,11,8,4,1690,1734,1608,-126
2015,11,8,5,1635,1680,1547,-133
2015,11,8,6,1542,1596,1453,-143
2015,11,8,7,1448,1528,1201,-327
2015,11,8,8,1417,1464,1145,-319
2015,11,8,9,1378,1432,1071,-361
2015,11,8,10,1361,1421,1085,-336
2015,11,8,11,1356,1423,1099,-324
2015,11,8,12,1365,1435,1106,-329
2015,11,8,13,1406,1468,1219,-249
2015,11,8,14,1463,1506,1373,-133
2015,11,8,15,1504,1537,1381,-156
2015,11,8,16,1534,1557,1464,-93
2015,11,8,17,1541,1544,1483,-61
2015,11,8,18,1527,1520,1537,17
2015,11,8,19,1520,1518,1571,53
2015,11,8,20,1511,1504,1600,96
2015,11,8,21,1499,1490,1640,150
2015,11,8,22,1497,1492,1701,209
2015,11,8,23,1505,1511,1763,252
2015,11,9,0,1551,1562,1744,182
2015,11,9,1,1671,1734,1760,26
2015,11,9,2,1747,1784,1803,19
2015,11,9,3,1734,1760,1785,25
2015,11,9,4,1703,1736,1836,100
2015,11,9,5,1628,1663,1846,183
2015,11,9,6,1520,1557,1665,108
2015,11,9,7,1415,1463,1432,-31
2015,11,9,8,1376,1415,1436,21
2015,11,9,9,1345,1388,1431,43
2015,11,9,10,1338,1374,1420,46
2015,11,9,11,1345,1388,1394,6
2015,11,9,12,1375,1433,1407,-26
2015,11,9,13,1461,1532,1280,-252
2015,11,9,14,1576,1663,1357,-306
2015,11,9,15,1617,1675,1541,-134
2015,11,9,16,1615,1658,1468,-190
2015,11,9,17,1605,1643,1497,-146
2015,11,9,18,1590,1613,1592,-21
2015,11,9,19,1581,1592,1587,-5
2015,11,9,20,1569,1585,1570,-15
2015,11,9,21,1568,1565,1552,-13
2015,11,9,22,1558,1556,1611,55
2015,11,9,23,1559,1573,1601,28
2015,11,10,0,1582,1605,1591,-14
2015,11,10,1,1677,1739,1765,26
2015,11,10,2,1751,1778,1833,55
2015,11,10,3,1738,1758,1792,34
2015,11,10,4,1727,1748,1802,54
2015,11,10,5,1642,1667,1655,-12
2015,11,10,6,1516,1552,1483,-69
2015,11,10,7,1412,1464,1285,-179
2015,11,10,8,1346,1400,1164,-236
2015,11,10,9,1314,1369,1161,-208
2015,11,10,10,1301,1362,1154,-208
2015,11,10,11,1305,1367,1148,-219
2015,11,10,12,1345,1405,1164,-241
2015,11,10,13,1442,1509,1357,-152
2015,11,10,14,1591,1640,1514,-126
2015,11,10,15,1619,1630,1645,15
2015,11,10,16,1598,1581,1628,47
2015,11,10,17,1578,1557,1641,84
2015,11,10,18,1558,1544,1723,179
2015,11,10,19,1546,1524,1817,293
2015,11,10,20,1538,1517,1824,307
2015,11,10,21,1532,1452,1830,378
2015,11,10,22,1531,1501,1922,421
2015,11,10,23,1536,1578,1972,394
2015,11,11,0,1572,1611,1901,290
2015,11,11,1,1711,1754,1966,212
2015,11,11,2,1751,1793,2007,214
2015,11,11,3,1730,1763,1878,115
2015,11,11,4,1713,1740,1850,110
2015,11,11,5,1636,1669,1789,120
2015,11,11,6,1510,1566,1528,-38
2015,11,11,7,1401,1488,1276,-212
2015,11,11,8,1457,1438,1256,-182
2015,11,11,9,1431,1405,1329,-76
2015,11,11,10,1405,1397,1361,-36
2015,11,11,11,1402,1402,1378,-24
2015,11,11,12,1420,1432,1381,-51
2015,11,11,13,1476,1510,1450,-60
2015,11,11,14,1581,1613,1735,122
2015,11,11,15,1695,1641,1856,215
2015,11,11,16,1713,1655,1999,344
2015,11,11,17,1693,1669,2033,364
2015,11,11,18,1670,1681,2050,369
2015,11,11,19,1659,1627,2034,407
2015,11,11,20,1644,1604,2060,456
2015,11,11,21,1632,1575,2079,504
2015,11,11,22,1626,1584,2084,500
2015,11,11,23,1628,1590,2090,500
2015,11,12,0,1651,1644,2057,413
2015,11,12,1,1713,1802,2104,302
2015,11,12,2,1843,1861,2107,246
2015,11,12,3,1873,1845,2062,217
2015,11,12,4,1859,1828,2044,216
2015,11,12,5,1841,1762,1943,181
2015,11,12,6,1755,1641,1784,143
2015,11,12,7,1637,1556,1563,7
2015,11,12,8,1523,1504,1445,-59
2015,11,12,9,1494,1479,1432,-47
2015,11,12,10,1480,1481,1410,-71
2015,11,12,11,1489,1479,1426,-53
2015,11,12,12,1526,1525,1404,-121
2015,11,12,13,1624,1638,1431,-207
2015,11,12,14,1773,1769,1590,-179
2015,11,12,15,1770,1784,1647,-137
2015,11,12,16,1713,1755,1608,-147
2015,11,12,17,1675,1720,1664,-56
2015,11,12,18,1644,1672,1680,8
2015,11,12,19,1619,1636,1719,83
2015,11,12,20,1600,1609,1734,125
2015,11,12,21,1587,1594,1743,149
2015,11,12,22,1565,1584,1804,220
2015,11,12,23,1636,1601,1824,223
2015,11,13,0,1671,1635,1872,237
2015,11,13,1,1814,1780,1977,197
2015,11,13,2,1866,1835,2062,227
2015,11,13,3,1842,1825,2040,215
2015,11,13,4,1836,1817,2001,184
2015,11,13,5,1771,1744,1881,137
2015,11,13,6,1659,1635,1716,81
2015,11,13,7,1573,1562,1425,-137
2015,11,13,8,1509,1503,1386,-117
2015,11,13,9,1483,1475,1357,-118
2015,11,13,10,1478,1470,1329,-141
2015,11,13,11,1480,1482,1340,-142
2015,11,13,12,1518,1516,1350,-166
2015,11,13,13,1603,1616,1356,-260
2015,11,13,14,1730,1759,1469,-290
2015,11,13,15,1755,1772,1449,-323
2015,11,13,16,1739,1745,1350,-395
2015,11,13,17,1715,1704,1370,-334
2015,11,13,18,1692,1669,1381,-288
2015,11,13,19,1646,1628,1515,-113
2015,11,13,20,1622,1586,1563,-23
2015,11,13,21,1611,1570,1595,25
2015,11,13,22,1600,1575,1558,-17
2015,11,13,23,1600,1586,1300,-286
2015,11,14,0,1641,1629,1224,-405
2015,11,14,1,1759,1765,1257,-508
2015,11,14,2,1811,1794,1235,-559
2015,11,14,3,1790,1767,1203,-564
2015,11,14,4,1785,1772,1232,-540
2015,11,14,5,1743,1719,1229,-490
2015,11,14,6,1651,1644,1200,-444
2015,11,14,7,1569,1568,1108,-460
2015,11,14,8,1524,1497,898,-599
2015,11,14,9,1490,1468,966,-502
2015,11,14,10,1475,1455,969,-486
2015,11,14,11,1476,1455,961,-494
2015,11,14,12,1495,1479,964,-515
2015,11,14,13,1541,1524,982,-542
2015,11,14,14,1608,1585,988,-597
2015,11,14,15,1639,1617,1119,-498
2015,11,14,16,1662,1640,1159,-481
2015,11,14,17,1663,1615,1206,-409
2015,11,14,18,1639,1584,1222,-362
2015,11,14,19,1612,1550,1212,-338
2015,11,14,20,1593,1526,1223,-303
2015,11,14,21,1575,1515,1219,-296
2015,11,14,22,1558,1504,1196,-308
2015,11,14,23,1569,1520,1275,-245
2015,11,15,0,1601,1567,1297,-270
2015,11,15,1,1719,1724,1417,-307
2015,11,15,2,1784,1747,1414,-333
2015,11,15,3,1767,1716,1395,-321
2015,11,15,4,1750,1675,1363,-312
2015,11,15,5,1707,1627,1333,-294
2015,11,15,6,1620,1561,1231,-330
2015,11,15,7,1546,1504,1152,-352
2015,11,15,8,1477,1452,1104,-348
2015,11,15,9,1443,1408,1155,-253
2015,11,15,10,1426,1388,1184,-204
2015,11,15,11,1425,1381,1214,-167
2015,11,15,12,1437,1392,1223,-169
2015,11,15,13,1475,1427,1256,-171
2015,11,15,14,1527,1464,1269,-195
2015,11,15,15,1553,1492,1266,-226
2015,11,15,16,1590,1533,1233,-300
2015,11,15,17,1593,1580,1257,-323
2015,11,15,18,1572,1618,1272,-346
2015,11,15,19,1561,1648,1282,-366
2015,11,15,20,1557,1668,1233,-435
2015,11,15,21,1550,1689,1263,-426
2015,11,15,22,1541,1684,1251,-433
2015,11,15,23,1557,1677,1195,-482
2015,11,16,0,1610,1717,1166,-551
2015,11,16,1,1750,1841,1261,-580
2015,11,16,2,1813,1869,1368,-501
2015,11,16,3,1796,1838,1404,-434
2015,11,16,4,1772,1803,1373,-430
2015,11,16,5,1704,1718,1253,-465
2015,11,16,6,1593,1600,1236,-364
2015,11,16,7,1510,1486,1153,-333
2015,11,16,8,1447,1414,1150,-264
2015,11,16,9,1412,1384,1230,-154
2015,11,16,10,1407,1371,1313,-58
2015,11,16,11,1411,1362,1312,-50
2015,11,16,12,1439,1399,1338,-61
2015,11,16,13,1516,1484,1334,-150
2015,11,16,14,1633,1640,1385,-255
2015,11,16,15,1678,1710,1450,-260
2015,11,16,16,1693,1710,1504,-206
2015,11,16,17,1704,1870,1674,-196
2015,11,16,18,1691,1709,1430,-279
2015,11,16,19,1685,1745,1421,-324
2015,11,16,20,1675,1780,1449,-331
2015,11,16,21,1672,1781,1463,-318
2015,11,16,22,1664,1797,1475,-322
2015,11,16,23,1685,1835,1453,-382
2015,11,17,0,1729,1870,1488,-382
2015,11,17,1,1848,2001,1510,-491
2015,11,17,2,1916,2020,1444,-576
2015,11,17,3,1904,1996,1485,-511
2015,11,17,4,1893,1947,1536,-411
2015,11,17,5,1810,1855,1504,-351
2015,11,17,6,1685,1715,1395,-320
2015,11,17,7,1596,1615,1291,-324
2015,11,17,8,1530,1546,1377,-169
2015,11,17,9,1498,1512,1461,-51
2015,11,17,10,1487,1490,1496,6
2015,11,17,11,1495,1479,1528,49
2015,11,17,12,1535,1508,1525,17
2015,11,17,13,1627,1570,1481,-89
2015,11,17,14,1765,1697,1502,-195
2015,11,17,15,1795,1742,1658,-84
2015,11,17,16,1780,1757,1654,-103
2015,11,17,17,1760,1750,1646,-104
2015,11,17,18,1740,1708,1681,-27
2015,11,17,19,1720,1700,1666,-34
2015,11,17,20,1703,1697,1648,-49
2015,11,17,21,1694,1673,1669,-4
2015,11,17,22,1688,1653,1625,-28
2015,11,17,23,1695,1676,1566,-110
2015,11,18,0,1732,1735,1590,-145
2015,11,18,1,1868,1927,1648,-279
2015,11,18,2,1945,1979,1599,-380
2015,11,18,3,1938,1957,1606,-351
2015,11,18,4,1918,1925,1640,-285
2015,11,18,5,1840,1840,1650,-190
2015,11,18,6,1720,1695,1593,-102
2015,11,18,7,1627,1601,1428,-173
2015,11,18,8,1576,1543,1411,-132
2015,11,18,9,1540,1508,1332,-176
2015,11,18,10,1529,1500,1295,-205
2015,11,18,11,1532,1508,1326,-182
2015,11,18,12,1568,1542,1358,-184
2015,11,18,13,1665,1631,1385,-246
2015,11,18,14,1817,1751,1540,-211
2015,11,18,15,1852,1744,1571,-173
2015,11,18,16,1819,1692,1525,-167
2015,11,18,17,1785,1655,1551,-104
2015,11,18,18,1755,1623,1690,67
2015,11,18,19,1727,1595,1742,147
2015,11,18,20,1702,1561,1724,163
2015,11,18,21,1680,1546,1755,209
2015,11,18,22,1671,1548,1711,163
2015,11,18,23,1685,1571,1754,183
2015,11,19,0,1720,1642,1829,187
2015,11,19,1,1857,1804,1777,-27
2015,11,19,2,1933,1856,1721,-135
2015,11,19,3,1929,1848,1743,-105
2015,11,19,4,1913,1824,1712,-112
2015,11,19,5,1841,1761,1694,-67
2015,11,19,6,1719,1651,1722,71
2015,11,19,7,1629,1561,1731,170
2015,11,19,8,1566,1498,1602,104
2015,11,19,9,1540,1473,1601,128
2015,11,19,10,1528,1454,1563,109
2015,11,19,11,1537,1470,1571,101
2015,11,19,12,1581,1511,1550,39
2015,11,19,13,1682,1620,1517,-103
2015,11,19,14,1828,1785,1447,-338
2015,11,19,15,1849,1801,1423,-378
2015,11,19,16,1821,1747,1424,-323
2015,11,19,17,1787,1705,1443,-262
2015,11,19,18,1747,1682,1424,-258
2015,11,19,19,1720,1643,1453,-190
2015,11,19,20,1691,1609,1459,-150
2015,11,19,21,1676,1603,1445,-158
2015,11,19,22,1661,1601,1458,-143
2015,11,19,23,1670,1605,1428,-177
2015,11,20,0,1708,1644,1492,-152
2015,11,20,1,1842,1806,1587,-219
2015,11,20,2,1917,1844,1659,-185
2015,11,20,3,1914,1817,1636,-181
2015,11,20,4,1891,1802,1637,-165
2015,11,20,5,1822,1737,1627,-110
2015,11,20,6,1699,1633,1558,-75
2015,11,20,7,1607,1540,1506,-34
2015,11,20,8,1515,1486,1503,17
2015,11,20,9,1486,1453,1519,66
2015,11,20,10,1474,1443,1546,103
2015,11,20,11,1479,1450,1584,134
2015,11,20,12,1517,1485,1602,117
2015,11,20,13,1615,1586,1559,-27
2015,11,20,14,1757,1738,1578,-160
2015,11,20,15,1781,1753,1579,-174
2015,11,20,16,1759,1716,1510,-206
2015,11,20,17,1725,1686,1406,-280
2015,11,20,18,1693,1644,1488,-156
2015,11,20,19,1669,1615,1533,-82
2015,11,20,20,1645,1577,1556,-21
2015,11,20,21,1630,1567,1616,49
2015,11,20,22,1620,1581,1653,72
2015,11,20,23,1632,1575,1651,76
2015,11,21,0,1666,1619,1539,-80
2015,11,21,1,1805,1753,1496,-257
2015,11,21,2,1861,1780,1510,-270
2015,11,21,3,1841,1753,1490,-263
2015,11,21,4,1827,1740,1570,-170
2015,11,21,5,1775,1688,1566,-122
2015,11,21,6,1678,1600,1541,-59
2015,11,21,7,1585,1521,1558,37
2015,11,21,8,1550,1462,1553,91
2015,11,21,9,1518,1430,1534,104
2015,11,21,10,1499,1412,1502,90
2015,11,21,11,1502,1415,1583,168
2015,11,21,12,1523,1414,1580,166
2015,11,21,13,1571,1491,1544,53
2015,11,21,14,1642,1576,1486,-90
2015,11,21,15,1682,1606,1415,-191
2015,11,21,16,1720,1619,1442,-177
2015,11,21,17,1733,1622,1400,-222
2015,11,21,18,1726,1595,1354,-241
2015,11,21,19,1709,1580,1324,-256
2015,11,21,20,1689,1559,1318,-241
2015,11,21,21,1667,1530,1302,-228
2015,11,21,22,1658,1526,1314,-212
2015,11,21,23,1675,1543,1327,-216
2015,11,22,0,1720,1607,1339,-268
2015,11,22,1,1864,1780,1434,-346
2015,11,22,2,1925,1804,1484,-320
2015,11,22,3,1920,1788,1529,-259
2015,11,22,4,1890,1773,1583,-190
2015,11,22,5,1833,1723,1577,-146
2015,11,22,6,1740,1640,1573,-67
2015,11,22,7,1650,1576,1546,-30
2015,11,22,8,1566,1539,1461,-78
2015,11,22,9,1532,1500,1404,-96
2015,11,22,10,1515,1469,1392,-77
2015,11,22,11,1515,1495,1440,-55
2015,11,22,12,1529,1514,1423,-91
2015,11,22,13,1573,1557,1368,-189
2015,11,22,14,1627,1610,1347,-263
2015,11,22,15,1652,1629,1355,-274
2015,11,22,16,1674,1650,1344,-306
2015,11,22,17,1674,1630,1305,-325
2015,11,22,18,1656,1608,1306,-302
2015,11,22,19,1634,1581,1312,-269
2015,11,22,20,1615,1551,1320,-231
2015,11,22,21,1596,1536,1324,-212
2015,11,22,22,1589,1538,1357,-181
2015,11,22,23,1601,1550,1364,-186
2015,11,23,0,1652,1616,1375,-241
2015,11,23,1,1800,1796,1504,-292
2015,11,23,2,1884,1859,1550,-309
2015,11,23,3,1883,1856,1584,-272
2015,11,23,4,1850,1830,1557,-273
2015,11,23,5,1778,1770,1540,-230
2015,11,23,6,1682,1676,1533,-143
2015,11,23,7,1596,1561,1475,-86
2015,11,23,8,1533,1499,1453,-46
2015,11,23,9,1508,1480,1444,-36
2015,11,23,10,1495,1474,1446,-28
2015,11,23,11,1503,1491,1448,-43
2015,11,23,12,1538,1529,1461,-68
2015,11,23,13,1621,1629,1515,-114
2015,11,23,14,1732,1775,1724,-51
2015,11,23,15,1778,1796,1861,65
2015,11,23,16,1761,1758,1605,-153
2015,11,23,17,1741,1727,1303,-424
2015,11,23,18,1717,1694,1354,-340
2015,11,23,19,1698,1647,1373,-274
2015,11,23,20,1676,1622,1386,-236
2015,11,23,21,1666,1605,1401,-204
2015,11,23,22,1656,1587,1399,-188
2015,11,23,23,1665,1595,1364,-231
2015,11,24,0,1705,1638,1361,-277
2015,11,24,1,1839,1797,1564,-233
2015,11,24,2,1911,1843,1698,-145
2015,11,24,3,1908,1833,1718,-115
2015,11,24,4,1892,1817,1666,-151
2015,11,24,5,1817,1757,1558,-199
2015,11,24,6,1701,1638,1459,-179
2015,11,24,7,1610,1548,1243,-305
2015,11,24,8,1524,1494,1171,-323
2015,11,24,9,1493,1467,1139,-328
2015,11,24,10,1481,1452,1122,-330
2015,11,24,11,1487,1460,1037,-423
2015,11,24,12,1528,1495,1126,-369
2015,11,24,13,1627,1594,1245,-349
2015,11,24,14,1775,1740,1448,-292
2015,11,24,15,1797,1735,1643,-92
2015,11,24,16,1759,1704,1615,-89
2015,11,24,17,1719,1670,1633,-37
2015,11,24,18,1685,1633,1628,-5
2015,11,24,19,1664,1597,1683,86
2015,11,24,20,1641,1593,1723,130
2015,11,24,21,1631,1571,1732,161
2015,11,24,22,1622,1570,1706,136
2015,11,24,23,1635,1579,1665,86
2015,11,25,0,1677,1622,1588,-34
2015,11,25,1,1821,1766,1590,-176
2015,11,25,2,1883,1805,1550,-255
2015,11,25,3,1869,1802,1559,-243
2015,11,25,4,1845,1778,1582,-196
2015,11,25,5,1772,1731,1549,-182
2015,11,25,6,1654,1616,1369,-247
2015,11,25,7,1549,1515,1156,-359
2015,11,25,8,1469,1459,1113,-346
2015,11,25,9,1465,1410,1081,-329
2015,11,25,10,1441,1401,1075,-326
2015,11,25,11,1436,1402,1042,-360
2015,11,25,12,1453,1426,1031,-395
2015,11,25,13,1511,1487,1114,-373
2015,11,25,14,1621,1618,1335,-283
2015,11,25,15,1730,1647,1545,-102
2015,11,25,16,1734,1644,1578,-66
2015,11,25,17,1703,1655,1625,-30
2015,11,25,18,1678,1645,1607,-38
2015,11,25,19,1659,1640,1593,-47
2015,11,25,20,1639,1586,1575,-11
2015,11,25,21,1632,1572,1561,-11
2015,11,25,22,1621,1570,1475,-95
2015,11,25,23,1620,1580,1476,-104
2015,11,26,0,1637,1638,1549,-89
2015,11,26,1,1700,1783,1710,-73
2015,11,26,2,1815,1785,1719,-66
2015,11,26,3,1836,1757,1653,-104
2015,11,26,4,1814,1743,1624,-119
2015,11,26,5,1779,1679,1530,-149
2015,11,26,6,1687,1588,1377,-211
2015,11,26,7,1572,1501,1168,-333
2015,11,26,8,1481,1422,1159,-263
2015,11,26,9,1452,1367,1179,-188
2015,11,26,10,1446,1346,1191,-155
2015,11,26,11,1448,1334,1190,-144
2015,11,26,12,1484,1349,1186,-163
2015,11,26,13,1540,1385,1209,-176
2015,11,26,14,1602,1437,1361,-76
2015,11,26,15,1641,1482,1537,55
2015,11,26,16,1656,1533,1564,31
2015,11,26,17,1675,1574,1577,3
2015,11,26,18,1668,1604,1669,65
2015,11,26,19,1650,1603,1683,80
2015,11,26,20,1587,1552,1663,111
2015,11,26,21,1519,1494,1628,134
2015,11,26,22,1472,1452,1751,299
2015,11,26,23,1452,1440,1776,336
2015,11,27,0,1468,1463,1844,381
2015,11,27,1,1589,1574,1973,399
2015,11,27,2,1622,1592,1955,363
2015,11,27,3,1629,1586,2020,434
2015,11,27,4,1644,1599,2008,409
2015,11,27,5,1611,1583,1986,403
2015,11,27,6,1568,1521,1875,354
2015,11,27,7,1515,1463,1658,195
2015,11,27,8,1467,1413,1536,123
2015,11,27,9,1440,1344,1507,163
2015,11,27,10,1437,1325,1394,69
2015,11,27,11,1444,1345,1396,51
2015,11,27,12,1481,1369,1424,55
2015,11,27,13,1541,1416,1474,58
2015,11,27,14,1603,1487,1716,229
2015,11,27,15,1624,1522,1790,268
2015,11,27,16,1632,1569,1825,256
2015,11,27,17,1640,1626,1879,253
2015,11,27,18,1627,1655,1937,282
2015,11,27,19,1607,1650,1962,312
2015,11,27,20,1573,1638,1956,318
2015,11,27,21,1551,1626,1961,335
2015,11,27,22,1539,1641,1963,322
2015,11,27,23,1550,1666,2021,355
2015,11,28,0,1605,1731,2057,326
2015,11,28,1,1780,1866,2123,257
2015,11,28,2,1819,1878,2091,213
2015,11,28,3,1809,1853,2022,169
2015,11,28,4,1811,1844,2049,205
2015,11,28,5,1748,1789,2026,237
2015,11,28,6,1682,1706,1937,231
2015,11,28,7,1610,1623,1631,8
2015,11,28,8,1544,1552,1485,-67
2015,11,28,9,1509,1517,1449,-68
2015,11,28,10,1488,1496,1394,-102
2015,11,28,11,1481,1491,1450,-41
2015,11,28,12,1506,1500,1451,-49
2015,11,28,13,1551,1543,1508,-35
2015,11,28,14,1608,1599,1676,77
2015,11,28,15,1637,1634,1807,173
2015,11,28,16,1667,1695,1872,177
2015,11,28,17,1671,1717,1884,167
2015,11,28,18,1658,1711,1901,190
2015,11,28,19,1633,1677,1921,244
2015,11,28,20,1608,1636,1890,254
2015,11,28,21,1587,1609,1878,269
2015,11,28,22,1580,1592,1875,283
2015,11,28,23,1600,1607,1946,339
2015,11,29,0,1652,1671,1970,299
2015,11,29,1,1815,1823,2057,234
2015,11,29,2,1856,1852,2067,215
2015,11,29,3,1849,1831,2047,216
2015,11,29,4,1829,1806,2078,272
2015,11,29,5,1766,1749,2056,307
2015,11,29,6,1670,1658,1959,301
2015,11,29,7,1593,1582,1711,129
2015,11,29,8,1537,1508,1666,158
2015,11,29,9,1503,1468,1646,178
2015,11,29,10,1485,1444,1652,208
2015,11,29,11,1482,1431,1624,193
2015,11,29,12,1493,1439,1636,197
2015,11,29,13,1533,1467,1670,203
2015,11,29,14,1585,1518,1822,304
2015,11,29,15,1610,1539,1916,377
2015,11,29,16,1640,1586,2000,414
2015,11,29,17,1646,1607,2087,480
2015,11,29,18,1631,1578,2096,518
2015,11,29,19,1612,1540,2036,496
2015,11,29,20,1595,1532,2058,526
2015,11,29,21,1573,1531,2025,494
2015,11,29,22,1564,1540,2007,467
2015,11,29,23,1582,1556,2026,470
2015,11,30,0,1647,1641,2150,509
2015,11,30,1,1817,1823,2258,435
2015,11,30,2,1881,1872,2235,363
2015,11,30,3,1871,1855,2163,308
2015,11,30,4,1843,1824,2168,344
2015,11,30,5,1774,1754,2087,333
2015,11,30,6,1668,1650,2025,375
2015,11,30,7,1583,1553,1849,296
2015,11,30,8,1535,1506,1739,233
2015,11,30,9,1507,1477,1754,277
2015,11,30,10,1500,1476,1775,299
2015,11,30,11,1509,1488,1782,294
2015,11,30,12,1550,1530,1858,328
2015,11,30,13,1640,1634,1897,263
2015,11,30,14,1772,1786,1876,90
2015,11,30,15,1815,1808,1865,57
2015,11,30,16,1792,1761,1998,237
2015,11,30,17,1772,1737,2126,389
2015,11,30,18,1747,1711,2233,522
2015,11,30,19,1716,1683,2315,632
2015,11,30,20,1690,1660,2361,701
2015,11,30,21,1674,1630,2359,729
2015,11,30,22,1668,1630,2372,742
2015,11,30,23,1688,1646,2382,736
2015,12,1,0,1738,1719,2400,681
2015,12,1,1,1919,1926,2405,479
2015,12,1,2,1983,1982,2394,412
2015,12,1,3,1971,1974,2361,387
2015,12,1,4,1954,1970,2322,352
2015,12,1,5,1881,1889,2240,351
2015,12,1,6,1759,1762,2019,257
2015,12,1,7,1658,1664,1846,182
2015,12,1,8,1611,1602,1721,119
2015,12,1,9,1581,1566,1756,190
2015,12,1,10,1572,1556,1783,227
2015,12,1,11,1580,1562,1833,271
2015,12,1,12,1624,1603,1875,272
2015,12,1,13,1723,1703,1976,273
2015,12,1,14,1863,1861,2121,260
2015,12,1,15,1892,1858,2212,354
2015,12,1,16,1853,1774,2137,363
2015,12,1,17,1814,1726,2272,546
2015,12,1,18,1772,1681,2264,583
2015,12,1,19,1734,1646,2315,669
2015,12,1,20,1705,1620,2350,730
2015,12,1,21,1686,1606,2234,628
2015,12,1,22,1675,1601,2227,626
2015,12,1,23,1688,1621,2187,566
2015,12,2,0,1741,1686,2177,491
2015,12,2,1,1920,1895,2224,329
2015,12,2,2,1999,1939,2307,368
2015,12,2,3,1988,1937,2303,366
2015,12,2,4,1970,1937,2288,351
2015,12,2,5,1901,1859,2223,364
2015,12,2,6,1788,1741,2000,259
2015,12,2,7,1685,1643,1816,173
2015,12,2,8,1639,1598,1750,152
2015,12,2,9,1612,1559,1630,71
2015,12,2,10,1607,1555,1589,34
2015,12,2,11,1609,1566,1651,85
2015,12,2,12,1652,1606,1729,123
2015,12,2,13,1753,1718,1825,107
2015,12,2,14,1913,1871,1974,103
2015,12,2,15,1925,1875,2039,164
2015,12,2,16,1884,1799,1952,153
2015,12,2,17,1843,1750,1968,218
2015,12,2,18,1803,1683,2049,366
2015,12,2,19,1765,1653,2059,406
2015,12,2,20,1727,1621,2008,387
2015,12,2,21,1700,1605,2059,454
2015,12,2,22,1689,1590,2098,508
2015,12,2,23,1697,1618,2073,455
2015,12,3,0,1749,1675,2128,453
2015,12,3,1,1918,1875,2212,337
2015,12,3,2,1991,1931,2253,322
2015,12,3,3,1983,1929,2267,338
2015,12,3,4,1971,1913,2298,385
2015,12,3,5,1902,1839,2293,454
2015,12,3,6,1779,1717,2117,400
2015,12,3,7,1685,1641,2005,364
2015,12,3,8,1629,1581,1829,248
2015,12,3,9,1596,1546,1813,267
2015,12,3,10,1584,1546,1793,247
2015,12,3,11,1593,1553,1819,266
2015,12,3,12,1637,1587,1873,286
2015,12,3,13,1736,1698,2017,319
2015,12,3,14,1889,1848,2202,354
2015,12,3,15,1899,1865,2239,374
2015,12,3,16,1852,1777,2181,404
2015,12,3,17,1800,1731,2166,435
2015,12,3,18,1768,1679,2207,528
2015,12,3,19,1725,1649,2205,556
2015,12,3,20,1690,1610,2179,569
2015,12,3,21,1667,1591,2103,512
2015,12,3,22,1655,1584,2117,533
2015,12,3,23,1663,1597,2106,509
2015,12,4,0,1709,1652,2148,496
2015,12,4,1,1878,1848,2208,360
2015,12,4,2,1944,1894,2254,360
2015,12,4,3,1940,1893,2219,326
2015,12,4,4,1943,1894,2147,253
2015,12,4,5,1880,1826,2102,276
2015,12,4,6,1764,1712,1863,151
2015,12,4,7,1668,1611,1579,-32
2015,12,4,8,1597,1542,1405,-137
2015,12,4,9,1565,1532,1326,-206
2015,12,4,10,1554,1530,1349,-181
2015,12,4,11,1557,1539,1412,-127
2015,12,4,12,1598,1581,1469,-112
2015,12,4,13,1698,1678,1538,-140
2015,12,4,14,1851,1830,1669,-161
2015,12,4,15,1877,1847,1928,81
2015,12,4,16,1841,1796,1891,95
2015,12,4,17,1805,1747,1912,165
2015,12,4,18,1757,1703,1914,211
2015,12,4,19,1719,1650,1982,332
2015,12,4,20,1687,1627,1963,336
2015,12,4,21,1675,1615,1939,324
2015,12,4,22,1658,1603,1893,290
2015,12,4,23,1671,1620,1944,324
2015,12,5,0,1710,1668,1956,288
2015,12,5,1,1858,1854,1919,65
2015,12,5,2,1916,1877,1948,71
2015,12,5,3,1905,1854,2004,150
2015,12,5,4,1898,1844,2063,219
2015,12,5,5,1850,1799,2072,273
2015,12,5,6,1744,1700,1907,207
2015,12,5,7,1656,1616,1829,213
2015,12,5,8,1595,1545,1743,198
2015,12,5,9,1550,1495,1595,100
2015,12,5,10,1529,1468,1554,86
2015,12,5,11,1526,1472,1574,102
2015,12,5,12,1547,1479,1616,137
2015,12,5,13,1602,1522,1691,169
2015,12,5,14,1668,1598,1814,216
2015,12,5,15,1696,1638,2031,393
2015,12,5,16,1717,1649,2043,394
2015,12,5,17,1720,1629,2006,377
2015,12,5,18,1695,1606,2031,425
2015,12,5,19,1672,1589,2081,492
2015,12,5,20,1644,1561,2036,475
2015,12,5,21,1617,1531,2056,525
2015,12,5,22,1602,1527,2051,524
2015,12,5,23,1615,1550,2068,518
2015,12,6,0,1671,1627,2089,462
2015,12,6,1,1842,1814,2129,315
2015,12,6,2,1916,1842,2104,262
2015,12,6,3,1906,1837,2070,233
2015,12,6,4,1883,1830,2025,195
2015,12,6,5,1828,1787,2066,279
2015,12,6,6,1734,1710,2045,335
2015,12,6,7,1653,1622,1839,217
2015,12,6,8,1591,1560,1742,182
2015,12,6,9,1554,1525,1728,203
2015,12,6,10,1529,1509,1694,185
2015,12,6,11,1536,1508,1715,207
2015,12,6,12,1552,1530,1656,126
2015,12,6,13,1596,1572,1738,166
2015,12,6,14,1654,1626,1973,347
2015,12,6,15,1679,1658,2144,486
2015,12,6,16,1690,1669,2197,528
2015,12,6,17,1684,1655,2162,507
2015,12,6,18,1657,1621,2126,505
2015,12,6,19,1635,1603,2154,551
2015,12,6,20,1611,1575,2179,604
2015,12,6,21,1591,1545,2130,585
2015,12,6,22,1578,1543,2067,524
2015,12,6,23,1592,1561,2150,589
2015,12,7,0,1655,1652,2232,580
2015,12,7,1,1836,1875,2341,466
2015,12,7,2,1921,1933,2390,457
2015,12,7,3,1909,1928,2386,458
2015,12,7,4,1887,1909,2415,506
2015,12,7,5,1815,1838,2354,516
2015,12,7,6,1712,1710,2300,590
2015,12,7,7,1623,1596,2099,503
2015,12,7,8,1564,1540,1980,440
2015,12,7,9,1533,1511,1890,379
2015,12,7,10,1520,1502,1832,330
2015,12,7,11,1528,1514,1865,351
2015,12,7,12,1563,1556,1887,331
2015,12,7,13,1654,1656,1994,338
2015,12,7,14,1780,1820,2266,446
2015,12,7,15,1806,1847,2386,539
2015,12,7,16,1776,1818,2391,573
2015,12,7,17,1748,1754,2347,593
2015,12,7,18,1712,1712,2320,608
2015,12,7,19,1683,1679,2307,628
2015,12,7,20,1653,1642,2272,630
2015,12,7,21,1639,1622,2283,661
2015,12,7,22,1629,1608,2235,627
2015,12,7,23,1646,1622,2252,630
2015,12,8,0,1697,1678,2264,586
2015,12,8,1,1873,1884,2330,446
2015,12,8,2,1952,1930,2337,407
2015,12,8,3,1943,1928,2319,391
2015,12,8,4,1922,1911,2273,362
2015,12,8,5,1848,1837,2237,400
2015,12,8,6,1721,1702,2078,376
2015,12,8,7,1622,1597,1968,371
2015,12,8,8,1552,1537,1871,334
2015,12,8,9,1524,1498,1803,305
2015,12,8,10,1517,1486,1811,325
2015,12,8,11,1521,1501,1865,364
2015,12,8,12,1565,1530,1970,440
2015,12,8,13,1673,1637,2082,445
2015,12,8,14,1829,1796,2188,392
2015,12,8,15,1854,1831,2279,448
2015,12,8,16,1802,1804,2387,583
2015,12,8,17,1758,1768,2358,590
2015,12,8,18,1722,1706,2352,646
2015,12,8,19,1689,1674,2348,674
2015,12,8,20,1660,1638,2289,651
2015,12,8,21,1641,1615,2264,649
2015,12,8,22,1634,1619,2205,586
2015,12,8,23,1655,1629,2164,535
2015,12,9,0,1714,1682,2199,517
2015,12,9,1,1895,1865,2273,408
2015,12,9,2,1957,1912,2176,264
2015,12,9,3,1934,1915,2137,222
2015,12,9,4,1919,1894,2144,250
2015,12,9,5,1841,1814,2121,307
2015,12,9,6,1711,1671,2046,375
2015,12,9,7,1610,1567,1920,353
2015,12,9,8,1546,1492,1828,336
2015,12,9,9,1517,1457,1829,372
2015,12,9,10,1502,1448,1829,381
2015,12,9,11,1507,1465,1875,410
2015,12,9,12,1548,1494,1865,371
2015,12,9,13,1652,1586,1919,333
2015,12,9,14,1817,1757,2172,415
2015,12,9,15,1829,1778,2276,498
2015,12,9,16,1783,1724,2230,506
2015,12,9,17,1739,1686,2204,518
2015,12,9,18,1702,1651,2224,573
2015,12,9,19,1675,1618,2262,644
2015,12,9,20,1652,1593,2270,677
2015,12,9,21,1638,1577,2282,705
2015,12,9,22,1635,1595,2361,766
2015,12,9,23,1652,1607,2339,732
2015,12,10,0,1712,1645,2363,718
2015,12,10,1,1898,1831,2412,581
2015,12,10,2,1946,1864,2365,501
2015,12,10,3,1930,1861,2386,525
2015,12,10,4,1907,1829,2402,573
2015,12,10,5,1828,1754,2336,582
2015,12,10,6,1692,1621,2100,479
2015,12,10,7,1584,1517,1885,368
2015,12,10,8,1490,1452,1779,327
2015,12,10,9,1456,1423,1747,324
2015,12,10,10,1442,1414,1734,320
2015,12,10,11,1456,1422,1747,325
2015,12,10,12,1501,1460,1859,399
2015,12,10,13,1615,1559,2077,518
2015,12,10,14,1766,1712,2079,367
2015,12,10,15,1781,1746,2240,494
2015,12,10,16,1742,1689,2201,512
2015,12,10,17,1713,1652,2196,544
2015,12,10,18,1670,1618,2141,523
2015,12,10,19,1642,1593,2155,562
2015,12,10,20,1631,1594,2162,568
2015,12,10,21,1615,1586,2169,583
2015,12,10,22,1614,1575,2165,590
2015,12,10,23,1637,1572,2145,573
2015,12,11,0,1688,1624,2270,646
2015,12,11,1,1852,1807,2368,561
2015,12,11,2,1904,1843,2340,497
2015,12,11,3,1890,1824,2360,536
2015,12,11,4,1858,1809,2381,572
2015,12,11,5,1770,1738,2330,592
2015,12,11,6,1639,1602,2239,637
2015,12,11,7,1537,1493,1995,502
2015,12,11,8,1475,1418,1808,390
2015,12,11,9,1446,1383,1834,451
2015,12,11,10,1435,1364,1866,502
2015,12,11,11,1441,1360,1853,493
2015,12,11,12,1481,1403,1892,489
2015,12,11,13,1592,1495,1976,481
2015,12,11,14,1735,1651,1991,340
2015,12,11,15,1755,1698,2277,579
2015,12,11,16,1730,1691,2345,654
2015,12,11,17,1706,1710,2369,659
2015,12,11,18,1655,1707,2379,672
2015,12,11,19,1628,1695,2355,660
2015,12,11,20,1613,1678,2304,626
2015,12,11,21,1582,1655,2277,622
2015,12,11,22,1602,1655,2324,669
2015,12,11,23,1624,1676,2279,603
2015,12,12,0,1677,1734,2247,513
2015,12,12,1,1843,1871,2205,334
2015,12,12,2,1865,1862,2063,201
2015,12,12,3,1840,1836,2011,175
2015,12,12,4,1809,1807,1918,111
2015,12,12,5,1734,1743,1917,174
2015,12,12,6,1622,1643,1658,15
2015,12,12,7,1527,1545,1273,-272
2015,12,12,8,1493,1474,1050,-424
2015,12,12,9,1455,1422,1013,-409
2015,12,12,10,1434,1409,1014,-395
2015,12,12,11,1430,1399,1019,-380
2015,12,12,12,1450,1408,1104,-304
2015,12,12,13,1500,1456,1260,-196
2015,12,12,14,1574,1540,1317,-223
2015,12,12,15,1620,1594,1342,-252
2015,12,12,16,1671,1669,1443,-226
2015,12,12,17,1690,1721,1544,-177
2015,12,12,18,1688,1738,1536,-202
2015,12,12,19,1673,1740,1449,-291
2015,12,12,20,1661,1729,1427,-302
2015,12,12,21,1641,1703,1540,-163
2015,12,12,22,1639,1681,1580,-101
2015,12,12,23,1669,1724,1659,-65
2015,12,13,0,1741,1799,1652,-147
2015,12,13,1,1921,1954,1730,-224
2015,12,13,2,1966,1955,1705,-250
2015,12,13,3,1939,1919,1680,-239
2015,12,13,4,1909,1892,1686,-206
2015,12,13,5,1835,1837,1543,-294
2015,12,13,6,1720,1748,1468,-280
2015,12,13,7,1627,1683,1406,-277
2015,12,13,8,1552,1606,1221,-385
2015,12,13,9,1516,1557,1146,-411
2015,12,13,10,1493,1545,1152,-393
2015,12,13,11,1492,1521,1159,-362
2015,12,13,12,1505,1530,1145,-385
2015,12,13,13,1541,1577,1273,-304
2015,12,13,14,1606,1598,1309,-289
2015,12,13,15,1647,1630,1425,-205
2015,12,13,16,1678,1658,1559,-99
2015,12,13,17,1683,1679,1537,-142
2015,12,13,18,1668,1680,1533,-147
2015,12,13,19,1651,1659,1557,-102
2015,12,13,20,1639,1634,1565,-69
2015,12,13,21,1612,1609,1550,-59
2015,12,13,22,1608,1602,1511,-91
2015,12,13,23,1637,1614,1473,-141
2015,12,14,0,1720,1682,1580,-102
2015,12,14,1,1918,1920,1797,-123
2015,12,14,2,1973,1991,1902,-89
2015,12,14,3,1964,1986,1885,-101
2015,12,14,4,1931,1964,1868,-96
2015,12,14,5,1851,1880,1739,-141
2015,12,14,6,1733,1754,1609,-145
2015,12,14,7,1638,1635,1400,-235
2015,12,14,8,1583,1572,1273,-299
2015,12,14,9,1549,1536,1206,-330
2015,12,14,10,1536,1525,1196,-329
2015,12,14,11,1535,1538,1224,-314
2015,12,14,12,1568,1571,1265,-306
2015,12,14,13,1656,1668,1499,-169
2015,12,14,14,1796,1821,1746,-75
2015,12,14,15,1837,1839,1745,-94
2015,12,14,16,1820,1813,1716,-97
2015,12,14,17,1796,1786,1767,-19
2015,12,14,18,1763,1757,1789,32
2015,12,14,19,1729,1730,1757,27
2015,12,14,20,1703,1712,1661,-51
2015,12,14,21,1687,1685,1659,-26
2015,12,14,22,1678,1686,1665,-21
2015,12,14,23,1698,1739,1656,-83
2015,12,15,0,1769,1838,1749,-89
2015,12,15,1,1959,2038,1806,-232
2015,12,15,2,2029,2070,1855,-215
2015,12,15,3,2015,2057,1857,-200
2015,12,15,4,1999,2021,1857,-164
2015,12,15,5,1916,1922,1825,-97
2015,12,15,6,1779,1787,1635,-152
2015,12,15,7,1675,1685,1448,-237
2015,12,15,8,1667,1613,1302,-311
2015,12,15,9,1633,1583,1308,-275
2015,12,15,10,1625,1573,1321,-252
2015,12,15,11,1637,1582,1353,-229
2015,12,15,12,1675,1616,1445,-171
2015,12,15,13,1780,1709,1719,10
2015,12,15,14,1941,1866,1822,-44
2015,12,15,15,1982,1899,1991,92
2015,12,15,16,1961,1861,2019,158
2015,12,15,17,1942,1836,2069,233
2015,12,15,18,1917,1818,2164,346
2015,12,15,19,1888,1825,2225,400
2015,12,15,20,1853,1813,2244,431
2015,12,15,21,1839,1991,2382,391
2015,12,15,22,1836,1815,2147,332
2015,12,15,23,1861,1846,2171,325
2015,12,16,0,1933,1916,2255,339
2015,12,16,1,2130,2108,2328,220
2015,12,16,2,2203,2136,2319,183
2015,12,16,3,2184,2121,2159,38
2015,12,16,4,2147,2094,2193,99
2015,12,16,5,2049,2003,2093,90
2015,12,16,6,1905,1866,1925,59
2015,12,16,7,1792,1756,1758,2
2015,12,16,8,1739,1689,1633,-56
2015,12,16,9,1711,1651,1625,-26
2015,12,16,10,1704,1644,1585,-59
2015,12,16,11,1716,1642,1577,-65
2015,12,16,12,1752,1677,1609,-68
2015,12,16,13,1856,1789,1851,62
2015,12,16,14,2016,1953,2030,77
2015,12,16,15,2042,1989,1969,-20
2015,12,16,16,2024,1942,1913,-29
2015,12,16,17,1994,1887,1854,-33
2015,12,16,18,1958,1842,1791,-51
2015,12,16,19,1918,1810,1598,-212
2015,12,16,20,1854,1778,1534,-244
2015,12,16,21,1843,1760,1540,-220
2015,12,16,22,1828,1763,1549,-214
2015,12,16,23,1856,1790,1647,-143
2015,12,17,0,1929,1845,1744,-101
2015,12,17,1,2131,2053,1888,-165
2015,12,17,2,2200,2112,1962,-150
2015,12,17,3,2193,2111,1988,-123
2015,12,17,4,2174,2092,2048,-44
2015,12,17,5,2081,2021,1978,-43
2015,12,17,6,1935,1882,1783,-99
2015,12,17,7,1832,1775,1696,-79
2015,12,17,8,1758,1707,1559,-148
2015,12,17,9,1726,1666,1553,-113
2015,12,17,10,1716,1654,1535,-119
2015,12,17,11,1730,1665,1494,-171
2015,12,17,12,1765,1706,1589,-117
2015,12,17,13,1869,1840,1775,-65
2015,12,17,14,2035,1959,1945,-14
2015,12,17,15,2072,2000,2000,0
2015,12,17,16,2030,1949,2026,77
2015,12,17,17,1997,1878,1934,56
2015,12,17,18,1963,1839,1911,72
2015,12,17,19,1922,1793,1918,125
2015,12,17,20,1881,1791,1903,112
2015,12,17,21,1856,1765,1819,54
2015,12,17,22,1844,1762,1721,-41
2015,12,17,23,1867,1778,1700,-78
2015,12,18,0,1932,1840,1796,-44
2015,12,18,1,2136,2043,1871,-172
2015,12,18,2,2206,2095,1926,-169
2015,12,18,3,2198,2091,1895,-196
2015,12,18,4,2176,2090,1890,-200
2015,12,18,5,2081,2021,1923,-98
2015,12,18,6,1940,1881,1879,-2
2015,12,18,7,1832,1769,1776,7
2015,12,18,8,1746,1702,1732,30
2015,12,18,9,1714,1669,1800,131
2015,12,18,10,1699,1653,1894,241
2015,12,18,11,1702,1659,1939,280
2015,12,18,12,1734,1689,2015,326
2015,12,18,13,1841,1789,2124,335
2015,12,18,14,2004,1929,2222,293
2015,12,18,15,2040,1969,2199,230
2015,12,18,16,1996,1930,2178,248
2015,12,18,17,1950,1879,2146,267
2015,12,18,18,1903,1819,2124,305
2015,12,18,19,1856,1768,2134,366
2015,12,18,20,1808,1727,2193,466
2015,12,18,21,1776,1687,2164,477
2015,12,18,22,1753,1669,1893,224
2015,12,18,23,1773,1679,1737,58
2015,12,19,0,1824,1735,1790,55
2015,12,19,1,2016,1925,1918,-7
2015,12,19,2,2094,1971,1967,-4
2015,12,19,3,2087,1967,1911,-56
2015,12,19,4,2071,1960,1863,-97
2015,12,19,5,2005,1900,1915,15
2015,12,19,6,1881,1805,1841,36
2015,12,19,7,1781,1713,1785,72
2015,12,19,8,1700,1638,1569,-69
2015,12,19,9,1663,1596,1582,-14
2015,12,19,10,1644,1584,1545,-39
2015,12,19,11,1640,1579,1539,-40
2015,12,19,12,1655,1599,1546,-53
2015,12,19,13,1699,1650,1658,8
2015,12,19,14,1778,1716,1786,70
2015,12,19,15,1814,1762,1793,31
2015,12,19,16,1825,1796,1798,2
2015,12,19,17,1813,1802,1875,73
2015,12,19,18,1783,1766,1779,13
2015,12,19,19,1746,1717,1722,5
2015,12,19,20,1713,1685,1674,-11
2015,12,19,21,1681,1661,1677,16
2015,12,19,22,1664,1646,1726,80
2015,12,19,23,1673,1678,1736,58
2015,12,20,0,1726,1759,1799,40
2015,12,20,1,1893,1942,1854,-88
2015,12,20,2,1981,1952,1795,-157
2015,12,20,3,1972,1936,1762,-174
2015,12,20,4,1957,1914,1778,-136
2015,12,20,5,1903,1855,1811,-44
2015,12,20,6,1791,1756,1803,47
2015,12,20,7,1705,1661,1716,55
2015,12,20,8,1639,1576,1656,80
2015,12,20,9,1597,1527,1620,93
2015,12,20,10,1575,1506,1560,54
2015,12,20,11,1569,1499,1554,55
2015,12,20,12,1574,1506,1580,74
2015,12,20,13,1626,1545,1666,121
2015,12,20,14,1693,1602,1738,136
2015,12,20,15,1721,1648,1807,159
2015,12,20,16,1743,1672,1856,184
2015,12,20,17,1743,1660,1770,110
2015,12,20,18,1716,1642,1817,175
2015,12,20,19,1695,1620,1833,213
2015,12,20,20,1669,1642,1880,238
2015,12,20,21,1644,1621,1900,279
2015,12,20,22,1639,1600,1863,263
2015,12,20,23,1660,1622,1906,284
2015,12,21,0,1731,1696,1934,238
2015,12,21,1,1928,1894,2127,233
2015,12,21,2,2014,1954,2111,157
2015,12,21,3,2012,1961,2020,59
2015,12,21,4,1987,1937,2106,169
2015,12,21,5,1919,1870,2047,177
2015,12,21,6,1799,1754,1872,118
2015,12,21,7,1692,1651,1655,4
2015,12,21,8,1621,1582,1567,-15
2015,12,21,9,1585,1533,1596,63
2015,12,21,10,1566,1508,1576,68
2015,12,21,11,1571,1518,1602,84
2015,12,21,12,1606,1548,1650,102
2015,12,21,13,1699,1624,1829,205
2015,12,21,14,1826,1745,1846,101
2015,12,21,15,1871,1792,1788,-4
2015,12,21,16,1853,1789,1846,57
2015,12,21,17,1830,1745,1838,93
2015,12,21,18,1798,1713,1846,133
2015,12,21,19,1768,1685,1849,164
2015,12,21,20,1727,1648,1808,160
2015,12,21,21,1711,1665,2024,359
2015,12,21,22,1701,1641,1930,289
2015,12,21,23,1718,1665,1913,248
2015,12,22,0,1788,1723,2020,297
2015,12,22,1,1983,1923,2130,207
2015,12,22,2,2055,1968,2185,217
2015,12,22,3,2049,1959,2173,214
2015,12,22,4,2036,1946,2217,271
2015,12,22,5,1954,1878,2188,310
2015,12,22,6,1824,1759,1994,235
2015,12,22,7,1706,1646,1845,199
2015,12,22,8,1606,1574,1578,4
2015,12,22,9,1568,1528,1458,-70
2015,12,22,10,1561,1508,1469,-39
2015,12,22,11,1563,1499,1528,29
2015,12,22,12,1605,1528,1601,73
2015,12,22,13,1705,1621,1748,127
2015,12,22,14,1865,1742,1708,-34
2015,12,22,15,1893,1796,1780,-16
2015,12,22,16,1858,1821,1541,-280
2015,12,22,17,1825,1845,1577,-268
2015,12,22,18,1794,1824,1507,-317
2015,12,22,19,1764,1803,1565,-238
2015,12,22,20,1741,1788,1633,-155
2015,12,22,21,1721,1793,1861,68
2015,12,22,22,1715,1807,1837,30
2015,12,22,23,1740,1824,1932,108
2015,12,23,0,1807,1859,2037,178
2015,12,23,1,1984,1994,2266,272
2015,12,23,2,2060,2008,2321,313
2015,12,23,3,2037,1981,2302,321
2015,12,23,4,2012,1956,2320,364
2015,12,23,5,1917,1882,2305,423
2015,12,23,6,1772,1754,2157,403
2015,12,23,7,1661,1646,1903,257
2015,12,23,8,1548,1565,1730,165
2015,12,23,9,1506,1537,1703,166
2015,12,23,10,1491,1515,1708,193
2015,12,23,11,1492,1510,1691,181
2015,12,23,12,1523,1528,1745,217
2015,12,23,13,1617,1591,1877,286
2015,12,23,14,1768,1699,1945,246
2015,12,23,15,1811,1752,2066,314
2015,12,23,16,1770,1781,2178,397
2015,12,23,17,1732,1796,2219,423
2015,12,23,18,1717,1762,2254,492
2015,12,23,19,1698,1718,2198,480
2015,12,23,20,1679,1693,2201,508
2015,12,23,21,1674,1681,2202,521
2015,12,23,22,1670,1642,2097,455
2015,12,23,23,1696,1685,2110,425
2015,12,24,0,1758,1754,2091,337
2015,12,24,1,1941,1928,2135,207
2015,12,24,2,1988,1954,2135,181
2015,12,24,3,1970,1931,2239,308
2015,12,24,4,1956,1922,2308,386
2015,12,24,5,1871,1860,2353,493
2015,12,24,6,1756,1760,2290,530
2015,12,24,7,1650,1656,2119,463
2015,12,24,8,1591,1572,1929,357
2015,12,24,9,1563,1519,1803,284
2015,12,24,10,1562,1498,1700,202
2015,12,24,11,1569,1495,1644,149
2015,12,24,12,1602,1514,1652,138
2015,12,24,13,1667,1582,1797,215
2015,12,24,14,1764,1669,1978,309
2015,12,24,15,1813,1718,2087,369
2015,12,24,16,1859,1771,2104,333
2015,12,24,17,1877,1814,2052,238
2015,12,24,18,1851,1810,2020,210
2015,12,24,19,1820,1783,1977,194
2015,12,24,20,1774,1740,1997,257
2015,12,24,21,1743,1710,2002,292
2015,12,24,22,1709,1683,1939,256
2015,12,24,23,1710,1673,1948,275
2015,12,25,0,1768,1705,1990,285
2015,12,25,1,1932,1852,2105,253
2015,12,25,2,1945,1854,2149,295
2015,12,25,3,1909,1826,2130,304
2015,12,25,4,1914,1810,2120,310
2015,12,25,5,1871,1791,2196,405
2015,12,25,6,1806,1724,2140,416
2015,12,25,7,1717,1660,2035,375
2015,12,25,8,1614,1591,1874,283
2015,12,25,9,1562,1538,1901,363
2015,12,25,10,1540,1507,1851,344
2015,12,25,11,1535,1492,1897,405
2015,12,25,12,1561,1504,1949,445
2015,12,25,13,1598,1546,2095,549
2015,12,25,14,1653,1603,2076,473
2015,12,25,15,1688,1625,1934,309
2015,12,25,16,1704,1634,1938,304
2015,12,25,17,1709,1622,1955,333
2015,12,25,18,1697,1595,1916,321
2015,12,25,19,1655,1565,1935,370
2015,12,25,20,1606,1533,1897,364
2015,12,25,21,1571,1506,1849,343
2015,12,25,22,1544,1489,1793,304
2015,12,25,23,1561,1502,1802,300
2015,12,26,0,1606,1550,1952,402
2015,12,26,1,1793,1730,2128,398
2015,12,26,2,1851,1787,2152,365
2015,12,26,3,1880,1785,2081,296
2015,12,26,4,1890,1798,2069,271
2015,12,26,5,1837,1773,2023,250
2015,12,26,6,1775,1697,1999,302
2015,12,26,7,1698,1624,1819,195
2015,12,26,8,1641,1561,1638,77
2015,12,26,9,1596,1524,1634,110
2015,12,26,10,1574,1499,1661,162
2015,12,26,11,1570,1504,1627,123
2015,12,26,12,1582,1519,1681,162
2015,12,26,13,1626,1562,1839,277
2015,12,26,14,1684,1624,1927,303
2015,12,26,15,1737,1668,2052,384
2015,12,26,16,1777,1703,2131,428
2015,12,26,17,1804,1715,2131,416
2015,12,26,18,1804,1714,2113,399
2015,12,26,19,1784,1751,2197,446
2015,12,26,20,1766,1778,2182,404
2015,12,26,21,1743,1811,2137,326
2015,12,26,22,1739,1840,2070,230
2015,12,26,23,1765,1875,2059,184
2015,12,27,0,1836,1927,2135,208
2015,12,27,1,2000,2074,2112,38
2015,12,27,2,2032,2109,2153,44
2015,12,27,3,2031,2082,2135,53
2015,12,27,4,2008,2043,2066,23
2015,12,27,5,1942,1973,2065,92
2015,12,27,6,1830,1872,2053,181
2015,12,27,7,1735,1789,1871,82
2015,12,27,8,1683,1707,1754,47
2015,12,27,9,1650,1654,1678,24
2015,12,27,10,1630,1637,1653,16
2015,12,27,11,1627,1606,1699,93
2015,12,27,12,1639,1611,1735,124
2015,12,27,13,1681,1636,1873,237
2015,12,27,14,1720,1690,1876,186
2015,12,27,15,1767,1724,1838,114
2015,12,27,16,1821,1783,1838,55
2015,12,27,17,1837,1828,1828,0
2015,12,27,18,1825,1848,1747,-101
2015,12,27,19,1803,1834,1749,-85
2015,12,27,20,1784,1818,1792,-26
2015,12,27,21,1757,1783,1780,-3
2015,12,27,22,1747,1782,1805,23
2015,12,27,23,1769,1801,1842,41
2015,12,28,0,1850,1851,2042,191
2015,12,28,1,2033,2019,2106,87
2015,12,28,2,2086,2059,2163,104
2015,12,28,3,2092,2033,2080,47
2015,12,28,4,2062,1996,2096,100
2015,12,28,5,1977,1922,2108,186
2015,12,28,6,1856,1811,2038,227
2015,12,28,7,1751,1711,1869,158
2015,12,28,8,1678,1649,1666,17
2015,12,28,9,1641,1613,1641,28
2015,12,28,10,1634,1592,1622,30
2015,12,28,11,1646,1598,1644,46
2015,12,28,12,1687,1632,1697,65
2015,12,28,13,1779,1689,1811,122
2015,12,28,14,1925,1810,1996,186
2015,12,28,15,1977,1871,1995,124
2015,12,28,16,1951,1896,2124,228
2015,12,28,17,1924,1918,2111,193
2015,12,28,18,1878,1861,2026,165
2015,12,28,19,1834,1771,2051,280
2015,12,28,20,1806,1734,2089,355
2015,12,28,21,1794,1721,2163,442
2015,12,28,22,1784,1711,2156,445
2015,12,28,23,1809,1729,2220,491
2015,12,29,0,1861,1796,2165,369
2015,12,29,1,2049,1999,2181,182
2015,12,29,2,2117,2064,2260,196
2015,12,29,3,2114,2049,2319,270
2015,12,29,4,2104,2050,2273,223
2015,12,29,5,2022,1988,2240,252
2015,12,29,6,1893,1868,2157,289
2015,12,29,7,1785,1762,1966,204
2015,12,29,8,1709,1682,1838,156
2015,12,29,9,1668,1641,1844,203
2015,12,29,10,1656,1607,1758,151
2015,12,29,11,1661,1625,1747,122
2015,12,29,12,1699,1621,1765,144
2015,12,29,13,1801,1683,1904,221
2015,12,29,14,1944,1773,2023,250
2015,12,29,15,1984,1830,2008,178
2015,12,29,16,1959,1859,2021,162
2015,12,29,17,1935,1877,2047,170
2015,12,29,18,1904,1859,2037,178
2015,12,29,19,1867,1836,2020,184
2015,12,29,20,1842,1803,1957,154
2015,12,29,21,1818,1784,1923,139
2015,12,29,22,1807,1756,1908,152
2015,12,29,23,1829,1782,1933,151
2015,12,30,0,1882,1835,2003,168
2015,12,30,1,2069,1975,2164,189
2015,12,30,2,2136,1984,2190,206
2015,12,30,3,2128,1983,2203,220
2015,12,30,4,2113,2018,2293,275
2015,12,30,5,2037,1967,2228,261
2015,12,30,6,1900,1854,2027,173
2015,12,30,7,1789,1746,1809,63
2015,12,30,8,1712,1674,1627,-47
2015,12,30,9,1676,1637,1676,39
2015,12,30,10,1667,1613,1604,-9
2015,12,30,11,1670,1619,1589,-30
2015,12,30,12,1703,1657,1676,19
2015,12,30,13,1797,1725,1766,41
2015,12,30,14,1941,1839,1815,-24
2015,12,30,15,1982,1887,1839,-48
2015,12,30,16,1969,1894,1928,34
2015,12,30,17,1950,1892,1850,-42
2015,12,30,18,1910,1849,1849,0
2015,12,30,19,1868,1802,1854,52
2015,12,30,20,1833,1748,1850,102
2015,12,30,21,1810,1712,1855,143
2015,12,30,22,1804,1684,1898,214
2015,12,30,23,1825,1706,1879,173
2015,12,31,0,1887,1765,1899,134
2015,12,31,1,2074,1959,2055,96
2015,12,31,2,2136,2013,2109,96
2015,12,31,3,2128,2005,2119,114
2015,12,31,4,2113,2008,2135,127
2015,12,31,5,2044,1953,2036,83
2015,12,31,6,1918,1852,1892,40
2015,12,31,7,1816,1758,1702,-56
2015,12,31,8,1742,1686,1520,-166
2015,12,31,9,1700,1650,1495,-155
2015,12,31,10,1684,1632,1529,-103
2015,12,31,11,1704,1626,1539,-87
2015,12,31,12,1736,1658,1597,-61
2015,12,31,13,1832,1711,1743,32
2015,12,31,14,1968,1817,1810,-7
2015,12,31,15,2011,1857,1977,120
2015,12,31,16,1993,1865,1980,115
2015,12,31,17,1967,1859,1914,55
2015,12,31,18,1935,1827,1857,30
2015,12,31,19,1889,1779,1857,78
2015,12,31,20,1854,1713,1833,120
2015,12,31,21,1829,1676,1827,151
2015,12,31,22,1812,1651,1757,106
2015,12,31,23,1835,1659,1733,74
2016,1,1,0,1899,1716,1928,212
2016,1,1,1,2075,1911,2104,193
2016,1,1,2,2131,1967,2120,153
2016,1,1,3,2124,1940,2172,232
2016,1,1,4,2112,1922,2133,211
2016,1,1,5,2030,1887,2082,195
2016,1,1,6,1911,1828,2038,210
2016,1,1,7,1809,1768,1872,104
2016,1,1,8,1744,1705,1702,-3
2016,1,1,9,1698,1655,1642,-13
2016,1,1,10,1678,1619,1595,-24
2016,1,1,11,1664,1597,1606,9
2016,1,1,12,1680,1612,1617,5
2016,1,1,13,1728,1648,1798,150
2016,1,1,14,1787,1692,1838,146
2016,1,1,15,1839,1703,1848,145
2016,1,1,16,1882,1731,1797,66
2016,1,1,17,1912,1773,1782,9
2016,1,1,18,1902,1793,1783,-10
2016,1,1,19,1885,1792,1777,-15
2016,1,1,20,1872,1784,1726,-58
2016,1,1,21,1853,1757,1814,57
2016,1,1,22,1846,1733,1793,60
2016,1,1,23,1869,1745,1813,68
2016,1,2,0,1928,1789,1923,134
2016,1,2,1,2081,1956,2167,211
2016,1,2,2,2122,1988,2163,175
2016,1,2,3,2119,1974,2134,160
2016,1,2,4,2080,1965,2141,176
2016,1,2,5,1985,1917,2064,147
2016,1,2,6,1891,1828,1961,133
2016,1,2,7,1796,1738,1929,191
2016,1,2,8,1727,1667,1785,118
2016,1,2,9,1685,1619,1801,182
2016,1,2,10,1655,1600,1775,175
2016,1,2,11,1638,1600,1776,176
2016,1,2,12,1652,1610,1818,208
2016,1,2,13,1690,1646,1950,304
2016,1,2,14,1733,1715,2069,354
2016,1,2,15,1773,1762,2075,313
2016,1,2,16,1821,1800,2113,313
2016,1,2,17,1830,1800,2116,316
2016,1,2,18,1811,1783,2091,308
2016,1,2,19,1774,1735,2091,356
2016,1,2,20,1740,1683,2045,362
2016,1,2,21,1710,1636,1948,312
2016,1,2,22,1696,1616,1972,356
2016,1,2,23,1713,1628,1995,367
2016,1,3,0,1779,1687,2083,396
2016,1,3,1,1965,1876,2184,308
2016,1,3,2,2014,1943,2250,307
2016,1,3,3,2006,1935,2239,304
2016,1,3,4,1980,1924,2230,306
2016,1,3,5,1927,1873,2198,325
2016,1,3,6,1834,1794,2153,359
2016,1,3,7,1746,1714,1904,190
2016,1,3,8,1676,1657,1720,63
2016,1,3,9,1630,1613,1697,84
2016,1,3,10,1608,1597,1710,113
2016,1,3,11,1601,1597,1707,110
2016,1,3,12,1608,1599,1764,165
2016,1,3,13,1646,1636,1898,262
2016,1,3,14,1685,1689,1985,296
2016,1,3,15,1731,1725,2011,286
2016,1,3,16,1773,1750,2036,286
2016,1,3,17,1786,1735,2028,293
2016,1,3,18,1762,1701,1969,268
2016,1,3,19,1732,1672,1983,311
2016,1,3,20,1707,1642,1967,325
2016,1,3,21,1680,1608,1933,325
2016,1,3,22,1667,1592,1896,304
2016,1,3,23,1688,1625,1934,309
2016,1,4,0,1759,1698,2040,342
2016,1,4,1,1962,1890,2157,267
2016,1,4,2,2019,1970,2212,242
2016,1,4,3,2012,1957,2192,235
2016,1,4,4,1990,1929,2192,263
2016,1,4,5,1927,1856,2138,282
2016,1,4,6,1815,1749,2072,323
2016,1,4,7,1716,1646,1922,276
2016,1,4,8,1631,1597,1741,144
2016,1,4,9,1586,1568,1673,105
2016,1,4,10,1575,1557,1632,75
2016,1,4,11,1580,1564,1633,69
2016,1,4,12,1607,1602,1749,147
2016,1,4,13,1697,1687,1942,255
2016,1,4,14,1827,1825,2060,235
2016,1,4,15,1874,1885,2138,253
2016,1,4,16,1866,1879,2147,268
2016,1,4,17,1853,1880,2128,248
2016,1,4,18,1824,1849,2088,239
2016,1,4,19,1791,1817,2140,323
2016,1,4,20,1759,1802,2145,343
2016,1,4,21,1744,1771,2139,368
2016,1,4,22,1733,1757,2112,355
2016,1,4,23,1751,1788,2110,322
2016,1,5,0,1811,1847,2089,242
2016,1,5,1,1993,1984,2197,213
2016,1,5,2,2037,2027,2249,222
2016,1,5,3,2023,2003,2236,233
2016,1,5,4,2016,1979,2228,249
2016,1,5,5,1946,1886,2131,245
2016,1,5,6,1821,1762,2035,273
2016,1,5,7,1709,1663,1909,246
2016,1,5,8,1631,1595,1774,179
2016,1,5,9,1595,1555,1718,163
2016,1,5,10,1585,1543,1712,169
2016,1,5,11,1582,1544,1691,147
2016,1,5,12,1613,1583,1739,156
2016,1,5,13,1710,1669,1962,293
2016,1,5,14,1850,1814,2056,242
2016,1,5,15,1891,1876,2092,216
2016,1,5,16,1883,1865,2086,221
2016,1,5,17,1880,1875,2078,203
2016,1,5,18,1857,1860,2048,188
2016,1,5,19,1823,1833,2090,257
2016,1,5,20,1799,1813,2143,330
2016,1,5,21,1778,1796,2173,377
2016,1,5,22,1767,1784,2198,414
2016,1,5,23,1780,1808,2131,323
2016,1,6,0,1833,1847,2097,250
2016,1,6,1,2007,1986,2268,282
2016,1,6,2,2049,2006,2307,301
2016,1,6,3,2025,1980,2324,344
2016,1,6,4,2010,1949,2281,332
2016,1,6,5,1944,1861,2209,348
2016,1,6,6,1824,1729,2138,409
2016,1,6,7,1713,1626,1936,310
2016,1,6,8,1620,1562,1760,198
2016,1,6,9,1580,1519,1652,133
2016,1,6,10,1567,1504,1627,123
2016,1,6,11,1561,1501,1629,128
2016,1,6,12,1597,1531,1775,244
2016,1,6,13,1692,1621,1940,319
2016,1,6,14,1837,1768,2097,329
2016,1,6,15,1877,1828,2152,324
2016,1,6,16,1871,1832,2128,296
2016,1,6,17,1859,1840,2150,310
2016,1,6,18,1835,1833,2077,244
2016,1,6,19,1797,1824,2073,249
2016,1,6,20,1772,1802,2095,293
2016,1,6,21,1754,1811,2153,342
2016,1,6,22,1742,1808,2164,356
2016,1,6,23,1760,1792,2187,395
2016,1,7,0,1818,1824,2179,355
2016,1,7,1,1979,1984,2247,263
2016,1,7,2,2020,2022,2337,315
2016,1,7,3,2004,2005,2353,348
2016,1,7,4,1995,1971,2390,419
2016,1,7,5,1929,1886,2367,481
2016,1,7,6,1806,1757,2374,617
2016,1,7,7,1703,1650,2185,535
2016,1,7,8,1611,1571,1935,364
2016,1,7,9,1569,1525,1932,407
2016,1,7,10,1553,1511,1937,426
2016,1,7,11,1556,1516,1948,432
2016,1,7,12,1592,1547,2034,487
2016,1,7,13,1685,1639,2200,561
2016,1,7,14,1825,1799,2340,541
2016,1,7,15,1867,1836,2419,583
2016,1,7,16,1865,1819,2404,585
2016,1,7,17,1858,1793,2431,638
2016,1,7,18,1836,1763,2387,624
2016,1,7,19,1802,1754,2385,631
2016,1,7,20,1776,1743,2358,615
2016,1,7,21,1758,1739,2343,604
2016,1,7,22,1750,1743,2336,593
2016,1,7,23,1773,1775,2289,514
2016,1,8,0,1825,1832,2262,430
2016,1,8,1,1984,1946,2233,287
2016,1,8,2,2024,2023,2308,285
2016,1,8,3,2011,1999,2298,299
2016,1,8,4,1997,1971,2335,364
2016,1,8,5,1926,1895,2232,337
2016,1,8,6,1806,1774,2143,369
2016,1,8,7,1703,1679,1968,289
2016,1,8,8,1645,1605,1812,207
2016,1,8,9,1607,1568,1765,197
2016,1,8,10,1586,1556,1753,197
2016,1,8,11,1590,1543,1799,256
2016,1,8,12,1617,1576,1875,299
2016,1,8,13,1706,1653,1993,340
2016,1,8,14,1838,1803,2083,280
2016,1,8,15,1887,1867,2160,293
2016,1,8,16,1897,1874,2161,287
2016,1,8,17,1899,1895,2071,176
2016,1,8,18,1879,1870,2075,205
2016,1,8,19,1843,1831,2157,326
2016,1,8,20,1814,1806,2175,369
2016,1,8,21,1799,1794,2155,361
2016,1,8,22,1789,1793,2190,397
2016,1,8,23,1804,1822,2258,436
2016,1,9,0,1857,1865,2252,387
2016,1,9,1,2010,1985,2255,270
2016,1,9,2,2059,2028,2279,251
2016,1,9,3,2044,2006,2152,146
2016,1,9,4,2028,1988,2149,161
2016,1,9,5,1973,1925,2127,202
2016,1,9,6,1871,1813,2066,253
2016,1,9,7,1775,1730,1979,249
2016,1,9,8,1728,1670,1798,128
2016,1,9,9,1677,1625,1785,160
2016,1,9,10,1652,1605,1760,155
2016,1,9,11,1648,1589,1764,175
2016,1,9,12,1665,1606,1798,192
2016,1,9,13,1707,1650,1907,257
2016,1,9,14,1761,1719,1935,216
2016,1,9,15,1813,1754,2080,326
2016,1,9,16,1866,1784,2154,370
2016,1,9,17,1886,1789,2153,364
2016,1,9,18,1870,1784,2164,380
2016,1,9,19,1840,1757,2157,400
2016,1,9,20,1814,1732,2167,435
2016,1,9,21,1780,1704,2154,450
2016,1,9,22,1760,1696,2104,408
2016,1,9,23,1775,1713,2078,365
2016,1,10,0,1835,1757,2101,344
2016,1,10,1,2001,1921,2207,286
2016,1,10,2,2054,1986,2257,271
2016,1,10,3,2038,1975,2275,300
2016,1,10,4,2010,1939,2263,324
2016,1,10,5,1961,1886,2173,287
2016,1,10,6,1872,1794,2145,351
2016,1,10,7,1790,1715,2063,348
2016,1,10,8,1732,1651,1854,203
2016,1,10,9,1685,1617,1812,195
2016,1,10,10,1664,1605,1721,116
2016,1,10,11,1658,1605,1706,101
2016,1,10,12,1671,1617,1753,136
2016,1,10,13,1705,1653,1912,259
2016,1,10,14,1750,1714,1933,219
2016,1,10,15,1789,1752,1974,222
2016,1,10,16,1846,1783,2054,271
2016,1,10,17,1863,1789,2054,265
2016,1,10,18,1841,1761,2053,292
2016,1,10,19,1812,1746,2065,319
2016,1,10,20,1788,1732,2114,382
2016,1,10,21,1763,1721,2102,381
2016,1,10,22,1750,1728,2052,324
2016,1,10,23,1769,1747,2048,301
2016,1,11,0,1836,1814,2127,313
2016,1,11,1,2004,1982,2234,252
2016,1,11,2,2056,2058,2280,222
2016,1,11,3,2054,2043,2232,189
2016,1,11,4,2029,2012,2187,175
2016,1,11,5,1966,1932,2148,216
2016,1,11,6,1869,1810,2057,247
2016,1,11,7,1774,1708,2014,306
2016,1,11,8,1726,1659,2004,345
2016,1,11,9,1682,1633,2016,383
2016,1,11,10,1674,1631,2015,384
2016,1,11,11,1680,1639,2035,396
2016,1,11,12,1705,1681,2037,356
2016,1,11,13,1773,1788,2072,284
2016,1,11,14,1896,1963,2268,305
2016,1,11,15,1954,2016,2299,283
2016,1,11,16,1973,1987,2290,303
2016,1,11,17,1977,1959,2199,240
2016,1,11,18,1945,1916,2125,209
2016,1,11,19,1915,1861,2104,243
2016,1,11,20,1885,1814,1976,162
2016,1,11,21,1868,1787,1947,160
2016,1,11,22,1852,1762,1962,200
2016,1,11,23,1870,1765,1940,175
2016,1,12,0,1924,1806,2083,277
2016,1,12,1,2101,1983,1903,-80
2016,1,12,2,2159,2076,1923,-153
2016,1,12,3,2135,2078,1864,-214
2016,1,12,4,2118,2055,1771,-284
2016,1,12,5,2045,1978,1714,-264
2016,1,12,6,1923,1850,1712,-138
2016,1,12,7,1820,1750,1633,-117
2016,1,12,8,1728,1693,1553,-140
2016,1,12,9,1691,1664,1458,-206
2016,1,12,10,1675,1656,1446,-210
2016,1,12,11,1688,1659,1424,-235
2016,1,12,12,1727,1698,1442,-256
2016,1,12,13,1830,1808,1590,-218
2016,1,12,14,1972,1984,1788,-196
2016,1,12,15,2011,2026,1952,-74
2016,1,12,16,1983,1970,1922,-48
2016,1,12,17,1958,1924,1843,-81
2016,1,12,18,1914,1870,1860,-10
2016,1,12,19,1869,1821,1834,13
2016,1,12,20,1832,1767,1828,61
2016,1,12,21,1814,1736,1812,76
2016,1,12,22,1800,1701,1840,139
2016,1,12,23,1814,1707,1864,157
2016,1,13,0,1860,1740,2038,298
2016,1,13,1,2025,1904,2187,283
2016,1,13,2,2093,2002,2307,305
2016,1,13,3,2091,1999,2293,294
2016,1,13,4,2072,2001,2302,301
2016,1,13,5,2001,1923,2245,322
2016,1,13,6,1875,1789,2201,412
2016,1,13,7,1768,1708,2048,340
2016,1,13,8,1709,1664,1904,240
2016,1,13,9,1675,1634,1924,290
2016,1,13,10,1667,1624,1904,280
2016,1,13,11,1671,1637,1849,212
2016,1,13,12,1712,1674,1805,131
2016,1,13,13,1808,1783,1923,140
2016,1,13,14,1951,1955,2143,188
2016,1,13,15,1993,2004,2128,124
2016,1,13,16,1963,1949,2008,59
2016,1,13,17,1934,2077,2095,18
2016,1,13,18,1892,1838,1861,23
2016,1,13,19,1845,1784,1816,32
2016,1,13,20,1808,1726,1808,82
2016,1,13,21,1782,1672,1717,45
2016,1,13,22,1762,1649,1684,35
2016,1,13,23,1774,1686,1799,113
2016,1,14,0,1820,1717,1962,245
2016,1,14,1,1972,1883,2151,268
2016,1,14,2,2041,1980,2286,306
2016,1,14,3,2041,1986,2264,278
2016,1,14,4,2021,1971,2251,280
2016,1,14,5,1951,1895,2223,328
2016,1,14,6,1831,1774,2160,386
2016,1,14,7,1733,1681,2034,353
2016,1,14,8,1682,1615,1890,275
2016,1,14,9,1647,1598,1879,281
2016,1,14,10,1633,1589,1886,297
2016,1,14,11,1640,1600,1946,346
2016,1,14,12,1679,1646,2069,423
2016,1,14,13,1781,1734,2218,484
2016,1,14,14,1931,1909,2364,455
2016,1,14,15,1971,1944,2463,519
2016,1,14,16,1934,1883,2372,489
2016,1,14,17,1908,1826,2311,485
2016,1,14,18,1866,1770,2237,467
2016,1,14,19,1822,1716,2019,303
2016,1,14,20,1793,1704,1939,235
2016,1,14,21,1771,1676,1812,136
2016,1,14,22,1758,1654,1871,217
2016,1,14,23,1771,1671,1934,263
2016,1,15,0,1816,1708,2014,306
2016,1,15,1,1971,1864,2097,233
2016,1,15,2,2037,1949,2112,163
2016,1,15,3,2034,1951,2077,126
2016,1,15,4,2022,1933,2062,129
2016,1,15,5,1951,1862,1940,78
2016,1,15,6,1833,1751,1748,-3
2016,1,15,7,1732,1667,1578,-89
2016,1,15,8,1670,1608,1392,-216
2016,1,15,9,1635,1580,1440,-140
2016,1,15,10,1624,1576,1401,-175
2016,1,15,11,1626,1582,1427,-155
2016,1,15,12,1661,1614,1478,-136
2016,1,15,13,1758,1711,1621,-90
2016,1,15,14,1898,1868,1866,-2
2016,1,15,15,1945,1903,2029,126
2016,1,15,16,1913,1874,2075,201
2016,1,15,17,1896,1831,2060,229
2016,1,15,18,1861,1834,2086,252
2016,1,15,19,1821,1795,2088,293
2016,1,15,20,1789,1780,2050,270
2016,1,15,21,1789,1756,2097,341
2016,1,15,22,1774,1746,2057,311
2016,1,15,23,1793,1762,2105,343
2016,1,16,0,1833,1796,2142,346
2016,1,16,1,1975,1917,2211,294
2016,1,16,2,2023,1940,2220,280
2016,1,16,3,2013,1916,2198,282
2016,1,16,4,2001,1910,2184,274
2016,1,16,5,1937,1875,2170,295
2016,1,16,6,1833,1788,1942,154
2016,1,16,7,1742,1711,1698,-13
2016,1,16,8,1696,1645,1690,45
2016,1,16,9,1660,1610,1616,6
2016,1,16,10,1643,1589,1620,31
2016,1,16,11,1637,1592,1635,43
2016,1,16,12,1655,1608,1691,83
2016,1,16,13,1701,1653,1748,95
2016,1,16,14,1774,1732,1905,173
2016,1,16,15,1828,1781,1884,103
2016,1,16,16,1864,1799,1870,71
2016,1,16,17,1878,1788,1862,74
2016,1,16,18,1857,1761,1872,111
2016,1,16,19,1810,1717,1885,168
2016,1,16,20,1779,1667,1839,172
2016,1,16,21,1750,1635,1788,153
2016,1,16,22,1730,1620,1783,163
2016,1,16,23,1743,1627,1774,147
2016,1,17,0,1790,1672,1872,200
2016,1,17,1,1945,1835,2092,257
2016,1,17,2,2003,1915,2119,204
2016,1,17,3,1999,1896,2080,184
2016,1,17,4,1972,1875,2130,255
2016,1,17,5,1919,1828,2109,281
2016,1,17,6,1832,1738,1922,184
2016,1,17,7,1749,1662,1708,46
2016,1,17,8,1680,1603,1677,74
2016,1,17,9,1639,1563,1669,106
2016,1,17,10,1620,1549,1666,117
2016,1,17,11,1612,1541,1733,192
2016,1,17,12,1620,1550,1787,237
2016,1,17,13,1659,1594,1844,250
2016,1,17,14,1719,1656,1906,250
2016,1,17,15,1761,1687,1925,238
2016,1,17,16,1796,1697,1917,220
2016,1,17,17,1801,1681,1802,121
2016,1,17,18,1775,1660,1741,81
2016,1,17,19,1740,1640,1737,97
2016,1,17,20,1717,1622,1696,74
2016,1,17,21,1692,1597,1592,-5
2016,1,17,22,1674,1591,1588,-3
2016,1,17,23,1688,1599,1493,-106
2016,1,18,0,1748,1634,1477,-157
2016,1,18,1,1917,1791,1629,-162
2016,1,18,2,1989,1906,1764,-142
2016,1,18,3,1990,1896,1700,-196
2016,1,18,4,1964,1868,1696,-172
2016,1,18,5,1899,1808,1712,-96
2016,1,18,6,1795,1719,1617,-102
2016,1,18,7,1705,1637,1543,-94
2016,1,18,8,1627,1579,1572,-7
2016,1,18,9,1593,1555,1533,-22
2016,1,18,10,1583,1549,1485,-64
2016,1,18,11,1585,1554,1457,-97
2016,1,18,12,1616,1584,1467,-117
2016,1,18,13,1701,1660,1645,-15
2016,1,18,14,1831,1761,1786,25
2016,1,18,15,1875,1799,1898,99
2016,1,18,16,1860,1800,1979,179
2016,1,18,17,1841,1785,1946,161
2016,1,18,18,1809,1745,1920,175
2016,1,18,19,1772,1717,1951,234
2016,1,18,20,1744,1674,1974,300
2016,1,18,21,1727,1649,2030,381
2016,1,18,22,1708,1632,2073,441
2016,1,18,23,1727,1649,2080,431
2016,1,19,0,1775,1706,2140,434
2016,1,19,1,1933,1850,2277,427
2016,1,19,2,2007,1925,2269,344
2016,1,19,3,1997,1912,2230,318
2016,1,19,4,1982,1889,2245,356
2016,1,19,5,1907,1808,2200,392
2016,1,19,6,1788,1686,2096,410
2016,1,19,7,1685,1590,1886,296
2016,1,19,8,1613,1530,1836,306
2016,1,19,9,1577,1492,1792,300
2016,1,19,10,1563,1481,1847,366
2016,1,19,11,1566,1490,1973,483
2016,1,19,12,1602,1525,2048,523
2016,1,19,13,1703,1629,2207,578
2016,1,19,14,1856,1785,2413,628
2016,1,19,15,1893,1819,2571,752
2016,1,19,16,1867,1790,2428,638
2016,1,19,17,1856,1748,2307,559
2016,1,19,18,1820,1706,2274,568
2016,1,19,19,1780,1666,2261,595
2016,1,19,20,1755,1631,2193,562
2016,1,19,21,1736,1609,2142,533
2016,1,19,22,1725,1611,2173,562
2016,1,19,23,1737,1632,2263,631
2016,1,20,0,1782,1680,2308,628
2016,1,20,1,1930,1812,2263,451
2016,1,20,2,1996,1894,2306,412
2016,1,20,3,1992,1882,2312,430
2016,1,20,4,1975,1872,2346,474
2016,1,20,5,1899,1786,2298,512
2016,1,20,6,1778,1671,2076,405
2016,1,20,7,1679,1587,1855,268
2016,1,20,8,1577,1522,1683,161
2016,1,20,9,1539,1482,1608,126
2016,1,20,10,1526,1464,1590,126
2016,1,20,11,1530,1467,1618,151
2016,1,20,12,1570,1501,1760,259
2016,1,20,13,1665,1589,2018,429
2016,1,20,14,1821,1756,2244,488
2016,1,20,15,1859,1798,2257,459
2016,1,20,16,1835,1771,2252,481
2016,1,20,17,1812,1724,2319,595
2016,1,20,18,1778,1689,2235,546
2016,1,20,19,1750,1655,2190,535
2016,1,20,20,1720,1626,2193,567
2016,1,20,21,1704,1606,2199,593
2016,1,20,22,1693,1590,2244,654
2016,1,20,23,1709,1603,2224,621
2016,1,21,0,1754,1645,2154,509
2016,1,21,1,1908,1769,2160,391
2016,1,21,2,1964,1875,2214,339
2016,1,21,3,1956,1869,2179,310
2016,1,21,4,1935,1869,2199,330
2016,1,21,5,1863,1798,2181,383
2016,1,21,6,1744,1675,2120,445
2016,1,21,7,1643,1589,2034,445
2016,1,21,8,1596,1542,1897,355
2016,1,21,9,1563,1520,1930,410
2016,1,21,10,1551,1517,1877,360
2016,1,21,11,1560,1524,1833,309
2016,1,21,12,1599,1566,1834,268
2016,1,21,13,1704,1681,1925,244
2016,1,21,14,1854,1849,2000,151
2016,1,21,15,1895,1884,2190,306
2016,1,21,16,1863,1829,2363,534
2016,1,21,17,1833,1768,2327,559
2016,1,21,18,1798,1730,2267,537
2016,1,21,19,1757,1705,2224,519
2016,1,21,20,1724,1666,2222,556
2016,1,21,21,1704,1653,2137,484
2016,1,21,22,1692,1631,2104,473
2016,1,21,23,1711,1638,2111,473
2016,1,22,0,1762,1684,2174,490
2016,1,22,1,1922,1833,2193,360
2016,1,22,2,1985,1941,2272,331
2016,1,22,3,1980,1919,2152,233
2016,1,22,4,1965,1925,2134,209
2016,1,22,5,1890,1854,2003,149
2016,1,22,6,1773,1730,1897,167
2016,1,22,7,1677,1644,1856,212
2016,1,22,8,1621,1588,1716,128
2016,1,22,9,1591,1552,1670,118
2016,1,22,10,1580,1551,1641,90
2016,1,22,11,1588,1562,1670,108
2016,1,22,12,1627,1605,1677,72
2016,1,22,13,1718,1694,1777,83
2016,1,22,14,1866,1856,1877,21
2016,1,22,15,1903,1900,2086,186
2016,1,22,16,1875,1846,2034,188
2016,1,22,17,1838,1802,1947,145
2016,1,22,18,1796,1757,1954,197
2016,1,22,19,1750,1708,1939,231
2016,1,22,20,1709,1655,1912,257
2016,1,22,21,1686,1623,1908,285
2016,1,22,22,1662,1603,1883,280
2016,1,22,23,1672,1607,1863,256
2016,1,23,0,1710,1638,1899,261
2016,1,23,1,1849,1758,1999,241
2016,1,23,2,1918,1851,2094,243
2016,1,23,3,1913,1845,2010,165
2016,1,23,4,1907,1837,2048,211
2016,1,23,5,1853,1798,2051,253
2016,1,23,6,1753,1706,1934,228
2016,1,23,7,1667,1630,1889,259
2016,1,23,8,1599,1571,1904,333
2016,1,23,9,1570,1532,1869,337
2016,1,23,10,1554,1526,1865,339
2016,1,23,11,1555,1520,1876,356
2016,1,23,12,1578,1542,1900,358
2016,1,23,13,1621,1588,1889,301
2016,1,23,14,1698,1659,1925,266
2016,1,23,15,1733,1710,2064,354
2016,1,23,16,1754,1722,2146,424
2016,1,23,17,1732,1697,2098,401
2016,1,23,18,1705,1674,2137,463
2016,1,23,19,1678,1623,2090,467
2016,1,23,20,1636,1586,2065,479
2016,1,23,21,1606,1548,2042,494
2016,1,23,22,1587,1528,2040,512
2016,1,23,23,1597,1532,2044,512
2016,1,24,0,1643,1560,2073,513
2016,1,24,1,1786,1701,2193,492
2016,1,24,2,1854,1798,2344,546
2016,1,24,3,1849,1801,2263,462
2016,1,24,4,1829,1783,2280,497
2016,1,24,5,1776,1735,2230,495
2016,1,24,6,1696,1651,2163,512
2016,1,24,7,1616,1582,2085,503
2016,1,24,8,1568,1507,2038,531
2016,1,24,9,1530,1485,1938,453
2016,1,24,10,1510,1470,1922,452
2016,1,24,11,1504,1469,1987,518
2016,1,24,12,1518,1478,2015,537
2016,1,24,13,1554,1515,2079,564
2016,1,24,14,1622,1579,2202,623
2016,1,24,15,1659,1623,2233,610
2016,1,24,16,1687,1654,2235,581
2016,1,24,17,1687,1643,2161,518
2016,1,24,18,1667,1614,2091,477
2016,1,24,19,1644,1585,2055,470
2016,1,24,20,1625,1568,2042,474
2016,1,24,21,1612,1548,2028,480
2016,1,24,22,1598,1542,2002,460
2016,1,24,23,1621,1555,2073,518
2016,1,25,0,1678,1592,2114,522
2016,1,25,1,1831,1750,2284,534
2016,1,25,2,1920,1858,2443,585
2016,1,25,3,1913,1859,2476,617
2016,1,25,4,1891,1824,2455,631
2016,1,25,5,1828,1754,2385,631
2016,1,25,6,1718,1632,2288,656
2016,1,25,7,1624,1544,2190,646
2016,1,25,8,1565,1489,2142,653
2016,1,25,9,1533,1476,2089,613
2016,1,25,10,1523,1470,2091,621
2016,1,25,11,1528,1487,2007,520
2016,1,25,12,1564,1539,2026,487
2016,1,25,13,1644,1644,2058,414
2016,1,25,14,1779,1819,2200,381
2016,1,25,15,1834,1862,2249,387
2016,1,25,16,1822,1824,2189,365
2016,1,25,17,1804,1789,2147,358
2016,1,25,18,1769,1749,2151,402
2016,1,25,19,1740,1712,2219,507
2016,1,25,20,1713,1675,2203,528
2016,1,25,21,1693,1665,2158,493
2016,1,25,22,1680,1653,2091,438
2016,1,25,23,1698,1677,2154,477
2016,1,26,0,1747,1728,2227,499
2016,1,26,1,1903,1889,2182,293
2016,1,26,2,1983,1965,2236,271
2016,1,26,3,1975,1952,2232,280
2016,1,26,4,1959,1935,2193,258
2016,1,26,5,1885,1848,2206,358
2016,1,26,6,1764,1718,2112,394
2016,1,26,7,1667,1626,1952,326
2016,1,26,8,1632,1569,1946,377
2016,1,26,9,1600,1548,1865,317
2016,1,26,10,1590,1537,1594,57
2016,1,26,11,1596,1540,1516,-24
2016,1,26,12,1641,1582,1565,-17
2016,1,26,13,1736,1684,1731,47
2016,1,26,14,1897,1846,1901,55
2016,1,26,15,1933,1893,1807,-86
2016,1,26,16,1901,1867,1810,-57
2016,1,26,17,1869,1824,1767,-57
2016,1,26,18,1831,1787,1776,-11
2016,1,26,19,1783,1737,1765,28
2016,1,26,20,1739,1733,1695,-38
2016,1,26,21,1716,1698,1681,-17
2016,1,26,22,1705,1673,1667,-6
2016,1,26,23,1719,1674,1696,22
2016,1,27,0,1763,1691,1775,84
2016,1,27,1,1927,1837,1803,-34
2016,1,27,2,2003,1964,1826,-138
2016,1,27,3,1998,1963,1866,-97
2016,1,27,4,1985,1963,1936,-27
2016,1,27,5,1908,1879,1882,3
2016,1,27,6,1786,1754,1856,102
2016,1,27,7,1693,1668,1836,168
2016,1,27,8,1625,1609,1739,130
2016,1,27,9,1601,1587,1679,92
2016,1,27,10,1594,1588,1654,66
2016,1,27,11,1604,1588,1645,57
2016,1,27,12,1648,1624,1657,33
2016,1,27,13,1740,1733,1790,57
2016,1,27,14,1907,1903,2012,109
2016,1,27,15,1944,1940,2104,164
2016,1,27,16,1902,1852,1990,138
2016,1,27,17,1855,1811,1924,113
2016,1,27,18,1812,1773,1874,101
2016,1,27,19,1761,1745,1913,168
2016,1,27,20,1721,1683,1941,258
2016,1,27,21,1700,1653,1917,264
2016,1,27,22,1678,1635,1859,224
2016,1,27,23,1694,1634,1901,267
2016,1,28,0,1731,1652,1851,199
2016,1,28,1,1882,1755,1857,102
2016,1,28,2,1963,1907,1949,42
2016,1,28,3,1967,1913,2043,130
2016,1,28,4,1959,1889,2052,163
2016,1,28,5,1884,1818,2041,223
2016,1,28,6,1771,1706,2007,301
2016,1,28,7,1675,1626,1872,246
2016,1,28,8,1621,1567,1735,168
2016,1,28,9,1590,1540,1631,91
2016,1,28,10,1580,1535,1585,50
2016,1,28,11,1579,1543,1602,59
2016,1,28,12,1627,1583,1633,50
2016,1,28,13,1732,1698,1709,11
2016,1,28,14,1903,1856,1913,57
2016,1,28,15,1930,1886,2078,192
2016,1,28,16,1881,1834,2095,261
2016,1,28,17,1835,1760,2004,244
2016,1,28,18,1794,1703,2019,316
2016,1,28,19,1742,1646,1966,320
2016,1,28,20,1705,1614,1949,335
2016,1,28,21,1685,1584,1915,331
2016,1,28,22,1664,1603,1945,342
2016,1,28,23,1675,1598,1987,389
2016,1,29,0,1697,1626,2129,503
2016,1,29,1,1857,1721,2163,442
2016,1,29,2,1947,1847,2253,406
2016,1,29,3,1946,1856,2349,493
2016,1,29,4,1938,1847,2450,603
2016,1,29,5,1867,1787,2464,677
2016,1,29,6,1749,1675,2318,643
2016,1,29,7,1656,1587,2127,540
2016,1,29,8,1572,1541,2048,507
2016,1,29,9,1543,1502,2063,561
2016,1,29,10,1534,1498,2043,545
2016,1,29,11,1538,1503,2038,535
2016,1,29,12,1572,1543,2021,478
2016,1,29,13,1674,1633,2070,437
2016,1,29,14,1836,1803,2333,530
2016,1,29,15,1875,1841,2409,568
2016,1,29,16,1833,1795,2388,593
2016,1,29,17,1789,1745,2316,571
2016,1,29,18,1749,1699,2283,584
2016,1,29,19,1712,1647,2293,646
2016,1,29,20,1677,1606,2214,608
2016,1,29,21,1655,1583,2205,622
2016,1,29,22,1637,1572,2189,617
2016,1,29,23,1647,1566,2176,610
2016,1,30,0,1670,1585,2156,571
2016,1,30,1,1779,1682,2196,514
2016,1,30,2,1872,1788,2277,489
2016,1,30,3,1869,1777,2281,504
2016,1,30,4,1861,1771,2248,477
2016,1,30,5,1806,1722,2232,510
2016,1,30,6,1713,1638,2178,540
2016,1,30,7,1625,1557,2039,482
2016,1,30,8,1545,1494,1988,494
2016,1,30,9,1512,1460,1973,513
2016,1,30,10,1495,1446,1982,536
2016,1,30,11,1494,1444,2016,572
2016,1,30,12,1514,1460,2029,569
2016,1,30,13,1563,1511,2063,552
2016,1,30,14,1638,1588,2067,479
2016,1,30,15,1686,1619,2086,467
2016,1,30,16,1693,1652,2182,530
2016,1,30,17,1670,1631,2156,525
2016,1,30,18,1655,1599,2167,568
2016,1,30,19,1618,1559,2110,551
2016,1,30,20,1590,1523,2058,535
2016,1,30,21,1563,1498,2084,586
2016,1,30,22,1565,1483,2023,540
2016,1,30,23,1576,1489,2044,555
2016,1,31,0,1610,1529,2059,530
2016,1,31,1,1738,1634,2102,468
2016,1,31,2,1813,1744,2169,425
2016,1,31,3,1807,1735,2205,470
2016,1,31,4,1790,1717,2270,553
2016,1,31,5,1734,1657,2242,585
2016,1,31,6,1650,1582,2199,617
2016,1,31,7,1566,1501,2147,646
2016,1,31,8,1515,1440,2073,633
2016,1,31,9,1477,1396,2068,672
2016,1,31,10,1457,1382,1971,589
2016,1,31,11,1455,1376,1975,599
2016,1,31,12,1467,1388,1974,586
2016,1,31,13,1509,1417,1948,531
2016,1,31,14,1586,1470,1901,431
2016,1,31,15,1625,1510,1900,390
2016,1,31,16,1649,1553,1950,397
2016,1,31,17,1649,1558,2020,462
2016,1,31,18,1631,1554,1961,407
2016,1,31,19,1606,1542,1953,411
2016,1,31,20,1593,1520,2004,484
2016,1,31,21,1582,1507,1999,492
2016,1,31,22,1578,1506,2024,518
2016,1,31,23,1594,1515,2073,558
2016,2,1,0,1642,1564,2060,496
2016,2,1,1,1782,1702,2145,443
2016,2,1,2,1859,1803,2224,421
2016,2,1,3,1846,1790,2226,436
2016,2,1,4,1821,1746,2171,425
2016,2,1,5,1749,1681,2180,499
2016,2,1,6,1645,1567,1949,382
2016,2,1,7,1558,1465,1658,193
2016,2,1,8,1492,1416,1596,180
2016,2,1,9,1459,1381,1511,130
2016,2,1,10,1448,1366,1547,181
2016,2,1,11,1452,1384,1534,150
2016,2,1,12,1483,1440,1506,66
2016,2,1,13,1568,1538,1573,35
2016,2,1,14,1702,1709,1723,14
2016,2,1,15,1760,1795,1805,10
2016,2,1,16,1765,1807,1840,33
2016,2,1,17,1764,1803,1837,34
2016,2,1,18,1749,1803,1875,72
2016,2,1,19,1731,1783,1839,56
2016,2,1,20,1712,1782,1935,153
2016,2,1,21,1708,1790,1916,126
2016,2,1,22,1704,1767,1866,99
2016,2,1,23,1725,1764,1872,108
2016,2,2,0,1772,1789,1874,85
2016,2,2,1,1908,1909,2029,120
2016,2,2,2,1975,2030,2117,87
2016,2,2,3,1964,2015,2125,110
2016,2,2,4,1947,1988,2119,131
2016,2,2,5,1863,1897,2044,147
2016,2,2,6,1736,1775,1924,149
2016,2,2,7,1640,1679,1745,66
2016,2,2,8,1588,1600,1678,78
2016,2,2,9,1555,1572,1672,100
2016,2,2,10,1548,1555,1604,49
2016,2,2,11,1559,1554,1547,-7
2016,2,2,12,1599,1591,1546,-45
2016,2,2,13,1700,1691,1594,-97
2016,2,2,14,1855,1847,1714,-133
2016,2,2,15,1904,1894,1723,-171
2016,2,2,16,1880,1878,1713,-165
2016,2,2,17,1857,1853,1645,-208
2016,2,2,18,1830,1843,1751,-92
2016,2,2,19,1796,1820,1793,-27
2016,2,2,20,1764,1796,1730,-66
2016,2,2,21,1752,1770,1588,-182
2016,2,2,22,1740,1746,1562,-184
2016,2,2,23,1752,1746,1565,-181
2016,2,3,0,1786,1785,1686,-99
2016,2,3,1,1934,1881,1801,-80
2016,2,3,2,2028,2042,1916,-126
2016,2,3,3,2022,2036,1891,-145
2016,2,3,4,2000,2013,1848,-165
2016,2,3,5,1918,1923,1780,-143
2016,2,3,6,1793,1799,1713,-86
2016,2,3,7,1701,1707,1498,-209
2016,2,3,8,1675,1640,1417,-223
2016,2,3,9,1645,1623,1396,-227
2016,2,3,10,1635,1614,1393,-221
2016,2,3,11,1645,1622,1371,-251
2016,2,3,12,1696,1662,1368,-294
2016,2,3,13,1800,1776,1355,-421
2016,2,3,14,1962,1925,1612,-313
2016,2,3,15,2003,1955,1698,-257
2016,2,3,16,1961,1922,1676,-246
2016,2,3,17,1913,1882,1579,-303
2016,2,3,18,1879,1826,1622,-204
2016,2,3,19,1835,1788,1670,-118
2016,2,3,20,1795,1744,1719,-25
2016,2,3,21,1771,1719,1744,25
2016,2,3,22,1749,1710,1800,90
2016,2,3,23,1763,1729,1820,91
2016,2,4,0,1804,1776,1899,123
2016,2,4,1,1962,1900,1922,22
2016,2,4,2,2055,2049,2030,-19
2016,2,4,3,2050,2049,1978,-71
2016,2,4,4,2038,2034,2009,-25
2016,2,4,5,1957,1960,2053,93
2016,2,4,6,1834,1840,2023,183
2016,2,4,7,1736,1747,1835,88
2016,2,4,8,1722,1690,1771,81
2016,2,4,9,1700,1675,1742,67
2016,2,4,10,1690,1673,1702,29
2016,2,4,11,1701,1686,1670,-16
2016,2,4,12,1747,1727,1756,29
2016,2,4,13,1853,1830,1878,48
2016,2,4,14,2007,1995,2061,66
2016,2,4,15,2050,2019,2062,43
2016,2,4,16,2008,1944,2059,115
2016,2,4,17,1958,1897,2129,232
2016,2,4,18,1918,1854,2042,188
2016,2,4,19,1863,1793,1950,157
2016,2,4,20,1820,1754,1861,107
2016,2,4,21,1783,1728,1866,138
2016,2,4,22,1743,1723,1856,133
2016,2,4,23,1725,1740,1899,159
2016,2,5,0,1760,1793,1982,189
2016,2,5,1,1881,1893,1966,73
2016,2,5,2,2029,2037,1984,-53
2016,2,5,3,2037,2037,2059,22
2016,2,5,4,2024,2025,2095,70
2016,2,5,5,1946,1949,2040,91
2016,2,5,6,1827,1827,2058,231
2016,2,5,7,1736,1740,1971,231
2016,2,5,8,1695,1688,1922,234
2016,2,5,9,1669,1653,1988,335
2016,2,5,10,1663,1647,1992,345
2016,2,5,11,1664,1653,1952,299
2016,2,5,12,1704,1691,1969,278
2016,2,5,13,1803,1779,1996,217
2016,2,5,14,1950,1931,2172,241
2016,2,5,15,1995,1963,2262,299
2016,2,5,16,1942,1926,2148,222
2016,2,5,17,1903,1886,2143,257
2016,2,5,18,1854,1829,2159,330
2016,2,5,19,1805,1791,2144,353
2016,2,5,20,1778,1743,2111,368
2016,2,5,21,1754,1712,2076,364
2016,2,5,22,1727,1861,2201,340
2016,2,5,23,1731,1680,1979,299
2016,2,6,0,1767,1712,1992,280
2016,2,6,1,1884,1796,2087,291
2016,2,6,2,1985,1935,2115,180
2016,2,6,3,1983,1942,2110,168
2016,2,6,4,1977,1955,2106,151
2016,2,6,5,1923,1907,2163,256
2016,2,6,6,1828,1817,2137,320
2016,2,6,7,1741,1748,2078,330
2016,2,6,8,1695,1684,1918,234
2016,2,6,9,1667,1649,1835,186
2016,2,6,10,1659,1641,1778,137
2016,2,6,11,1656,1645,1778,133
2016,2,6,12,1681,1662,1714,52
2016,2,6,13,1727,1702,1669,-33
2016,2,6,14,1803,1779,1809,30
2016,2,6,15,1849,1805,1865,60
2016,2,6,16,1861,1813,1894,81
2016,2,6,17,1849,1790,1897,107
2016,2,6,18,1812,1748,1940,192
2016,2,6,19,1756,1708,1962,254
2016,2,6,20,1716,1651,1920,269
2016,2,6,21,1674,1615,1893,278
2016,2,6,22,1649,1585,1858,273
2016,2,6,23,1655,1567,1650,83
2016,2,7,0,1686,1596,1756,160
2016,2,7,1,1808,1701,1922,221
2016,2,7,2,1919,1849,2013,164
2016,2,7,3,1924,1861,2049,188
2016,2,7,4,1909,1853,2049,196
2016,2,7,5,1866,1805,2011,206
2016,2,7,6,1776,1727,1985,258
2016,2,7,7,1701,1658,1804,146
2016,2,7,8,1651,1600,1620,20
2016,2,7,9,1610,1555,1553,-2
2016,2,7,10,1599,1540,1575,35
2016,2,7,11,1603,1541,1613,72
2016,2,7,12,1611,1554,1606,52
2016,2,7,13,1653,1600,1583,-17
2016,2,7,14,1722,1653,1556,-97
2016,2,7,15,1760,1688,1414,-274
2016,2,7,16,1766,1702,1383,-319
2016,2,7,17,1755,1685,1353,-332
2016,2,7,18,1716,1651,1348,-303
2016,2,7,19,1675,1622,1489,-133
2016,2,7,20,1649,1595,1485,-110
2016,2,7,21,1634,1577,1503,-74
2016,2,7,22,1595,1563,1478,-85
2016,2,7,23,1599,1564,1421,-143
2016,2,8,0,1642,1568,1346,-222
2016,2,8,1,1765,1626,1288,-338
2016,2,8,2,1888,1746,1382,-364
2016,2,8,3,1892,1751,1457,-294
2016,2,8,4,1879,1754,1527,-227
2016,2,8,5,1825,1749,1555,-194
2016,2,8,6,1722,1658,1451,-207
2016,2,8,7,1635,1574,1276,-298
2016,2,8,8,1579,1517,1224,-293
2016,2,8,9,1552,1495,1212,-283
2016,2,8,10,1543,1496,1174,-322
2016,2,8,11,1552,1511,1133,-378
2016,2,8,12,1586,1554,1135,-419
2016,2,8,13,1676,1651,1231,-420
2016,2,8,14,1815,1798,1331,-467
2016,2,8,15,1859,1829,1497,-332
2016,2,8,16,1826,1784,1480,-304
2016,2,8,17,1792,1744,1489,-255
2016,2,8,18,1751,1703,1490,-213
2016,2,8,19,1713,1667,1511,-156
2016,2,8,20,1676,1642,1578,-64
2016,2,8,21,1656,1619,1560,-59
2016,2,8,22,1641,1601,1556,-45
2016,2,8,23,1639,1588,1552,-36
2016,2,9,0,1672,1614,1600,-14
2016,2,9,1,1787,1692,1676,-16
2016,2,9,2,1910,1843,1809,-34
2016,2,9,3,1913,1851,1776,-75
2016,2,9,4,1910,1842,1736,-106
2016,2,9,5,1841,1767,1695,-72
2016,2,9,6,1720,1644,1598,-46
2016,2,9,7,1625,1558,1434,-124
2016,2,9,8,1547,1494,1462,-32
2016,2,9,9,1522,1475,1490,15
2016,2,9,10,1518,1475,1467,-8
2016,2,9,11,1526,1484,1456,-28
2016,2,9,12,1568,1524,1504,-20
2016,2,9,13,1667,1627,1611,-16
2016,2,9,14,1816,1798,1758,-40
2016,2,9,15,1850,1828,1876,48
2016,2,9,16,1808,1790,1781,-9
2016,2,9,17,1774,1737,1770,33
2016,2,9,18,1734,1687,1759,72
2016,2,9,19,1702,1647,1761,114
2016,2,9,20,1676,1613,1715,102
2016,2,9,21,1656,1581,1652,71
2016,2,9,22,1637,1580,1664,84
2016,2,9,23,1642,1566,1654,88
2016,2,10,0,1668,1595,1690,95
2016,2,10,1,1766,1663,1784,121
2016,2,10,2,1874,1809,1818,9
2016,2,10,3,1880,1826,1826,0
2016,2,10,4,1876,1818,1860,42
2016,2,10,5,1807,1749,1768,19
2016,2,10,6,1687,1632,1707,75
2016,2,10,7,1597,1546,1499,-47
2016,2,10,8,1515,1495,1365,-130
2016,2,10,9,1496,1471,1380,-91
2016,2,10,10,1486,1462,1373,-89
2016,2,10,11,1490,1477,1388,-89
2016,2,10,12,1531,1516,1468,-48
2016,2,10,13,1633,1627,1531,-96
2016,2,10,14,1793,1796,1709,-87
2016,2,10,15,1814,1816,1750,-66
2016,2,10,16,1765,1760,1593,-167
2016,2,10,17,1718,1709,1628,-81
2016,2,10,18,1683,1658,1710,52
2016,2,10,19,1648,1624,1781,157
2016,2,10,20,1624,1572,1811,239
2016,2,10,21,1613,1563,1820,257
2016,2,10,22,1599,1554,1834,280
2016,2,10,23,1603,1561,1833,272
2016,2,11,0,1624,1588,1777,189
2016,2,11,1,1718,1647,1738,91
2016,2,11,2,1813,1781,1868,87
2016,2,11,3,1824,1802,1865,63
2016,2,11,4,1817,1804,1904,100
2016,2,11,5,1747,1723,1966,243
2016,2,11,6,1631,1611,1899,288
2016,2,11,7,1545,1527,1746,219
2016,2,11,8,1490,1469,1688,219
2016,2,11,9,1460,1441,1717,276
2016,2,11,10,1451,1441,1801,360
2016,2,11,11,1462,1456,1731,275
2016,2,11,12,1507,1494,1727,233
2016,2,11,13,1611,1598,1759,161
2016,2,11,14,1773,1761,1980,219
2016,2,11,15,1800,1789,2033,244
2016,2,11,16,1754,1713,2033,320
2016,2,11,17,1711,1676,2018,342
2016,2,11,18,1675,1628,2064,436
2016,2,11,19,1638,1582,2043,461
2016,2,11,20,1615,1566,2060,494
2016,2,11,21,1591,1557,2087,530
2016,2,11,22,1587,1557,2097,540
2016,2,11,23,1596,1552,2083,531
2016,2,12,0,1625,1581,2089,508
2016,2,12,1,1704,1644,2084,440
2016,2,12,2,1804,1780,2240,460
2016,2,12,3,1810,1781,2246,465
2016,2,12,4,1800,1775,2320,545
2016,2,12,5,1737,1704,2133,429
2016,2,12,6,1623,1591,1803,212
2016,2,12,7,1532,1511,1637,126
2016,2,12,8,1468,1451,1598,147
2016,2,12,9,1436,1423,1525,102
2016,2,12,10,1430,1411,1509,98
2016,2,12,11,1442,1420,1493,73
2016,2,12,12,1480,1456,1521,65
2016,2,12,13,1582,1580,1594,14
2016,2,12,14,1728,1713,1752,39
2016,2,12,15,1762,1732,1847,115
2016,2,12,16,1734,1703,1776,73
2016,2,12,17,1694,1673,1764,91
2016,2,12,18,1663,1630,1789,159
2016,2,12,19,1634,1601,1779,178
2016,2,12,20,1609,1577,1757,180
2016,2,12,21,1599,1562,1741,179
2016,2,12,22,1594,1557,1713,156
2016,2,12,23,1600,1558,1740,182
2016,2,13,0,1610,1564,1698,134
2016,2,13,1,1680,1603,1719,116
2016,2,13,2,1770,1727,1813,86
2016,2,13,3,1776,1718,1805,87
2016,2,13,4,1771,1709,1824,115
2016,2,13,5,1710,1660,1819,159
2016,2,13,6,1605,1588,1745,157
2016,2,13,7,1522,1505,1617,112
2016,2,13,8,1461,1448,1609,161
2016,2,13,9,1425,1410,1580,170
2016,2,13,10,1413,1387,1515,128
2016,2,13,11,1414,1400,1479,79
2016,2,13,12,1433,1425,1526,101
2016,2,13,13,1474,1473,1570,97
2016,2,13,14,1549,1541,1634,93
2016,2,13,15,1590,1574,1767,193
2016,2,13,16,1617,1603,1835,232
2016,2,13,17,1606,1582,1821,239
2016,2,13,18,1585,1556,1827,271
2016,2,13,19,1559,1521,1871,350
2016,2,13,20,1542,1489,1861,372
2016,2,13,21,1519,1468,1829,361
2016,2,13,22,1514,1450,1846,396
2016,2,13,23,1527,1463,1872,409
2016,2,14,0,1545,1491,1889,398
2016,2,14,1,1644,1560,1930,370
2016,2,14,2,1730,1687,1995,308
2016,2,14,3,1727,1683,1982,299
2016,2,14,4,1711,1662,1951,289
2016,2,14,5,1651,1623,1858,235
2016,2,14,6,1567,1554,1789,235
2016,2,14,7,1488,1480,1662,182
2016,2,14,8,1449,1414,1595,181
2016,2,14,9,1415,1380,1562,182
2016,2,14,10,1400,1366,1559,193
2016,2,14,11,1397,1366,1564,198
2016,2,14,12,1408,1378,1584,206
2016,2,14,13,1451,1414,1615,201
2016,2,14,14,1519,1475,1628,153
2016,2,14,15,1560,1506,1701,195
2016,2,14,16,1575,1525,1758,233
2016,2,14,17,1566,1519,1700,181
2016,2,14,18,1549,1504,1661,157
2016,2,14,19,1527,1481,1648,167
2016,2,14,20,1521,1468,1673,205
2016,2,14,21,1509,1463,1706,243
2016,2,14,22,1506,1462,1714,252
2016,2,14,23,1511,1470,1758,288
2016,2,15,0,1549,1491,1820,329
2016,2,15,1,1643,1567,1985,418
2016,2,15,2,1753,1707,2117,410
2016,2,15,3,1744,1701,2136,435
2016,2,15,4,1728,1679,2020,341
2016,2,15,5,1662,1633,2035,402
2016,2,15,6,1568,1547,1925,378
2016,2,15,7,1484,1467,1708,241
2016,2,15,8,1437,1415,1687,272
2016,2,15,9,1407,1385,1578,193
2016,2,15,10,1383,1374,1600,226
2016,2,15,11,1401,1379,1602,223
2016,2,15,12,1450,1418,1556,138
2016,2,15,13,1540,1489,1509,20
2016,2,15,14,1671,1601,1545,-56
2016,2,15,15,1707,1635,1546,-89
2016,2,15,16,1693,1642,1593,-49
2016,2,15,17,1664,1640,1694,54
2016,2,15,18,1632,1629,1738,109
2016,2,15,19,1599,1598,1722,124
2016,2,15,20,1574,1582,1711,129
2016,2,15,21,1572,1563,1749,186
2016,2,15,22,1574,1549,1797,248
2016,2,15,23,1586,1541,1742,201
2016,2,16,0,1614,1555,1729,174
2016,2,16,1,1702,1615,1740,125
2016,2,16,2,1804,1767,1814,47
2016,2,16,3,1801,1771,1890,119
2016,2,16,4,1786,1757,1867,110
2016,2,16,5,1715,1686,1758,72
2016,2,16,6,1598,1569,1755,186
2016,2,16,7,1505,1472,1669,197
2016,2,16,8,1442,1408,1659,251
2016,2,16,9,1413,1379,1638,259
2016,2,16,10,1410,1370,1618,248
2016,2,16,11,1418,1378,1601,223
2016,2,16,12,1463,1421,1564,143
2016,2,16,13,1570,1517,1607,90
2016,2,16,14,1711,1665,1716,51
2016,2,16,15,1737,1680,1711,31
2016,2,16,16,1708,1648,1638,-10
2016,2,16,17,1677,1626,1646,20
2016,2,16,18,1645,1613,1628,15
2016,2,16,19,1615,1595,1628,33
2016,2,16,20,1598,1572,1360,-212
2016,2,16,21,1589,1565,1331,-234
2016,2,16,22,1582,1553,1315,-238
2016,2,16,23,1585,1556,1280,-276
2016,2,17,0,1607,1563,1316,-247
2016,2,17,1,1683,1606,1329,-277
2016,2,17,2,1783,1737,1424,-313
2016,2,17,3,1785,1746,1451,-295
2016,2,17,4,1768,1731,1546,-185
2016,2,17,5,1695,1653,1515,-138
2016,2,17,6,1581,1547,1380,-167
2016,2,17,7,1493,1454,1372,-82
2016,2,17,8,1413,1397,1351,-46
2016,2,17,9,1388,1370,1201,-169
2016,2,17,10,1380,1363,1084,-279
2016,2,17,11,1394,1371,961,-410
2016,2,17,12,1447,1411,993,-418
2016,2,17,13,1548,1506,1151,-355
2016,2,17,14,1682,1650,1347,-303
2016,2,17,15,1695,1669,1506,-163
2016,2,17,16,1666,1631,1426,-205
2016,2,17,17,1636,1610,1412,-198
2016,2,17,18,1623,1575,1460,-115
2016,2,17,19,1609,1544,1482,-62
2016,2,17,20,1607,1509,1540,31
2016,2,17,21,1605,1511,1568,57
2016,2,17,22,1614,1512,1541,29
2016,2,17,23,1615,1529,1536,7
2016,2,18,0,1630,1546,1563,17
2016,2,18,1,1687,1586,1556,-30
2016,2,18,2,1771,1713,1708,-5
2016,2,18,3,1770,1709,1736,27
2016,2,18,4,1740,1703,1705,2
2016,2,18,5,1660,1627,1748,121
2016,2,18,6,1542,1518,1695,177
2016,2,18,7,1452,1431,1551,120
2016,2,18,8,1380,1373,1466,93
2016,2,18,9,1353,1345,1535,190
2016,2,18,10,1344,1332,1552,220
2016,2,18,11,1360,1346,1506,160
2016,2,18,12,1411,1371,1515,144
2016,2,18,13,1526,1467,1569,102
2016,2,18,14,1641,1615,1711,96
2016,2,18,15,1660,1629,1714,85
2016,2,18,16,1644,1571,1674,103
2016,2,18,17,1627,1554,1724,170
2016,2,18,18,1620,1544,1747,203
2016,2,18,19,1607,1535,1768,233
2016,2,18,20,1608,1524,1828,304
2016,2,18,21,1609,1518,1873,355
2016,2,18,22,1601,1528,1908,380
2016,2,18,23,1605,1551,1945,394
2016,2,19,0,1614,1591,1909,318
2016,2,19,1,1653,1638,1854,216
2016,2,19,2,1712,1730,1872,142
2016,2,19,3,1736,1720,1847,127
2016,2,19,4,1711,1697,1791,94
2016,2,19,5,1631,1618,1770,152
2016,2,19,6,1519,1503,1658,155
2016,2,19,7,1432,1408,1489,81
2016,2,19,8,1368,1347,1413,66
2016,2,19,9,1341,1307,1418,111
2016,2,19,10,1330,1288,1461,173
2016,2,19,11,1345,1291,1458,167
2016,2,19,12,1396,1326,1403,77
2016,2,19,13,1500,1404,1411,7
2016,2,19,14,1606,1545,1529,-16
2016,2,19,15,1627,1563,1560,-3
2016,2,19,16,1599,1569,1589,20
2016,2,19,17,1585,1578,1613,35
2016,2,19,18,1567,1558,1683,125
2016,2,19,19,1550,1569,1708,139
2016,2,19,20,1571,1565,1690,125
2016,2,19,21,1570,1561,1399,-162
2016,2,19,22,1575,1555,1369,-186
2016,2,19,23,1586,1559,1229,-330
2016,2,20,0,1596,1567,1214,-353
2016,2,20,1,1631,1604,1305,-299
2016,2,20,2,1692,1696,1344,-352
2016,2,20,3,1705,1679,1375,-304
2016,2,20,4,1688,1669,1460,-209
2016,2,20,5,1611,1611,1483,-128
2016,2,20,6,1506,1531,1488,-43
2016,2,20,7,1429,1446,1475,29
2016,2,20,8,1383,1376,1309,-67
2016,2,20,9,1348,1338,1306,-32
2016,2,20,10,1333,1326,1359,33
2016,2,20,11,1334,1323,1378,55
2016,2,20,12,1352,1341,1375,34
2016,2,20,13,1395,1381,1474,93
2016,2,20,14,1461,1448,1618,170
2016,2,20,15,1508,1477,1573,96
2016,2,20,16,1532,1503,1508,5
2016,2,20,17,1540,1499,1517,18
2016,2,20,18,1539,1492,1557,65
2016,2,20,19,1525,1477,1609,132
2016,2,20,20,1524,1464,1582,118
2016,2,20,21,1512,1454,1587,133
2016,2,20,22,1525,1449,1591,142
2016,2,20,23,1549,1455,1615,160
2016,2,21,0,1576,1477,1626,149
2016,2,21,1,1630,1533,1603,70
2016,2,21,2,1681,1659,1630,-29
2016,2,21,3,1679,1655,1639,-16
2016,2,21,4,1646,1632,1620,-12
2016,2,21,5,1577,1576,1539,-37
2016,2,21,6,1485,1501,1550,49
2016,2,21,7,1412,1428,1493,65
2016,2,21,8,1383,1367,1234,-133
2016,2,21,9,1341,1340,1156,-184
2016,2,21,10,1328,1328,1158,-170
2016,2,21,11,1326,1328,1149,-179
2016,2,21,12,1335,1337,1174,-163
2016,2,21,13,1369,1379,1212,-167
2016,2,21,14,1432,1434,1292,-142
2016,2,21,15,1475,1445,1409,-36
2016,2,21,16,1502,1463,1456,-7
2016,2,21,17,1508,1455,1458,3
2016,2,21,18,1484,1448,1504,56
2016,2,21,19,1474,1440,1521,81
2016,2,21,20,1476,1434,1537,103
2016,2,21,21,1468,1436,1509,73
2016,2,21,22,1477,1439,1509,70
2016,2,21,23,1495,1452,1507,55
2016,2,22,0,1537,1488,1605,117
2016,2,22,1,1625,1559,1611,52
2016,2,22,2,1720,1707,1760,53
2016,2,22,3,1696,1723,1800,77
2016,2,22,4,1668,1691,1767,76
2016,2,22,5,1597,1621,1724,103
2016,2,22,6,1500,1516,1625,109
2016,2,22,7,1414,1424,1427,3
2016,2,22,8,1382,1366,1409,43
2016,2,22,9,1353,1339,1407,68
2016,2,22,10,1343,1335,1414,79
2016,2,22,11,1356,1352,1422,70
2016,2,22,12,1393,1390,1415,25
2016,2,22,13,1473,1496,1455,-41
2016,2,22,14,1606,1647,1571,-76
2016,2,22,15,1641,1663,1685,22
2016,2,22,16,1629,1637,1665,28
2016,2,22,17,1613,1612,1676,64
2016,2,22,18,1591,1566,1706,140
2016,2,22,19,1565,1567,1727,160
2016,2,22,20,1544,1566,1740,174
2016,2,22,21,1534,1575,1755,180
2016,2,22,22,1540,1578,1784,206
2016,2,22,23,1546,1574,1792,218
2016,2,23,0,1581,1592,1741,149
2016,2,23,1,1675,1647,1744,97
2016,2,23,2,1773,1786,1791,5
2016,2,23,3,1761,1793,1815,22
2016,2,23,4,1743,1764,1838,74
2016,2,23,5,1666,1681,1729,48
2016,2,23,6,1551,1563,1634,71
2016,2,23,7,1456,1478,1503,25
2016,2,23,8,1452,1421,1372,-49
2016,2,23,9,1416,1395,1362,-33
2016,2,23,10,1416,1379,1342,-37
2016,2,23,11,1427,1387,1383,-4
2016,2,23,12,1465,1428,1414,-14
2016,2,23,13,1563,1535,1434,-101
2016,2,23,14,1718,1685,1603,-82
2016,2,23,15,1752,1722,1838,116
2016,2,23,16,1738,1731,1868,137
2016,2,23,17,1724,1755,1900,145
2016,2,23,18,1708,1746,1906,160
2016,2,23,19,1683,1720,1919,199
2016,2,23,20,1656,1693,1871,178
2016,2,23,21,1643,1681,1837,156
2016,2,23,22,1633,1686,1809,123
2016,2,23,23,1638,1687,1805,118
2016,2,24,0,1664,1697,1787,90
2016,2,24,1,1742,1769,1733,-36
2016,2,24,2,1869,1903,1826,-77
2016,2,24,3,1881,1930,1815,-115
2016,2,24,4,1862,1914,1724,-190
2016,2,24,5,1784,1821,1635,-186
2016,2,24,6,1670,1696,1545,-151
2016,2,24,7,1578,1609,1501,-108
2016,2,24,8,1523,1545,1414,-131
2016,2,24,9,1494,1524,1407,-117
2016,2,24,10,1489,1515,1397,-118
2016,2,24,11,1503,1531,1393,-138
2016,2,24,12,1544,1573,1407,-166
2016,2,24,13,1650,1675,1592,-83
2016,2,24,14,1810,1818,1787,-31
2016,2,24,15,1825,1821,1660,-161
2016,2,24,16,1783,1786,1601,-185
2016,2,24,17,1733,1736,1579,-157
2016,2,24,18,1676,1694,1548,-146
2016,2,24,19,1654,1646,1592,-54
2016,2,24,20,1626,1604,1636,32
2016,2,24,21,1604,1577,1677,100
2016,2,24,22,1591,1554,1655,101
2016,2,24,23,1592,1548,1628,80
2016,2,25,0,1615,1576,1642,66
2016,2,25,1,1694,1628,1627,-1
2016,2,25,2,1822,1793,1649,-144
2016,2,25,3,1834,1825,1696,-129
2016,2,25,4,1828,1820,1674,-146
2016,2,25,5,1759,1753,1637,-116
2016,2,25,6,1649,1642,1591,-51
2016,2,25,7,1560,1560,1489,-71
2016,2,25,8,1515,1497,1349,-148
2016,2,25,9,1492,1468,1400,-68
2016,2,25,10,1486,1458,1391,-67
2016,2,25,11,1501,1475,1401,-74
2016,2,25,12,1544,1505,1446,-59
2016,2,25,13,1650,1614,1464,-150
2016,2,25,14,1804,1741,1431,-310
2016,2,25,15,1818,1746,1350,-396
2016,2,25,16,1772,1693,1277,-416
2016,2,25,17,1736,1654,1266,-388
2016,2,25,18,1697,1634,1196,-438
2016,2,25,19,1656,1579,1108,-471
2016,2,25,20,1624,1552,1105,-447
2016,2,25,21,1602,1525,1054,-471
2016,2,25,22,1593,1528,1047,-481
2016,2,25,23,1592,1519,1028,-491
2016,2,26,0,1609,1559,1064,-495
2016,2,26,1,1677,1600,1082,-518
2016,2,26,2,1810,1749,1162,-587
2016,2,26,3,1825,1782,1256,-526
2016,2,26,4,1821,1773,1382,-391
2016,2,26,5,1755,1712,1428,-284
2016,2,26,6,1640,1600,1371,-229
2016,2,26,7,1555,1517,1374,-143
2016,2,26,8,1494,1464,1331,-133
2016,2,26,9,1464,1441,1367,-74
2016,2,26,10,1460,1434,1335,-99
2016,2,26,11,1468,1447,1345,-102
2016,2,26,12,1508,1484,1348,-136
2016,2,26,13,1607,1578,1409,-169
2016,2,26,14,1753,1711,1496,-215
2016,2,26,15,1769,1721,1548,-173
2016,2,26,16,1736,1688,1487,-201
2016,2,26,17,1695,1660,1426,-234
2016,2,26,18,1654,1624,1482,-142
2016,2,26,19,1617,1593,1448,-145
2016,2,26,20,1590,1545,1392,-153
2016,2,26,21,1574,1542,1424,-118
2016,2,26,22,1561,1534,1452,-82
2016,2,26,23,1558,1527,1445,-82
2016,2,27,0,1576,1537,1429,-108
2016,2,27,1,1626,1560,1427,-133
2016,2,27,2,1743,1675,1485,-190
2016,2,27,3,1750,1689,1572,-117
2016,2,27,4,1747,1695,1516,-179
2016,2,27,5,1696,1652,1487,-165
2016,2,27,6,1610,1571,1520,-51
2016,2,27,7,1530,1499,1419,-80
2016,2,27,8,1469,1447,1287,-160
2016,2,27,9,1431,1407,1263,-144
2016,2,27,10,1421,1396,1266,-130
2016,2,27,11,1423,1404,1284,-120
2016,2,27,12,1436,1414,1313,-101
2016,2,27,13,1477,1453,1365,-88
2016,2,27,14,1530,1521,1477,-44
2016,2,27,15,1563,1542,1563,21
2016,2,27,16,1584,1547,1608,61
2016,2,27,17,1574,1537,1646,109
2016,2,27,18,1554,1512,1649,137
2016,2,27,19,1532,1485,1647,162
2016,2,27,20,1513,1471,1707,236
2016,2,27,21,1493,1453,1717,264
2016,2,27,22,1492,1448,1738,290
2016,2,27,23,1506,1474,1766,292
2016,2,28,0,1528,1486,1709,223
2016,2,28,1,1595,1527,1668,141
2016,2,28,2,1701,1656,1738,82
2016,2,28,3,1697,1668,1721,53
2016,2,28,4,1681,1641,1735,94
2016,2,28,5,1627,1593,1695,102
2016,2,28,6,1545,1511,1649,138
2016,2,28,7,1470,1436,1493,57
2016,2,28,8,1426,1380,1405,25
2016,2,28,9,1389,1355,1438,83
2016,2,28,10,1380,1340,1425,85
2016,2,28,11,1381,1345,1413,68
2016,2,28,12,1393,1361,1418,57
2016,2,28,13,1433,1394,1420,26
2016,2,28,14,1487,1443,1405,-38
2016,2,28,15,1524,1456,1361,-95
2016,2,28,16,1540,1472,1375,-97
2016,2,28,17,1541,1474,1409,-65
2016,2,28,18,1526,1460,1395,-65
2016,2,28,19,1500,1465,1022,-443
2016,2,28,20,1474,1476,1052,-424
2016,2,28,21,1475,1465,1039,-426
2016,2,28,22,1474,1457,1035,-422
2016,2,28,23,1488,1467,1055,-412
2016,2,29,0,1518,1493,1071,-422
2016,2,29,1,1596,1561,1246,-315
2016,2,29,2,1720,1696,1370,-326
2016,2,29,3,1720,1715,1454,-261
2016,2,29,4,1696,1687,1533,-154
2016,2,29,5,1628,1612,1545,-67
2016,2,29,6,1537,1516,1494,-22
2016,2,29,7,1453,1418,1433,15
2016,2,29,8,1393,1359,1343,-16
2016,2,29,9,1365,1339,1331,-8
2016,2,29,10,1360,1342,1370,28
2016,2,29,11,1370,1357,1376,19
2016,2,29,12,1406,1396,1443,47
2016,2,29,13,1490,1499,1469,-30
2016,2,29,14,1608,1625,1556,-69
2016,2,29,15,1638,1640,1582,-58
2016,2,29,16,1629,1605,1574,-31
2016,2,29,17,1615,1590,1598,8
2016,2,29,18,1600,1566,1630,64
2016,2,29,19,1584,1556,1662,106
2016,2,29,20,1575,1540,1707,167
2016,2,29,21,1574,1550,1709,159
2016,2,29,22,1572,1543,1717,174
2016,2,29,23,1573,1533,1753,220
2016,3,1,0,1595,1546,1739,193
2016,3,1,1,1654,1574,1693,119
2016,3,1,2,1774,1703,1733,30
2016,3,1,3,1765,1720,1723,3
2016,3,1,4,1747,1702,1719,17
2016,3,1,5,1669,1622,1733,111
2016,3,1,6,1552,1505,1732,227
2016,3,1,7,1459,1409,1573,164
2016,3,1,8,1395,1355,1440,85
2016,3,1,9,1364,1318,1429,111
2016,3,1,10,1356,1323,1355,32
2016,3,1,11,1368,1321,1357,36
2016,3,1,12,1411,1360,1327,-33
2016,3,1,13,1509,1463,1437,-26
2016,3,1,14,1649,1598,1549,-49
2016,3,1,15,1664,1596,1599,3
2016,3,1,16,1638,1583,1564,-19
2016,3,1,17,1619,1557,1561,4
2016,3,1,18,1599,1542,1526,-16
2016,3,1,19,1582,1537,1579,42
2016,3,1,20,1568,1514,1560,46
2016,3,1,21,1563,1518,1613,95
2016,3,1,22,1556,1517,1687,170
2016,3,1,23,1560,1534,1729,195
2016,3,2,0,1582,1544,1678,134
2016,3,2,1,1647,1570,1656,86
2016,3,2,2,1755,1700,1742,42
2016,3,2,3,1757,1708,1728,20
2016,3,2,4,1736,1680,1779,99
2016,3,2,5,1663,1604,1730,126
2016,3,2,6,1546,1493,1555,62
2016,3,2,7,1454,1401,1540,139
2016,3,2,8,1382,1350,1451,101
2016,3,2,9,1357,1315,1402,87
2016,3,2,10,1347,1302,1376,74
2016,3,2,11,1359,1313,1436,123
2016,3,2,12,1409,1344,1413,69
2016,3,2,13,1511,1446,1501,55
2016,3,2,14,1634,1581,1606,25
2016,3,2,15,1642,1590,1659,69
2016,3,2,16,1626,1567,1663,96
2016,3,2,17,1613,1543,1689,146
2016,3,2,18,1602,1538,1749,211
2016,3,2,19,1590,1529,1762,233
2016,3,2,20,1593,1519,1766,247
2016,3,2,21,1596,1512,1820,308
2016,3,2,22,1599,1516,1771,255
2016,3,2,23,1604,1530,1739,209
2016,3,3,0,1610,1547,1711,164
2016,3,3,1,1635,1573,1788,215
2016,3,3,2,1713,1687,1830,143
2016,3,3,3,1733,1705,1871,166
2016,3,3,4,1708,1681,1844,163
2016,3,3,5,1631,1603,1800,197
2016,3,3,6,1516,1479,1660,181
2016,3,3,7,1430,1392,1514,122
2016,3,3,8,1376,1331,1263,-68
2016,3,3,9,1342,1313,1242,-71
2016,3,3,10,1338,1297,1247,-50
2016,3,3,11,1353,1300,1314,14
2016,3,3,12,1399,1343,1330,-13
2016,3,3,13,1515,1447,1356,-91
2016,3,3,14,1630,1582,1489,-93
2016,3,3,15,1631,1595,1602,7
2016,3,3,16,1622,1557,1583,26
2016,3,3,17,1603,1546,1523,-23
2016,3,3,18,1595,1534,1511,-23
2016,3,3,19,1590,1526,1455,-71
2016,3,3,20,1586,1507,1445,-62
2016,3,3,21,1587,1515,1611,96
2016,3,3,22,1593,1521,1639,118
2016,3,3,23,1596,1521,1671,150
2016,3,4,0,1604,1552,1661,109
2016,3,4,1,1632,1575,1606,31
2016,3,4,2,1710,1687,1724,37
2016,3,4,3,1725,1707,1766,59
2016,3,4,4,1702,1689,1838,149
2016,3,4,5,1613,1608,1940,332
2016,3,4,6,1500,1494,1867,373
2016,3,4,7,1422,1398,1787,389
2016,3,4,8,1365,1334,1644,310
2016,3,4,9,1337,1312,1633,321
2016,3,4,10,1329,1303,1671,368
2016,3,4,11,1340,1308,1664,356
2016,3,4,12,1388,1339,1666,327
2016,3,4,13,1489,1431,1715,284
2016,3,4,14,1594,1568,1855,287
2016,3,4,15,1610,1584,1908,324
2016,3,4,16,1599,1568,1838,270
2016,3,4,17,1580,1556,1796,240
2016,3,4,18,1582,1536,1821,285
2016,3,4,19,1571,1525,1758,233
2016,3,4,20,1567,1513,1742,229
2016,3,4,21,1572,1505,1762,257
2016,3,4,22,1574,1521,1842,321
2016,3,4,23,1588,1517,1802,285
2016,3,5,0,1592,1535,1793,258
2016,3,5,1,1612,1541,1759,218
2016,3,5,2,1668,1634,1776,142
2016,3,5,3,1688,1653,1825,172
2016,3,5,4,1660,1630,1843,213
2016,3,5,5,1599,1574,1891,317
2016,3,5,6,1495,1489,1767,278
2016,3,5,7,1414,1403,1794,391
2016,3,5,8,1372,1351,1721,370
2016,3,5,9,1349,1309,1723,414
2016,3,5,10,1336,1288,1698,410
2016,3,5,11,1338,1284,1690,406
2016,3,5,12,1357,1305,1711,406
2016,3,5,13,1405,1341,1724,383
2016,3,5,14,1473,1402,1762,360
2016,3,5,15,1508,1430,1738,308
2016,3,5,16,1512,1464,1784,320
2016,3,5,17,1521,1459,1754,295
2016,3,5,18,1522,1471,1722,251
2016,3,5,19,1529,1465,1738,273
2016,3,5,20,1539,1443,1706,263
2016,3,5,21,1534,1427,1700,273
2016,3,5,22,1536,1439,1730,291
2016,3,5,23,1537,1454,1757,303
2016,3,6,0,1559,1468,1779,311
2016,3,6,1,1593,1519,1772,253
2016,3,6,2,1675,1632,1857,225
2016,3,6,3,1682,1637,1876,239
2016,3,6,4,1658,1605,1906,301
2016,3,6,5,1592,1541,1892,351
2016,3,6,6,1496,1459,1804,345
2016,3,6,7,1417,1393,1791,398
2016,3,6,8,1377,1332,1620,288
2016,3,6,9,1341,1292,1613,321
2016,3,6,10,1329,1271,1582,311
2016,3,6,11,1328,1260,1592,332
2016,3,6,12,1340,1264,1581,317
2016,3,6,13,1381,1295,1588,293
2016,3,6,14,1439,1329,1591,262
2016,3,6,15,1472,1359,1569,210
2016,3,6,16,1504,1412,1631,219
2016,3,6,17,1512,1439,1676,237
2016,3,6,18,1509,1442,1678,236
2016,3,6,19,1504,1445,1665,220
2016,3,6,20,1495,1454,1697,243
2016,3,6,21,1489,1438,1715,277
2016,3,6,22,1490,1430,1700,270
2016,3,6,23,1506,1445,1723,278
2016,3,7,0,1536,1475,1795,320
2016,3,7,1,1593,1541,1804,263
2016,3,7,2,1695,1659,1946,287
2016,3,7,3,1698,1681,1994,313
2016,3,7,4,1666,1645,1980,335
2016,3,7,5,1586,1567,1933,366
2016,3,7,6,1485,1459,1824,365
2016,3,7,7,1403,1363,1678,315
2016,3,7,8,1356,1314,1631,317
2016,3,7,9,1333,1290,1599,309
2016,3,7,10,1328,1275,1598,323
2016,3,7,11,1340,1288,1606,318
2016,3,7,12,1379,1318,1621,303
2016,3,7,13,1479,1410,1644,234
2016,3,7,14,1581,1546,1799,253
2016,3,7,15,1604,1573,1925,352
2016,3,7,16,1604,1561,1936,375
2016,3,7,17,1598,1557,1943,386
2016,3,7,18,1587,1543,1988,445
2016,3,7,19,1565,1536,1980,444
2016,3,7,20,1552,1522,1986,464
2016,3,7,21,1539,1516,1943,427
2016,3,7,22,1542,1505,1885,380
2016,3,7,23,1541,1530,1907,377
2016,3,8,0,1559,1548,1849,301
2016,3,8,1,1626,1599,1815,216
2016,3,8,2,1738,1733,1885,152
2016,3,8,3,1755,1746,1903,157
2016,3,8,4,1726,1738,1867,129
2016,3,8,5,1640,1641,1793,152
2016,3,8,6,1526,1522,1731,209
2016,3,8,7,1440,1433,1638,205
2016,3,8,8,1401,1385,1301,-84
2016,3,8,9,1370,1350,1201,-149
2016,3,8,10,1381,1344,1184,-160
2016,3,8,11,1376,1350,1197,-153
2016,3,8,12,1416,1379,1202,-177
2016,3,8,13,1521,1476,1247,-229
2016,3,8,14,1658,1620,1308,-312
2016,3,8,15,1673,1639,1357,-282
2016,3,8,16,1656,1615,1387,-228
2016,3,8,17,1641,1589,1367,-222
2016,3,8,18,1621,1575,1364,-211
2016,3,8,19,1603,1564,1390,-174
2016,3,8,20,1590,1555,1378,-177
2016,3,8,21,1582,1557,1382,-175
2016,3,8,22,1577,1550,1411,-139
2016,3,8,23,1581,1547,1377,-170
2016,3,9,0,1606,1555,1407,-148
2016,3,9,1,1677,1598,1402,-196
2016,3,9,2,1801,1728,1491,-237
2016,3,9,3,1813,1766,1507,-259
2016,3,9,4,1790,1749,1518,-231
2016,3,9,5,1706,1685,1569,-116
2016,3,9,6,1595,1557,1459,-98
2016,3,9,7,1510,1476,1381,-95
2016,3,9,8,1453,1407,1289,-118
2016,3,9,9,1424,1381,1260,-121
2016,3,9,10,1412,1378,1359,-19
2016,3,9,11,1425,1386,1415,29
2016,3,9,12,1461,1419,1451,32
2016,3,9,13,1572,1518,1563,45
2016,3,9,14,1715,1642,1691,49
2016,3,9,15,1723,1649,1852,203
2016,3,9,16,1686,1616,1964,348
2016,3,9,17,1657,1580,1992,412
2016,3,9,18,1633,1547,2004,457
2016,3,9,19,1604,1533,2003,470
2016,3,9,20,1590,1511,1938,427
2016,3,9,21,1573,1496,1922,426
2016,3,9,22,1562,1489,1906,417
2016,3,9,23,1563,1509,2007,498
2016,3,10,0,1586,1526,2020,494
2016,3,10,1,1641,1554,1964,410
2016,3,10,2,1776,1678,1785,107
2016,3,10,3,1791,1710,1742,32
2016,3,10,4,1777,1697,1768,71
2016,3,10,5,1707,1626,1723,97
2016,3,10,6,1590,1519,1626,107
2016,3,10,7,1501,1439,1396,-43
2016,3,10,8,1426,1387,1167,-220
2016,3,10,9,1401,1356,1181,-175
2016,3,10,10,1395,1344,1269,-75
2016,3,10,11,1401,1362,1329,-33
2016,3,10,12,1436,1393,1314,-79
2016,3,10,13,1534,1484,1308,-176
2016,3,10,14,1686,1614,1331,-283
2016,3,10,15,1701,1618,1415,-203
2016,3,10,16,1670,1586,1473,-113
2016,3,10,17,1643,1561,1463,-98
2016,3,10,18,1616,1549,1571,22
2016,3,10,19,1595,1535,1632,97
2016,3,10,20,1578,1513,1724,211
2016,3,10,21,1576,1527,1858,331
2016,3,10,22,1566,1525,2032,507
2016,3,10,23,1570,1527,2044,517
2016,3,11,0,1583,1542,2036,494
2016,3,11,1,1616,1557,1975,418
2016,3,11,2,1736,1666,1983,317
2016,3,11,3,1759,1711,2037,326
2016,3,11,4,1748,1700,2037,337
2016,3,11,5,1676,1630,1976,346
2016,3,11,6,1561,1506,1875,369
2016,3,11,7,1472,1419,1843,424
2016,3,11,8,1394,1358,1757,399
2016,3,11,9,1366,1335,1733,398
2016,3,11,10,1358,1332,1720,388
2016,3,11,11,1370,1343,1716,373
2016,3,11,12,1406,1375,1729,354
2016,3,11,13,1509,1468,1743,275
2016,3,11,14,1630,1590,1878,288
2016,3,11,15,1646,1598,1996,398
2016,3,11,16,1625,1567,1958,391
2016,3,11,17,1608,1559,1987,428
2016,3,11,18,1582,1560,2013,453
2016,3,11,19,1566,1551,2002,451
2016,3,11,20,1553,1539,2087,548
2016,3,11,21,1553,1530,2098,568
2016,3,11,22,1542,1536,2122,586
2016,3,11,23,1566,1543,2092,549
2016,3,12,0,1568,1544,2083,539
2016,3,12,1,1594,1560,2072,512
2016,3,12,2,1694,1636,2116,480
2016,3,12,3,1708,1651,2060,409
2016,3,12,4,1697,1649,2044,395
2016,3,12,5,1636,1582,2043,461
2016,3,12,6,1539,1498,1908,410
2016,3,12,7,1451,1406,1766,360
2016,3,12,8,1393,1345,1560,215
2016,3,12,9,1360,1303,1499,196
2016,3,12,10,1348,1289,1495,206
2016,3,12,11,1353,1279,1563,284
2016,3,12,12,1370,1292,1576,284
2016,3,12,13,1413,1333,1574,241
2016,3,12,14,1480,1370,1644,274
2016,3,12,15,1510,1404,1632,228
2016,3,12,16,1546,1441,1638,197
2016,3,12,17,1562,1453,1765,312
2016,3,12,18,1556,1459,1820,361
2016,3,12,19,1545,1471,1864,393
2016,3,12,20,1537,1475,1888,413
2016,3,12,21,1516,1467,1891,424
2016,3,12,22,1514,1460,1887,427
2016,3,12,23,1515,1478,1902,424
2016,3,13,0,1543,1500,1951,451
2016,3,13,1,1594,1537,2031,494
2016,3,13,2,1698,1648,2086,438
2016,3,13,3,1713,1698,2117,419
2016,3,13,4,1687,1683,2113,430
2016,3,13,5,1624,1622,2092,470
2016,3,13,6,1534,1534,2053,519
2016,3,13,7,1457,1466,1948,482
2016,3,13,8,1404,1406,1685,279
2016,3,13,9,1049,1371,1648,277
2016,3,13,10,1355,1352,1682,330
2016,3,13,11,1359,1355,1603,248
2016,3,13,12,1362,1381,1589,208
2016,3,13,13,1396,1425,1631,206
2016,3,13,14,1463,1461,1649,188
2016,3,13,15,1508,1463,1671,208
2016,3,13,16,1526,1466,1587,121
2016,3,13,17,1527,1451,1639,188
2016,3,13,18,1519,1438,1591,153
2016,3,13,19,1505,1420,1575,155
2016,3,13,20,1485,1399,1605,206
2016,3,13,21,1478,1390,1640,250
2016,3,13,22,1471,1391,1654,263
2016,3,13,23,1472,1401,1634,233
2016,3,14,0,1477,1441,1720,279
2016,3,14,1,1512,1486,1743,257
2016,3,14,2,1582,1609,1824,215
2016,3,14,3,1685,1658,2025,367
2016,3,14,4,1699,1603,2004,401
2016,3,14,5,1597,1494,1920,426
2016,3,14,6,1494,1384,1695,311
2016,3,14,7,1410,1319,1623,304
2016,3,14,8,1352,1278,1635,357
2016,3,14,9,1329,1264,1626,362
2016,3,14,10,1323,1264,1635,371
2016,3,14,11,1337,1292,1686,394
2016,3,14,12,1368,1375,1829,454
2016,3,14,13,1457,1517,2046,529
2016,3,14,14,1568,1597,2144,547
2016,3,14,15,1597,1587,2041,454
2016,3,14,16,1588,1581,1977,396
2016,3,14,17,1582,1552,1936,384
2016,3,14,18,1567,1539,1916,377
2016,3,14,19,1552,1522,1904,382
2016,3,14,20,1531,1512,2033,521
2016,3,14,21,1531,1511,2063,552
2016,3,14,22,1531,1509,2046,537
2016,3,14,23,1526,1513,2010,497
2016,3,15,0,1532,1517,2029,512
2016,3,15,1,1556,1538,2048,510
2016,3,15,2,1603,1643,2090,447
2016,3,15,3,1707,1690,2135,445
2016,3,15,4,1730,1629,2033,404
2016,3,15,5,1618,1516,2000,484
2016,3,15,6,1501,1394,1967,573
2016,3,15,7,1415,1331,1843,512
2016,3,15,8,1351,1292,1841,549
2016,3,15,9,1326,1266,1830,564
2016,3,15,10,1327,1264,1821,557
2016,3,15,11,1335,1296,1864,568
2016,3,15,12,1390,1377,1988,611
2016,3,15,13,1508,1528,2046,518
2016,3,15,14,1612,1595,2054,459
2016,3,15,15,1604,1578,2031,453
2016,3,15,16,1589,1560,2104,544
2016,3,15,17,1574,1551,2145,594
2016,3,15,18,1562,1532,2133,601
2016,3,15,19,1539,1518,2186,668
2016,3,15,20,1524,1507,2186,679
2016,3,15,21,1519,1499,2195,696
2016,3,15,22,1518,1493,2186,693
2016,3,15,23,1523,1495,2140,645
2016,3,16,0,1532,1679,2331,652
2016,3,16,1,1555,1531,2107,576
2016,3,16,2,1669,1643,2026,383
2016,3,16,3,1720,1712,2034,322
2016,3,16,4,1681,1654,2019,365
2016,3,16,5,1588,1539,1949,410
2016,3,16,6,1473,1427,1910,483
2016,3,16,7,1401,1379,1869,490
2016,3,16,8,1328,1333,1871,538
2016,3,16,9,1313,1322,1851,529
2016,3,16,10,1313,1318,1842,524
2016,3,16,11,1331,1355,1872,517
2016,3,16,12,1401,1442,1912,470
2016,3,16,13,1538,1606,1907,301
2016,3,16,14,1636,1678,1793,115
2016,3,16,15,1624,1641,1622,-19
2016,3,16,16,1594,1603,1453,-150
2016,3,16,17,1569,1572,1409,-163
2016,3,16,18,1557,1544,1419,-125
2016,3,16,19,1525,1517,1453,-64
2016,3,16,20,1515,1512,1529,17
2016,3,16,21,1510,1502,1576,74
2016,3,16,22,1512,1505,1511,6
2016,3,16,23,1518,1512,1525,13
2016,3,17,0,1519,1519,1519,0
2016,3,17,1,1542,1529,1490,-39
2016,3,17,2,1645,1643,1570,-73
2016,3,17,3,1696,1701,1607,-94
2016,3,17,4,1654,1647,1635,-12
2016,3,17,5,1558,1523,1576,53
2016,3,17,6,1449,1424,1525,101
2016,3,17,7,1383,1380,1489,109
2016,3,17,8,1349,1334,1374,40
2016,3,17,9,1329,1326,1310,-16
2016,3,17,10,1331,1330,1268,-62
2016,3,17,11,1347,1358,1268,-90
2016,3,17,12,1417,1455,1297,-158
2016,3,17,13,1564,1617,1363,-254
2016,3,17,14,1648,1690,1387,-303
2016,3,17,15,1638,1664,1316,-348
2016,3,17,16,1609,1631,1272,-359
2016,3,17,17,1584,1606,1311,-295
2016,3,17,18,1558,1580,1381,-199
2016,3,17,19,1537,1553,1412,-141
2016,3,17,20,1524,1536,1509,-27
2016,3,17,21,1516,1523,1550,27
2016,3,17,22,1510,1526,1521,-5
2016,3,17,23,1519,1533,1483,-50
2016,3,18,0,1517,1533,1557,24
2016,3,18,1,1530,1549,1557,8
2016,3,18,2,1612,1637,1687,50
2016,3,18,3,1676,1711,1840,129
2016,3,18,4,1646,1654,1785,131
2016,3,18,5,1551,1533,1721,188
2016,3,18,6,1443,1427,1674,247
2016,3,18,7,1383,1366,1651,285
2016,3,18,8,1329,1323,1711,388
2016,3,18,9,1311,1306,1677,371
2016,3,18,10,1311,1311,1612,301
2016,3,18,11,1336,1342,1581,239
2016,3,18,12,1406,1415,1627,212
2016,3,18,13,1545,1560,1699,139
2016,3,18,14,1624,1634,1824,190
2016,3,18,15,1621,1613,1865,252
2016,3,18,16,1594,1589,1862,273
2016,3,18,17,1571,1577,1892,315
2016,3,18,18,1547,1559,1863,304
2016,3,18,19,1522,1531,1855,324
2016,3,18,20,1514,1529,1899,370
2016,3,18,21,1503,1521,1899,378
2016,3,18,22,1505,1513,1882,369
2016,3,18,23,1509,1511,1878,367
2016,3,19,0,1506,1515,1825,310
2016,3,19,1,1507,1518,1798,280
2016,3,19,2,1592,1594,1853,259
2016,3,19,3,1654,1651,1930,279
2016,3,19,4,1626,1605,1932,327
2016,3,19,5,1543,1512,1909,397
2016,3,19,6,1459,1422,1922,500
2016,3,19,7,1406,1367,1834,467
2016,3,19,8,1370,1330,1769,439
2016,3,19,9,1346,1313,1675,362
2016,3,19,10,1348,1315,1632,317
2016,3,19,11,1350,1324,1623,299
2016,3,19,12,1397,1370,1591,221
2016,3,19,13,1471,1447,1621,174
2016,3,19,14,1511,1498,1606,108
2016,3,19,15,1543,1536,1609,73
2016,3,19,16,1555,1542,1655,113
2016,3,19,17,1546,1516,1693,177
2016,3,19,18,1519,1494,1693,199
2016,3,19,19,1496,1458,1682,224
2016,3,19,20,1470,1431,1688,257
2016,3,19,21,1446,1417,1689,272
2016,3,19,22,1443,1405,1686,281
2016,3,19,23,1452,1421,1763,342
2016,3,20,0,1460,1449,1799,350
2016,3,20,1,1484,1482,1782,300
2016,3,20,2,1572,1578,1866,288
2016,3,20,3,1635,1632,1949,317
2016,3,20,4,1612,1595,1927,332
2016,3,20,5,1533,1521,1855,334
2016,3,20,6,1457,1437,1836,399
2016,3,20,7,1402,1384,1693,309
2016,3,20,8,1356,1353,1474,121
2016,3,20,9,1332,1330,1420,90
2016,3,20,10,1341,1335,1345,10
2016,3,20,11,1340,1342,1323,-19
2016,3,20,12,1381,1369,931,-438
2016,3,20,13,1434,1435,956,-479
2016,3,20,14,1470,1468,1007,-461
2016,3,20,15,1500,1489,1067,-422
2016,3,20,16,1517,1496,1109,-387
2016,3,20,17,1508,1477,1126,-351
2016,3,20,18,1484,1450,1117,-333
2016,3,20,19,1461,1427,1172,-255
2016,3,20,20,1438,1407,1240,-167
2016,3,20,21,1420,1395,1217,-178
2016,3,20,22,1421,1394,1230,-164
2016,3,20,23,1437,1406,1305,-101
2016,3,21,0,1458,1445,1227,-218
2016,3,21,1,1484,1485,1142,-343
2016,3,21,2,1575,1593,1137,-456
2016,3,21,3,1642,1665,1183,-482
2016,3,21,4,1609,1610,1201,-409
2016,3,21,5,1521,1503,1141,-362
2016,3,21,6,1429,1398,1044,-354
2016,3,21,7,1369,1334,1076,-258
2016,3,21,8,1315,1306,911,-395
2016,3,21,9,1298,1294,939,-355
2016,3,21,10,1304,1275,1092,-183
2016,3,21,11,1317,1293,1049,-244
2016,3,21,12,1384,1380,1156,-224
2016,3,21,13,1503,1536,1307,-229
2016,3,21,14,1553,1586,1514,-72
2016,3,21,15,1552,1566,1447,-119
2016,3,21,16,1547,1543,1387,-156
2016,3,21,17,1541,1532,1452,-80
2016,3,21,18,1530,1531,1513,-18
2016,3,21,19,1515,1531,1594,63
2016,3,21,20,1506,1528,1706,178
2016,3,21,21,1508,1539,1768,229
2016,3,21,22,1517,1531,1807,276
2016,3,21,23,1533,1541,1870,329
2016,3,22,0,1548,1536,1819,283
2016,3,22,1,1557,1549,1829,280
2016,3,22,2,1646,1642,1907,265
2016,3,22,3,1698,1697,2032,335
2016,3,22,4,1650,1629,1938,309
2016,3,22,5,1539,1509,1818,309
2016,3,22,6,1429,1398,1774,376
2016,3,22,7,1358,1336,1721,385
2016,3,22,8,1323,1292,1700,408
2016,3,22,9,1298,1274,1639,365
2016,3,22,10,1294,1276,1624,348
2016,3,22,11,1305,1292,1637,345
2016,3,22,12,1357,1370,1719,349
2016,3,22,13,1489,1515,1840,325
2016,3,22,14,1582,1571,1771,200
2016,3,22,15,1582,1587,1771,184
2016,3,22,16,1570,1591,1780,189
2016,3,22,17,1559,1578,1827,249
2016,3,22,18,1549,1549,1911,362
2016,3,22,19,1537,1533,2028,495
2016,3,22,20,1532,1538,2094,556
2016,3,22,21,1540,1539,2160,621
2016,3,22,22,1548,1539,2136,597
2016,3,22,23,1568,1546,2141,595
2016,3,23,0,1572,1541,2119,578
2016,3,23,1,1585,1550,2093,543
2016,3,23,2,1671,1632,2108,476
2016,3,23,3,1715,1705,2130,425
2016,3,23,4,1673,1618,2139,521
2016,3,23,5,1567,1508,2020,512
2016,3,23,6,1452,1402,1912,510
2016,3,23,7,1376,1350,1850,500
2016,3,23,8,1324,1309,1809,500
2016,3,23,9,1302,1296,1865,569
2016,3,23,10,1297,1305,1858,553
2016,3,23,11,1294,1334,1818,484
2016,3,23,12,1367,1411,1827,416
2016,3,23,13,1506,1572,1818,246
2016,3,23,14,1594,1616,1885,269
2016,3,23,15,1596,1589,1924,335
2016,3,23,16,1588,1576,1923,347
2016,3,23,17,1580,1559,1922,363
2016,3,23,18,1573,1541,1976,435
2016,3,23,19,1561,1533,1963,430
2016,3,23,20,1557,1538,2056,518
2016,3,23,21,1554,1528,2085,557
2016,3,23,22,1553,1525,2044,519
2016,3,23,23,1564,1529,2041,512
2016,3,24,0,1562,1533,2040,507
2016,3,24,1,1592,1555,1998,443
2016,3,24,2,1678,1656,2042,386
2016,3,24,3,1741,1734,2073,339
2016,3,24,4,1700,1687,2065,378
2016,3,24,5,1592,1565,1976,411
2016,3,24,6,1480,1475,1930,455
2016,3,24,7,1419,1424,1836,412
2016,3,24,8,1382,1387,1807,420
2016,3,24,9,1364,1378,1795,417
2016,3,24,10,1372,1388,1757,369
2016,3,24,11,1399,1414,1776,362
2016,3,24,12,1472,1517,1775,258
2016,3,24,13,1622,1655,1859,204
2016,3,24,14,1713,1688,1922,234
2016,3,24,15,1707,1667,1761,94
2016,3,24,16,1677,1630,1692,62
2016,3,24,17,1645,1601,1646,45
2016,3,24,18,1605,1566,1616,50
2016,3,24,19,1572,1535,1607,72
2016,3,24,20,1552,1520,1730,210
2016,3,24,21,1539,1508,1780,272
2016,3,24,22,1526,1494,1826,332
2016,3,24,23,1533,1476,1774,298
2016,3,25,0,1541,1488,1791,303
2016,3,25,1,1566,1502,1807,305
2016,3,25,2,1655,1601,1882,281
2016,3,25,3,1715,1678,2024,346
2016,3,25,4,1672,1624,1966,342
2016,3,25,5,1578,1532,1939,407
2016,3,25,6,1469,1440,1916,476
2016,3,25,7,1409,1388,1900,512
2016,3,25,8,1384,1358,1759,401
2016,3,25,9,1369,1337,1649,312
2016,3,25,10,1333,1345,1692,347
2016,3,25,11,1389,1368,1706,338
2016,3,25,12,1457,1440,1736,296
2016,3,25,13,1596,1549,1719,170
2016,3,25,14,1679,1577,1809,232
2016,3,25,15,1661,1586,1756,170
2016,3,25,16,1635,1567,1743,176
2016,3,25,17,1605,1548,1812,264
2016,3,25,18,1577,1514,1910,396
2016,3,25,19,1553,1489,1860,371
2016,3,25,20,1536,1473,1830,357
2016,3,25,21,1520,1472,1836,364
2016,3,25,22,1513,1457,1876,419
2016,3,25,23,1510,1450,1902,452
2016,3,26,0,1513,1466,1925,459
2016,3,26,1,1527,1473,1917,444
2016,3,26,2,1607,1556,1936,380
2016,3,26,3,1678,1642,1944,302
2016,3,26,4,1656,1609,1901,292
2016,3,26,5,1575,1530,1832,302
2016,3,26,6,1488,1431,1741,310
2016,3,26,7,1432,1389,1586,197
2016,3,26,8,1389,1343,1523,180
2016,3,26,9,1359,1314,1493,179
2016,3,26,10,1358,1318,1552,234
2016,3,26,11,1368,1330,1561,231
2016,3,26,12,1410,1367,1663,296
2016,3,26,13,1482,1437,1603,166
2016,3,26,14,1517,1475,1729,254
2016,3,26,15,1546,1515,1773,258
2016,3,26,16,1566,1539,1842,303
2016,3,26,17,1556,1530,1945,415
2016,3,26,18,1527,1527,1925,398
2016,3,26,19,1510,1529,1946,417
2016,3,26,20,1486,1512,1955,443
2016,3,26,21,1470,1486,1919,433
2016,3,26,22,1462,1470,1901,431
2016,3,26,23,1461,1468,1968,500
2016,3,27,0,1483,1486,1964,478
2016,3,27,1,1507,1493,1907,414
2016,3,27,2,1596,1589,2090,501
2016,3,27,3,1656,1661,2113,452
2016,3,27,4,1636,1633,2074,441
2016,3,27,5,1570,1564,1941,377
2016,3,27,6,1494,1473,1786,313
2016,3,27,7,1441,1424,1582,158
2016,3,27,8,1403,1385,1517,132
2016,3,27,9,1383,1359,1489,130
2016,3,27,10,1382,1363,1494,131
2016,3,27,11,1389,1376,1511,135
2016,3,27,12,1423,1421,1538,117
2016,3,27,13,1483,1483,1492,9
2016,3,27,14,1519,1517,1485,-32
2016,3,27,15,1545,1533,1534,1
2016,3,27,16,1558,1523,1537,14
2016,3,27,17,1547,1493,1530,37
2016,3,27,18,1525,1447,1501,54
2016,3,27,19,1492,1411,1475,64
2016,3,27,20,1473,1372,1478,106
2016,3,27,21,1456,1345,1528,183
2016,3,27,22,1446,1331,1602,271
2016,3,27,23,1445,1342,1613,271
2016,3,28,0,1479,1371,1664,293
2016,3,28,1,1510,1416,1710,294
2016,3,28,2,1609,1510,1852,342
2016,3,28,3,1669,1593,1949,356
2016,3,28,4,1643,1557,1990,433
2016,3,28,5,1561,1475,1906,431
2016,3,28,6,1470,1383,1801,418
2016,3,28,7,1411,1336,1629,293
2016,3,28,8,1366,1310,1594,284
2016,3,28,9,1348,1300,1576,276
2016,3,28,10,1341,1305,1554,249
2016,3,28,11,1362,1337,1574,237
2016,3,28,12,1427,1413,1575,162
2016,3,28,13,1541,1532,1681,149
2016,3,28,14,1604,1577,1836,259
2016,3,28,15,1609,1579,1857,278
2016,3,28,16,1605,1563,1840,277
2016,3,28,17,1594,1543,1816,273
2016,3,28,18,1567,1552,1812,260
2016,3,28,19,1556,1552,1809,257
2016,3,28,20,1554,1534,1816,282
2016,3,28,21,1548,1529,1859,330
2016,3,28,22,1548,1523,1873,350
2016,3,28,23,1550,1525,1923,398
2016,3,29,0,1557,1534,1966,432
2016,3,29,1,1569,1552,1989,437
2016,3,29,2,1644,1629,1995,366
2016,3,29,3,1711,1690,2015,325
2016,3,29,4,1683,1618,1985,367
2016,3,29,5,1587,1501,1859,358
2016,3,29,6,1473,1396,1756,360
2016,3,29,7,1399,1327,1712,385
2016,3,29,8,1343,1292,1682,390
2016,3,29,9,1323,1272,1689,417
2016,3,29,10,1312,1273,1708,435
2016,3,29,11,1327,1296,1731,435
2016,3,29,12,1389,1367,1753,386
2016,3,29,13,1510,1497,1754,257
2016,3,29,14,1597,1533,1718,185
2016,3,29,15,1602,1536,1726,190
2016,3,29,16,1595,1538,1782,244
2016,3,29,17,1582,1547,1814,267
2016,3,29,18,1572,1540,1858,318
2016,3,29,19,1547,1534,1896,362
2016,3,29,20,1545,1531,1968,437
2016,3,29,21,1540,1533,1977,444
2016,3,29,22,1538,1541,1966,425
2016,3,29,23,1540,1548,1943,395
2016,3,30,0,1553,1543,1941,398
2016,3,30,1,1566,1554,2010,456
2016,3,30,2,1644,1624,2069,445
2016,3,30,3,1718,1684,2132,448
2016,3,30,4,1689,1623,2107,484
2016,3,30,5,1591,1510,2023,513
2016,3,30,6,1477,1406,1839,433
2016,3,30,7,1413,1359,1727,368
2016,3,30,8,1354,1322,1708,386
2016,3,30,9,1335,1306,1632,326
2016,3,30,10,1337,1304,1615,311
2016,3,30,11,1353,1324,1595,271
2016,3,30,12,1425,1407,1592,185
2016,3,30,13,1556,1530,1654,124
2016,3,30,14,1654,1595,1644,49
2016,3,30,15,1657,1610,1704,94
2016,3,30,16,1633,1607,1779,172
2016,3,30,17,1606,1585,1812,227
2016,3,30,18,1603,1572,1863,291
2016,3,30,19,1591,1558,1918,360
2016,3,30,20,1580,1542,1971,429
2016,3,30,21,1571,1525,1958,433
2016,3,30,22,1561,1497,1944,447
2016,3,30,23,1567,1512,2000,488
2016,3,31,0,1576,1521,2002,481
2016,3,31,1,1596,2068,2564,496
2016,3,31,2,1677,1631,2127,496
2016,3,31,3,1745,1725,1902,177
2016,3,31,4,1717,1671,1832,161
2016,3,31,5,1616,1565,1728,163
2016,3,31,6,1510,1463,1579,116
2016,3,31,7,1442,1416,1533,117
2016,3,31,8,1416,1384,1503,119
2016,3,31,9,1399,1377,1493,116
2016,3,31,10,1398,1376,1496,120
2016,3,31,11,1421,1408,1461,53
2016,3,31,12,1482,1500,1444,-56
2016,3,31,13,1621,1626,1449,-177
2016,3,31,14,1719,1662,1463,-199
2016,3,31,15,1714,1642,1487,-155
2016,3,31,16,1690,1615,1536,-79
2016,3,31,17,1662,1595,1612,17
2016,3,31,18,1631,1566,1619,53
2016,3,31,19,1604,1530,1666,136
2016,3,31,20,1583,1508,1696,188
2016,3,31,21,1566,1500,1686,186
2016,3,31,22,1556,1499,1661,162
2016,3,31,23,1554,1503,1655,152
2016,4,1,0,1555,1513,1617,104
2016,4,1,1,1580,1531,1647,116
2016,4,1,2,1675,1623,1721,98
2016,4,1,3,1739,1694,1807,113
2016,4,1,4,1716,1647,1900,253
2016,4,1,5,1626,1552,1812,260
2016,4,1,6,1523,1445,1838,393
2016,4,1,7,1457,1400,1737,337
2016,4,1,8,1408,1360,1644,284
2016,4,1,9,1381,1342,1595,253
2016,4,1,10,1378,1348,1573,225
2016,4,1,11,1396,1379,1541,162
2016,4,1,12,1462,1465,1514,49
2016,4,1,13,1583,1596,1501,-95
2016,4,1,14,1700,1635,1217,-418
2016,4,1,15,1718,1651,1147,-504
2016,4,1,16,1705,1652,1210,-442
2016,4,1,17,1686,1631,1227,-404
2016,4,1,18,1657,1607,1253,-354
2016,4,1,19,1626,1566,1268,-298
2016,4,1,20,1605,1541,1258,-283
2016,4,1,21,1585,1518,1328,-190
2016,4,1,22,1570,1499,1368,-131
2016,4,1,23,1565,1489,1324,-165
2016,4,2,0,1565,1497,1322,-175
2016,4,2,1,1574,1508,1465,-43
2016,4,2,2,1659,1580,1609,29
2016,4,2,3,1734,1670,1730,60
2016,4,2,4,1722,1639,1702,63
2016,4,2,5,1649,1569,1636,67
2016,4,2,6,1558,1496,1490,-6
2016,4,2,7,1501,1441,1329,-112
2016,4,2,8,1429,1398,1215,-183
2016,4,2,9,1399,1385,1211,-174
2016,4,2,10,1397,1384,1218,-166
2016,4,2,11,1410,1397,1222,-175
2016,4,2,12,1461,1438,1233,-205
2016,4,2,13,1530,1510,1275,-235
2016,4,2,14,1559,1535,1277,-258
2016,4,2,15,1588,1549,1386,-163
2016,4,2,16,1606,1538,1394,-144
2016,4,2,17,1596,1510,1414,-96
2016,4,2,18,1568,1490,1439,-51
2016,4,2,19,1540,1457,1427,-30
2016,4,2,20,1518,1435,1423,-12
2016,4,2,21,1496,1420,1423,3
2016,4,2,22,1481,1412,1434,22
2016,4,2,23,1484,1421,1474,53
2016,4,3,0,1494,1439,1522,83
2016,4,3,1,1526,1460,1613,153
2016,4,3,2,1601,1523,1704,181
2016,4,3,3,1672,1605,1796,191
2016,4,3,4,1650,1580,1758,178
2016,4,3,5,1582,1498,1708,210
2016,4,3,6,1497,1421,1563,142
2016,4,3,7,1446,1374,1497,123
2016,4,3,8,1397,1340,1539,199
2016,4,3,9,1370,1324,1485,161
2016,4,3,10,1362,1325,1415,90
2016,4,3,11,1374,1334,1409,75
2016,4,3,12,1404,1366,1440,74
2016,4,3,13,1452,1411,1482,71
2016,4,3,14,1478,1425,1469,44
2016,4,3,15,1516,1452,1467,15
2016,4,3,16,1531,1451,1449,-2
2016,4,3,17,1527,1433,1475,42
2016,4,3,18,1513,1418,1475,57
2016,4,3,19,1494,1414,1532,118
2016,4,3,20,1480,1415,1529,114
2016,4,3,21,1456,1410,1559,149
2016,4,3,22,1454,1411,1585,174
2016,4,3,23,1460,1437,1638,201
2016,4,4,0,1483,1466,1770,304
2016,4,4,1,1514,1492,1830,338
2016,4,4,2,1606,1558,1832,274
2016,4,4,3,1671,1637,1844,207
2016,4,4,4,1638,1589,1791,202
2016,4,4,5,1553,1486,1674,188
2016,4,4,6,1461,1382,1560,178
2016,4,4,7,1401,1333,1427,94
2016,4,4,8,1338,1296,1424,128
2016,4,4,9,1319,1278,1337,59
2016,4,4,10,1320,1286,1330,44
2016,4,4,11,1338,1319,1309,-10
2016,4,4,12,1397,1407,1348,-59
2016,4,4,13,1495,1549,1399,-150
2016,4,4,14,1554,1577,1439,-138
2016,4,4,15,1586,1570,1546,-24
2016,4,4,16,1587,1551,1523,-28
2016,4,4,17,1577,1543,1523,-20
2016,4,4,18,1572,1718,1708,-10
2016,4,4,19,1557,1544,1535,-9
2016,4,4,20,1554,1543,1554,11
2016,4,4,21,1552,1552,1609,57
2016,4,4,22,1549,1560,1712,152
2016,4,4,23,1552,1579,1713,134
2016,4,5,0,1555,1573,1707,134
2016,4,5,1,1575,1574,1722,148
2016,4,5,2,1634,1604,1783,179
2016,4,5,3,1697,1689,1859,170
2016,4,5,4,1664,1619,1886,267
2016,4,5,5,1568,1490,1808,318
2016,4,5,6,1456,1385,1728,343
2016,4,5,7,1389,1316,1648,332
2016,4,5,8,1311,1283,1578,295
2016,4,5,9,1287,1264,1548,284
2016,4,5,10,1283,1263,1548,285
2016,4,5,11,1298,1289,1539,250
2016,4,5,12,1365,1356,1556,200
2016,4,5,13,1478,1463,1615,152
2016,4,5,14,1553,1493,1550,57
2016,4,5,15,1563,1504,1549,45
2016,4,5,16,1563,1505,1588,83
2016,4,5,17,1556,1516,1599,83
2016,4,5,18,1556,1509,1599,90
2016,4,5,19,1556,1506,1626,120
2016,4,5,20,1565,1499,1717,218
2016,4,5,21,1575,1515,1773,258
2016,4,5,22,1582,1521,1806,285
2016,4,5,23,1595,1517,1836,319
2016,4,6,0,1591,1507,1878,371
2016,4,6,1,1594,1519,1855,336
2016,4,6,2,1637,1580,1904,324
2016,4,6,3,1691,1656,1998,342
2016,4,6,4,1654,1588,1945,357
2016,4,6,5,1550,1473,1759,286
2016,4,6,6,1445,1365,1656,291
2016,4,6,7,1372,1309,1493,184
2016,4,6,8,1318,1270,1385,115
2016,4,6,9,1294,1259,1306,47
2016,4,6,10,1292,1257,1268,11
2016,4,6,11,1310,1293,1280,-13
2016,4,6,12,1377,1374,1412,38
2016,4,6,13,1492,1495,1538,43
2016,4,6,14,1570,1536,1540,4
2016,4,6,15,1589,1522,1499,-23
2016,4,6,16,1582,1506,1482,-24
2016,4,6,17,1576,1509,1545,36
2016,4,6,18,1567,1490,1554,64
2016,4,6,19,1559,1474,1573,99
2016,4,6,20,1565,1480,1606,126
2016,4,6,21,1576,1491,1657,166
2016,4,6,22,1583,1514,1680,166
2016,4,6,23,1589,1533,1671,138
2016,4,7,0,1590,1529,1694,165
2016,4,7,1,1594,1529,1715,186
2016,4,7,2,1624,1571,1764,193
2016,4,7,3,1687,1660,1894,234
2016,4,7,4,1650,1597,1874,277
2016,4,7,5,1543,1486,1737,251
2016,4,7,6,1436,1386,1627,241
2016,4,7,7,1365,1318,1579,261
2016,4,7,8,1318,1287,1406,119
2016,4,7,9,1295,1270,1414,144
2016,4,7,10,1287,1271,1420,149
2016,4,7,11,1307,1289,1409,120
2016,4,7,12,1373,1373,1376,3
2016,4,7,13,1470,1483,1444,-39
2016,4,7,14,1534,1537,1391,-146
2016,4,7,15,1556,1540,1434,-106
2016,4,7,16,1554,1530,1462,-68
2016,4,7,17,1556,1531,1536,5
2016,4,7,18,1553,1523,1529,6
2016,4,7,19,1552,1522,1547,25
2016,4,7,20,1562,1540,1658,118
2016,4,7,21,1565,1550,1671,121
2016,4,7,22,1577,1543,1619,76
2016,4,7,23,1596,1550,1626,76
2016,4,8,0,1589,1546,1618,72
2016,4,8,1,1592,1538,1584,46
2016,4,8,2,1632,1586,1701,115
2016,4,8,3,1686,1658,1804,146
2016,4,8,4,1650,1595,1780,185
2016,4,8,5,1535,1480,1678,198
2016,4,8,6,1432,1377,1595,218
2016,4,8,7,1356,1316,1539,223
2016,4,8,8,1301,1277,1353,76
2016,4,8,9,1274,1259,1325,66
2016,4,8,10,1271,1257,1266,9
2016,4,8,11,1284,1282,1237,-45
2016,4,8,12,1345,1337,1313,-24
2016,4,8,13,1452,1461,1375,-86
2016,4,8,14,1521,1511,1377,-134
2016,4,8,15,1551,1529,1395,-134
2016,4,8,16,1564,1568,1399,-169
2016,4,8,17,1573,1577,1435,-142
2016,4,8,18,1566,1578,1505,-73
2016,4,8,19,1554,1562,1497,-65
2016,4,8,20,1553,1548,1484,-64
2016,4,8,21,1551,1540,1490,-50
2016,4,8,22,1560,1522,1415,-107
2016,4,8,23,1563,1520,1411,-109
2016,4,9,0,1562,1516,1386,-130
2016,4,9,1,1567,1533,1489,-44
2016,4,9,2,1605,1595,1577,-18
2016,4,9,3,1667,1646,1624,-22
2016,4,9,4,1638,1601,1622,21
2016,4,9,5,1552,1513,1541,28
2016,4,9,6,1460,1417,1457,40
2016,4,9,7,1391,1359,1354,-5
2016,4,9,8,1344,1314,1254,-60
2016,4,9,9,1311,1284,1241,-43
2016,4,9,10,1301,1273,1205,-68
2016,4,9,11,1308,1280,1196,-84
2016,4,9,12,1342,1318,1211,-107
2016,4,9,13,1409,1371,1242,-129
2016,4,9,14,1451,1403,1316,-87
2016,4,9,15,1466,1437,1343,-94
2016,4,9,16,1506,1447,1331,-116
2016,4,9,17,1496,1444,1429,-15
2016,4,9,18,1494,1431,1551,120
2016,4,9,19,1510,1425,1588,163
2016,4,9,20,1500,1417,1660,243
2016,4,9,21,1501,1410,1688,278
2016,4,9,22,1506,1401,1679,278
2016,4,9,23,1525,1413,1652,239
2016,4,10,0,1544,1446,1660,214
2016,4,10,1,1560,1463,1683,220
2016,4,10,2,1601,1494,1756,262
2016,4,10,3,1642,1564,1832,268
2016,4,10,4,1601,1525,1836,311
2016,4,10,5,1514,1440,1747,307
2016,4,10,6,1432,1362,1578,216
2016,4,10,7,1370,1295,1469,174
2016,4,10,8,1330,1258,1399,141
2016,4,10,9,1294,1234,1296,62
2016,4,10,10,1281,1229,1283,54
2016,4,10,11,1285,1238,1228,-10
2016,4,10,12,1312,1264,1224,-40
2016,4,10,13,1344,1300,1227,-73
2016,4,10,14,1379,1320,1234,-86
2016,4,10,15,1460,1359,1219,-140
2016,4,10,16,1491,1377,1249,-128
2016,4,10,17,1489,1384,1300,-84
2016,4,10,18,1488,1383,1330,-53
2016,4,10,19,1473,1376,1405,29
2016,4,10,20,1463,1332,1389,57
2016,4,10,21,1463,1363,1441,78
2016,4,10,22,1465,1384,1522,138
2016,4,10,23,1473,1408,1588,180
2016,4,11,0,1491,1443,1622,179
2016,4,11,1,1529,1452,1680,228
2016,4,11,2,1588,1509,1673,164
2016,4,11,3,1637,1593,1707,114
2016,4,11,4,1613,1538,1701,163
2016,4,11,5,1520,1423,1606,183
2016,4,11,6,1428,1326,1580,254
2016,4,11,7,1360,1268,1504,236
2016,4,11,8,1320,1233,1451,218
2016,4,11,9,1287,1210,1444,234
2016,4,11,10,1277,1204,1447,243
2016,4,11,11,1293,1238,1472,234
2016,4,11,12,1353,1322,1543,221
2016,4,11,13,1449,1448,1735,287
2016,4,11,14,1513,1495,1774,279
2016,4,11,15,1548,1502,1795,293
2016,4,11,16,1553,1504,1704,200
2016,4,11,17,1550,1510,1673,163
2016,4,11,18,1539,1505,1668,163
2016,4,11,19,1527,1500,1635,135
2016,4,11,20,1520,1500,1609,109
2016,4,11,21,1517,1496,1581,85
2016,4,11,22,1514,1490,1570,80
2016,4,11,23,1520,1510,1598,88
2016,4,12,0,1530,1519,1618,99
2016,4,12,1,1562,1519,1674,155
2016,4,12,2,1610,1558,1716,158
2016,4,12,3,1671,1639,1789,150
2016,4,12,4,1638,1582,1767,185
2016,4,12,5,1537,1469,1705,236
2016,4,12,6,1425,1368,1594,226
2016,4,12,7,1358,1312,1510,198
2016,4,12,8,1303,1274,1341,67
2016,4,12,9,1285,1262,1286,24
2016,4,12,10,1282,1272,1285,13
2016,4,12,11,1297,1302,1288,-14
2016,4,12,12,1364,1391,1345,-46
2016,4,12,13,1481,1519,1445,-74
2016,4,12,14,1561,1536,1542,6
2016,4,12,15,1588,1563,1576,13
2016,4,12,16,1575,1550,1567,17
2016,4,12,17,1557,1577,1632,55
2016,4,12,18,1535,1564,1612,48
2016,4,12,19,1515,1542,1630,88
2016,4,12,20,1502,1521,1594,73
2016,4,12,21,1504,1505,1615,110
2016,4,12,22,1496,1502,1639,137
2016,4,12,23,1495,1503,1683,180
2016,4,13,0,1501,1494,1693,199
2016,4,13,1,1520,1508,1683,175
2016,4,13,2,1579,1580,1737,157
2016,4,13,3,1662,1674,1834,160
2016,4,13,4,1636,1607,1787,180
2016,4,13,5,1531,1490,1693,203
2016,4,13,6,1424,1382,1566,184
2016,4,13,7,1358,1333,1474,141
2016,4,13,8,1301,1302,1368,66
2016,4,13,9,1280,1286,1383,97
2016,4,13,10,1278,1295,1376,81
2016,4,13,11,1300,1323,1461,138
2016,4,13,12,1376,1411,1516,105
2016,4,13,13,1505,1533,1661,128
2016,4,13,14,1575,1566,1788,222
2016,4,13,15,1574,1545,1739,194
2016,4,13,16,1566,1526,1684,158
2016,4,13,17,1560,1524,1744,220
2016,4,13,18,1549,1514,1762,248
2016,4,13,19,1535,1515,1842,327
2016,4,13,20,1533,1524,1887,363
2016,4,13,21,1542,1527,1887,360
2016,4,13,22,1548,1541,1884,343
2016,4,13,23,1559,1539,1896,357
2016,4,14,0,1553,1549,1997,448
2016,4,14,1,1557,1553,2009,456
2016,4,14,2,1598,1585,2057,472
2016,4,14,3,1668,1675,2183,508
2016,4,14,4,1639,1603,2072,469
2016,4,14,5,1536,1485,1972,487
2016,4,14,6,1429,1384,1833,449
2016,4,14,7,1362,1318,1729,411
2016,4,14,8,1301,1285,1560,275
2016,4,14,9,1276,1265,1590,325
2016,4,14,10,1280,1256,1597,341
2016,4,14,11,1304,1276,1644,368
2016,4,14,12,1372,1362,1696,334
2016,4,14,13,1485,1479,1816,337
2016,4,14,14,1556,1519,1853,334
2016,4,14,15,1574,1515,1845,330
2016,4,14,16,1579,1528,1837,309
2016,4,14,17,1583,1542,1832,290
2016,4,14,18,1582,1539,1835,296
2016,4,14,19,1581,1537,1862,325
2016,4,14,20,1582,1551,1896,345
2016,4,14,21,1590,1558,1947,389
2016,4,14,22,1598,1565,1940,375
2016,4,14,23,1602,1584,2047,463
2016,4,15,0,1596,1579,2031,452
2016,4,15,1,1595,1567,2030,463
2016,4,15,2,1619,1603,2059,456
2016,4,15,3,1692,1675,2157,482
2016,4,15,4,1657,1613,2192,579
2016,4,15,5,1550,1491,2111,620
2016,4,15,6,1436,1382,1974,592
2016,4,15,7,1366,1310,1931,621
2016,4,15,8,1305,1256,1796,540
2016,4,15,9,1281,1238,1771,533
2016,4,15,10,1264,1238,1724,486
2016,4,15,11,1276,1258,1714,456
2016,4,15,12,1336,1323,1711,388
2016,4,15,13,1438,1436,1743,307
2016,4,15,14,1510,1474,1795,321
2016,4,15,15,1534,1502,1796,294
2016,4,15,16,1551,1525,1859,334
2016,4,15,17,1560,1526,1822,296
2016,4,15,18,1559,1521,1527,6
2016,4,15,19,1560,1519,1517,-2
2016,4,15,20,1564,1535,1655,120
2016,4,15,21,1566,1531,1703,172
2016,4,15,22,1565,1519,1670,151
2016,4,15,23,1566,1506,1647,141
2016,4,16,0,1569,1503,1636,133
2016,4,16,1,1564,1510,1621,111
2016,4,16,2,1588,1548,1644,96
2016,4,16,3,1648,1621,1612,-9
2016,4,16,4,1622,1581,1575,-6
2016,4,16,5,1537,1494,1541,47
2016,4,16,6,1444,1403,1526,123
2016,4,16,7,1377,1332,1429,97
2016,4,16,8,1335,1308,1380,72
2016,4,16,9,1305,1287,1376,89
2016,4,16,10,1299,1319,1333,14
2016,4,16,11,1309,1335,1264,-71
2016,4,16,12,1348,1257,1315,58
2016,4,16,13,1399,1306,1368,62
2016,4,16,14,1436,1360,1419,59
2016,4,16,15,1479,1440,1494,54
2016,4,16,16,1524,1472,1514,42
2016,4,16,17,1532,1496,1500,4
2016,4,16,18,1524,1482,1474,-8
2016,4,16,19,1510,1455,1423,-32
2016,4,16,20,1497,1457,1478,21
2016,4,16,21,1484,1447,1531,84
2016,4,16,22,1479,1450,1528,78
2016,4,16,23,1493,1464,1519,55
2016,4,17,0,1509,1477,1502,25
2016,4,17,1,1530,1498,1504,6
2016,4,17,2,1571,1547,1518,-29
2016,4,17,3,1642,1613,1629,16
2016,4,17,4,1618,1580,1691,111
2016,4,17,5,1536,1516,1715,199
2016,4,17,6,1451,1428,1670,242
2016,4,17,7,1390,1371,1655,284
2016,4,17,8,1368,1325,1662,337
2016,4,17,9,1349,1303,1641,338
2016,4,17,10,1354,1296,1641,345
2016,4,17,11,1367,1304,1646,342
2016,4,17,12,1369,1331,1662,331
2016,4,17,13,1407,1361,1704,343
2016,4,17,14,1459,1399,1663,264
2016,4,17,15,1482,1451,1678,227
2016,4,17,16,1508,1497,1712,215
2016,4,17,17,1517,1498,1719,221
2016,4,17,18,1508,1490,1701,211
2016,4,17,19,1495,1482,1676,194
2016,4,17,20,1484,1465,1631,166
2016,4,17,21,1465,1450,1595,145
2016,4,17,22,1459,1444,1569,125
2016,4,17,23,1469,1459,1552,93
2016,4,18,0,1494,1488,1549,61
2016,4,18,1,1528,1530,1625,95
2016,4,18,2,1590,1591,1751,160
2016,4,18,3,1668,1658,1777,119
2016,4,18,4,1643,1608,1821,213
2016,4,18,5,1551,1502,1803,301
2016,4,18,6,1455,1398,1725,327
2016,4,18,7,1392,1343,1672,329
2016,4,18,8,1365,1312,1590,278
2016,4,18,9,1348,1298,1505,207
2016,4,18,10,1343,1298,1493,195
2016,4,18,11,1364,1322,1525,203
2016,4,18,12,1427,1401,1590,189
2016,4,18,13,1532,1515,1695,180
2016,4,18,14,1608,1572,1764,192
2016,4,18,15,1619,1588,1713,125
2016,4,18,16,1616,1581,1701,120
2016,4,18,17,1606,1584,1633,49
2016,4,18,18,1591,1579,1650,71
2016,4,18,19,1570,1554,1624,70
2016,4,18,20,1557,1553,1618,65
2016,4,18,21,1551,1541,1602,61
2016,4,18,22,1538,1554,1644,90
2016,4,18,23,1544,1556,1645,89
2016,4,19,0,1547,1554,1607,53
2016,4,19,1,1565,1577,1592,15
2016,4,19,2,1628,1619,1603,-16
2016,4,19,3,1706,1704,1730,26
2016,4,19,4,1686,1647,1710,63
2016,4,19,5,1593,1529,1583,54
2016,4,19,6,1482,1431,1493,62
2016,4,19,7,1414,1364,1411,47
2016,4,19,8,1380,1334,1259,-75
2016,4,19,9,1349,1334,1263,-71
2016,4,19,10,1363,1342,1297,-45
2016,4,19,11,1384,1372,1293,-79
2016,4,19,12,1456,1460,1356,-104
2016,4,19,13,1591,1581,1418,-163
2016,4,19,14,1641,1614,1391,-223
2016,4,19,15,1644,1600,1444,-156
2016,4,19,16,1629,1551,1468,-83
2016,4,19,17,1609,1541,1530,-11
2016,4,19,18,1594,1437,1496,59
2016,4,19,19,1572,1502,1624,122
2016,4,19,20,1562,1509,1661,152
2016,4,19,21,1558,1509,1733,224
2016,4,19,22,1552,1496,1758,262
2016,4,19,23,1552,1492,1746,254
2016,4,20,0,1557,1495,1755,260
2016,4,20,1,1563,1516,1747,231
2016,4,20,2,1604,1568,1699,131
2016,4,20,3,1697,1676,1751,75
2016,4,20,4,1684,1617,1768,151
2016,4,20,5,1582,1500,1743,243
2016,4,20,6,1474,1396,1701,305
2016,4,20,7,1401,1333,1639,306
2016,4,20,8,1337,1297,1435,138
2016,4,20,9,1329,1294,1419,125
2016,4,20,10,1334,1301,1367,66
2016,4,20,11,1352,1325,1381,56
2016,4,20,12,1433,1410,1425,15
2016,4,20,13,1553,1533,1524,-9
2016,4,20,14,1618,1574,1565,-9
2016,4,20,15,1615,1564,1572,8
2016,4,20,16,1595,1541,1644,103
2016,4,20,17,1582,1527,1720,193
2016,4,20,18,1550,1527,1798,271
2016,4,20,19,1552,1514,1829,315
2016,4,20,20,1545,1528,1832,304
2016,4,20,21,1553,1542,1847,305
2016,4,20,22,1556,1552,1851,299
2016,4,20,23,1570,1554,1880,326
2016,4,21,0,1567,1554,1845,291
2016,4,21,1,1572,1554,1787,233
2016,4,21,2,1601,1570,1792,222
2016,4,21,3,1681,1664,1858,194
2016,4,21,4,1660,1601,1852,251
2016,4,21,5,1556,1486,1674,188
2016,4,21,6,1447,1385,1637,252
2016,4,21,7,1379,1318,1571,253
2016,4,21,8,1306,1285,1508,223
2016,4,21,9,1293,1264,1465,201
2016,4,21,10,1297,1264,1463,199
2016,4,21,11,1314,1293,1458,165
2016,4,21,12,1381,1377,1464,87
2016,4,21,13,1489,1495,1645,150
2016,4,21,14,1556,1533,1693,160
2016,4,21,15,1572,1530,1705,175
2016,4,21,16,1572,1534,1702,168
2016,4,21,17,1575,1535,1737,202
2016,4,21,18,1572,1537,1746,209
2016,4,21,19,1571,1541,1751,210
2016,4,21,20,1583,1550,1823,273
2016,4,21,21,1587,1567,1839,272
2016,4,21,22,1588,1573,1873,300
2016,4,21,23,1592,1585,1871,286
2016,4,22,0,1582,1583,1848,265
2016,4,22,1,1573,1574,1865,291
2016,4,22,2,1596,1597,1928,331
2016,4,22,3,1677,1680,2038,358
2016,4,22,4,1652,1617,2027,410
2016,4,22,5,1544,1499,1876,377
2016,4,22,6,1437,1389,1768,379
2016,4,22,7,1364,1319,1641,322
2016,4,22,8,1304,1274,1637,363
2016,4,22,9,1281,1258,1553,295
2016,4,22,10,1283,1254,1528,274
2016,4,22,11,1297,1268,1444,176
2016,4,22,12,1347,1333,1350,17
2016,4,22,13,1445,1436,1372,-64
2016,4,22,14,1510,1479,1396,-83
2016,4,22,15,1540,1495,1436,-59
2016,4,22,16,1562,1513,1574,61
2016,4,22,17,1575,1524,1664,140
2016,4,22,18,1581,1535,1723,188
2016,4,22,19,1586,1546,1736,190
2016,4,22,20,1593,1566,1751,185
2016,4,22,21,1602,1584,1813,229
2016,4,22,22,1597,1597,1802,205
2016,4,22,23,1607,1586,1756,170
2016,4,23,0,1594,1553,1696,143
2016,4,23,1,1580,1530,1725,195
2016,4,23,2,1596,1533,1714,181
2016,4,23,3,1661,1627,1759,132
2016,4,23,4,1634,1582,1780,198
2016,4,23,5,1543,1496,1710,214
2016,4,23,6,1450,1403,1623,220
2016,4,23,7,1378,1323,1263,-60
2016,4,23,8,1296,1269,1272,3
2016,4,23,9,1276,1243,1294,51
2016,4,23,10,1269,1230,1317,87
2016,4,23,11,1270,1238,1316,78
2016,4,23,12,1294,1263,1386,123
2016,4,23,13,1333,1286,1444,158
2016,4,23,14,1358,1324,1375,51
2016,4,23,15,1422,1387,1413,26
2016,4,23,16,1477,1414,1326,-88
2016,4,23,17,1505,1440,1396,-44
2016,4,23,18,1518,1456,1437,-19
2016,4,23,19,1540,1456,1560,104
2016,4,23,20,1551,1451,1623,172
2016,4,23,21,1567,1454,1659,205
2016,4,23,22,1584,1479,1708,229
2016,4,23,23,1606,1511,1744,233
2016,4,24,0,1621,1542,1772,230
2016,4,24,1,1625,1536,1764,228
2016,4,24,2,1642,1550,1836,286
2016,4,24,3,1687,1625,1879,254
2016,4,24,4,1630,1587,1873,286
2016,4,24,5,1534,1485,1803,318
2016,4,24,6,1429,1394,1477,83
2016,4,24,7,1356,1328,1394,66
2016,4,24,8,1292,1271,1398,127
2016,4,24,9,1264,1237,1390,153
2016,4,24,10,1259,1218,1330,112
2016,4,24,11,1258,1219,1329,110
2016,4,24,12,1272,1253,1346,93
2016,4,24,13,1292,1269,1272,3
2016,4,24,14,1316,1302,1264,-38
2016,4,24,15,1379,1343,1329,-14
2016,4,24,16,1423,1375,1366,-9
2016,4,24,17,1448,1394,1442,48
2016,4,24,18,1453,1574,1674,100
2016,4,24,19,1462,1405,1535,130
2016,4,24,20,1470,1413,1543,130
2016,4,24,21,1476,1423,1578,155
2016,4,24,22,1488,1435,1591,156
2016,4,24,23,1510,1469,1600,131
2016,4,25,0,1536,1459,1559,100
2016,4,25,1,1561,1452,1599,147
2016,4,25,2,1587,1538,1508,-30
2016,4,25,3,1639,1652,1537,-115
2016,4,25,4,1598,1601,1514,-87
2016,4,25,5,1499,1482,1450,-32
2016,4,25,6,1395,1362,1399,37
2016,4,25,7,1325,1291,1233,-58
2016,4,25,8,1270,1250,1259,9
2016,4,25,9,1256,1230,1269,39
2016,4,25,10,1252,1229,1268,39
2016,4,25,11,1263,1252,1324,72
2016,4,25,12,1313,1329,1329,0
2016,4,25,13,1393,1432,1326,-106
2016,4,25,14,1455,1483,1300,-183
2016,4,25,15,1502,1502,1304,-198
2016,4,25,16,1526,1518,1395,-123
2016,4,25,17,1538,1531,1438,-93
2016,4,25,18,1541,1548,1499,-49
2016,4,25,19,1544,1540,1507,-33
2016,4,25,20,1557,1555,1549,-6
2016,4,25,21,1566,1090,1127,37
2016,4,25,22,1565,1581,1608,27
2016,4,25,23,1580,1589,1622,33
2016,4,26,0,1586,1593,1619,26
2016,4,26,1,1588,1586,1614,28
2016,4,26,2,1616,1600,1577,-23
2016,4,26,3,1678,1692,1745,53
2016,4,26,4,1635,1618,1725,107
2016,4,26,5,1528,1487,1630,143
2016,4,26,6,1416,1374,1622,248
2016,4,26,7,1340,1304,1564,260
2016,4,26,8,1301,1267,1505,238
2016,4,26,9,1289,1243,1470,227
2016,4,26,10,1292,1238,1435,197
2016,4,26,11,1304,1258,1478,220
2016,4,26,12,1363,1345,1519,174
2016,4,26,13,1471,1446,1561,115
2016,4,26,14,1550,1500,1667,167
2016,4,26,15,1574,1514,1701,187
2016,4,26,16,1575,1455,1667,212
2016,4,26,17,1576,1499,1883,384
2016,4,26,18,1567,1417,1783,366
2016,4,26,19,1557,1490,1939,449
2016,4,26,20,1553,1478,1932,454
2016,4,26,21,1545,1479,1956,477
2016,4,26,22,1532,1461,1930,469
2016,4,26,23,1546,1472,1955,483
2016,4,27,0,1548,1497,1912,415
2016,4,27,1,1569,1506,1897,391
2016,4,27,2,1619,1534,1972,438
2016,4,27,3,1692,1639,2041,402
2016,4,27,4,1671,1584,2014,430
2016,4,27,5,1570,1469,1881,412
2016,4,27,6,1462,1380,1727,347
2016,4,27,7,1385,1318,1575,257
2016,4,27,8,1328,1287,1394,107
2016,4,27,9,1307,1263,1390,127
2016,4,27,10,1309,1260,1352,92
2016,4,27,11,1320,1286,1396,110
2016,4,27,12,1395,1370,1459,89
2016,4,27,13,1510,1479,1492,13
2016,4,27,14,1585,1520,1476,-44
2016,4,27,15,1579,1532,1553,21
2016,4,27,16,1555,1497,1554,57
2016,4,27,17,1553,1501,1564,63
2016,4,27,18,1531,1509,1586,77
2016,4,27,19,1535,1497,1601,104
2016,4,27,20,1530,1495,1626,131
2016,4,27,21,1522,1508,1633,125
2016,4,27,22,1540,1522,1615,93
2016,4,27,23,1540,1533,1601,68
2016,4,28,0,1555,1533,1567,34
2016,4,28,1,1552,1534,1516,-18
2016,4,28,2,1587,1567,1498,-69
2016,4,28,3,1675,1656,1600,-56
2016,4,28,4,1646,1601,1499,-102
2016,4,28,5,1532,1486,1372,-114
2016,4,28,6,1442,1383,1232,-151
2016,4,28,7,1363,1321,1206,-115
2016,4,28,8,1315,1276,1283,7
2016,4,28,9,1281,1253,1284,31
2016,4,28,10,1278,1252,1248,-4
2016,4,28,11,1289,1275,1263,-12
2016,4,28,12,1349,1349,1252,-97
2016,4,28,13,1452,1466,1287,-179
2016,4,28,14,1520,1513,1403,-110
2016,4,28,15,1544,1521,1468,-53
2016,4,28,16,1537,1520,1532,12
2016,4,28,17,1547,1538,1670,132
2016,4,28,18,1538,1540,1700,160
2016,4,28,19,1545,1537,1711,174
2016,4,28,20,1542,1550,1713,163
2016,4,28,21,1535,1558,1739,181
2016,4,28,22,1532,1567,1778,211
2016,4,28,23,1545,1568,1761,193
2016,4,29,0,1543,1557,1746,189
2016,4,29,1,1539,1540,1745,205
2016,4,29,2,1565,1571,1786,215
2016,4,29,3,1650,1666,1819,153
2016,4,29,4,1623,1622,1780,158
2016,4,29,5,1522,1497,1768,271
2016,4,29,6,1420,1390,1642,252
2016,4,29,7,1350,1335,1581,246
2016,4,29,8,1303,1297,1550,253
2016,4,29,9,1279,1275,1468,193
2016,4,29,10,1283,1273,1453,180
2016,4,29,11,1298,1296,1477,181
2016,4,29,12,1359,1362,1487,125
2016,4,29,13,1463,1465,1439,-26
2016,4,29,14,1532,1507,1538,31
2016,4,29,15,1556,1501,1548,47
2016,4,29,16,1559,1486,1583,97
2016,4,29,17,1564,1532,1681,149
2016,4,29,18,1563,1536,1734,198
2016,4,29,19,1545,1500,1681,181
2016,4,29,20,1535,1507,1726,219
2016,4,29,21,1530,1507,1743,236
2016,4,29,22,1531,1489,1764,275
2016,4,29,23,1527,1497,1830,333
2016,4,30,0,1519,1489,1880,391
2016,4,30,1,1519,1485,1805,320
2016,4,30,2,1557,1532,1808,276
2016,4,30,3,1641,1632,1889,257
2016,4,30,4,1625,1598,1939,341
2016,4,30,5,1542,1513,1831,318
2016,4,30,6,1454,1420,1696,276
2016,4,30,7,1388,1351,1545,194
2016,4,30,8,1350,1313,1429,116
2016,4,30,9,1328,1281,1414,133
2016,4,30,10,1318,1276,1386,110
2016,4,30,11,1328,1290,1394,104
2016,4,30,12,1361,1325,1406,81
2016,4,30,13,1412,1351,1283,-68
2016,4,30,14,1439,1393,1239,-154
2016,4,30,15,1465,1426,1236,-190
2016,4,30,16,1486,1457,1247,-210
2016,4,30,17,1500,1461,1255,-206
2016,4,30,18,1492,1465,1258,-207
2016,4,30,19,1485,1451,1267,-184
2016,4,30,20,1474,1433,1295,-138
2016,4,30,21,1455,1416,1331,-85
2016,4,30,22,1464,1417,1328,-89
2016,4,30,23,1467,1415,1335,-80
2016,5,1,0,1476,1439,1320,-119
2016,5,1,1,1494,1473,1272,-201
2016,5,1,2,1526,1523,1331,-192
2016,5,1,3,1608,1569,1369,-200
2016,5,1,4,1603,1534,1442,-92
2016,5,1,5,1523,1468,1470,2
2016,5,1,6,1439,1404,1442,38
2016,5,1,7,1379,1341,1353,12
2016,5,1,8,1339,1300,1366,66
2016,5,1,9,1315,1281,1338,57
2016,5,1,10,1306,1280,1341,61
2016,5,1,11,1311,1288,1343,55
2016,5,1,12,1336,1318,1342,24
2016,5,1,13,1368,1349,1309,-40
2016,5,1,14,1398,1380,1296,-84
2016,5,1,15,1435,1439,1337,-102
2016,5,1,16,1467,1478,1347,-131
2016,5,1,17,1481,1509,1388,-121
2016,5,1,18,1471,1517,1417,-100
2016,5,1,19,1464,1505,1446,-59
2016,5,1,20,1458,1473,1549,76
2016,5,1,21,1441,1461,1586,125
2016,5,1,22,1445,1470,1599,129
2016,5,1,23,1455,1499,1633,134
2016,5,2,0,1479,1544,1703,159
2016,5,2,1,1510,1566,1733,167
2016,5,2,2,1560,1620,1791,171
2016,5,2,3,1642,1693,1823,130
2016,5,2,4,1626,1646,1774,128
2016,5,2,5,1540,1529,1678,149
2016,5,2,6,1450,1425,1583,158
2016,5,2,7,1381,1370,1486,116
2016,5,2,8,1356,1338,1480,142
2016,5,2,9,1341,1319,1472,153
2016,5,2,10,1339,1327,1470,143
2016,5,2,11,1359,1359,1467,108
2016,5,2,12,1422,1445,1519,74
2016,5,2,13,1527,1555,1581,26
2016,5,2,14,1568,1604,1554,-50
2016,5,2,15,1586,1609,1524,-85
2016,5,2,16,1594,1599,1560,-39
2016,5,2,17,1594,1593,1588,-5
2016,5,2,18,1585,1568,1573,5
2016,5,2,19,1572,1538,1567,29
2016,5,2,20,1555,1528,1618,90
2016,5,2,21,1547,1513,1627,114
2016,5,2,22,1547,1509,1675,166
2016,5,2,23,1544,1519,1682,163
2016,5,3,0,1545,1534,1708,174
2016,5,3,1,1556,1537,1688,151
2016,5,3,2,1600,1570,1726,156
2016,5,3,3,1686,1679,1865,186
2016,5,3,4,1665,1625,1861,236
2016,5,3,5,1569,1508,1762,254
2016,5,3,6,1460,1395,1720,325
2016,5,3,7,1397,1328,1652,324
2016,5,3,8,1338,1286,1645,359
2016,5,3,9,1316,1267,1611,344
2016,5,3,10,1315,1264,1591,327
2016,5,3,11,1335,1292,1606,314
2016,5,3,12,1396,1375,1658,283
2016,5,3,13,1511,1475,1669,194
2016,5,3,14,1583,1513,1651,138
2016,5,3,15,1587,1521,1633,112
2016,5,3,16,1580,1416,1607,191
2016,5,3,17,1582,1482,1726,244
2016,5,3,18,1580,1353,1629,276
2016,5,3,19,1562,1479,1717,238
2016,5,3,20,1553,1489,1756,267
2016,5,3,21,1549,1506,1871,365
2016,5,3,22,1553,1547,1909,362
2016,5,3,23,1554,1560,1867,307
2016,5,4,0,1550,1579,1886,307
2016,5,4,1,1540,1578,1915,337
2016,5,4,2,1589,1590,1878,288
2016,5,4,3,1670,1694,1930,236
2016,5,4,4,1652,1639,1974,335
2016,5,4,5,1553,1510,1899,389
2016,5,4,6,1450,1390,1709,319
2016,5,4,7,1378,1319,1598,279
2016,5,4,8,1317,1287,1361,74
2016,5,4,9,1290,1266,1272,6
2016,5,4,10,1286,1265,1271,6
2016,5,4,11,1302,1286,1299,13
2016,5,4,12,1367,1366,1303,-63
2016,5,4,13,1473,1462,1410,-52
2016,5,4,14,1540,1511,1514,3
2016,5,4,15,1559,1513,1522,9
2016,5,4,16,1559,1525,1542,17
2016,5,4,17,1569,1531,1604,73
2016,5,4,18,1568,1543,1675,132
2016,5,4,19,1571,1558,1737,179
2016,5,4,20,1580,1585,1813,228
2016,5,4,21,1581,1594,1821,227
2016,5,4,22,1602,1623,1827,204
2016,5,4,23,1610,1642,1889,247
2016,5,5,0,1605,1640,1897,257
2016,5,5,1,1596,1636,1904,268
2016,5,5,2,1612,1623,1907,284
2016,5,5,3,1685,1711,2089,378
2016,5,5,4,1661,1655,2096,441
2016,5,5,5,1556,1516,2011,495
2016,5,5,6,1438,1378,1888,510
2016,5,5,7,1357,1320,1744,424
2016,5,5,8,1307,1283,1557,274
2016,5,5,9,1277,1255,1479,224
2016,5,5,10,1269,1253,1451,198
2016,5,5,11,1281,1274,1435,161
2016,5,5,12,1347,1344,1468,124
2016,5,5,13,1438,1433,1386,-47
2016,5,5,14,1511,1487,1456,-31
2016,5,5,15,1537,1509,1482,-27
2016,5,5,16,1526,1547,1587,40
2016,5,5,17,1561,1565,1529,-36
2016,5,5,18,1583,1581,1589,8
2016,5,5,19,1606,1602,1672,70
2016,5,5,20,1634,1637,1737,100
2016,5,5,21,1649,2198,2261,63
2016,5,5,22,1706,1713,1790,77
2016,5,5,23,1725,1729,1907,178
2016,5,6,0,1723,1719,1963,244
2016,5,6,1,1701,1694,1951,257
2016,5,6,2,1698,1679,2023,344
2016,5,6,3,1747,1750,2150,400
2016,5,6,4,1711,1692,2165,473
2016,5,6,5,1595,1560,2056,496
2016,5,6,6,1468,1442,1833,391
2016,5,6,7,1383,1360,1756,396
2016,5,6,8,1322,1316,1537,221
2016,5,6,9,1292,1291,1477,186
2016,5,6,10,1281,1279,1415,136
2016,5,6,11,1285,1291,1428,137
2016,5,6,12,1343,1344,1462,118
2016,5,6,13,1423,1430,1510,80
2016,5,6,14,1505,1495,1693,198
2016,5,6,15,1537,1535,1783,248
2016,5,6,16,1582,1575,1850,275
2016,5,6,17,1609,1612,1860,248
2016,5,6,18,1638,1631,1872,241
2016,5,6,19,1654,1645,1877,232
2016,5,6,20,1679,1670,1961,291
2016,5,6,21,1680,1686,2053,367
2016,5,6,22,1707,1694,2084,390
2016,5,6,23,1723,1691,2129,438
2016,5,7,0,1708,1690,2124,434
2016,5,7,1,1685,1656,2114,458
2016,5,7,2,1679,1634,2065,431
2016,5,7,3,1714,1713,2147,434
2016,5,7,4,1681,1673,2126,453
2016,5,7,5,1580,1564,2052,488
2016,5,7,6,1460,1450,1893,443
2016,5,7,7,1379,1371,1720,349
2016,5,7,8,1327,1311,1666,355
2016,5,7,9,1305,1277,1658,381
2016,5,7,10,1290,1266,1700,434
2016,5,7,11,1289,1260,1722,462
2016,5,7,12,1311,1280,1721,441
2016,5,7,13,1341,1292,1678,386
2016,5,7,14,1356,1342,1530,188
2016,5,7,15,1410,1400,1557,157
2016,5,7,16,1455,1422,1573,151
2016,5,7,17,1474,1430,1579,149
2016,5,7,18,1485,1453,1634,181
2016,5,7,19,1482,1453,1616,163
2016,5,7,20,1483,1451,1702,251
2016,5,7,21,1479,1461,1765,304
2016,5,7,22,1501,1465,1839,374
2016,5,7,23,1524,1483,1846,363
2016,5,8,0,1527,1507,1760,253
2016,5,8,1,1547,1519,1843,324
2016,5,8,2,1567,1522,1875,353
2016,5,8,3,1621,1587,1941,354
2016,5,8,4,1606,1551,1937,386
2016,5,8,5,1516,1476,1864,388
2016,5,8,6,1432,1401,1653,252
2016,5,8,7,1358,1343,1605,262
2016,5,8,8,1309,1292,1505,213
2016,5,8,9,1277,1269,1294,25
2016,5,8,10,1271,1254,1251,-3
2016,5,8,11,1269,1244,1243,-1
2016,5,8,12,1288,1267,1189,-78
2016,5,8,13,1301,1282,1188,-94
2016,5,8,14,1332,1314,1272,-42
2016,5,8,15,1385,1361,1429,68
2016,5,8,16,1425,1388,1524,136
2016,5,8,17,1449,1401,1530,129
2016,5,8,18,1448,1398,1509,111
2016,5,8,19,1445,1406,1568,162
2016,5,8,20,1442,1384,1527,143
2016,5,8,21,1433,1393,1581,188
2016,5,8,22,1453,1405,1709,304
2016,5,8,23,1476,1409,1723,314
2016,5,9,0,1502,1433,1756,323
2016,5,9,1,1537,1456,1724,268
2016,5,9,2,1564,1491,1778,287
2016,5,9,3,1635,1598,1810,212
2016,5,9,4,1618,1570,1825,255
2016,5,9,5,1522,1470,1712,242
2016,5,9,6,1422,1366,1517,151
2016,5,9,7,1345,1301,1329,28
2016,5,9,8,1290,1261,1316,55
2016,5,9,9,1276,1246,1323,77
2016,5,9,10,1273,1246,1394,148
2016,5,9,11,1284,1272,1407,135
2016,5,9,12,1346,1355,1423,68
2016,5,9,13,1436,1442,1389,-53
2016,5,9,14,1506,1510,1438,-72
2016,5,9,15,1546,1540,1524,-16
2016,5,9,16,1536,1573,1629,56
2016,5,9,17,1554,1583,1763,180
2016,5,9,18,1560,1531,1796,265
2016,5,9,19,1558,1567,1850,283
2016,5,9,20,1560,1593,1871,278
2016,5,9,21,1560,1585,1840,255
2016,5,9,22,1566,1584,1856,272
2016,5,9,23,1574,1585,1904,319
2016,5,10,0,1579,1573,1928,355
2016,5,10,1,1584,1579,1949,370
2016,5,10,2,1601,1590,1911,321
2016,5,10,3,1678,1678,1911,233
2016,5,10,4,1653,1636,1913,277
2016,5,10,5,1550,1510,1748,238
2016,5,10,6,1441,1394,1758,364
2016,5,10,7,1361,1321,1624,303
2016,5,10,8,1310,1280,1593,313
2016,5,10,9,1282,1258,1562,304
2016,5,10,10,1273,1256,1467,211
2016,5,10,11,1286,1278,1268,-10
2016,5,10,12,1350,1353,1184,-169
2016,5,10,13,1445,1446,1241,-205
2016,5,10,14,1519,1505,1186,-319
2016,5,10,15,1545,1522,1185,-337
2016,5,10,16,1562,1542,1199,-343
2016,5,10,17,1578,1557,1294,-263
2016,5,10,18,1588,1584,1408,-176
2016,5,10,19,1597,1593,1474,-119
2016,5,10,20,1608,1617,1590,-27
2016,5,10,21,1625,1644,1607,-37
2016,5,10,22,1649,1665,1645,-20
2016,5,10,23,1664,1683,1728,45
2016,5,11,0,1674,1690,1764,74
2016,5,11,1,1646,1679,1741,62
2016,5,11,2,1651,1660,1684,24
2016,5,11,3,1725,1730,1720,-10
2016,5,11,4,1697,1679,1679,0
2016,5,11,5,1582,1540,1575,35
2016,5,11,6,1457,1421,1408,-13
2016,5,11,7,1374,1345,1362,17
2016,5,11,8,1321,1300,1322,22
2016,5,11,9,1294,1275,1343,68
2016,5,11,10,1286,1263,1330,67
2016,5,11,11,1300,1280,1307,27
2016,5,11,12,1357,1348,1356,8
2016,5,11,13,1445,1432,1404,-28
2016,5,11,14,1516,1493,1468,-25
2016,5,11,15,1549,1531,1538,7
2016,5,11,16,1576,1562,1544,-18
2016,5,11,17,1599,1585,1628,43
2016,5,11,18,1605,1606,1630,24
2016,5,11,19,1618,1634,1614,-20
2016,5,11,20,1622,1664,1662,-2
2016,5,11,21,1629,1686,1682,-4
2016,5,11,22,1646,1696,1779,83
2016,5,11,23,1647,1706,1838,132
2016,5,12,0,1653,1708,1812,104
2016,5,12,1,1638,1664,1743,79
2016,5,12,2,1645,1641,1723,82
2016,5,12,3,1707,1714,1941,227
2016,5,12,4,1689,1664,1982,318
2016,5,12,5,1582,1527,1894,367
2016,5,12,6,1457,1401,1611,210
2016,5,12,7,1377,1326,1543,217
2016,5,12,8,1321,1291,1594,303
2016,5,12,9,1291,1262,1600,338
2016,5,12,10,1278,1256,1576,320
2016,5,12,11,1293,1275,1512,237
2016,5,12,12,1350,1343,1442,99
2016,5,12,13,1443,1432,1453,21
2016,5,12,14,1521,1490,1534,44
2016,5,12,15,1549,1520,1514,-6
2016,5,12,16,1568,1560,1536,-24
2016,5,12,17,1589,1582,1599,17
2016,5,12,18,1602,1607,1691,84
2016,5,12,19,1622,1615,1696,81
2016,5,12,20,1639,1655,1667,12
2016,5,12,21,1662,1684,1668,-16
2016,5,12,22,1692,1706,1679,-27
2016,5,12,23,1707,1725,1760,35
2016,5,13,0,1712,1731,1790,59
2016,5,13,1,1706,1719,1803,84
2016,5,13,2,1696,1704,1873,169
2016,5,13,3,1749,1770,1894,124
2016,5,13,4,1711,1728,1861,133
2016,5,13,5,1595,1577,1718,141
2016,5,13,6,1469,1441,1596,155
2016,5,13,7,1382,1349,1500,151
2016,5,13,8,1336,1295,1495,200
2016,5,13,9,1303,1273,1440,167
2016,5,13,10,1291,1268,1390,122
2016,5,13,11,1300,1283,1405,122
2016,5,13,12,1353,1342,1458,116
2016,5,13,13,1435,1425,1504,79
2016,5,13,14,1505,1481,1584,103
2016,5,13,15,1554,1519,1653,134
2016,5,13,16,1583,1571,1729,158
2016,5,13,17,1609,1604,1754,150
2016,5,13,18,1643,1640,1829,189
2016,5,13,19,1670,1674,1868,194
2016,5,13,20,1696,1713,1897,184
2016,5,13,21,1728,1756,1917,161
2016,5,13,22,1774,1777,1940,163
2016,5,13,23,1797,1817,1927,110
2016,5,14,0,1797,1816,1954,138
2016,5,14,1,1764,1795,1976,181
2016,5,14,2,1734,1756,1943,187
2016,5,14,3,1767,1800,1935,135
2016,5,14,4,1749,1743,1945,202
2016,5,14,5,1631,1616,1792,176
2016,5,14,6,1508,1481,1767,286
2016,5,14,7,1409,1391,1720,329
2016,5,14,8,1374,1329,1727,398
2016,5,14,9,1340,1294,1787,493
2016,5,14,10,1307,1274,1773,499
2016,5,14,11,1303,1265,1753,488
2016,5,14,12,1322,1287,1821,534
2016,5,14,13,1346,1294,1821,527
2016,5,14,14,1388,1342,1811,469
2016,5,14,15,1451,1406,1882,476
2016,5,14,16,1514,1467,1960,493
2016,5,14,17,1566,1509,1996,487
2016,5,14,18,1600,1527,2086,559
2016,5,14,19,1631,1546,2109,563
2016,5,14,20,1653,1576,2123,547
2016,5,14,21,1675,1608,2165,557
2016,5,14,22,1692,1640,2174,534
2016,5,14,23,1714,1664,2206,542
2016,5,15,0,1713,1680,2208,528
2016,5,15,1,1696,1671,2219,548
2016,5,15,2,1686,1652,2222,570
2016,5,15,3,1704,1708,2236,528
2016,5,15,4,1681,1663,2294,631
2016,5,15,5,1600,1564,2240,676
2016,5,15,6,1486,1459,2181,722
2016,5,15,7,1404,1371,2048,677
2016,5,15,8,1346,1322,1935,613
2016,5,15,9,1313,1289,1833,544
2016,5,15,10,1299,1274,1780,506
2016,5,15,11,1294,1264,1785,521
2016,5,15,12,1306,1278,1796,518
2016,5,15,13,1322,1268,1731,463
2016,5,15,14,1350,1298,1646,348
2016,5,15,15,1410,1372,1630,258
2016,5,15,16,1469,1430,1738,308
2016,5,15,17,1528,1479,1854,375
2016,5,15,18,1566,1506,1941,435
2016,5,15,19,1599,1537,1842,305
2016,5,15,20,1628,1545,1803,258
2016,5,15,21,1657,1604,1866,262
2016,5,15,22,1680,1616,1933,317
2016,5,15,23,1725,1647,1949,302
2016,5,16,0,1751,1664,2037,373
2016,5,16,1,1750,1681,1991,310
2016,5,16,2,1749,1666,1971,305
2016,5,16,3,1757,1727,1943,216
2016,5,16,4,1721,1692,1919,227
2016,5,16,5,1609,1553,1857,304
2016,5,16,6,1490,1420,1786,366
2016,5,16,7,1400,1335,1630,295
2016,5,16,8,1320,1291,1552,261
2016,5,16,9,1287,1258,1533,275
2016,5,16,10,1276,1246,1512,266
2016,5,16,11,1292,1265,1480,215
2016,5,16,12,1345,1332,1457,125
2016,5,16,13,1438,1415,1514,99
2016,5,16,14,1512,1485,1687,202
2016,5,16,15,1555,1542,1667,125
2016,5,16,16,1583,1562,1639,77
2016,5,16,17,1616,1579,1770,191
2016,5,16,18,1636,1616,1772,156
2016,5,16,19,1648,1620,1813,193
2016,5,16,20,1674,1651,1861,210
2016,5,16,21,1686,1679,2000,321
2016,5,16,22,1707,1701,2001,300
2016,5,16,23,1722,1718,2025,307
2016,5,17,0,1725,1717,1983,266
2016,5,17,1,1715,1693,1933,240
2016,5,17,2,1722,1670,1905,235
2016,5,17,3,1762,1712,2082,370
2016,5,17,4,1717,1660,2040,380
2016,5,17,5,1597,1532,1916,384
2016,5,17,6,1468,1403,1816,413
2016,5,17,7,1375,1323,1679,356
2016,5,17,8,1312,1280,1596,316
2016,5,17,9,1287,1260,1595,335
2016,5,17,10,1277,1251,1598,347
2016,5,17,11,1287,1267,1563,296
2016,5,17,12,1343,1333,1567,234
2016,5,17,13,1440,1408,1547,139
2016,5,17,14,1521,1469,1566,97
2016,5,17,15,1556,1500,1673,173
2016,5,17,16,1572,1516,1797,281
2016,5,17,17,1597,1529,1873,344
2016,5,17,18,1602,1536,1930,394
2016,5,17,19,1602,1542,1980,438
2016,5,17,20,1601,1570,1922,352
2016,5,17,21,1612,1562,1949,387
2016,5,17,22,1607,1557,1875,318
2016,5,17,23,1611,1551,1906,355
2016,5,18,0,1597,1544,1892,348
2016,5,18,1,1600,1551,1886,335
2016,5,18,2,1617,1572,1941,369
2016,5,18,3,1689,1644,2048,404
2016,5,18,4,1664,1603,2007,404
2016,5,18,5,1560,1469,1952,483
2016,5,18,6,1441,1364,1778,414
2016,5,18,7,1357,1309,1758,449
2016,5,18,8,1320,1271,1725,454
2016,5,18,9,1285,1255,1647,392
2016,5,18,10,1282,1252,1627,375
2016,5,18,11,1302,1276,1318,42
2016,5,18,12,1369,1358,1321,-37
2016,5,18,13,1484,1454,1311,-143
2016,5,18,14,1555,1525,1347,-178
2016,5,18,15,1572,1563,1406,-157
2016,5,18,16,1582,1590,1479,-111
2016,5,18,17,1587,1607,1401,-206
2016,5,18,18,1591,1599,1475,-124
2016,5,18,19,1579,1547,1463,-84
2016,5,18,20,1574,1547,1561,14
2016,5,18,21,1576,1559,1620,61
2016,5,18,22,1567,1546,1597,51
2016,5,18,23,1573,1552,1674,122
2016,5,19,0,1565,1545,1736,191
2016,5,19,1,1579,1552,1750,198
2016,5,19,2,1608,1569,1729,160
2016,5,19,3,1677,1650,1798,148
2016,5,19,4,1662,1620,1895,275
2016,5,19,5,1561,1492,2026,534
2016,5,19,6,1450,1378,1982,604
2016,5,19,7,1370,1304,1952,648
2016,5,19,8,1320,1274,1826,552
2016,5,19,9,1298,1256,1844,588
2016,5,19,10,1293,1253,1741,488
2016,5,19,11,1308,1264,1654,390
2016,5,19,12,1385,1343,1656,313
2016,5,19,13,1472,1450,1686,236
2016,5,19,14,1543,1504,1792,288
2016,5,19,15,1558,1519,1821,302
2016,5,19,16,1555,1526,1885,359
2016,5,19,17,1557,1533,1892,359
2016,5,19,18,1545,1539,1946,407
2016,5,19,19,1543,1543,2067,524
2016,5,19,20,1551,1550,2065,515
2016,5,19,21,1560,1564,2050,486
2016,5,19,22,1561,1572,2030,458
2016,5,19,23,1562,1589,2024,435
2016,5,20,0,1566,1590,1985,395
2016,5,20,1,1566,1586,1787,201
2016,5,20,2,1593,1579,1835,256
2016,5,20,3,1659,1656,1875,219
2016,5,20,4,1650,1636,1899,263
2016,5,20,5,1545,1509,1850,341
2016,5,20,6,1433,1393,1821,428
2016,5,20,7,1360,1326,1768,442
2016,5,20,8,1314,1278,1621,343
2016,5,20,9,1285,1249,1630,381
2016,5,20,10,1279,1246,1634,388
2016,5,20,11,1288,1254,1645,391
2016,5,20,12,1336,1321,1655,334
2016,5,20,13,1423,1371,1678,307
2016,5,20,14,1495,1445,1649,204
2016,5,20,15,1530,1478,1633,155
2016,5,20,16,1557,1515,1670,155
2016,5,20,17,1579,1544,1786,242
2016,5,20,18,1597,1564,1831,267
2016,5,20,19,1603,1589,1832,243
2016,5,20,20,1610,1608,1898,290
2016,5,20,21,1621,1635,1999,364
2016,5,20,22,1643,1653,2031,378
2016,5,20,23,1656,1679,2054,375
2016,5,21,0,1662,1685,2065,380
2016,5,21,1,1640,1673,1975,302
2016,5,21,2,1621,1652,1919,267
2016,5,21,3,1687,1697,1855,158
2016,5,21,4,1669,1671,1916,245
2016,5,21,5,1583,1556,1850,294
2016,5,21,6,1471,1440,1683,243
2016,5,21,7,1386,1355,1445,90
2016,5,21,8,1349,1294,1435,141
2016,5,21,9,1307,1264,1440,176
2016,5,21,10,1286,1240,1462,222
2016,5,21,11,1280,1232,1466,234
2016,5,21,12,1300,1254,1465,211
2016,5,21,13,1314,1252,1440,188
2016,5,21,14,1359,1317,1461,144
2016,5,21,15,1409,1375,1488,113
2016,5,21,16,1471,1429,1526,97
2016,5,21,17,1517,1473,1550,77
2016,5,21,18,1550,1513,1623,110
2016,5,21,19,1573,1537,1721,184
2016,5,21,20,1587,1554,1909,355
2016,5,21,21,1610,1582,1891,309
2016,5,21,22,1629,1616,1898,282
2016,5,21,23,1655,1655,1884,229
2016,5,22,0,1678,1673,1942,269
2016,5,22,1,1675,1664,1970,306
2016,5,22,2,1648,1639,1947,308
2016,5,22,3,1679,1684,1967,283
2016,5,22,4,1671,1656,1989,333
2016,5,22,5,1580,1546,1981,435
2016,5,22,6,1478,1434,1957,523
2016,5,22,7,1392,1343,1723,380
2016,5,22,8,1328,1280,1637,357
2016,5,22,9,1300,1250,1570,320
2016,5,22,10,1281,1233,1573,340
2016,5,22,11,1269,1227,1558,331
2016,5,22,12,1277,1231,1532,301
2016,5,22,13,1279,1220,1536,316
2016,5,22,14,1311,1269,1569,300
2016,5,22,15,1379,1333,1647,314
2016,5,22,16,1439,1390,1642,252
2016,5,22,17,1484,1432,1695,263
2016,5,22,18,1506,1464,1718,254
2016,5,22,19,1531,1505,1873,368
2016,5,22,20,1541,1525,2004,479
2016,5,22,21,1567,1563,2076,513
2016,5,22,22,1597,1606,2141,535
2016,5,22,23,1614,1654,2260,606
2016,5,23,0,1648,1700,2293,593
2016,5,23,1,1664,1712,2290,578
2016,5,23,2,1652,1700,2243,543
2016,5,23,3,1692,1737,2224,487
2016,5,23,4,1676,1703,2308,605
2016,5,23,5,1566,1563,2176,613
2016,5,23,6,1443,1419,2072,653
2016,5,23,7,1359,1338,1769,431
2016,5,23,8,1320,1275,1665,390
2016,5,23,9,1292,1244,1619,375
2016,5,23,10,1278,1231,1589,358
2016,5,23,11,1290,1249,1572,323
2016,5,23,12,1334,1309,1583,274
2016,5,23,13,1405,1373,1585,212
2016,5,23,14,1495,1453,1596,143
2016,5,23,15,1531,1515,1587,72
2016,5,23,16,1556,1559,1645,86
2016,5,23,17,1586,1605,1787,182
2016,5,23,18,1609,1642,1992,350
2016,5,23,19,1627,1668,2110,442
2016,5,23,20,1653,1705,2131,426
2016,5,23,21,1679,1757,2192,435
2016,5,23,22,1710,1787,2244,457
2016,5,23,23,1731,1828,2323,495
2016,5,24,0,1738,1829,2338,509
2016,5,24,1,1727,1822,2274,452
2016,5,24,2,1710,1775,2208,433
2016,5,24,3,1760,1817,2248,431
2016,5,24,4,1723,1762,2255,493
2016,5,24,5,1606,1604,2128,524
2016,5,24,6,1507,1459,2019,560
2016,5,24,7,1414,1369,1802,433
2016,5,24,8,1346,1316,1703,387
2016,5,24,9,1309,1284,1587,303
2016,5,24,10,1289,1277,1547,270
2016,5,24,11,1297,1281,1503,222
2016,5,24,12,1351,1333,1531,198
2016,5,24,13,1427,1404,1662,258
2016,5,24,14,1505,1475,1759,284
2016,5,24,15,1551,1523,1750,227
2016,5,24,16,1590,1561,1812,251
2016,5,24,17,1618,1617,1918,301
2016,5,24,18,1649,1648,2011,363
2016,5,24,19,1678,1659,2029,370
2016,5,24,20,1705,1700,2081,381
2016,5,24,21,1736,1734,2265,531
2016,5,24,22,1772,1781,2489,708
2016,5,24,23,1803,1814,2408,594
2016,5,25,0,1798,1830,2520,690
2016,5,25,1,1772,1801,2443,642
2016,5,25,2,1764,1749,2423,674
2016,5,25,3,1797,1779,2477,698
2016,5,25,4,1770,1738,2519,781
2016,5,25,5,1638,1588,2336,748
2016,5,25,6,1500,1451,2119,668
2016,5,25,7,1406,1359,1975,616
2016,5,25,8,1341,1299,1891,592
2016,5,25,9,1305,1270,1867,597
2016,5,25,10,1297,1244,1822,578
2016,5,25,11,1299,1267,1805,538
2016,5,25,12,1349,1329,1802,473
2016,5,25,13,1434,1380,1826,446
2016,5,25,14,1506,1475,1925,450
2016,5,25,15,1547,1517,1969,452
2016,5,25,16,1587,1551,2049,498
2016,5,25,17,1609,1591,2131,540
2016,5,25,18,1645,1631,2216,585
2016,5,25,19,1648,1657,2298,641
2016,5,25,20,1688,1672,2320,648
2016,5,25,21,1706,1722,2455,733
2016,5,25,22,1739,1769,2446,677
2016,5,25,23,1764,1786,2440,654
2016,5,26,0,1770,1764,2325,561
2016,5,26,1,1747,1727,2304,577
2016,5,26,2,1729,1719,2300,581
2016,5,26,3,1772,1755,2348,593
2016,5,26,4,1736,1719,2356,637
2016,5,26,5,1634,1577,2254,677
2016,5,26,6,1487,1435,2137,702
2016,5,26,7,1383,1355,2040,685
2016,5,26,8,1339,1307,2058,751
2016,5,26,9,1299,1277,2007,730
2016,5,26,10,1306,1258,1996,738
2016,5,26,11,1312,1272,1985,713
2016,5,26,12,1360,1307,1960,653
2016,5,26,13,1431,1360,1943,583
2016,5,26,14,1496,1447,1985,538
2016,5,26,15,1534,1493,2043,550
2016,5,26,16,1565,1533,2135,602
2016,5,26,17,1596,1563,2212,649
2016,5,26,18,1603,1602,2262,660
2016,5,26,19,1601,1607,2270,663
2016,5,26,20,1614,1628,2309,681
2016,5,26,21,1629,1645,2389,744
2016,5,26,22,1629,1635,2410,775
2016,5,26,23,1637,1641,2409,768
2016,5,27,0,1633,1620,2397,777
2016,5,27,1,1619,1595,2379,784
2016,5,27,2,1610,1582,2376,794
2016,5,27,3,1671,1654,2410,756
2016,5,27,4,1677,1645,2395,750
2016,5,27,5,1574,1539,2269,730
2016,5,27,6,1456,1413,2061,648
2016,5,27,7,1375,1339,1964,625
2016,5,27,8,1324,1289,1984,695
2016,5,27,9,1289,1262,1842,580
2016,5,27,10,1276,1257,1734,477
2016,5,27,11,1282,1265,1731,466
2016,5,27,12,1333,1322,1801,479
2016,5,27,13,1390,1378,1920,542
2016,5,27,14,1480,1440,1957,517
2016,5,27,15,1534,1481,2063,582
2016,5,27,16,1569,1519,2158,639
2016,5,27,17,1593,1543,2252,709
2016,5,27,18,1609,1560,2263,703
2016,5,27,19,1619,1585,2234,649
2016,5,27,20,1629,1609,2302,693
2016,5,27,21,1633,1612,2339,727
2016,5,27,22,1652,1633,2324,691
2016,5,27,23,1657,1661,2335,674
2016,5,28,0,1674,1648,2306,658
2016,5,28,1,1646,1616,2251,635
2016,5,28,2,1636,1597,2173,576
2016,5,28,3,1682,1648,2225,577
2016,5,28,4,1676,1644,2219,575
2016,5,28,5,1581,1551,2112,561
2016,5,28,6,1462,1435,1940,505
2016,5,28,7,1383,1351,1952,601
2016,5,28,8,1333,1300,1912,612
2016,5,28,9,1295,1268,1866,598
2016,5,28,10,1276,1253,1833,580
2016,5,28,11,1270,1255,1762,507
2016,5,28,12,1274,1275,1753,478
2016,5,28,13,1280,1280,1800,520
2016,5,28,14,1326,1327,1789,462
2016,5,28,15,1391,1384,1834,450
2016,5,28,16,1443,1433,1910,477
2016,5,28,17,1478,1471,1985,514
2016,5,28,18,1513,1506,2020,514
2016,5,28,19,1529,1528,2023,495
2016,5,28,20,1548,1558,2029,471
2016,5,28,21,1569,1586,2049,463
2016,5,28,22,1594,1620,2065,445
2016,5,28,23,1625,1673,2097,424
2016,5,29,0,1654,1701,2157,456
2016,5,29,1,1655,1706,2203,497
2016,5,29,2,1639,1690,2211,521
2016,5,29,3,1678,1713,2203,490
2016,5,29,4,1676,1681,2203,522
2016,5,29,5,1588,1565,2110,545
2016,5,29,6,1485,1458,1999,541
2016,5,29,7,1395,1359,1913,554
2016,5,29,8,1336,1304,1648,344
2016,5,29,9,1296,1261,1478,217
2016,5,29,10,1272,1239,1461,222
2016,5,29,11,1264,1233,1513,280
2016,5,29,12,1270,1245,1565,320
2016,5,29,13,1266,1234,1676,442
2016,5,29,14,1297,1289,1769,480
2016,5,29,15,1374,1351,1858,507
2016,5,29,16,1438,1407,1956,549
2016,5,29,17,1501,1453,2054,601
2016,5,29,18,1553,1503,2197,694
2016,5,29,19,1599,1534,2253,719
2016,5,29,20,1630,1581,2285,704
2016,5,29,21,1666,1622,2293,671
2016,5,29,22,1701,1653,2267,614
2016,5,29,23,1745,1695,2335,640
2016,5,30,0,1771,1726,2314,588
2016,5,30,1,1763,1733,2260,527
2016,5,30,2,1750,1704,2319,615
2016,5,30,3,1767,1729,2374,645
2016,5,30,4,1741,1705,2409,704
2016,5,30,5,1631,1580,2323,743
2016,5,30,6,1505,1464,2247,783
2016,5,30,7,1404,1381,2035,654
2016,5,30,8,1341,1315,2014,699
2016,5,30,9,1299,1280,1977,697
2016,5,30,10,1274,1261,1969,708
2016,5,30,11,1253,1261,1928,667
2016,5,30,12,1258,1272,1945,673
2016,5,30,13,1253,1271,1902,631
2016,5,30,14,1285,1321,1871,550
2016,5,30,15,1363,1396,1952,556
2016,5,30,16,1436,1459,2031,572
2016,5,30,17,1492,1521,2081,560
2016,5,30,18,1543,1588,2098,510
2016,5,30,19,1592,1614,2132,518
2016,5,30,20,1631,1661,2241,580
2016,5,30,21,1672,1689,2315,626
2016,5,30,22,1723,1730,2305,575
2016,5,30,23,1762,1764,2259,495
2016,5,31,0,1789,1774,2279,505
2016,5,31,1,1770,1748,2308,560
2016,5,31,2,1761,1721,2326,605
2016,5,31,3,1766,1781,2349,568
2016,5,31,4,1732,1742,2380,638
2016,5,31,5,1598,1614,2299,685
2016,5,31,6,1492,1459,2128,669
2016,5,31,7,1393,1368,2055,687
2016,5,31,8,1350,1304,2050,746
2016,5,31,9,1324,1263,2042,779
2016,5,31,10,1314,1242,1995,753
2016,5,31,11,1311,1254,1996,742
2016,5,31,12,1359,1312,1952,640
2016,5,31,13,1430,1358,1968,610
2016,5,31,14,1495,1454,1955,501
2016,5,31,15,1548,1537,2010,473
2016,5,31,16,1603,1598,2030,432
2016,5,31,17,1656,1664,2017,353
2016,5,31,18,1701,1898,2138,240
2016,5,31,19,1740,1776,2087,311
2016,5,31,20,1770,1824,2235,411
2016,5,31,21,1809,1806,2271,465
2016,5,31,22,1836,1779,2310,531
2016,5,31,23,1858,1762,2237,475
2016,6,1,0,1851,1720,2153,433
2016,6,1,1,1814,1660,2157,497
2016,6,1,2,1797,1628,2163,535
2016,6,1,3,1810,1692,2246,554
2016,6,1,4,1775,1680,2276,596
2016,6,1,5,1662,1550,2154,604
2016,6,1,6,1510,1415,1992,577
2016,6,1,7,1418,1334,1933,599
2016,6,1,8,1345,1283,1895,612
2016,6,1,9,1319,1262,1847,585
2016,6,1,10,1299,1248,1854,606
2016,6,1,11,1308,1261,1811,550
2016,6,1,12,1357,1315,1829,514
2016,6,1,13,1433,1373,1785,412
2016,6,1,14,1507,1448,1811,363
2016,6,1,15,1585,1494,1890,396
2016,6,1,16,1635,1549,1902,353
2016,6,1,17,1667,1597,1916,319
2016,6,1,18,1703,1616,1933,317
2016,6,1,19,1713,1638,1984,346
2016,6,1,20,1729,1668,2070,402
2016,6,1,21,1750,1714,2158,444
2016,6,1,22,1756,1759,2223,464
2016,6,1,23,1766,1780,2193,413
2016,6,2,0,1766,1792,2169,377
2016,6,2,1,1729,1776,2136,360
2016,6,2,2,1724,1705,2112,407
2016,6,2,3,1748,1732,2105,373
2016,6,2,4,1721,1701,2134,433
2016,6,2,5,1607,1570,2019,449
2016,6,2,6,1476,1445,1962,517
2016,6,2,7,1374,1353,1822,469
2016,6,2,8,1333,1295,1820,525
2016,6,2,9,1292,1265,1845,580
2016,6,2,10,1282,1259,1840,581
2016,6,2,11,1283,1276,1830,554
2016,6,2,12,1331,1329,1820,491
2016,6,2,13,1407,1374,1798,424
2016,6,2,14,1489,1452,1852,400
2016,6,2,15,1546,1512,1941,429
2016,6,2,16,1591,1565,2029,464
2016,6,2,17,1638,1619,2086,467
2016,6,2,18,1686,1677,2120,443
2016,6,2,19,1726,1712,2245,533
2016,6,2,20,1774,1796,2350,554
2016,6,2,21,1826,1813,2375,562
2016,6,2,22,1866,1874,2413,539
2016,6,2,23,1896,1914,2426,512
2016,6,3,0,1892,1916,2419,503
2016,6,3,1,1853,1881,2409,528
2016,6,3,2,1821,1850,2347,497
2016,6,3,3,1838,1875,2351,476
2016,6,3,4,1797,1838,2338,500
2016,6,3,5,1659,1685,2150,465
2016,6,3,6,1514,1534,2081,547
2016,6,3,7,1416,1430,2016,586
2016,6,3,8,1389,1357,1895,538
2016,6,3,9,1343,1316,1884,568
2016,6,3,10,1320,1295,1850,555
2016,6,3,11,1323,1307,1824,517
2016,6,3,12,1364,1345,1832,487
2016,6,3,13,1423,1394,1763,369
2016,6,3,14,1514,1478,1811,333
2016,6,3,15,1592,1548,1874,326
2016,6,3,16,1663,1634,1912,278
2016,6,3,17,1747,1720,1974,254
2016,6,3,18,1810,1786,2138,352
2016,6,3,19,1863,1854,2259,405
2016,6,3,20,1930,1924,2383,459
2016,6,3,21,2006,2000,2496,496
2016,6,3,22,2073,2050,2543,493
2016,6,3,23,2120,2078,2480,402
2016,6,4,0,2121,2059,2468,409
2016,6,4,1,2088,1997,2388,391
2016,6,4,2,2027,1934,2389,455
2016,6,4,3,1990,1941,2380,439
2016,6,4,4,1940,1888,2361,473
2016,6,4,5,1807,1744,2202,458
2016,6,4,6,1656,1603,2085,482
2016,6,4,7,1537,1505,1985,480
2016,6,4,8,1477,1432,1952,520
2016,6,4,9,1420,1389,1739,350
2016,6,4,10,1394,1360,1688,328
2016,6,4,11,1381,1347,1666,319
2016,6,4,12,1387,1362,1645,283
2016,6,4,13,1399,1354,1592,238
2016,6,4,14,1449,1432,1633,201
2016,6,4,15,1569,1535,1747,212
2016,6,4,16,1674,1636,1802,166
2016,6,4,17,1765,1738,1953,215
2016,6,4,18,1845,1811,2125,314
2016,6,4,19,1906,1872,2197,325
2016,6,4,20,1968,1925,2245,320
2016,6,4,21,2020,1971,2372,401
2016,6,4,22,2062,2009,2387,378
2016,6,4,23,2082,2011,2408,397
2016,6,5,0,2077,1962,2351,389
2016,6,5,1,2035,1919,2349,430
2016,6,5,2,2015,1878,2303,425
2016,6,5,3,1982,1896,2327,431
2016,6,5,4,1936,1874,2344,470
2016,6,5,5,1817,1752,2308,556
2016,6,5,6,1670,1617,2138,521
2016,6,5,7,1562,1520,1972,452
2016,6,5,8,1515,1441,1551,110
2016,6,5,9,1431,1387,1488,101
2016,6,5,10,1398,1360,1453,93
2016,6,5,11,1381,1349,1421,72
2016,6,5,12,1379,1340,1409,69
2016,6,5,13,1376,1326,1432,106
2016,6,5,14,1408,1379,1487,108
2016,6,5,15,1511,1475,1595,120
2016,6,5,16,1615,1571,1725,154
2016,6,5,17,1714,1661,1826,165
2016,6,5,18,1792,1743,2001,258
2016,6,5,19,1865,1827,2204,377
2016,6,5,20,1944,1898,2280,382
2016,6,5,21,2012,1963,2303,340
2016,6,5,22,2072,2027,2368,341
2016,6,5,23,2114,2072,2401,329
2016,6,6,0,2130,2112,2465,353
2016,6,6,1,2110,2085,2538,453
2016,6,6,2,2088,2036,2536,500
2016,6,6,3,2048,1997,2514,517
2016,6,6,4,1982,1928,2459,531
2016,6,6,5,1836,1756,2312,556
2016,6,6,6,1672,1597,2154,557
2016,6,6,7,1557,1487,2044,557
2016,6,6,8,1489,1412,1926,514
2016,6,6,9,1420,1362,1806,444
2016,6,6,10,1404,1339,1631,292
2016,6,6,11,1402,1350,1474,124
2016,6,6,12,1440,1383,1464,81
2016,6,6,13,1517,1429,1484,55
2016,6,6,14,1603,1530,1563,33
2016,6,6,15,1675,1649,1687,38
2016,6,6,16,1765,1722,1805,83
2016,6,6,17,1859,1812,2056,244
2016,6,6,18,1953,1900,2152,252
2016,6,6,19,2033,1968,2249,281
2016,6,6,20,2114,2044,2315,271
2016,6,6,21,2191,2117,2405,288
2016,6,6,22,2255,2168,2442,274
2016,6,6,23,2318,2200,2469,269
2016,6,7,0,2323,2190,2465,275
2016,6,7,1,2275,2099,2365,266
2016,6,7,2,2234,2006,2221,215
2016,6,7,3,2181,1995,2223,228
2016,6,7,4,2090,1950,2263,313
2016,6,7,5,1917,1784,2146,362
2016,6,7,6,1738,1616,2059,443
2016,6,7,7,1607,1508,2012,504
2016,6,7,8,1509,1443,1811,368
2016,6,7,9,1448,1394,1701,307
2016,6,7,10,1424,1370,1612,242
2016,6,7,11,1419,1376,1643,267
2016,6,7,12,1458,1421,1673,252
2016,6,7,13,1525,1474,1794,320
2016,6,7,14,1656,1567,1861,294
2016,6,7,15,1739,1644,1862,218
2016,6,7,16,1834,1718,2059,341
2016,6,7,17,1935,1809,2253,444
2016,6,7,18,2020,1894,2299,405
2016,6,7,19,2097,1968,2429,461
2016,6,7,20,2186,2043,2529,486
2016,6,7,21,2249,2127,2568,441
2016,6,7,22,2309,2211,2610,399
2016,6,7,23,2351,2199,2594,395
2016,6,8,0,2349,2139,2495,356
2016,6,8,1,2291,2055,2415,360
2016,6,8,2,2258,1993,2338,345
2016,6,8,3,2215,2006,2310,304
2016,6,8,4,2117,1972,2257,285
2016,6,8,5,1949,1817,1988,171
2016,6,8,6,1765,1644,1819,175
2016,6,8,7,1637,1543,1629,86
2016,6,8,8,1533,1470,1624,154
2016,6,8,9,1475,1416,1731,315
2016,6,8,10,1443,1385,1765,380
2016,6,8,11,1439,1387,1740,353
2016,6,8,12,1476,1421,1802,381
2016,6,8,13,1546,1467,1818,351
2016,6,8,14,1641,1570,1895,325
2016,6,8,15,1728,1660,1970,310
2016,6,8,16,1822,1750,2120,370
2016,6,8,17,1924,1847,2233,386
2016,6,8,18,2024,1931,2416,485
2016,6,8,19,2102,2012,2454,442
2016,6,8,20,2187,2106,2563,457
2016,6,8,21,2252,2152,2594,442
2016,6,8,22,2315,2214,2592,378
2016,6,8,23,2360,2256,2687,431
2016,6,9,0,2359,2223,2723,500
2016,6,9,1,2303,2196,2661,465
2016,6,9,2,2254,2134,2600,466
2016,6,9,3,2211,2142,2570,428
2016,6,9,4,2125,2067,2469,402
2016,6,9,5,1950,1870,2282,412
2016,6,9,6,1760,1696,2098,402
2016,6,9,7,1632,1572,1949,377
2016,6,9,8,1550,1510,1955,445
2016,6,9,9,1497,1463,1896,433
2016,6,9,10,1467,1429,1881,452
2016,6,9,11,1469,1429,1876,447
2016,6,9,12,1505,1471,1891,420
2016,6,9,13,1574,1521,1928,407
2016,6,9,14,1661,1632,1899,267
2016,6,9,15,1742,1733,1974,241
2016,6,9,16,1834,1824,2131,307
2016,6,9,17,1949,1912,2324,412
2016,6,9,18,2048,2019,2452,433
2016,6,9,19,2132,2105,2582,477
2016,6,9,20,2222,2200,2556,356
2016,6,9,21,2291,2225,2634,409
2016,6,9,22,2368,2269,2673,404
2016,6,9,23,2402,2300,2649,349
2016,6,10,0,2372,2265,2620,355
2016,6,10,1,2309,2187,2573,386
2016,6,10,2,2245,2113,2487,374
2016,6,10,3,2210,2105,2417,312
2016,6,10,4,2137,2047,2373,326
2016,6,10,5,1975,1867,2256,389
2016,6,10,6,1789,1702,2224,522
2016,6,10,7,1658,1588,1937,349
2016,6,10,8,1569,1512,1649,137
2016,6,10,9,1516,1456,1498,42
2016,6,10,10,1485,1418,1489,71
2016,6,10,11,1489,1415,1458,43
2016,6,10,12,1520,1452,1496,44
2016,6,10,13,1585,1495,1605,110
2016,6,10,14,1674,1602,1672,70
2016,6,10,15,1799,1686,1803,117
2016,6,10,16,1903,1782,2174,392
2016,6,10,17,2024,1897,2299,402
2016,6,10,18,2118,1994,2165,171
2016,6,10,19,2210,2086,2122,36
2016,6,10,20,2295,2174,2276,102
2016,6,10,21,2359,2230,2449,219
2016,6,10,22,2401,2295,2521,226
2016,6,10,23,2421,2286,2539,253
2016,6,11,0,2380,2217,2528,311
2016,6,11,1,2301,2154,2541,387
2016,6,11,2,2229,2095,2399,304
2016,6,11,3,2195,2097,2245,148
2016,6,11,4,2129,2042,2269,227
2016,6,11,5,1987,1891,2112,221
2016,6,11,6,1813,1738,1968,230
2016,6,11,7,1679,1621,1865,244
2016,6,11,8,1590,1533,1414,-119
2016,6,11,9,1519,1469,1350,-119
2016,6,11,10,1491,1430,1319,-111
2016,6,11,11,1469,1406,1273,-133
2016,6,11,12,1474,1407,1222,-185
2016,6,11,13,1480,1401,1197,-204
2016,6,11,14,1534,1494,1240,-254
2016,6,11,15,1631,1599,1326,-273
2016,6,11,16,1734,1711,1632,-79
2016,6,11,17,1842,1801,1734,-67
2016,6,11,18,1921,1895,1808,-87
2016,6,11,19,1999,1965,1850,-115
2016,6,11,20,2070,2031,1960,-71
2016,6,11,21,2118,2088,2003,-85
2016,6,11,22,2144,2086,1969,-117
2016,6,11,23,2137,2074,1975,-99
2016,6,12,0,2124,2036,2021,-15
2016,6,12,1,2068,1973,2022,49
2016,6,12,2,2023,1919,2068,149
2016,6,12,3,1998,1934,2063,129
2016,6,12,4,1965,1909,2112,203
2016,6,12,5,1834,1789,2124,335
2016,6,12,6,1700,1653,2124,471
2016,6,12,7,1590,1548,1933,385
2016,6,12,8,1522,1485,1563,78
2016,6,12,9,1459,1429,1586,157
2016,6,12,10,1419,1389,1574,185
2016,6,12,11,1397,1378,1580,202
2016,6,12,12,1395,1373,1618,245
2016,6,12,13,1387,1357,1600,243
2016,6,12,14,1427,1433,1670,237
2016,6,12,15,1528,1535,1844,309
2016,6,12,16,1636,1656,1993,337
2016,6,12,17,1734,1771,2099,328
2016,6,12,18,1827,1879,2208,329
2016,6,12,19,1907,1968,2241,273
2016,6,12,20,1981,2039,2318,279
2016,6,12,21,2046,2110,2375,265
2016,6,12,22,2102,2140,2374,234
2016,6,12,23,2150,2161,2407,246
2016,6,13,0,2156,2135,2445,310
2016,6,13,1,2122,2084,2436,352
2016,6,13,2,2088,2061,2430,369
2016,6,13,3,2051,2049,2356,307
2016,6,13,4,1993,2005,2357,352
2016,6,13,5,1866,1824,2251,427
2016,6,13,6,1703,1649,2115,466
2016,6,13,7,1586,1526,1862,336
2016,6,13,8,1493,1453,1767,314
2016,6,13,9,1440,1402,1695,293
2016,6,13,10,1420,1384,1708,324
2016,6,13,11,1419,1393,1715,322
2016,6,13,12,1454,1433,1758,325
2016,6,13,13,1515,1479,1731,252
2016,6,13,14,1606,1590,1733,143
2016,6,13,15,1700,1669,1794,125
2016,6,13,16,1787,1768,1914,146
2016,6,13,17,1876,1865,2024,159
2016,6,13,18,1953,1950,2136,186
2016,6,13,19,2032,2005,2207,202
2016,6,13,20,2106,2068,2261,193
2016,6,13,21,2164,2133,2466,333
2016,6,13,22,2213,2172,2587,415
2016,6,13,23,2236,2192,2572,380
2016,6,14,0,2212,2160,2536,376
2016,6,14,1,2156,2127,2485,358
2016,6,14,2,2113,2047,2460,413
2016,6,14,3,2092,2033,2426,393
2016,6,14,4,2028,1978,2383,405
2016,6,14,5,1874,1790,2187,397
2016,6,14,6,1703,1626,2096,470
2016,6,14,7,1579,1508,1920,412
2016,6,14,8,1470,1435,1847,412
2016,6,14,9,1422,1380,1819,439
2016,6,14,10,1399,1357,1800,443
2016,6,14,11,1391,1351,1801,450
2016,6,14,12,1423,1393,1803,410
2016,6,14,13,1485,1439,1814,375
2016,6,14,14,1582,1535,1847,312
2016,6,14,15,1655,1605,1839,234
2016,6,14,16,1735,1685,1898,213
2016,6,14,17,1822,1745,1935,190
2016,6,14,18,1886,1837,2098,261
2016,6,14,19,1941,1887,2223,336
2016,6,14,20,2011,1962,2397,435
2016,6,14,21,2067,2023,2446,423
2016,6,14,22,2132,2093,2451,358
2016,6,14,23,2163,2141,2517,376
2016,6,15,0,2149,2161,2553,392
2016,6,15,1,2095,2141,2530,389
2016,6,15,2,2058,2098,2517,419
2016,6,15,3,2039,2067,2476,409
2016,6,15,4,1990,1990,2446,456
2016,6,15,5,1838,1798,2392,594
2016,6,15,6,1681,1615,2241,626
2016,6,15,7,1553,1496,2121,625
2016,6,15,8,1454,1420,1935,515
2016,6,15,9,1389,1374,1867,493
2016,6,15,10,1364,1343,1798,455
2016,6,15,11,1373,1345,1740,395
2016,6,15,12,1401,1386,1740,354
2016,6,15,13,1458,1428,1734,306
2016,6,15,14,1557,1531,1793,262
2016,6,15,15,1642,1609,1801,192
2016,6,15,16,1726,1699,1833,134
2016,6,15,17,1819,1798,2012,214
2016,6,15,18,1907,1877,2269,392
2016,6,15,19,1977,1932,2352,420
2016,6,15,20,2043,2025,2375,350
2016,6,15,21,2100,2082,2464,382
2016,6,15,22,2168,2159,2547,388
2016,6,15,23,2216,2218,2657,439
2016,6,16,0,2202,2235,2695,460
2016,6,16,1,2148,2233,2623,390
2016,6,16,2,2079,2182,2546,364
2016,6,16,3,2072,2139,2526,387
2016,6,16,4,2029,2059,2509,450
2016,6,16,5,1873,1859,2300,441
2016,6,16,6,1701,1676,2160,484
2016,6,16,7,1571,1540,1988,448
2016,6,16,8,1501,1461,1952,491
2016,6,16,9,1443,1406,1868,462
2016,6,16,10,1413,1382,1863,481
2016,6,16,11,1412,1377,1870,493
2016,6,16,12,1440,1415,1869,454
2016,6,16,13,1485,1463,1887,424
2016,6,16,14,1572,1565,1894,329
2016,6,16,15,1652,1648,1944,296
2016,6,16,16,1739,1739,1976,237
2016,6,16,17,1820,1840,2144,304
2016,6,16,18,1913,1911,2233,322
2016,6,16,19,1984,1980,2294,314
2016,6,16,20,2060,2065,2364,299
2016,6,16,21,2110,2110,2537,427
2016,6,16,22,2178,2183,2593,410
2016,6,16,23,2222,2229,2624,395
2016,6,17,0,2218,2243,2619,376
2016,6,17,1,2156,2241,2568,327
2016,6,17,2,2107,2193,2557,364
2016,6,17,3,2098,2140,2496,356
2016,6,17,4,2047,2060,2437,377
2016,6,17,5,1901,1867,2174,307
2016,6,17,6,1724,1675,2091,416
2016,6,17,7,1590,2070,2544,474
2016,6,17,8,1499,1461,1815,354
2016,6,17,9,1442,1407,1730,323
2016,6,17,10,1418,1381,1689,308
2016,6,17,11,1419,1379,1685,306
2016,6,17,12,1439,1407,1690,283
2016,6,17,13,1474,1452,1692,240
2016,6,17,14,1575,1559,1798,239
2016,6,17,15,1663,1647,1978,331
2016,6,17,16,1760,1740,1996,256
2016,6,17,17,1851,1851,2080,229
2016,6,17,18,1937,1937,2177,240
2016,6,17,19,2005,2010,2317,307
2016,6,17,20,2099,2089,2411,322
2016,6,17,21,2181,2169,2538,369
2016,6,17,22,2246,2242,2628,386
2016,6,17,23,2304,2295,2661,366
2016,6,18,0,2295,2307,2708,401
2016,6,18,1,2230,2270,2668,398
2016,6,18,2,2164,2188,2565,377
2016,6,18,3,2133,2108,2491,383
2016,6,18,4,2090,2020,2493,473
2016,6,18,5,1949,1843,2246,403
2016,6,18,6,1767,1659,2222,563
2016,6,18,7,1630,1556,2077,521
2016,6,18,8,1500,1466,1987,521
2016,6,18,9,1445,1386,1915,529
2016,6,18,10,1409,1363,1856,493
2016,6,18,11,1393,1358,1897,539
2016,6,18,12,1391,1356,1920,564
2016,6,18,13,1399,1350,1873,523
2016,6,18,14,1463,1421,1840,419
2016,6,18,15,1571,1520,1952,432
2016,6,18,16,1689,1629,2098,469
2016,6,18,17,1789,1744,2327,583
2016,6,18,18,1893,1861,2460,599
2016,6,18,19,1982,1968,2450,482
2016,6,18,20,2072,2077,2581,504
2016,6,18,21,2152,2169,2620,451
2016,6,18,22,2221,2260,2601,341
2016,6,18,23,2264,2369,2705,336
2016,6,19,0,2281,2355,2672,317
2016,6,19,1,2282,2350,2680,330
2016,6,19,2,2238,2287,2666,379
2016,6,19,3,2153,2208,2590,382
2016,6,19,4,2095,2151,2546,395
2016,6,19,5,1957,2002,2472,470
2016,6,19,6,1796,1841,2441,600
2016,6,19,7,1657,1726,2338,612
2016,6,19,8,1611,1645,2031,386
2016,6,19,9,1531,1584,1951,367
2016,6,19,10,1502,1539,1818,279
2016,6,19,11,1481,1508,1789,281
2016,6,19,12,1467,1491,1729,238
2016,6,19,13,1446,1462,1683,221
2016,6,19,14,1488,1565,1752,187
2016,6,19,15,1553,1693,1822,129
2016,6,19,16,1675,1830,1899,69
2016,6,19,17,1785,1960,1978,18
2016,6,19,18,1899,2078,2148,70
2016,6,19,19,2002,2171,2358,187
2016,6,19,20,2084,2253,2366,113
2016,6,19,21,2164,2318,2481,163
2016,6,19,22,2234,2390,2570,180
2016,6,19,23,2296,2446,2689,243
2016,6,20,0,2315,2473,2684,211
2016,6,20,1,2298,2467,2685,218
2016,6,20,2,2256,2414,2641,227
2016,6,20,3,2183,2358,2614,256
2016,6,20,4,2128,2302,2601,299
2016,6,20,5,1980,2106,2440,334
2016,6,20,6,1797,1906,2392,486
2016,6,20,7,1657,1763,2205,442
2016,6,20,8,1671,1666,1869,203
2016,6,20,9,1603,1598,1710,112
2016,6,20,10,1597,1557,1684,127
2016,6,20,11,1593,1547,1651,104
2016,6,20,12,1615,1579,1629,50
2016,6,20,13,1661,1620,1638,18
2016,6,20,14,1762,1749,1690,-59
2016,6,20,15,1869,1875,1857,-18
2016,6,20,16,1948,1999,2037,38
2016,6,20,17,2071,2119,2177,58
2016,6,20,18,2189,2229,2356,127
2016,6,20,19,2292,2315,2435,120
2016,6,20,20,2395,2401,2494,93
2016,6,20,21,2455,2455,2522,67
2016,6,20,22,2519,2500,2685,185
2016,6,20,23,2587,2528,2696,168
2016,6,21,0,2596,2502,2646,144
2016,6,21,1,2609,2491,2675,184
2016,6,21,2,2562,2423,2616,193
2016,6,21,3,2486,2383,2498,115
2016,6,21,4,2384,2297,2443,146
2016,6,21,5,2169,2087,2240,153
2016,6,21,6,1954,1866,2148,282
2016,6,21,7,1785,1734,2016,282
2016,6,21,8,1694,1632,1900,268
2016,6,21,9,1631,1558,1840,282
2016,6,21,10,1597,1512,1819,307
2016,6,21,11,1577,1500,1735,235
2016,6,21,12,1610,1534,1774,240
2016,6,21,13,1663,1584,1848,264
2016,6,21,14,1783,1713,1919,206
2016,6,21,15,1891,1818,1974,156
2016,6,21,16,2009,1945,2034,89
2016,6,21,17,2129,2065,2137,72
2016,6,21,18,2236,2165,2221,56
2016,6,21,19,2313,2248,2304,56
2016,6,21,20,2399,2353,2337,-16
2016,6,21,21,2465,2404,2372,-32
2016,6,21,22,2531,2479,2369,-110
2016,6,21,23,2581,2519,2356,-163
2016,6,22,0,2566,2508,2339,-169
2016,6,22,1,2531,2495,2343,-152
2016,6,22,2,2475,2415,2263,-152
2016,6,22,3,2426,2363,2235,-128
2016,6,22,4,2358,2259,2332,73
2016,6,22,5,2173,2041,2139,98
2016,6,22,6,1956,1859,2118,259
2016,6,22,7,1810,1718,2049,331
2016,6,22,8,1659,1629,1841,212
2016,6,22,9,1598,1566,1786,220
2016,6,22,10,1578,1533,1780,247
2016,6,22,11,1577,1524,1744,220
2016,6,22,12,1605,1537,1750,213
2016,6,22,13,1660,1605,1797,192
2016,6,22,14,1777,1731,1891,160
2016,6,22,15,1887,1846,2012,166
2016,6,22,16,2009,1983,2082,99
2016,6,22,17,2141,2112,2194,82
2016,6,22,18,2262,2239,2302,63
2016,6,22,19,2370,2337,2428,91
2016,6,22,20,2469,2445,2346,-99
2016,6,22,21,2532,2525,2444,-81
2016,6,22,22,2578,2575,2508,-67
2016,6,22,23,2611,2606,2539,-67
2016,6,23,0,2572,2574,2531,-43
2016,6,23,1,2527,2495,2437,-58
2016,6,23,2,2462,2362,2421,59
2016,6,23,3,2413,2325,2332,7
2016,6,23,4,2335,2248,2423,175
2016,6,23,5,2138,2053,2200,147
2016,6,23,6,1924,1872,2094,222
2016,6,23,7,1775,1747,1876,129
2016,6,23,8,1680,1667,1725,58
2016,6,23,9,1622,1619,1626,7
2016,6,23,10,1583,1585,1555,-30
2016,6,23,11,1584,1583,1560,-23
2016,6,23,12,1608,1621,1627,6
2016,6,23,13,1665,1661,1745,84
2016,6,23,14,1768,1767,1842,75
2016,6,23,15,1878,1900,1999,99
2016,6,23,16,2010,2028,2273,245
2016,6,23,17,2131,2154,2371,217
2016,6,23,18,2240,2260,2483,223
2016,6,23,19,2331,2352,2556,204
2016,6,23,20,2417,2451,2538,87
2016,6,23,21,2471,2515,2533,18
2016,6,23,22,2528,2553,2604,51
2016,6,23,23,2548,2543,2700,157
2016,6,24,0,2505,2457,2641,184
2016,6,24,1,2467,2295,2587,292
2016,6,24,2,2396,2169,2538,369
2016,6,24,3,2371,2137,2438,301
2016,6,24,4,2300,2094,2469,375
2016,6,24,5,2126,1933,2401,468
2016,6,24,6,1929,1760,2275,515
2016,6,24,7,1784,1651,2002,351
2016,6,24,8,1638,1584,1950,366
2016,6,24,9,1576,1541,1878,337
2016,6,24,10,1539,1512,1865,353
2016,6,24,11,1535,1524,1903,379
2016,6,24,12,1572,1548,1969,421
2016,6,24,13,1621,1614,2012,398
2016,6,24,14,1744,1704,2096,392
2016,6,24,15,1854,1805,2083,278
2016,6,24,16,1998,1921,2324,403
2016,6,24,17,2130,2048,2463,415
2016,6,24,18,2239,2135,2609,474
2016,6,24,19,2339,2221,2620,399
2016,6,24,20,2432,2332,2692,360
2016,6,24,21,2472,2392,2771,379
2016,6,24,22,2526,2433,2854,421
2016,6,24,23,2543,2434,2834,400
2016,6,25,0,2514,2326,2828,502
2016,6,25,1,2467,2209,2637,428
2016,6,25,2,2374,2124,2485,361
2016,6,25,3,2337,2140,2431,291
2016,6,25,4,2256,2111,2372,261
2016,6,25,5,2113,1965,2308,343
2016,6,25,6,1935,1803,2066,263
2016,6,25,7,1784,1670,1873,203
2016,6,25,8,1663,1589,1881,292
2016,6,25,9,1592,1542,1862,320
2016,6,25,10,1547,1510,1841,331
2016,6,25,11,1530,1495,1861,366
2016,6,25,12,1531,1514,1976,462
2016,6,25,13,1524,1519,1968,449
2016,6,25,14,1577,1581,1961,380
2016,6,25,15,1703,1676,1922,246
2016,6,25,16,1846,1786,1931,145
2016,6,25,17,1977,1866,1972,106
2016,6,25,18,2091,1944,2035,91
2016,6,25,19,2185,1997,2129,132
2016,6,25,20,2274,2096,2212,116
2016,6,25,21,2335,2169,2275,106
2016,6,25,22,2370,2189,2316,127
2016,6,25,23,2377,2195,2490,295
2016,6,26,0,2371,2185,2455,270
2016,6,26,1,2324,2120,2372,252
2016,6,26,2,2252,2081,2231,150
2016,6,26,3,2207,2072,2159,87
2016,6,26,4,2148,2045,2162,117
2016,6,26,5,2014,1914,2064,150
2016,6,26,6,1852,1775,1931,156
2016,6,26,7,1726,1677,2037,360
2016,6,26,8,1627,1573,1899,326
2016,6,26,9,1561,1519,1912,393
2016,6,26,10,1518,1472,1893,421
2016,6,26,11,1495,1452,1860,408
2016,6,26,12,1497,1458,1877,419
2016,6,26,13,1486,1434,1841,407
2016,6,26,14,1526,1511,1857,346
2016,6,26,15,1628,1634,1878,244
2016,6,26,16,1754,1748,1986,238
2016,6,26,17,1878,1852,2186,334
2016,6,26,18,1986,1943,2138,195
2016,6,26,19,2079,1998,2209,211
2016,6,26,20,2167,2067,2235,168
2016,6,26,21,2223,2145,2443,298
2016,6,26,22,2260,2163,2476,313
2016,6,26,23,2274,2160,2481,321
2016,6,27,0,2274,2090,2463,373
2016,6,27,1,2230,2029,2397,368
2016,6,27,2,2179,1979,2302,323
2016,6,27,3,2149,1972,2303,331
2016,6,27,4,2093,1931,2292,361
2016,6,27,5,1948,1793,2138,345
2016,6,27,6,1780,1645,2051,406
2016,6,27,7,1655,1545,1936,391
2016,6,27,8,1538,1480,1911,431
2016,6,27,9,1480,1437,1925,488
2016,6,27,10,1458,1417,1887,470
2016,6,27,11,1453,1426,1903,477
2016,6,27,12,1490,1464,1902,438
2016,6,27,13,1552,1515,1932,417
2016,6,27,14,1654,1615,1956,341
2016,6,27,15,1746,1734,2001,267
2016,6,27,16,1877,1846,2070,224
2016,6,27,17,1975,1949,2126,177
2016,6,27,18,2058,2045,2067,22
2016,6,27,19,2146,2134,2189,55
2016,6,27,20,2222,2218,2291,73
2016,6,27,21,2267,2293,2449,156
2016,6,27,22,2301,2346,2530,184
2016,6,27,23,2313,2361,2521,160
2016,6,28,0,2302,2334,2522,188
2016,6,28,1,2267,2255,2569,314
2016,6,28,2,2203,2157,2484,327
2016,6,28,3,2183,2128,2451,323
2016,6,28,4,2124,2069,2396,327
2016,6,28,5,1956,1909,2264,355
2016,6,28,6,1785,1733,2060,327
2016,6,28,7,1648,1620,1980,360
2016,6,28,8,1567,1545,1898,353
2016,6,28,9,1510,1499,1882,383
2016,6,28,10,1486,1465,1877,412
2016,6,28,11,1470,1463,1849,386
2016,6,28,12,1509,1508,1877,369
2016,6,28,13,1575,1551,1882,331
2016,6,28,14,1682,1667,1938,271
2016,6,28,15,1776,1772,1913,141
2016,6,28,16,1882,1884,1961,77
2016,6,28,17,1991,1985,2183,198
2016,6,28,18,2066,2074,2309,235
2016,6,28,19,2148,2157,2452,295
2016,6,28,20,2231,2228,2598,370
2016,6,28,21,2296,2294,2667,373
2016,6,28,22,2327,2333,2705,372
2016,6,28,23,2339,2361,2733,372
2016,6,29,0,2306,2344,2731,387
2016,6,29,1,2243,2288,2674,386
2016,6,29,2,2181,2198,2560,362
2016,6,29,3,2159,2152,2497,345
2016,6,29,4,2098,2089,2377,288
2016,6,29,5,1938,1903,2215,312
2016,6,29,6,1766,1718,2140,422
2016,6,29,7,1635,1591,2054,463
2016,6,29,8,1564,1516,2109,593
2016,6,29,9,1519,1471,2068,597
2016,6,29,10,1488,1448,1912,464
2016,6,29,11,1488,1452,1877,425
2016,6,29,12,1516,1503,1880,377
2016,6,29,13,1576,1552,1876,324
2016,6,29,14,1679,1656,1913,257
2016,6,29,15,1768,1764,2007,243
2016,6,29,16,1879,1858,2062,204
2016,6,29,17,1976,1964,2229,265
2016,6,29,18,2065,2069,2307,238
2016,6,29,19,2144,2145,2460,315
2016,6,29,20,2213,2221,2471,250
2016,6,29,21,2295,2290,2655,365
2016,6,29,22,2350,2346,2746,400
2016,6,29,23,2361,2400,2759,359
2016,6,30,0,2345,2383,2691,308
2016,6,30,1,2280,2330,2594,264
2016,6,30,2,2215,2268,2551,283
2016,6,30,3,2195,2237,2571,334
2016,6,30,4,2133,2166,2489,323
2016,6,30,5,1973,1978,2268,290
2016,6,30,6,1791,1791,2192,401
2016,6,30,7,1659,1676,2098,422
2016,6,30,8,1488,1596,2024,428
2016,6,30,9,1446,1518,1915,397
2016,6,30,10,1427,1449,1835,386
2016,6,30,11,1436,1455,1827,372
2016,6,30,12,1495,1521,1817,296
2016,6,30,13,1611,1572,1797,225
2016,6,30,14,1677,1679,1793,114
2016,6,30,15,1788,1785,1862,77
2016,6,30,16,1905,1855,1870,15
2016,6,30,17,2014,1932,1985,53
2016,6,30,18,2100,1991,2024,33
2016,6,30,19,2185,2043,2234,191
2016,6,30,20,2270,2126,2360,234
2016,6,30,21,2338,2197,2384,187
2016,6,30,22,2380,2270,2441,171
2016,6,30,23,2393,2305,2460,155
2016,7,1,0,2349,2260,2530,270
2016,7,1,1,2270,2175,2417,242
2016,7,1,2,2210,2109,2349,240
2016,7,1,3,2187,2123,2338,215
2016,7,1,4,2131,2090,2359,269
2016,7,1,5,1972,1922,2305,383
2016,7,1,6,1788,1751,2189,438
2016,7,1,7,1652,1638,1985,347
2016,7,1,8,1560,1559,2049,490
2016,7,1,9,1511,1514,1922,408
2016,7,1,10,1479,1485,1803,318
2016,7,1,11,1477,1481,1772,291
2016,7,1,12,1513,1518,1913,395
2016,7,1,13,1575,1555,1983,428
2016,7,1,14,1664,1647,2008,361
2016,7,1,15,1763,1747,2149,402
2016,7,1,16,1848,1849,2262,413
2016,7,1,17,1937,1919,2267,348
2016,7,1,18,2027,1986,2341,355
2016,7,1,19,2088,2031,2344,313
2016,7,1,20,2152,2046,2452,406
2016,7,1,21,2196,1979,2443,464
2016,7,1,22,2204,1921,2393,472
2016,7,1,23,2187,1895,2411,516
2016,7,2,0,2123,1872,2374,502
2016,7,2,1,2053,1835,2371,536
2016,7,2,2,2003,1803,2366,563
2016,7,2,3,2004,1827,2327,500
2016,7,2,4,1950,1817,2363,546
2016,7,2,5,1819,1714,2243,529
2016,7,2,6,1673,1588,2228,640
2016,7,2,7,1568,1497,2209,712
2016,7,2,8,1460,1435,2180,745
2016,7,2,9,1412,1404,2135,731
2016,7,2,10,1379,1375,2062,687
2016,7,2,11,1367,1369,2059,690
2016,7,2,12,1379,1380,2056,676
2016,7,2,13,1373,1382,2056,674
2016,7,2,14,1445,1451,1985,534
2016,7,2,15,1591,1556,2046,490
2016,7,2,16,1693,1639,2105,466
2016,7,2,17,1786,1729,2230,501
2016,7,2,18,1872,1773,2284,511
2016,7,2,19,1932,1831,2401,570
2016,7,2,20,1999,1860,2467,607
2016,7,2,21,2072,1894,2558,664
2016,7,2,22,2119,1948,2651,703
2016,7,2,23,2156,1987,2642,655
2016,7,3,0,2148,1988,2644,656
2016,7,3,1,2096,1955,2590,635
2016,7,3,2,2044,1907,2523,616
2016,7,3,3,2016,1908,2500,592
2016,7,3,4,1979,1893,2491,598
2016,7,3,5,1855,1780,2258,478
2016,7,3,6,1708,1638,2237,599
2016,7,3,7,1603,1523,2106,583
2016,7,3,8,1496,1456,1963,507
2016,7,3,9,1444,1403,1892,489
2016,7,3,10,1407,1371,1918,547
2016,7,3,11,1390,1360,1879,519
2016,7,3,12,1385,1352,1855,503
2016,7,3,13,1403,1334,1851,517
2016,7,3,14,1463,1408,1944,536
2016,7,3,15,1574,1511,2065,554
2016,7,3,16,1694,1615,2133,518
2016,7,3,17,1796,1730,2292,562
2016,7,3,18,1901,1822,2321,499
2016,7,3,19,1984,1904,2404,500
2016,7,3,20,2069,1976,2556,580
2016,7,3,21,2147,2034,2534,500
2016,7,3,22,2201,2095,2532,437
2016,7,3,23,2242,2142,2583,441
2016,7,4,0,2244,2185,2534,349
2016,7,4,1,2186,2180,2538,358
2016,7,4,2,2125,2129,2364,235
2016,7,4,3,2089,2075,2206,131
2016,7,4,4,2049,2017,2180,163
2016,7,4,5,1888,1871,2083,212
2016,7,4,6,1747,1708,2050,342
2016,7,4,7,1633,1582,1936,354
2016,7,4,8,1552,1494,1888,394
2016,7,4,9,1492,1435,1900,465
2016,7,4,10,1452,1404,1860,456
2016,7,4,11,1420,1392,1864,472
2016,7,4,12,1411,1404,1871,467
2016,7,4,13,1406,1386,1842,456
2016,7,4,14,1476,1454,1859,405
2016,7,4,15,1590,1560,1901,341
2016,7,4,16,1716,1665,2088,423
2016,7,4,17,1831,1793,2189,396
2016,7,4,18,1940,1917,2333,416
2016,7,4,19,2037,2024,2513,489
2016,7,4,20,2129,2109,2570,461
2016,7,4,21,2210,2192,2620,428
2016,7,4,22,2271,2204,2632,428
2016,7,4,23,2310,2200,2610,410
2016,7,5,0,2313,2153,2554,401
2016,7,5,1,2268,2039,2508,469
2016,7,5,2,2181,1951,2374,423
2016,7,5,3,2146,1935,2302,367
2016,7,5,4,2096,1891,2308,417
2016,7,5,5,1927,1808,2225,417
2016,7,5,6,1787,1671,2196,525
2016,7,5,7,1666,1556,2044,488
2016,7,5,8,1523,1470,1983,513
2016,7,5,9,1455,1423,1949,526
2016,7,5,10,1433,1391,1940,549
2016,7,5,11,1427,1394,1947,553
2016,7,5,12,1467,1424,1928,504
2016,7,5,13,1514,1466,1965,499
2016,7,5,14,1621,1578,2044,466
2016,7,5,15,1794,1701,2136,435
2016,7,5,16,1913,1832,2224,392
2016,7,5,17,2040,1948,2214,266
2016,7,5,18,2141,2061,2203,142
2016,7,5,19,2241,2152,2254,102
2016,7,5,20,2336,2251,2377,126
2016,7,5,21,2395,2332,2425,93
2016,7,5,22,2455,2387,2465,78
2016,7,5,23,2481,2424,2523,99
2016,7,6,0,2449,2428,2558,130
2016,7,6,1,2390,2392,2519,127
2016,7,6,2,2292,2323,2407,84
2016,7,6,3,2269,2279,2327,48
2016,7,6,4,2202,2202,2316,114
2016,7,6,5,2017,1989,2155,166
2016,7,6,6,1826,1799,2059,260
2016,7,6,7,1687,1667,1987,320
2016,7,6,8,1582,1591,1929,338
2016,7,6,9,1528,1537,1881,344
2016,7,6,10,1494,1505,1882,377
2016,7,6,11,1482,1496,1876,380
2016,7,6,12,1521,1536,1884,348
2016,7,6,13,1563,1574,1878,304
2016,7,6,14,1676,1695,1940,245
2016,7,6,15,1787,1810,1965,155
2016,7,6,16,1905,1935,2089,154
2016,7,6,17,2028,2054,2081,27
2016,7,6,18,2142,2154,2142,-12
2016,7,6,19,2200,2238,2260,22
2016,7,6,20,2295,2323,2364,41
2016,7,6,21,2359,2385,2493,108
2016,7,6,22,2407,2446,2512,66
2016,7,6,23,2431,2488,2499,11
2016,7,7,0,2426,2493,2571,78
2016,7,7,1,2354,2452,2533,81
2016,7,7,2,2245,2377,2465,88
2016,7,7,3,2224,2335,2395,60
2016,7,7,4,2164,2257,2356,99
2016,7,7,5,1996,2047,2162,115
2016,7,7,6,1813,1822,2136,314
2016,7,7,7,1673,1679,1991,312
2016,7,7,8,1613,1585,1874,289
2016,7,7,9,1551,1531,1915,384
2016,7,7,10,1517,1494,1917,423
2016,7,7,11,1507,1495,1889,394
2016,7,7,12,1544,1531,1893,362
2016,7,7,13,1592,1565,1886,321
2016,7,7,14,1699,1700,1970,270
2016,7,7,15,1794,1815,1934,119
2016,7,7,16,1916,1939,1978,39
2016,7,7,17,2025,2059,2035,-24
2016,7,7,18,2123,2165,2176,11
2016,7,7,19,2195,2242,2199,-43
2016,7,7,20,2296,2330,2328,-2
2016,7,7,21,2348,2409,2384,-25
2016,7,7,22,2418,2470,2474,4
2016,7,7,23,2440,2498,2459,-39
2016,7,8,0,2410,2493,2359,-134
2016,7,8,1,2339,2413,2337,-76
2016,7,8,2,2258,2297,2363,66
2016,7,8,3,2229,2262,2322,60
2016,7,8,4,2165,2201,2285,84
2016,7,8,5,2009,2017,2177,160
2016,7,8,6,1818,1830,2124,294
2016,7,8,7,1669,1702,1934,232
2016,7,8,8,1596,1606,1882,276
2016,7,8,9,1532,1535,1953,418
2016,7,8,10,1493,1503,1963,460
2016,7,8,11,1488,1493,1923,430
2016,7,8,12,1518,1531,1926,395
2016,7,8,13,1556,1574,1880,306
2016,7,8,14,1675,1687,1872,185
2016,7,8,15,1794,1801,1858,57
2016,7,8,16,1908,1924,1955,31
2016,7,8,17,2024,2029,2129,100
2016,7,8,18,2129,2139,2296,157
2016,7,8,19,2216,2229,2442,213
2016,7,8,20,2308,2327,2451,124
2016,7,8,21,2360,2403,2554,151
2016,7,8,22,2409,2464,2644,180
2016,7,8,23,2437,2482,2640,158
2016,7,9,0,2405,2474,2566,92
2016,7,9,1,2355,2391,2545,154
2016,7,9,2,2258,2327,2358,31
2016,7,9,3,2230,2298,2347,49
2016,7,9,4,2177,2249,2338,89
2016,7,9,5,2035,2098,2142,44
2016,7,9,6,1857,1911,2056,145
2016,7,9,7,1722,1776,1962,186
2016,7,9,8,1665,1672,1950,278
2016,7,9,9,1590,1596,1881,285
2016,7,9,10,1545,1541,1776,235
2016,7,9,11,1522,1514,1724,210
2016,7,9,12,1512,1516,1753,237
2016,7,9,13,1492,1501,1717,216
2016,7,9,14,1581,1583,1753,170
2016,7,9,15,1712,1703,1754,51
2016,7,9,16,1854,1840,1859,19
2016,7,9,17,1981,1975,1980,5
2016,7,9,18,2091,2097,2148,51
2016,7,9,19,2178,2190,2274,84
2016,7,9,20,2261,2273,2323,50
2016,7,9,21,2330,2362,2350,-12
2016,7,9,22,2387,2413,2431,18
2016,7,9,23,2419,2452,2489,37
2016,7,10,0,2427,2462,2514,52
2016,7,10,1,2390,2435,2517,82
2016,7,10,2,2294,2362,2479,117
2016,7,10,3,2263,2310,2329,19
2016,7,10,4,2223,2231,2405,174
2016,7,10,5,2083,2056,2168,112
2016,7,10,6,1916,1860,2117,257
2016,7,10,7,1779,1727,1932,205
2016,7,10,8,1651,1621,1835,214
2016,7,10,9,1591,1551,1753,202
2016,7,10,10,1537,1494,1863,369
2016,7,10,11,1511,1471,1786,315
2016,7,10,12,1503,1454,1785,331
2016,7,10,13,1477,1437,1698,261
2016,7,10,14,1554,1508,1658,150
2016,7,10,15,1680,1639,1753,114
2016,7,10,16,1830,1788,1845,57
2016,7,10,17,1957,1917,2061,144
2016,7,10,18,2069,2038,2155,117
2016,7,10,19,2172,2139,2199,60
2016,7,10,20,2262,2241,2233,-8
2016,7,10,21,2333,2325,2282,-43
2016,7,10,22,2396,2398,2364,-34
2016,7,10,23,2436,2420,2372,-48
2016,7,11,0,2449,2464,2399,-65
2016,7,11,1,2416,2441,2393,-48
2016,7,11,2,2324,2367,2472,105
2016,7,11,3,2296,2333,2448,115
2016,7,11,4,2250,2272,2374,102
2016,7,11,5,2098,2085,2102,17
2016,7,11,6,1916,1872,1868,-4
2016,7,11,7,1780,1743,1823,80
2016,7,11,8,1657,1645,1799,154
2016,7,11,9,1593,1581,1728,147
2016,7,11,10,1553,1543,1665,122
2016,7,11,11,1545,1538,1699,161
2016,7,11,12,1578,1560,1725,165
2016,7,11,13,1621,1599,1744,145
2016,7,11,14,1746,1726,1786,60
2016,7,11,15,1859,1857,1874,17
2016,7,11,16,2000,1968,1987,19
2016,7,11,17,2129,2076,2097,21
2016,7,11,18,2229,2172,2039,-133
2016,7,11,19,2310,2252,2088,-164
2016,7,11,20,2409,2324,2181,-143
2016,7,11,21,2484,2400,2317,-83
2016,7,11,22,2550,2444,2429,-15
2016,7,11,23,2576,2472,2521,49
2016,7,12,0,2554,2495,2646,151
2016,7,12,1,2503,2464,2633,169
2016,7,12,2,2390,2388,2546,158
2016,7,12,3,2379,2337,2494,157
2016,7,12,4,2309,2257,2496,239
2016,7,12,5,2125,2046,2162,116
2016,7,12,6,1922,1839,2042,203
2016,7,12,7,1774,1709,1827,118
2016,7,12,8,1632,1618,1688,70
2016,7,12,9,1566,1547,1696,149
2016,7,12,10,1536,1487,1644,157
2016,7,12,11,1524,1473,1592,119
2016,7,12,12,1557,1510,1607,97
2016,7,12,13,1609,1538,1592,54
2016,7,12,14,1719,1646,1629,-17
2016,7,12,15,1829,1761,1707,-54
2016,7,12,16,2012,1869,1864,-5
2016,7,12,17,2152,1995,1912,-83
2016,7,12,18,2252,2110,1920,-190
2016,7,12,19,2348,2187,2038,-149
2016,7,12,20,2438,2275,2121,-154
2016,7,12,21,2507,2362,2248,-114
2016,7,12,22,2569,2425,2357,-68
2016,7,12,23,2625,2463,2433,-30
2016,7,13,0,2608,2482,2470,-12
2016,7,13,1,2568,2446,2376,-70
2016,7,13,2,2467,2374,2186,-188
2016,7,13,3,2438,2322,2120,-202
2016,7,13,4,2370,2216,2114,-102
2016,7,13,5,2160,2000,1959,-41
2016,7,13,6,1950,1802,1722,-80
2016,7,13,7,1796,1662,1628,-34
2016,7,13,8,1617,1569,1551,-18
2016,7,13,9,1548,1506,1563,57
2016,7,13,10,1511,1465,1535,70
2016,7,13,11,1498,1453,1544,91
2016,7,13,12,1532,1492,1578,86
2016,7,13,13,1573,1527,1587,60
2016,7,13,14,1689,1634,1610,-24
2016,7,13,15,1837,1740,1675,-65
2016,7,13,16,1961,1849,1884,35
2016,7,13,17,2085,1966,1879,-87
2016,7,13,18,2198,2091,1947,-144
2016,7,13,19,2296,2193,2055,-138
2016,7,13,20,2392,2303,2071,-232
2016,7,13,21,2466,2394,2217,-177
2016,7,13,22,2559,2479,2291,-188
2016,7,13,23,2597,2522,2317,-205
2016,7,14,0,2591,2534,2337,-197
2016,7,14,1,2552,2467,2375,-92
2016,7,14,2,2439,2399,2303,-96
2016,7,14,3,2399,2358,2255,-103
2016,7,14,4,2314,2262,2231,-31
2016,7,14,5,2128,2050,2055,5
2016,7,14,6,1914,1832,1974,142
2016,7,14,7,1765,1691,1842,151
2016,7,14,8,1641,1596,1719,123
2016,7,14,9,1562,1527,1638,111
2016,7,14,10,1522,1486,1620,134
2016,7,14,11,1511,1472,1614,142
2016,7,14,12,1545,1516,1597,81
2016,7,14,13,1579,1557,1602,45
2016,7,14,14,1685,1669,1589,-80
2016,7,14,15,1797,1776,1641,-135
2016,7,14,16,1925,1891,1731,-160
2016,7,14,17,2052,2025,1820,-205
2016,7,14,18,2165,2252,1875,-377
2016,7,14,19,2271,2308,2119,-189
2016,7,14,20,2354,2369,2203,-166
2016,7,14,21,2434,2453,2295,-158
2016,7,14,22,2489,2529,2295,-234
2016,7,14,23,2536,2581,2313,-268
2016,7,15,0,2543,2568,2284,-284
2016,7,15,1,2484,2520,2298,-222
2016,7,15,2,2398,2437,2299,-138
2016,7,15,3,2361,2380,2233,-147
2016,7,15,4,2289,2285,2154,-131
2016,7,15,5,2098,2082,1966,-116
2016,7,15,6,1893,1914,1905,-9
2016,7,15,7,1744,1783,1819,36
2016,7,15,8,1684,1696,1723,27
2016,7,15,9,1590,1641,1647,6
2016,7,15,10,1546,1613,1529,-84
2016,7,15,11,1538,1617,1424,-193
2016,7,15,12,1565,1652,1449,-203
2016,7,15,13,1595,1698,1442,-256
2016,7,15,14,1706,1809,1457,-352
2016,7,15,15,1820,1920,1495,-425
2016,7,15,16,1944,2044,1641,-403
2016,7,15,17,2042,2163,1679,-484
2016,7,15,18,2147,2250,1778,-472
2016,7,15,19,2236,2342,1865,-477
2016,7,15,20,2321,2425,1879,-546
2016,7,15,21,2402,2484,1862,-622
2016,7,15,22,2492,2502,1973,-529
2016,7,15,23,2534,2518,2020,-498
2016,7,16,0,2531,2496,1949,-547
2016,7,16,1,2458,2427,1953,-474
2016,7,16,2,2361,2328,1889,-439
2016,7,16,3,2319,2316,1800,-516
2016,7,16,4,2267,2245,1829,-416
2016,7,16,5,2095,2084,1796,-288
2016,7,16,6,1900,1909,1703,-206
2016,7,16,7,1759,1771,1690,-81
2016,7,16,8,1676,1673,1646,-27
2016,7,16,9,1605,1607,1592,-15
2016,7,16,10,1558,1561,1535,-26
2016,7,16,11,1534,1539,1560,21
2016,7,16,12,1531,1535,1581,46
2016,7,16,13,1529,1515,1545,30
2016,7,16,14,1599,1603,1536,-67
2016,7,16,15,1704,1731,1557,-174
2016,7,16,16,1837,1859,1694,-165
2016,7,16,17,1962,1986,1863,-123
2016,7,16,18,2110,2097,1977,-120
2016,7,16,19,2193,2193,1984,-209
2016,7,16,20,2271,2284,2043,-241
2016,7,16,21,2349,2366,2082,-284
2016,7,16,22,2413,2429,2185,-244
2016,7,16,23,2451,2457,2222,-235
2016,7,17,0,2461,2439,2224,-215
2016,7,17,1,2431,2381,2271,-110
2016,7,17,2,2357,2278,2251,-27
2016,7,17,3,2324,2251,2201,-50
2016,7,17,4,2270,2202,2216,14
2016,7,17,5,2127,2060,2096,36
2016,7,17,6,1943,1899,2054,155
2016,7,17,7,1798,1783,1980,197
2016,7,17,8,1686,1698,1984,286
2016,7,17,9,1613,1634,1992,358
2016,7,17,10,1565,1596,1965,369
2016,7,17,11,1537,1566,1933,367
2016,7,17,12,1518,1562,1931,369
2016,7,17,13,1485,1537,1840,303
2016,7,17,14,1551,1599,1861,262
2016,7,17,15,1669,1734,1885,151
2016,7,17,16,1806,1879,2030,151
2016,7,17,17,1933,2038,2084,46
2016,7,17,18,2077,2163,2149,-14
2016,7,17,19,2171,2269,2235,-34
2016,7,17,20,2257,2345,2224,-121
2016,7,17,21,2333,2382,2410,28
2016,7,17,22,2394,2412,2529,117
2016,7,17,23,2435,2403,2538,135
2016,7,18,0,2458,2349,2666,317
2016,7,18,1,2432,2273,2573,300
2016,7,18,2,2359,2206,2466,260
2016,7,18,3,2308,2209,2355,146
2016,7,18,4,2239,2160,2324,164
2016,7,18,5,2085,1988,2150,162
2016,7,18,6,1903,1811,2075,264
2016,7,18,7,1767,1688,1956,268
2016,7,18,8,1642,1617,1946,329
2016,7,18,9,1584,1569,2037,468
2016,7,18,10,1557,1553,2012,459
2016,7,18,11,1556,1565,1995,430
2016,7,18,12,1589,1613,1976,363
2016,7,18,13,1644,1651,1957,306
2016,7,18,14,1745,1771,1972,201
2016,7,18,15,1862,1882,2002,120
2016,7,18,16,1983,2013,2059,46
2016,7,18,17,2120,2140,2224,84
2016,7,18,18,2255,2256,2322,66
2016,7,18,19,2340,2358,2457,99
2016,7,18,20,2441,2458,2635,177
2016,7,18,21,2521,2524,2685,161
2016,7,18,22,2571,2572,2762,190
2016,7,18,23,2596,2568,2683,115
2016,7,19,0,2593,2483,2659,176
2016,7,19,1,2541,2364,2518,154
2016,7,19,2,2453,2268,2402,134
2016,7,19,3,2392,2265,2391,126
2016,7,19,4,2322,2199,2353,154
2016,7,19,5,2138,2020,2158,138
2016,7,19,6,1935,1838,2223,385
2016,7,19,7,1772,1720,2115,395
2016,7,19,8,1645,1645,2041,396
2016,7,19,9,1588,1592,2017,425
2016,7,19,10,1579,1556,1959,403
2016,7,19,11,1570,1559,1919,360
2016,7,19,12,1608,1608,1909,301
2016,7,19,13,1664,1653,1984,331
2016,7,19,14,1761,1757,2016,259
2016,7,19,15,1859,1874,2092,218
2016,7,19,16,1980,1985,2076,91
2016,7,19,17,2108,2112,2230,118
2016,7,19,18,2221,2237,2317,80
2016,7,19,19,2297,2321,2323,2
2016,7,19,20,2388,2371,2357,-14
2016,7,19,21,2467,2437,2336,-101
2016,7,19,22,2514,2483,2393,-90
2016,7,19,23,2526,2464,2457,-7
2016,7,20,0,2479,2456,2489,33
2016,7,20,1,2401,2415,2477,62
2016,7,20,2,2331,2303,2514,211
2016,7,20,3,2302,2257,2511,254
2016,7,20,4,2226,2182,2447,265
2016,7,20,5,2066,2013,2297,284
2016,7,20,6,1860,1828,2306,478
2016,7,20,7,1719,1701,2193,492
2016,7,20,8,1663,1628,2051,423
2016,7,20,9,1595,1588,1962,374
2016,7,20,10,1569,1550,1838,288
2016,7,20,11,1566,1543,1764,221
2016,7,20,12,1601,1581,1636,55
2016,7,20,13,1655,1630,1675,45
2016,7,20,14,1751,1729,1725,-4
2016,7,20,15,1858,1840,1784,-56
2016,7,20,16,1985,1964,1860,-104
2016,7,20,17,2113,2083,2034,-49
2016,7,20,18,2222,2199,2176,-23
2016,7,20,19,2302,2277,2347,70
2016,7,20,20,2389,2358,2424,66
2016,7,20,21,2475,2420,2563,143
2016,7,20,22,2525,2468,2584,116
2016,7,20,23,2525,2499,2582,83
2016,7,21,0,2490,2467,2492,25
2016,7,21,1,2425,2413,2525,112
2016,7,21,2,2344,2312,2409,97
2016,7,21,3,2303,2293,2362,69
2016,7,21,4,2239,2232,2347,115
2016,7,21,5,2059,2036,2158,122
2016,7,21,6,1867,1856,2157,301
2016,7,21,7,1729,1723,2153,430
2016,7,21,8,1660,1642,1993,351
2016,7,21,9,1595,1594,1973,379
2016,7,21,10,1568,1563,1984,421
2016,7,21,11,1567,1554,1936,382
2016,7,21,12,1602,1600,1915,315
2016,7,21,13,1655,1648,1951,303
2016,7,21,14,1741,1743,2087,344
2016,7,21,15,1858,1867,2140,273
2016,7,21,16,1971,1985,2231,246
2016,7,21,17,2098,2113,2376,263
2016,7,21,18,2226,2220,2429,209
2016,7,21,19,2311,2327,2611,284
2016,7,21,20,2390,2413,2654,241
2016,7,21,21,2462,2472,2843,371
2016,7,21,22,2517,2530,2930,400
2016,7,21,23,2526,2564,3005,441
2016,7,22,0,2492,2552,2990,438
2016,7,22,1,2429,2496,2958,462
2016,7,22,2,2351,2397,2773,376
2016,7,22,3,2298,2381,2696,315
2016,7,22,4,2241,2298,2661,363
2016,7,22,5,2092,2100,2543,443
2016,7,22,6,1907,1905,2293,388
2016,7,22,7,1762,1770,2108,338
2016,7,22,8,1703,1680,2006,326
2016,7,22,9,1640,1620,1992,372
2016,7,22,10,1607,1572,1981,409
2016,7,22,11,1598,1557,1927,370
2016,7,22,12,1631,1598,1903,305
2016,7,22,13,1673,1643,1933,290
2016,7,22,14,1774,1742,2065,323
2016,7,22,15,1891,1863,2161,298
2016,7,22,16,2023,1995,2162,167
2016,7,22,17,2156,2128,2366,238
2016,7,22,18,2281,2243,2490,247
2016,7,22,19,2368,2351,2551,200
2016,7,22,20,2454,2453,2632,179
2016,7,22,21,2527,2524,2745,221
2016,7,22,22,2569,2583,2816,233
2016,7,22,23,2604,2608,2815,207
2016,7,23,0,2545,2579,2782,203
2016,7,23,1,2476,2519,2759,240
2016,7,23,2,2376,2435,2688,253
2016,7,23,3,2347,2417,2635,218
2016,7,23,4,2291,2329,2554,225
2016,7,23,5,2131,2155,2312,157
2016,7,23,6,1946,1981,2308,327
2016,7,23,7,1801,1850,2199,349
2016,7,23,8,1777,1744,2105,361
2016,7,23,9,1709,1679,2057,378
2016,7,23,10,1655,1637,2066,429
2016,7,23,11,1624,1611,2050,439
2016,7,23,12,1617,1602,2035,433
2016,7,23,13,1605,1589,2019,430
2016,7,23,14,1665,1659,2072,413
2016,7,23,15,1804,1807,2193,386
2016,7,23,16,1911,1961,2318,357
2016,7,23,17,2049,2085,2323,238
2016,7,23,18,2177,2214,2468,254
2016,7,23,19,2277,2311,2537,226
2016,7,23,20,2359,2386,2593,207
2016,7,23,21,2414,2455,2597,142
2016,7,23,22,2448,2511,2682,171
2016,7,23,23,2463,2550,2705,155
2016,7,24,0,2446,2543,2728,185
2016,7,24,1,2392,2519,2661,142
2016,7,24,2,2312,2439,2631,192
2016,7,24,3,2286,2398,2608,210
2016,7,24,4,2233,2312,2503,191
2016,7,24,5,2100,2140,2423,283
2016,7,24,6,1940,1982,2357,375
2016,7,24,7,1801,1850,2287,437
2016,7,24,8,1765,1737,2139,402
2016,7,24,9,1700,1679,2086,407
2016,7,24,10,1642,1627,2034,407
2016,7,24,11,1611,1605,2006,401
2016,7,24,12,1600,1601,2032,431
2016,7,24,13,1579,1589,2015,426
2016,7,24,14,1630,1631,2072,441
2016,7,24,15,1708,1746,2175,429
2016,7,24,16,1854,1905,2195,290
2016,7,24,17,1993,2050,2330,280
2016,7,24,18,2122,2172,2449,277
2016,7,24,19,2232,2271,2546,275
2016,7,24,20,2322,2363,2619,256
2016,7,24,21,2387,2427,2736,309
2016,7,24,22,2432,2425,2759,334
2016,7,24,23,2447,2405,2727,322
2016,7,25,0,2433,2336,2784,448
2016,7,25,1,2377,2243,2753,510
2016,7,25,2,2296,2142,2660,518
2016,7,25,3,2266,2135,2650,515
2016,7,25,4,2213,2075,2596,521
2016,7,25,5,2064,1923,2463,540
2016,7,25,6,1891,1767,2312,545
2016,7,25,7,1761,1660,2095,435
2016,7,25,8,1644,1593,2024,431
2016,7,25,9,1602,1559,1961,402
2016,7,25,10,1567,1533,1952,419
2016,7,25,11,1566,1546,2068,522
2016,7,25,12,1612,1580,2034,454
2016,7,25,13,1677,1645,2063,418
2016,7,25,14,1765,1762,2126,364
2016,7,25,15,1876,1893,2183,290
2016,7,25,16,2001,2185,2471,286
2016,7,25,17,2127,2128,2401,273
2016,7,25,18,2230,2235,2514,279
2016,7,25,19,2311,2349,2620,271
2016,7,25,20,2390,2441,2775,334
2016,7,25,21,2440,2509,2816,307
2016,7,25,22,2480,2543,2847,304
2016,7,25,23,2477,2512,2882,370
2016,7,26,0,2426,2439,2771,332
2016,7,26,1,2360,2294,2719,425
2016,7,26,2,2296,2212,2616,404
2016,7,26,3,2277,2227,2555,328
2016,7,26,4,2206,2153,2559,406
2016,7,26,5,2050,1981,2390,409
2016,7,26,6,1868,1824,2338,514
2016,7,26,7,1734,1706,2272,566
2016,7,26,8,1652,1626,2268,642
2016,7,26,9,1600,1578,2210,632
2016,7,26,10,1571,1558,2192,634
2016,7,26,11,1563,1556,2182,626
2016,7,26,12,1605,1615,2196,581
2016,7,26,13,1667,1669,2226,557
2016,7,26,14,1755,1754,2189,435
2016,7,26,15,1860,1839,2259,420
2016,7,26,16,1981,1948,2314,366
2016,7,26,17,2095,2038,2363,325
2016,7,26,18,2200,2154,2434,280
2016,7,26,19,2292,2246,2541,295
2016,7,26,20,2372,2300,2587,287
2016,7,26,21,2428,2404,2709,305
2016,7,26,22,2477,2460,2767,307
2016,7,26,23,2473,2482,2791,309
2016,7,27,0,2433,2442,2799,357
2016,7,27,1,2370,2376,2739,363
2016,7,27,2,2301,2301,2582,281
2016,7,27,3,2278,2295,2501,206
2016,7,27,4,2213,2217,2393,176
2016,7,27,5,2048,2037,2225,188
2016,7,27,6,1862,1855,2256,401
2016,7,27,7,1727,1734,2281,547
2016,7,27,8,1685,1661,2222,561
2016,7,27,9,1621,1611,2160,549
2016,7,27,10,1583,1569,2150,581
2016,7,27,11,1578,1570,2129,559
2016,7,27,12,1619,1604,2166,562
2016,7,27,13,1681,1650,2181,531
2016,7,27,14,1767,1745,2199,454
2016,7,27,15,1852,1853,2281,428
2016,7,27,16,1968,1979,2353,374
2016,7,27,17,2076,2073,2445,372
2016,7,27,18,2183,2171,2518,347
2016,7,27,19,2273,2325,2611,286
2016,7,27,20,2371,2374,2693,319
2016,7,27,21,2428,2438,2837,399
2016,7,27,22,2473,2488,2802,314
2016,7,27,23,2482,2527,2853,326
2016,7,28,0,2466,2517,2846,329
2016,7,28,1,2394,2405,2735,330
2016,7,28,2,2321,2316,2663,347
2016,7,28,3,2298,2299,2576,277
2016,7,28,4,2229,2226,2595,369
2016,7,28,5,2064,2062,2357,295
2016,7,28,6,1866,1884,2297,413
2016,7,28,7,1727,1722,2257,535
2016,7,28,8,1671,1637,2212,575
2016,7,28,9,1625,1575,2208,633
2016,7,28,10,1584,1540,2184,644
2016,7,28,11,1573,1545,2154,609
2016,7,28,12,1608,1595,2164,569
2016,7,28,13,1661,1637,2215,578
2016,7,28,14,1741,1737,2213,476
2016,7,28,15,1850,1847,2302,455
2016,7,28,16,1965,1973,2428,455
2016,7,28,17,2083,2100,2399,299
2016,7,28,18,2202,2210,2478,268
2016,7,28,19,2299,2319,2615,296
2016,7,28,20,2359,2429,2660,231
2016,7,28,21,2456,2499,2737,238
2016,7,28,22,2516,2552,2792,240
2016,7,28,23,2521,2569,2773,204
2016,7,29,0,2497,2537,2766,229
2016,7,29,1,2430,2434,2657,223
2016,7,29,2,2341,2358,2572,214
2016,7,29,3,2320,2348,2581,233
2016,7,29,4,2252,2265,2575,310
2016,7,29,5,2100,2082,2506,424
2016,7,29,6,1911,1882,2450,568
2016,7,29,7,1772,1752,2279,527
2016,7,29,8,1682,1650,2278,628
2016,7,29,9,1615,1589,2254,665
2016,7,29,10,1568,1550,2252,702
2016,7,29,11,1570,1543,2249,706
2016,7,29,12,1612,1599,2226,627
2016,7,29,13,1658,1655,2215,560
2016,7,29,14,1746,1744,2147,403
2016,7,29,15,1863,1859,2217,358
2016,7,29,16,1986,1997,2245,248
2016,7,29,17,2125,2121,2331,210
2016,7,29,18,2236,2227,2400,173
2016,7,29,19,2346,2309,2440,131
2016,7,29,20,2430,2388,2480,92
2016,7,29,21,2493,2421,2534,113
2016,7,29,22,2531,2370,2590,220
2016,7,29,23,2524,2355,2737,382
2016,7,30,0,2476,2219,2705,486
2016,7,30,1,2386,1991,2498,507
2016,7,30,2,2292,1919,2395,476
2016,7,30,3,2263,1976,2332,356
2016,7,30,4,2210,1954,2320,366
2016,7,30,5,2083,1812,2222,410
2016,7,30,6,1920,1682,2319,637
2016,7,30,7,1781,1588,2253,665
2016,7,30,8,1592,1517,2207,690
2016,7,30,9,1549,1486,2202,716
2016,7,30,10,1491,1459,2114,655
2016,7,30,11,1485,1453,2125,672
2016,7,30,12,1480,1478,2167,689
2016,7,30,13,1474,1472,2165,693
2016,7,30,14,1535,1539,2101,562
2016,7,30,15,1737,1645,2180,535
2016,7,30,16,1871,1753,2258,505
2016,7,30,17,2000,1868,2325,457
2016,7,30,18,2116,1968,2375,407
2016,7,30,19,2220,2054,2407,353
2016,7,30,20,2300,2132,2452,320
2016,7,30,21,2374,2206,2479,273
2016,7,30,22,2418,2247,2569,322
2016,7,30,23,2428,2284,2680,396
2016,7,31,0,2405,2263,2713,450
2016,7,31,1,2327,2220,2658,438
2016,7,31,2,2254,2147,2572,425
2016,7,31,3,2223,2074,2440,366
2016,7,31,4,2164,1955,2431,476
2016,7,31,5,2046,1816,2250,434
2016,7,31,6,1898,1690,2260,570
2016,7,31,7,1768,1585,2215,630
2016,7,31,8,1607,1522,2125,603
2016,7,31,9,1545,1478,2106,628
2016,7,31,10,1463,1449,2101,652
2016,7,31,11,1449,1425,2078,653
2016,7,31,12,1449,1450,2090,640
2016,7,31,13,1439,1430,2120,690
2016,7,31,14,1477,1491,2124,633
2016,7,31,15,1669,1585,2165,580
2016,7,31,16,1805,1709,2299,590
2016,7,31,17,1930,1820,2387,567
2016,7,31,18,2047,1925,2418,493
2016,7,31,19,2152,2010,2570,560
2016,7,31,20,2232,2085,2622,537
2016,7,31,21,2302,2154,2630,476
2016,7,31,22,2355,2193,2658,465
2016,7,31,23,2386,2239,2657,418
2016,8,1,0,2381,2234,2632,398
2016,8,1,1,2313,2201,2670,469
2016,8,1,2,2253,2133,2427,294
2016,8,1,3,2226,2147,2173,26
2016,8,1,4,2178,2068,2148,80
2016,8,1,5,2047,1907,1986,79
2016,8,1,6,1878,1744,1727,-17
2016,8,1,7,1745,1635,1646,11
2016,8,1,8,1600,1556,1616,60
2016,8,1,9,1547,1520,1639,119
2016,8,1,10,1509,1493,1721,228
2016,8,1,11,1513,1500,1765,265
2016,8,1,12,1561,1547,1888,341
2016,8,1,13,1624,1600,1885,285
2016,8,1,14,1709,1690,1846,156
2016,8,1,15,1861,1795,1909,114
2016,8,1,16,1993,1915,2043,128
2016,8,1,17,2105,2025,2139,114
2016,8,1,18,2220,2120,2173,53
2016,8,1,19,2323,2205,2343,138
2016,8,1,20,2398,2275,2422,147
2016,8,1,21,2461,2332,2496,164
2016,8,1,22,2488,2370,2519,149
2016,8,1,23,2490,2403,2685,282
2016,8,2,0,2428,2341,2584,243
2016,8,2,1,2350,2209,2472,263
2016,8,2,2,2288,2134,2384,250
2016,8,2,3,2274,2155,2382,227
2016,8,2,4,2214,2105,2252,147
2016,8,2,5,2046,1942,1974,32
2016,8,2,6,1859,1768,1833,65
2016,8,2,7,1729,1637,1834,197
2016,8,2,8,1609,1571,1697,126
2016,8,2,9,1556,1528,1665,137
2016,8,2,10,1539,1497,1657,160
2016,8,2,11,1525,1499,1644,145
2016,8,2,12,1576,1548,1679,131
2016,8,2,13,1642,1611,1727,116
2016,8,2,14,1731,1679,1765,86
2016,8,2,15,1820,1760,1803,43
2016,8,2,16,1922,1866,1833,-33
2016,8,2,17,2026,1967,1982,15
2016,8,2,18,2116,2047,2136,89
2016,8,2,19,2207,2126,2288,162
2016,8,2,20,2281,2224,2299,75
2016,8,2,21,2335,2296,2427,131
2016,8,2,22,2353,2338,2505,167
2016,8,2,23,2359,2307,2487,180
2016,8,3,0,2299,2277,2393,116
2016,8,3,1,2217,2208,2317,109
2016,8,3,2,2159,2141,2266,125
2016,8,3,3,2154,2171,2293,122
2016,8,3,4,2089,2095,2243,148
2016,8,3,5,1939,1919,1880,-39
2016,8,3,6,1774,1760,1917,157
2016,8,3,7,1646,1645,1983,338
2016,8,3,8,1595,1570,1875,305
2016,8,3,9,1543,1526,1817,291
2016,8,3,10,1510,1505,1740,235
2016,8,3,11,1530,1504,1731,227
2016,8,3,12,1573,1560,1751,191
2016,8,3,13,1635,1642,1762,120
2016,8,3,14,1715,1703,1831,128
2016,8,3,15,1809,1794,1850,56
2016,8,3,16,1907,1892,2000,108
2016,8,3,17,2010,1994,2126,132
2016,8,3,18,2091,2089,2228,139
2016,8,3,19,2167,2172,2348,176
2016,8,3,20,2236,2240,2397,157
2016,8,3,21,2302,2314,2516,202
2016,8,3,22,2329,2344,2569,225
2016,8,3,23,2340,2336,2566,230
2016,8,4,0,2299,2243,2485,242
2016,8,4,1,2196,2150,2411,261
2016,8,4,2,2144,2113,2301,188
2016,8,4,3,2136,2169,2304,135
2016,8,4,4,2088,2083,2306,223
2016,8,4,5,1933,1920,2078,158
2016,8,4,6,1768,1764,2040,276
2016,8,4,7,1643,1639,1940,301
2016,8,4,8,1584,1569,1857,288
2016,8,4,9,1532,1524,1821,297
2016,8,4,10,1497,1504,1794,290
2016,8,4,11,1499,1509,1834,325
2016,8,4,12,1534,1558,1836,278
2016,8,4,13,1595,1625,1914,289
2016,8,4,14,1687,1710,1948,238
2016,8,4,15,1776,1807,2017,210
2016,8,4,16,1891,1915,2090,175
2016,8,4,17,1999,2026,2105,79
2016,8,4,18,2080,2118,2272,154
2016,8,4,19,2165,2172,2510,338
2016,8,4,20,2229,2255,2507,252
2016,8,4,21,2291,2335,2604,269
2016,8,4,22,2329,2386,2693,307
2016,8,4,23,2316,2351,2717,366
2016,8,5,0,2265,2314,2669,355
2016,8,5,1,2182,2210,2579,369
2016,8,5,2,2120,2136,2467,331
2016,8,5,3,2119,2117,2392,275
2016,8,5,4,2067,2015,2377,362
2016,8,5,5,1921,1852,2185,333
2016,8,5,6,1758,1707,2174,467
2016,8,5,7,1639,1600,2117,517
2016,8,5,8,1558,1539,1942,403
2016,8,5,9,1517,1493,1943,450
2016,8,5,10,1486,1475,1925,450
2016,8,5,11,1500,1477,1897,420
2016,8,5,12,1549,1547,1916,369
2016,8,5,13,1620,1613,1896,283
2016,8,5,14,1696,1686,1889,203
2016,8,5,15,1791,1775,2021,246
2016,8,5,16,1890,1875,2129,254
2016,8,5,17,1997,1993,2250,257
2016,8,5,18,2085,2082,2326,244
2016,8,5,19,2153,2145,2396,251
2016,8,5,20,2218,2229,2525,296
2016,8,5,21,2291,2272,2653,381
2016,8,5,22,2319,2239,2661,422
2016,8,5,23,2317,2185,2613,428
2016,8,6,0,2250,2115,2575,460
2016,8,6,1,2166,2028,2477,449
2016,8,6,2,2108,1983,2380,397
2016,8,6,3,2115,2006,1992,-14
2016,8,6,4,2057,1918,2127,209
2016,8,6,5,1935,1804,1920,116
2016,8,6,6,1793,1670,1867,197
2016,8,6,7,1661,1576,1628,52
2016,8,6,8,1591,1518,1376,-142
2016,8,6,9,1534,1469,1375,-94
2016,8,6,10,1502,1438,1290,-148
2016,8,6,11,1451,1431,1194,-237
2016,8,6,12,1459,1448,1160,-288
2016,8,6,13,1461,1461,1182,-279
2016,8,6,14,1514,1522,1290,-232
2016,8,6,15,1645,1624,1287,-337
2016,8,6,16,1770,1714,1524,-190
2016,8,6,17,1877,1788,1701,-87
2016,8,6,18,1974,1873,1808,-65
2016,8,6,19,2050,1956,2000,44
2016,8,6,20,2125,2013,1954,-59
2016,8,6,21,2205,2098,1997,-101
2016,8,6,22,2248,2141,2066,-75
2016,8,6,23,2250,2096,2095,-1
2016,8,7,0,2223,1988,2145,157
2016,8,7,1,2151,1916,2113,197
2016,8,7,2,2092,1863,2042,179
2016,8,7,3,2067,1870,2073,203
2016,8,7,4,2018,1816,1996,180
2016,8,7,5,1914,1712,1912,200
2016,8,7,6,1781,1595,1818,223
2016,8,7,7,1660,1500,1693,193
2016,8,7,8,1485,1449,1444,-5
2016,8,7,9,1442,1411,1418,7
2016,8,7,10,1415,1388,1428,40
2016,8,7,11,1399,1391,1435,44
2016,8,7,12,1410,1399,1438,39
2016,8,7,13,1397,1393,1445,52
2016,8,7,14,1441,1424,1487,63
2016,8,7,15,1544,1512,1521,9
2016,8,7,16,1665,1618,1617,-1
2016,8,7,17,1845,1715,1695,-20
2016,8,7,18,1954,1808,1889,81
2016,8,7,19,2050,1888,2099,211
2016,8,7,20,2125,1971,2208,237
2016,8,7,21,2207,2047,2397,350
2016,8,7,22,2254,2111,2465,354
2016,8,7,23,2268,2157,2590,433
2016,8,8,0,2262,2179,2571,392
2016,8,8,1,2193,2135,2545,410
2016,8,8,2,2133,1851,2276,425
2016,8,8,3,2111,1639,1944,305
2016,8,8,4,2064,1833,2148,315
2016,8,8,5,1928,1730,2073,343
2016,8,8,6,1775,1600,2035,435
2016,8,8,7,1656,1506,1998,492
2016,8,8,8,1503,1445,1892,447
2016,8,8,9,1460,1408,1870,462
2016,8,8,10,1443,1382,1858,476
2016,8,8,11,1453,1394,1834,440
2016,8,8,12,1499,1448,1859,411
2016,8,8,13,1570,1514,1857,343
2016,8,8,14,1644,1603,1942,339
2016,8,8,15,1794,1698,2026,328
2016,8,8,16,1902,1794,2085,291
2016,8,8,17,2017,1906,2105,199
2016,8,8,18,2112,2004,2309,305
2016,8,8,19,2207,2056,2498,442
2016,8,8,20,2279,2184,2619,435
2016,8,8,21,2359,2272,2820,548
2016,8,8,22,2393,2309,2812,503
2016,8,8,23,2394,2246,2768,522
2016,8,9,0,2346,2140,2744,604
2016,8,9,1,2260,2084,2773,689
2016,8,9,2,2184,2031,2553,522
2016,8,9,3,2167,2067,2571,504
2016,8,9,4,2086,2013,2526,513
2016,8,9,5,1927,1844,2300,456
2016,8,9,6,1763,1675,2205,530
2016,8,9,7,1648,1560,2083,523
2016,8,9,8,1517,1489,1798,309
2016,8,9,9,1464,1444,1755,311
2016,8,9,10,1460,1427,1775,348
2016,8,9,11,1458,1431,1748,317
2016,8,9,12,1512,1481,1733,252
2016,8,9,13,1579,1550,1746,196
2016,8,9,14,1660,1639,1801,162
2016,8,9,15,1783,1729,1818,89
2016,8,9,16,1918,1820,1852,32
2016,8,9,17,2034,1923,2055,132
2016,8,9,18,2148,2006,2151,145
2016,8,9,19,2247,2105,2331,226
2016,8,9,20,2320,2197,2299,102
2016,8,9,21,2399,2256,2437,181
2016,8,9,22,2435,2292,2465,173
2016,8,9,23,2443,2263,2457,194
2016,8,10,0,2371,2299,2602,303
2016,8,10,1,2299,2239,2566,327
2016,8,10,2,2229,2144,2531,387
2016,8,10,3,2204,2175,2475,300
2016,8,10,4,2141,2089,2417,328
2016,8,10,5,1980,1920,2185,265
2016,8,10,6,1796,1753,2076,323
2016,8,10,7,1677,1646,1969,323
2016,8,10,8,1596,1577,1975,398
2016,8,10,9,1548,1527,1940,413
2016,8,10,10,1516,1490,1905,415
2016,8,10,11,1520,1498,1882,384
2016,8,10,12,1568,1550,1922,372
2016,8,10,13,1639,1620,2017,397
2016,8,10,14,1708,1669,2027,358
2016,8,10,15,1801,1725,2030,305
2016,8,10,16,1900,1816,2087,271
2016,8,10,17,1986,1900,2228,328
2016,8,10,18,2073,1978,2330,352
2016,8,10,19,2136,2042,2373,331
2016,8,10,20,2213,2132,2468,336
2016,8,10,21,2276,2206,2532,326
2016,8,10,22,2293,2269,2525,256
2016,8,10,23,2297,2291,2523,232
2016,8,11,0,2221,2251,2487,236
2016,8,11,1,2135,2207,2507,300
2016,8,11,2,2098,2126,2460,334
2016,8,11,3,2102,2168,2520,352
2016,8,11,4,2039,2093,2462,369
2016,8,11,5,1900,1916,2291,375
2016,8,11,6,1747,1750,2211,461
2016,8,11,7,1631,1632,2194,562
2016,8,11,8,1571,1560,2120,560
2016,8,11,9,1524,1525,2140,615
2016,8,11,10,1499,1499,2125,626
2016,8,11,11,1504,1509,2086,577
2016,8,11,12,1546,1566,2118,552
2016,8,11,13,1620,1668,2164,496
2016,8,11,14,1697,1726,2123,397
2016,8,11,15,1779,1799,2112,313
2016,8,11,16,1874,1893,2152,259
2016,8,11,17,1980,1984,2184,200
2016,8,11,18,2072,2064,2265,201
2016,8,11,19,2159,2127,2365,238
2016,8,11,20,2251,2211,2410,199
2016,8,11,21,2338,2281,2503,222
2016,8,11,22,2388,2324,2535,211
2016,8,11,23,2406,2340,2536,196
2016,8,12,0,2357,2296,2507,211
2016,8,12,1,2279,2243,2474,231
2016,8,12,2,2196,2174,2466,292
2016,8,12,3,2201,2190,2406,216
2016,8,12,4,2120,2089,2337,248
2016,8,12,5,1963,1919,2080,161
2016,8,12,6,1793,1754,2016,262
2016,8,12,7,1670,1614,2008,394
2016,8,12,8,1592,1533,1979,446
2016,8,12,9,1541,1497,2000,503
2016,8,12,10,1510,1461,1972,511
2016,8,12,11,1514,1460,1975,515
2016,8,12,12,1553,1509,1984,475
2016,8,12,13,1618,1578,2026,448
2016,8,12,14,1683,1649,2026,377
2016,8,12,15,1773,1739,2110,371
2016,8,12,16,1875,1829,2249,420
2016,8,12,17,1982,1927,2351,424
2016,8,12,18,2091,2033,2444,411
2016,8,12,19,2181,2115,2477,362
2016,8,12,20,2271,2194,2479,285
2016,8,12,21,2351,2264,2535,271
2016,8,12,22,2398,2324,2539,215
2016,8,12,23,2398,2352,2614,262
2016,8,13,0,2316,2337,2603,266
2016,8,13,1,2252,2267,2563,296
2016,8,13,2,2170,2176,2575,399
2016,8,13,3,2152,2184,2589,405
2016,8,13,4,2077,2096,2508,412
2016,8,13,5,1943,1936,2277,341
2016,8,13,6,1795,1766,2192,426
2016,8,13,7,1667,1636,2104,468
2016,8,13,8,1610,1567,1846,279
2016,8,13,9,1556,1514,1844,330
2016,8,13,10,1507,1471,1835,364
2016,8,13,11,1504,1454,1781,327
2016,8,13,12,1510,1468,1792,324
2016,8,13,13,1512,1481,1759,278
2016,8,13,14,1555,1517,1731,214
2016,8,13,15,1640,1622,1808,186
2016,8,13,16,1741,1741,1874,133
2016,8,13,17,1835,1845,1918,73
2016,8,13,18,1914,1926,2069,143
2016,8,13,19,1980,2008,2158,150
2016,8,13,20,2045,2065,2243,178
2016,8,13,21,2104,2089,2330,241
2016,8,13,22,2133,2052,2308,256
2016,8,13,23,2125,1980,2343,363
2016,8,14,0,2086,1918,2265,347
2016,8,14,1,2025,1852,2140,288
2016,8,14,2,1976,1814,2187,373
2016,8,14,3,1977,1850,2175,325
2016,8,14,4,1932,1787,2155,368
2016,8,14,5,1839,1678,1961,283
2016,8,14,6,1718,1573,1943,370
2016,8,14,7,1602,1475,1898,423
2016,8,14,8,1526,1413,1700,287
2016,8,14,9,1451,1377,1682,305
2016,8,14,10,1420,1355,1691,336
2016,8,14,11,1405,1341,1675,334
2016,8,14,12,1405,1353,1646,293
2016,8,14,13,1397,1367,1668,301
2016,8,14,14,1461,1387,1682,295
2016,8,14,15,1548,1462,1696,234
2016,8,14,16,1645,1552,1763,211
2016,8,14,17,1732,1644,1887,243
2016,8,14,18,1815,1725,1900,175
2016,8,14,19,1883,1802,2011,209
2016,8,14,20,1946,1856,1997,141
2016,8,14,21,2006,1912,1734,-178
2016,8,14,22,2050,1963,1869,-94
2016,8,14,23,2072,1995,1895,-100
2016,8,15,0,2063,1978,2045,67
2016,8,15,1,2026,1952,2097,145
2016,8,15,2,1981,1912,2210,298
2016,8,15,3,1987,1944,2184,240
2016,8,15,4,1948,1874,2145,271
2016,8,15,5,1834,1728,1923,195
2016,8,15,6,1691,1580,1782,202
2016,8,15,7,1573,1478,1744,266
2016,8,15,8,1460,1416,1710,294
2016,8,15,9,1425,1377,1602,225
2016,8,15,10,1407,1355,1584,229
2016,8,15,11,1418,1371,1592,221
2016,8,15,12,1465,1429,1612,183
2016,8,15,13,1541,1509,1643,134
2016,8,15,14,1617,1587,1665,78
2016,8,15,15,1689,1664,1698,34
2016,8,15,16,1797,1739,1835,96
2016,8,15,17,1865,1821,2053,232
2016,8,15,18,1946,1898,2197,299
2016,8,15,19,2021,1969,2384,415
2016,8,15,20,2104,2063,2525,462
2016,8,15,21,2175,2149,2613,464
2016,8,15,22,2248,2232,2616,384
2016,8,15,23,2266,2291,2619,328
2016,8,16,0,2240,2295,2617,322
2016,8,16,1,2164,2248,2612,364
2016,8,16,2,2098,2171,2574,403
2016,8,16,3,2110,2162,2474,312
2016,8,16,4,2027,2042,2400,358
2016,8,16,5,1867,1842,2238,396
2016,8,16,6,1717,1665,2056,391
2016,8,16,7,1597,1553,1915,362
2016,8,16,8,1515,1493,1871,378
2016,8,16,9,1477,1446,1814,368
2016,8,16,10,1452,1418,1791,373
2016,8,16,11,1455,1424,1789,365
2016,8,16,12,1504,1484,1802,318
2016,8,16,13,1584,1575,1845,270
2016,8,16,14,1665,1645,1815,170
2016,8,16,15,1741,1742,1832,90
2016,8,16,16,1832,1813,1941,128
2016,8,16,17,1923,1895,1952,57
2016,8,16,18,2005,1974,1992,18
2016,8,16,19,2093,2050,2161,111
2016,8,16,20,2177,2136,2270,134
2016,8,16,21,2258,2197,2390,193
2016,8,16,22,2290,2229,2446,217
2016,8,16,23,2298,2194,2428,234
2016,8,17,0,2225,2093,2319,226
2016,8,17,1,2146,2016,2294,278
2016,8,17,2,2093,1979,2335,356
2016,8,17,3,2093,2014,2215,201
2016,8,17,4,2023,1928,2162,234
2016,8,17,5,1869,1765,1904,139
2016,8,17,6,1712,1599,1841,242
2016,8,17,7,1589,1510,1686,176
2016,8,17,8,1513,1432,1677,245
2016,8,17,9,1457,1407,1700,293
2016,8,17,10,1433,1397,1684,287
2016,8,17,11,1437,1402,1679,277
2016,8,17,12,1488,1457,1737,280
2016,8,17,13,1566,1546,1839,293
2016,8,17,14,1671,1599,1829,230
2016,8,17,15,1735,1676,1877,201
2016,8,17,16,1825,1754,1992,238
2016,8,17,17,1922,1832,2129,297
2016,8,17,18,2000,1905,2237,332
2016,8,17,19,2068,1957,2294,337
2016,8,17,20,2154,2061,2426,365
2016,8,17,21,2235,2128,2453,325
2016,8,17,22,2283,2194,2411,217
2016,8,17,23,2314,2233,2087,-146
2016,8,18,0,2249,2175,2100,-75
2016,8,18,1,2170,2070,1994,-76
2016,8,18,2,2096,2011,1972,-39
2016,8,18,3,2096,2045,1990,-55
2016,8,18,4,2022,1940,1885,-55
2016,8,18,5,1876,1762,1716,-46
2016,8,18,6,1719,1619,1604,-15
2016,8,18,7,1600,1528,1493,-35
2016,8,18,8,1489,1475,1336,-139
2016,8,18,9,1450,1435,1290,-145
2016,8,18,10,1424,1403,1252,-151
2016,8,18,11,1432,1412,1273,-139
2016,8,18,12,1480,1474,1308,-166
2016,8,18,13,1553,1563,1415,-148
2016,8,18,14,1635,1620,1472,-148
2016,8,18,15,1702,1700,1540,-160
2016,8,18,16,1793,1773,1524,-249
2016,8,18,17,1874,1856,1541,-315
2016,8,18,18,1957,1943,1636,-307
2016,8,18,19,2038,2022,1776,-246
2016,8,18,20,2134,2101,1903,-198
2016,8,18,21,2210,2169,2090,-79
2016,8,18,22,2256,2192,2055,-137
2016,8,18,23,2265,2133,2010,-123
2016,8,19,0,2208,2099,1999,-100
2016,8,19,1,2122,2020,2032,12
2016,8,19,2,2072,1974,2063,89
2016,8,19,3,2078,1981,1978,-3
2016,8,19,4,2007,1886,1848,-38
2016,8,19,5,1868,1732,1699,-33
2016,8,19,6,1709,1606,1589,-17
2016,8,19,7,1587,1522,1525,3
2016,8,19,8,1464,1462,1335,-127
2016,8,19,9,1410,1435,1263,-172
2016,8,19,10,1434,1418,1217,-201
2016,8,19,11,1437,1420,1233,-187
2016,8,19,12,1491,1483,1253,-230
2016,8,19,13,1571,1574,1311,-263
2016,8,19,14,1634,1637,1318,-319
2016,8,19,15,1709,1713,1306,-407
2016,8,19,16,1795,1801,1336,-465
2016,8,19,17,1878,1888,1449,-439
2016,8,19,18,1957,1953,1609,-344
2016,8,19,19,2019,2000,1717,-283
2016,8,19,20,2107,2073,1738,-335
2016,8,19,21,2184,2115,1937,-178
2016,8,19,22,2222,2130,1978,-152
2016,8,19,23,2227,2110,2023,-87
2016,8,20,0,2168,2066,1919,-147
2016,8,20,1,2096,1937,1856,-81
2016,8,20,2,2036,1884,1783,-101
2016,8,20,3,2039,1929,1879,-50
2016,8,20,4,1988,1851,1833,-18
2016,8,20,5,1862,1728,1751,23
2016,8,20,6,1719,1596,1537,-59
2016,8,20,7,1600,1497,1443,-54
2016,8,20,8,1475,1442,1392,-50
2016,8,20,9,1435,1395,1423,28
2016,8,20,10,1401,1363,1389,26
2016,8,20,11,1392,1365,1380,15
2016,8,20,12,1403,1384,1380,-4
2016,8,20,13,1417,1409,1414,5
2016,8,20,14,1459,1436,1436,0
2016,8,20,15,1544,1516,1436,-80
2016,8,20,16,1645,1609,1452,-157
2016,8,20,17,1726,1695,1468,-227
2016,8,20,18,1794,1765,1532,-233
2016,8,20,19,1855,1832,1594,-238
2016,8,20,20,1909,1885,1658,-227
2016,8,20,21,1976,1938,1744,-194
2016,8,20,22,2009,1990,1806,-184
2016,8,20,23,2006,2023,1853,-170
2016,8,21,0,1999,2012,1896,-116
2016,8,21,1,1955,1963,1936,-27
2016,8,21,2,1923,1916,1889,-27
2016,8,21,3,1939,1934,1852,-82
2016,8,21,4,1901,1836,1793,-43
2016,8,21,5,1782,1696,1637,-59
2016,8,21,6,1656,1583,1529,-54
2016,8,21,7,1555,1495,1418,-77
2016,8,21,8,1470,1436,1275,-161
2016,8,21,9,1427,1394,1167,-227
2016,8,21,10,1394,1368,1124,-244
2016,8,21,11,1385,1354,1163,-191
2016,8,21,12,1394,1355,1171,-184
2016,8,21,13,1396,1366,1166,-200
2016,8,21,14,1430,1383,1185,-198
2016,8,21,15,1506,1476,1342,-134
2016,8,21,16,1593,1564,1317,-247
2016,8,21,17,1672,1642,1488,-154
2016,8,21,18,1741,1705,1663,-42
2016,8,21,19,1808,1767,1733,-34
2016,8,21,20,1866,1807,1940,133
2016,8,21,21,1927,1827,2027,200
2016,8,21,22,1961,1850,1998,148
2016,8,21,23,1962,1883,2081,198
2016,8,22,0,1967,1886,2100,214
2016,8,22,1,1933,1874,2028,154
2016,8,22,2,1900,1851,2032,181
2016,8,22,3,1908,1857,1990,133
2016,8,22,4,1863,1773,1981,208
2016,8,22,5,1745,1637,1793,156
2016,8,22,6,1614,1500,1673,173
2016,8,22,7,1512,1409,1561,152
2016,8,22,8,1415,1365,1512,147
2016,8,22,9,1384,1338,1511,173
2016,8,22,10,1365,1329,1457,128
2016,8,22,11,1376,1347,1422,75
2016,8,22,12,1426,1413,1461,48
2016,8,22,13,1509,1520,1497,-23
2016,8,22,14,1576,1587,1496,-91
2016,8,22,15,1663,1645,1578,-67
2016,8,22,16,1736,1697,1651,-46
2016,8,22,17,1809,1751,1873,122
2016,8,22,18,1877,1795,1969,174
2016,8,22,19,1932,1818,2001,183
2016,8,22,20,1996,1868,2097,229
2016,8,22,21,2058,1902,2159,257
2016,8,22,22,2089,1916,2127,211
2016,8,22,23,2095,1972,2163,191
2016,8,23,0,2072,1973,2175,202
2016,8,23,1,2021,1880,2027,147
2016,8,23,2,1982,1823,1934,111
2016,8,23,3,1988,1865,2008,143
2016,8,23,4,1924,1781,1985,204
2016,8,23,5,1782,1627,1907,280
2016,8,23,6,1637,1495,1814,319
2016,8,23,7,1533,1420,1709,289
2016,8,23,8,1412,1376,1576,200
2016,8,23,9,1361,1325,1396,71
2016,8,23,10,1354,1311,1391,80
2016,8,23,11,1362,1317,1434,117
2016,8,23,12,1418,1382,1481,99
2016,8,23,13,1507,1483,1496,13
2016,8,23,14,1574,1547,1532,-15
2016,8,23,15,1645,1606,1556,-50
2016,8,23,16,1721,1667,1576,-91
2016,8,23,17,1794,1745,1602,-143
2016,8,23,18,1855,1790,1813,23
2016,8,23,19,1913,1839,1843,4
2016,8,23,20,1979,1910,1913,3
2016,8,23,21,2033,1896,1915,19
2016,8,23,22,2076,1924,1955,31
2016,8,23,23,2086,1966,2114,148
2016,8,24,0,2047,1962,2190,228
2016,8,24,1,2004,1938,2220,282
2016,8,24,2,1971,1900,2132,232
2016,8,24,3,1969,1951,2140,189
2016,8,24,4,1900,1848,1985,137
2016,8,24,5,1751,1695,1895,200
2016,8,24,6,1605,1526,1683,157
2016,8,24,7,1503,1439,1596,157
2016,8,24,8,1417,1383,1517,134
2016,8,24,9,1377,1344,1381,37
2016,8,24,10,1363,1331,1384,53
2016,8,24,11,1370,1338,1354,16
2016,8,24,12,1425,1405,1389,-16
2016,8,24,13,1504,1502,1480,-22
2016,8,24,14,1581,1551,1564,13
2016,8,24,15,1635,1593,1625,32
2016,8,24,16,1692,1648,1670,22
2016,8,24,17,1759,1690,1787,97
2016,8,24,18,1822,1742,1842,100
2016,8,24,19,1867,1785,1944,159
2016,8,24,20,1924,1839,2107,268
2016,8,24,21,1970,1867,2177,310
2016,8,24,22,1997,1872,2231,359
2016,8,24,23,2010,1880,2248,368
2016,8,25,0,1984,1882,2288,406
2016,8,25,1,1933,1865,2305,440
2016,8,25,2,1895,1841,2332,491
2016,8,25,3,1909,1901,2386,485
2016,8,25,4,1862,1805,2364,559
2016,8,25,5,1727,1653,2201,548
2016,8,25,6,1588,1503,2134,631
2016,8,25,7,1492,1412,2065,653
2016,8,25,8,1392,1354,2079,725
2016,8,25,9,1359,1326,2042,716
2016,8,25,10,1352,1311,1973,662
2016,8,25,11,1360,1320,1962,642
2016,8,25,12,1416,1393,1993,600
2016,8,25,13,1496,1498,2052,554
2016,8,25,14,1568,1544,1939,395
2016,8,25,15,1619,1596,1982,386
2016,8,25,16,1678,1655,2044,389
2016,8,25,17,1751,1724,2075,351
2016,8,25,18,1806,1787,2186,399
2016,8,25,19,1850,1844,2327,483
2016,8,25,20,1911,1915,2469,554
2016,8,25,21,1953,1960,2545,585
2016,8,25,22,1981,2006,2560,554
2016,8,25,23,1989,2014,2561,547
2016,8,26,0,1964,2002,2505,503
2016,8,26,1,1914,1945,2436,491
2016,8,26,2,1875,1920,2474,554
2016,8,26,3,1898,1952,2499,547
2016,8,26,4,1847,1854,2372,518
2016,8,26,5,1712,1698,2204,506
2016,8,26,6,1567,1558,2135,577
2016,8,26,7,1473,1466,2055,589
2016,8,26,8,1448,1407,1965,558
2016,8,26,9,1403,1367,2001,634
2016,8,26,10,1381,1358,1986,628
2016,8,26,11,1388,1367,1940,573
2016,8,26,12,1438,1427,1940,513
2016,8,26,13,1508,1533,2012,479
2016,8,26,14,1575,1582,1973,391
2016,8,26,15,1621,1631,2045,414
2016,8,26,16,1685,1702,2079,377
2016,8,26,17,1743,1764,2215,451
2016,8,26,18,1801,1813,2239,426
2016,8,26,19,1846,1847,2294,447
2016,8,26,20,1900,1897,2359,462
2016,8,26,21,1940,1935,2332,397
2016,8,26,22,1966,1948,2369,421
2016,8,26,23,1976,1920,2347,427
2016,8,27,0,1955,1891,2322,431
2016,8,27,1,1913,1832,2229,397
2016,8,27,2,1863,1821,2165,344
2016,8,27,3,1884,1850,2170,320
2016,8,27,4,1836,1781,2168,387
2016,8,27,5,1725,1656,2088,432
2016,8,27,6,1594,1520,2086,566
2016,8,27,7,1499,1434,2053,619
2016,8,27,8,1436,1379,1887,508
2016,8,27,9,1396,1340,1819,479
2016,8,27,10,1367,1322,1784,462
2016,8,27,11,1356,1317,1766,449
2016,8,27,12,1372,1348,1797,449
2016,8,27,13,1384,1374,1809,435
2016,8,27,14,1429,1405,1834,429
2016,8,27,15,1503,1495,1869,374
2016,8,27,16,1586,1583,1939,356
2016,8,27,17,1661,1656,2055,399
2016,8,27,18,1722,1738,2077,339
2016,8,27,19,1773,1801,2131,330
2016,8,27,20,1825,1863,2166,303
2016,8,27,21,1873,1916,2328,412
2016,8,27,22,1901,1936,2341,405
2016,8,27,23,1912,1923,2355,432
2016,8,28,0,1916,1832,2277,445
2016,8,28,1,1879,1761,2217,456
2016,8,28,2,1839,1742,2254,512
2016,8,28,3,1850,1770,2239,469
2016,8,28,4,1814,1697,2223,526
2016,8,28,5,1713,1589,2212,623
2016,8,28,6,1595,1479,2049,570
2016,8,28,7,1498,1404,1738,334
2016,8,28,8,1407,1341,1518,177
2016,8,28,9,1368,1313,1485,172
2016,8,28,10,1346,1292,1487,195
2016,8,28,11,1336,1287,1553,266
2016,8,28,12,1347,1307,1593,286
2016,8,28,13,1350,1317,1609,292
2016,8,28,14,1376,1343,1663,320
2016,8,28,15,1467,1403,1741,338
2016,8,28,16,1559,1459,1779,320
2016,8,28,17,1658,1530,1883,353
2016,8,28,18,1715,1592,1955,363
2016,8,28,19,1806,1660,2117,457
2016,8,28,20,1884,1716,2146,430
2016,8,28,21,1935,1759,2161,402
2016,8,28,22,1970,1815,2166,351
2016,8,28,23,1965,1802,2156,354
2016,8,29,0,1885,1786,2182,396
2016,8,29,1,1857,1794,2200,406
2016,8,29,2,1834,1786,2258,472
2016,8,29,3,1854,1826,2263,437
2016,8,29,4,1808,1730,2160,430
2016,8,29,5,1690,1581,2100,519
2016,8,29,6,1551,1446,2072,626
2016,8,29,7,1475,1371,1963,592
2016,8,29,8,1372,1321,1921,600
2016,8,29,9,1339,1300,1847,547
2016,8,29,10,1331,1289,1765,476
2016,8,29,11,1344,1309,1739,430
2016,8,29,12,1405,1372,1708,336
2016,8,29,13,1483,1479,1742,263
2016,8,29,14,1569,1546,1825,279
2016,8,29,15,1672,1600,1901,301
2016,8,29,16,1742,1672,2047,375
2016,8,29,17,1785,1730,2111,381
2016,8,29,18,1837,1797,2267,470
2016,8,29,19,1885,1837,2420,583
2016,8,29,20,1931,1885,2445,560
2016,8,29,21,1968,1923,2488,565
2016,8,29,22,1987,1957,2421,464
2016,8,29,23,1969,1971,2440,469
2016,8,30,0,1955,1947,2403,456
2016,8,30,1,1898,1902,2372,470
2016,8,30,2,1867,1881,2309,428
2016,8,30,3,1897,1894,2320,426
2016,8,30,4,1847,1790,2275,485
2016,8,30,5,1712,1632,2227,595
2016,8,30,6,1578,1492,1948,456
2016,8,30,7,1483,1417,1877,460
2016,8,30,8,1401,1362,1793,431
2016,8,30,9,1369,1325,1770,445
2016,8,30,10,1355,1311,1740,429
2016,8,30,11,1358,1319,1746,427
2016,8,30,12,1416,1378,1746,368
2016,8,30,13,1522,1494,1874,380
2016,8,30,14,1599,1552,1961,409
2016,8,30,15,1659,1610,1932,322
2016,8,30,16,1713,1658,1994,336
2016,8,30,17,1771,1722,2243,521
2016,8,30,18,1798,1788,2415,627
2016,8,30,19,1854,1829,2434,605
2016,8,30,20,1901,1888,2421,533
2016,8,30,21,1939,1941,2453,512
2016,8,30,22,1957,1974,2474,500
2016,8,30,23,1974,2002,2526,524
2016,8,31,0,1935,1995,2533,538
2016,8,31,1,1891,1938,2451,513
2016,8,31,2,1874,1917,2390,473
2016,8,31,3,1882,1957,2382,425
2016,8,31,4,1816,1853,2307,454
2016,8,31,5,1685,1689,2140,451
2016,8,31,6,1554,1542,1989,447
2016,8,31,7,1462,1447,1981,534
2016,8,31,8,1423,1396,1983,587
2016,8,31,9,1393,1369,1981,612
2016,8,31,10,1427,1352,1968,616
2016,8,31,11,1380,1359,1970,611
2016,8,31,12,1436,1428,1987,559
2016,8,31,13,1524,1545,2028,483
2016,8,31,14,1590,1595,2049,454
2016,8,31,15,1644,1650,2044,394
2016,8,31,16,1703,1716,2092,376
2016,8,31,17,1758,1780,2140,360
2016,8,31,18,1805,1842,2254,412
2016,8,31,19,1847,1896,2255,359
2016,8,31,20,1906,1946,2402,456
2016,8,31,21,1940,2004,2515,511
2016,8,31,22,1958,2048,2529,481
2016,8,31,23,1975,2085,2531,446
2016,9,1,0,1951,2093,2537,444
2016,9,1,1,1911,2038,2454,416
2016,9,1,2,1889,2001,2402,401
2016,9,1,3,1906,2031,2411,380
2016,9,1,4,1845,1912,2339,427
2016,9,1,5,1708,1742,2118,376
2016,9,1,6,1576,1584,1973,389
2016,9,1,7,1478,1486,1914,428
2016,9,1,8,1462,1431,1818,387
2016,9,1,9,1429,1386,1826,440
2016,9,1,10,1403,1370,1824,454
2016,9,1,11,1411,1388,1820,432
2016,9,1,12,1460,1444,1811,367
2016,9,1,13,1554,1542,1850,308
2016,9,1,14,1617,1593,2020,427
2016,9,1,15,1653,1669,2081,412
2016,9,1,16,1720,1730,2256,526
2016,9,1,17,1786,1795,2351,556
2016,9,1,18,1846,1863,2386,523
2016,9,1,19,1897,1901,2450,549
2016,9,1,20,1967,1970,2497,527
2016,9,1,21,2018,2026,2558,532
2016,9,1,22,2045,2080,2630,550
2016,9,1,23,2065,2113,2641,528
2016,9,2,0,2031,2097,2602,505
2016,9,2,1,1979,2032,2536,504
2016,9,2,2,1937,2005,2461,456
2016,9,2,3,1962,2019,2462,443
2016,9,2,4,1895,1908,2236,328
2016,9,2,5,1747,1744,2054,310
2016,9,2,6,1601,1600,1806,206
2016,9,2,7,1500,1517,1690,173
2016,9,2,8,1495,1441,1733,292
2016,9,2,9,1454,1400,1764,364
2016,9,2,10,1435,1382,1744,362
2016,9,2,11,1442,1387,1758,371
2016,9,2,12,1488,1445,1814,369
2016,9,2,13,1573,1545,1926,381
2016,9,2,14,1640,1595,1975,380
2016,9,2,15,1701,1708,2159,451
2016,9,2,16,1767,1740,2198,458
2016,9,2,17,1839,1813,2281,468
2016,9,2,18,1911,1884,2307,423
2016,9,2,19,1962,1952,2414,462
2016,9,2,20,2034,2007,2458,451
2016,9,2,21,2096,2054,2577,523
2016,9,2,22,2118,2092,2633,541
2016,9,2,23,2116,2104,2649,545
2016,9,3,0,2080,2047,2590,543
2016,9,3,1,2015,1918,2454,536
2016,9,3,2,1989,1888,2412,524
2016,9,3,3,2003,1907,2470,563
2016,9,3,4,1922,1838,2403,565
2016,9,3,5,1794,1730,2246,516
2016,9,3,6,1650,1599,2129,530
2016,9,3,7,1553,1515,2128,613
2016,9,3,8,1500,1463,2102,639
2016,9,3,9,1445,1416,2056,640
2016,9,3,10,1425,1390,1947,557
2016,9,3,11,1409,1384,1875,491
2016,9,3,12,1421,1406,1892,486
2016,9,3,13,1438,1429,1910,481
2016,9,3,14,1480,1456,1908,452
2016,9,3,15,1581,1546,1978,432
2016,9,3,16,1670,1628,2033,405
2016,9,3,17,1767,1723,2085,362
2016,9,3,18,1849,1805,2125,320
2016,9,3,19,1918,1890,2253,363
2016,9,3,20,1991,1944,2362,418
2016,9,3,21,2049,1988,2366,378
2016,9,3,22,2093,2181,2529,348
2016,9,3,23,2110,2026,2450,424
2016,9,4,0,2093,2047,2472,425
2016,9,4,1,2036,2009,2465,456
2016,9,4,2,1997,1985,2433,448
2016,9,4,3,1987,1962,2380,418
2016,9,4,4,1921,1869,2326,457
2016,9,4,5,1801,1738,2138,400
2016,9,4,6,1671,1604,2141,537
2016,9,4,7,1566,1507,2133,626
2016,9,4,8,1472,1444,2015,571
2016,9,4,9,1425,1401,1968,567
2016,9,4,10,1399,1379,1910,531
2016,9,4,11,1389,1363,1902,539
2016,9,4,12,1399,1376,1878,502
2016,9,4,13,1408,1395,1869,474
2016,9,4,14,1446,1412,1834,422
2016,9,4,15,1537,1507,1812,305
2016,9,4,16,1640,1597,1858,261
2016,9,4,17,1741,1688,1868,180
2016,9,4,18,1835,1777,1992,215
2016,9,4,19,1936,1849,2123,274
2016,9,4,20,2023,1900,2261,361
2016,9,4,21,2099,1938,2300,362
2016,9,4,22,2156,1957,2367,410
2016,9,4,23,2184,1985,2438,453
2016,9,5,0,2177,2008,2488,480
2016,9,5,1,2120,1981,2479,498
2016,9,5,2,2072,1955,2421,466
2016,9,5,3,2060,1964,2434,470
2016,9,5,4,1984,1878,2297,419
2016,9,5,5,1831,1749,2284,535
2016,9,5,6,1687,1599,2212,613
2016,9,5,7,1589,1501,2129,628
2016,9,5,8,1483,1431,1965,534
2016,9,5,9,1428,1377,1802,425
2016,9,5,10,1412,1357,1784,427
2016,9,5,11,1392,1370,1786,416
2016,9,5,12,1396,1390,1823,433
2016,9,5,13,1399,1418,1794,376
2016,9,5,14,1436,1435,1825,390
2016,9,5,15,1533,1531,1819,288
2016,9,5,16,1641,1646,1895,249
2016,9,5,17,1745,1770,2029,259
2016,9,5,18,1874,1877,2170,293
2016,9,5,19,1971,1958,2269,311
2016,9,5,20,2063,2027,2319,292
2016,9,5,21,2141,2074,2469,395
2016,9,5,22,2197,2126,2562,436
2016,9,5,23,2214,2174,2687,513
2016,9,6,0,2195,2163,2668,505
2016,9,6,1,2126,2106,2631,525
2016,9,6,2,2076,2083,2621,538
2016,9,6,3,2060,2099,2678,579
2016,9,6,4,1973,1973,2558,585
2016,9,6,5,1823,1797,2327,530
2016,9,6,6,1697,1637,2095,458
2016,9,6,7,1590,1548,1877,329
2016,9,6,8,1496,1487,1827,340
2016,9,6,9,1459,1446,1825,379
2016,9,6,10,1438,1432,1791,359
2016,9,6,11,1431,1441,1750,309
2016,9,6,12,1485,1498,1800,302
2016,9,6,13,1572,1627,1835,208
2016,9,6,14,1650,1678,1870,192
2016,9,6,15,1726,1773,1941,168
2016,9,6,16,1814,1864,1772,-92
2016,9,6,17,1895,1941,1804,-137
2016,9,6,18,1974,1984,1814,-170
2016,9,6,19,2047,2046,1896,-150
2016,9,6,20,2118,2113,1988,-125
2016,9,6,21,2175,2151,2041,-110
2016,9,6,22,2210,2151,1991,-160
2016,9,6,23,2205,2053,1882,-171
2016,9,7,0,2152,1959,1805,-154
2016,9,7,1,2054,1892,1784,-108
2016,9,7,2,2030,1897,1851,-46
2016,9,7,3,2047,1897,1884,-13
2016,9,7,4,1972,1815,1876,61
2016,9,7,5,1809,1659,1744,85
2016,9,7,6,1647,1527,1725,198
2016,9,7,7,1548,1439,1732,293
2016,9,7,8,1486,1386,1707,321
2016,9,7,9,1447,1371,1605,234
2016,9,7,10,1431,1347,1577,230
2016,9,7,11,1443,1369,1602,233
2016,9,7,12,1496,1435,1611,176
2016,9,7,13,1602,1558,1645,87
2016,9,7,14,1672,1607,1648,41
2016,9,7,15,1724,1649,1702,53
2016,9,7,16,1790,1665,1793,128
2016,9,7,17,1854,1731,1705,-26
2016,9,7,18,1911,1758,1557,-201
2016,9,7,19,1962,1768,1636,-132
2016,9,7,20,2012,1785,1700,-85
2016,9,7,21,2053,1804,1810,6
2016,9,7,22,2078,1829,1860,31
2016,9,7,23,2071,1819,1878,59
2016,9,8,0,2017,1785,1897,112
2016,9,8,1,1954,1750,1945,195
2016,9,8,2,1959,1794,1938,144
2016,9,8,3,1970,1834,1945,111
2016,9,8,4,1892,1740,1965,225
2016,9,8,5,1749,1605,1840,235
2016,9,8,6,1602,1474,1788,314
2016,9,8,7,1510,1392,1742,350
2016,9,8,8,1422,1353,1501,148
2016,9,8,9,1388,1320,1434,114
2016,9,8,10,1379,1307,1445,138
2016,9,8,11,1386,1326,1478,152
2016,9,8,12,1445,1395,1531,136
2016,9,8,13,1555,1525,1681,156
2016,9,8,14,1615,1565,1720,155
2016,9,8,15,1677,1622,1703,81
2016,9,8,16,1733,1679,1681,2
2016,9,8,17,1797,1721,1698,-23
2016,9,8,18,1866,1777,1720,-57
2016,9,8,19,1922,1826,1808,-18
2016,9,8,20,1990,1887,1858,-29
2016,9,8,21,2041,1935,1943,8
2016,9,8,22,2109,2009,2075,66
2016,9,8,23,2134,2042,2137,95
2016,9,9,0,2111,2052,2133,81
2016,9,9,1,2038,2005,2115,110
2016,9,9,2,2010,1962,1997,35
2016,9,9,3,2013,1941,2006,65
2016,9,9,4,1919,1814,2005,191
2016,9,9,5,1767,1649,2046,397
2016,9,9,6,1608,1525,1819,294
2016,9,9,7,1514,1433,1670,237
2016,9,9,8,1416,1378,1490,112
2016,9,9,9,1387,1342,1457,115
2016,9,9,10,1359,1325,1394,69
2016,9,9,11,1368,1329,1385,56
2016,9,9,12,1422,1388,1385,-3
2016,9,9,13,1516,1504,1363,-141
2016,9,9,14,1570,1533,1525,-8
2016,9,9,15,1633,1604,1557,-47
2016,9,9,16,1703,1661,1636,-25
2016,9,9,17,1780,1716,1748,32
2016,9,9,18,1851,1780,1793,13
2016,9,9,19,1917,1855,1918,63
2016,9,9,20,2008,1935,1986,51
2016,9,9,21,2090,2024,2049,25
2016,9,9,22,2142,2082,2085,3
2016,9,9,23,2184,2140,2075,-65
2016,9,10,0,2152,2134,2061,-73
2016,9,10,1,2082,2051,1981,-70
2016,9,10,2,2044,1987,1898,-89
2016,9,10,3,2027,1952,1824,-128
2016,9,10,4,1931,1842,1780,-62
2016,9,10,5,1780,1702,1687,-15
2016,9,10,6,1631,1554,1689,135
2016,9,10,7,1531,1468,1636,168
2016,9,10,8,1443,1403,1587,184
2016,9,10,9,1401,1352,1586,234
2016,9,10,10,1365,1320,1491,171
2016,9,10,11,1359,1319,1458,139
2016,9,10,12,1375,1325,1425,100
2016,9,10,13,1405,1358,1395,37
2016,9,10,14,1449,1370,1346,-24
2016,9,10,15,1533,1437,1395,-42
2016,9,10,16,1607,1500,1448,-52
2016,9,10,17,1665,1552,1566,14
2016,9,10,18,1719,1599,1627,28
2016,9,10,19,1758,1623,1719,96
2016,9,10,20,1800,1673,1690,17
2016,9,10,21,1837,1725,1769,44
2016,9,10,22,1865,1782,1801,19
2016,9,10,23,1878,1847,1850,3
2016,9,11,0,1877,1876,1852,-24
2016,9,11,1,1857,1849,1810,-39
2016,9,11,2,1843,1834,1792,-42
2016,9,11,3,1846,1845,1826,-19
2016,9,11,4,1796,1757,1781,24
2016,9,11,5,1696,1622,1762,140
2016,9,11,6,1580,1485,1704,219
2016,9,11,7,1486,1390,1535,145
2016,9,11,8,1410,1333,1361,28
2016,9,11,9,1365,1307,1351,44
2016,9,11,10,1333,1283,1376,93
2016,9,11,11,1322,1283,1385,102
2016,9,11,12,1331,1292,1425,133
2016,9,11,13,1346,1317,1425,108
2016,9,11,14,1374,1328,1457,129
2016,9,11,15,1462,1395,1551,156
2016,9,11,16,1541,1477,1658,181
2016,9,11,17,1606,1555,1783,228
2016,9,11,18,1677,1642,1839,197
2016,9,11,19,1740,1736,1879,143
2016,9,11,20,1798,1821,2000,179
2016,9,11,21,1847,1898,2034,136
2016,9,11,22,1892,1935,2022,87
2016,9,11,23,1920,1863,1978,115
2016,9,12,0,1940,1828,1963,135
2016,9,12,1,1917,1775,1957,182
2016,9,12,2,1893,1794,1953,159
2016,9,12,3,1891,1796,1910,114
2016,9,12,4,1827,1709,1816,107
2016,9,12,5,1704,1584,1756,172
2016,9,12,6,1574,1452,1653,201
2016,9,12,7,1472,1379,1562,183
2016,9,12,8,1392,1320,1495,175
2016,9,12,9,1342,1298,1486,188
2016,9,12,10,1341,1288,1460,172
2016,9,12,11,1355,1295,1421,126
2016,9,12,12,1414,1372,1452,80
2016,9,12,13,1505,1482,1454,-28
2016,9,12,14,1567,1529,1545,16
2016,9,12,15,1655,1586,1556,-30
2016,9,12,16,1721,1646,1579,-67
2016,9,12,17,1795,1708,1794,86
2016,9,12,18,1861,1775,1843,68
2016,9,12,19,1928,1846,1500,-346
2016,9,12,20,1992,1816,1223,-593
2016,9,12,21,2038,1884,1395,-489
2016,9,12,22,2072,1905,1362,-543
2016,9,12,23,2075,1895,1386,-509
2016,9,13,0,2043,1828,1311,-517
2016,9,13,1,1987,1764,1325,-439
2016,9,13,2,1953,1781,1312,-469
2016,9,13,3,1967,1790,1316,-474
2016,9,13,4,1896,1690,1195,-495
2016,9,13,5,1747,1552,1132,-420
2016,9,13,6,1604,1423,993,-430
2016,9,13,7,1499,1351,859,-492
2016,9,13,8,1380,1298,840,-458
2016,9,13,9,1350,1271,847,-424
2016,9,13,10,1305,1262,843,-419
2016,9,13,11,1309,1266,834,-432
2016,9,13,12,1372,1328,873,-455
2016,9,13,13,1476,1439,945,-494
2016,9,13,14,1542,1471,1022,-449
2016,9,13,15,1638,1517,1082,-435
2016,9,13,16,1702,1566,1115,-451
2016,9,13,17,1771,1628,1114,-514
2016,9,13,18,1826,1677,1144,-533
2016,9,13,19,1890,1729,1149,-580
2016,9,13,20,1956,1789,1196,-593
2016,9,13,21,1995,1841,1239,-602
2016,9,13,22,2030,1890,1268,-622
2016,9,13,23,2040,1929,1269,-660
2016,9,14,0,2012,1912,1234,-678
2016,9,14,1,1966,1849,1241,-608
2016,9,14,2,1940,1861,1275,-586
2016,9,14,3,1948,1854,1308,-546
2016,9,14,4,1873,1752,1232,-520
2016,9,14,5,1725,1598,1155,-443
2016,9,14,6,1581,1467,1069,-398
2016,9,14,7,1500,1384,991,-393
2016,9,14,8,1390,1333,868,-465
2016,9,14,9,1353,1310,795,-515
2016,9,14,10,1335,1297,732,-565
2016,9,14,11,1341,1310,719,-591
2016,9,14,12,1396,1381,732,-649
2016,9,14,13,1495,1502,846,-656
2016,9,14,14,1570,1546,882,-664
2016,9,14,15,1620,1598,889,-709
2016,9,14,16,1678,1657,944,-713
2016,9,14,17,1747,1705,1003,-702
2016,9,14,18,1804,1760,1121,-639
2016,9,14,19,1865,1811,1201,-610
2016,9,14,20,1923,1870,1187,-683
2016,9,14,21,1958,1903,1213,-690
2016,9,14,22,1986,1940,1286,-654
2016,9,14,23,1996,1945,1305,-640
2016,9,15,0,1961,1905,1270,-635
2016,9,15,1,1924,1852,1230,-622
2016,9,15,2,1910,1866,1201,-665
2016,9,15,3,1921,1878,1202,-676
2016,9,15,4,1847,1772,1131,-641
2016,9,15,5,1708,1613,1009,-604
2016,9,15,6,1566,1485,945,-540
2016,9,15,7,1474,1387,850,-537
2016,9,15,8,1398,1341,827,-514
2016,9,15,9,1365,1312,847,-465
2016,9,15,10,1336,1275,840,-435
2016,9,15,11,1336,1282,826,-456
2016,9,15,12,1400,1344,849,-495
2016,9,15,13,1495,1462,995,-467
2016,9,15,14,1560,1497,1051,-446
2016,9,15,15,1611,1545,1107,-438
2016,9,15,16,1664,1605,1103,-502
2016,9,15,17,1719,1664,1148,-516
2016,9,15,18,1767,1713,1232,-481
2016,9,15,19,1814,1775,1237,-538
2016,9,15,20,1869,1803,1328,-475
2016,9,15,21,1914,1815,1371,-444
2016,9,15,22,1943,1841,1378,-463
2016,9,15,23,1954,1859,1342,-517
2016,9,16,0,1929,1837,1260,-577
2016,9,16,1,1875,1788,1310,-478
2016,9,16,2,1846,1817,1299,-518
2016,9,16,3,1875,1821,1317,-504
2016,9,16,4,1809,1722,1246,-476
2016,9,16,5,1666,1584,1144,-440
2016,9,16,6,1539,1458,1120,-338
2016,9,16,7,1445,1374,992,-382
2016,9,16,8,1382,1329,838,-491
2016,9,16,9,1343,1296,808,-488
2016,9,16,10,1321,1277,783,-494
2016,9,16,11,1329,1287,797,-490
2016,9,16,12,1380,1344,860,-484
2016,9,16,13,1471,1453,914,-539
2016,9,16,14,1534,1493,983,-510
2016,9,16,15,1585,1532,1019,-513
2016,9,16,16,1634,1567,953,-614
2016,9,16,17,1686,1614,970,-644
2016,9,16,18,1733,1673,914,-759
2016,9,16,19,1770,1712,904,-808
2016,9,16,20,1816,1760,976,-784
2016,9,16,21,1853,1804,1000,-804
2016,9,16,22,1884,1843,1101,-742
2016,9,16,23,1897,1873,1233,-640
2016,9,17,0,1869,1872,1350,-522
2016,9,17,1,1817,1818,1394,-424
2016,9,17,2,1794,1810,1419,-391
2016,9,17,3,1817,1822,1438,-384
2016,9,17,4,1765,1727,1506,-221
2016,9,17,5,1654,1614,1508,-106
2016,9,17,6,1529,1483,1561,78
2016,9,17,7,1439,1408,1494,86
2016,9,17,8,1382,1356,1203,-153
2016,9,17,9,1336,1321,1117,-204
2016,9,17,10,1299,1310,1116,-194
2016,9,17,11,1287,1301,1116,-185
2016,9,17,12,1299,1328,1092,-236
2016,9,17,13,1320,1361,1159,-202
2016,9,17,14,1360,1378,1181,-197
2016,9,17,15,1431,1446,1225,-221
2016,9,17,16,1497,1501,1267,-234
2016,9,17,17,1547,1570,1379,-191
2016,9,17,18,1593,1622,1500,-122
2016,9,17,19,1638,1667,1607,-60
2016,9,17,20,1673,1734,1765,31
2016,9,17,21,1711,1784,1854,70
2016,9,17,22,1752,1834,1866,32
2016,9,17,23,1779,1860,1857,-3
2016,9,18,0,1791,1872,1890,18
2016,9,18,1,1770,1847,1870,23
2016,9,18,2,1752,1840,1841,1
2016,9,18,3,1760,1801,1802,1
2016,9,18,4,1721,1701,1761,60
2016,9,18,5,1625,1568,1611,43
2016,9,18,6,1520,1460,1576,116
2016,9,18,7,1430,1374,1550,176
2016,9,18,8,1370,1319,1428,109
2016,9,18,9,1330,1271,1321,50
2016,9,18,10,1305,1266,1176,-90
2016,9,18,11,1297,1266,1162,-104
2016,9,18,12,1304,1272,1167,-105
2016,9,18,13,1312,1306,1185,-121
2016,9,18,14,1340,1308,1178,-130
2016,9,18,15,1413,1361,1259,-102
2016,9,18,16,1477,1433,1405,-28
2016,9,18,17,1535,1480,1433,-47
2016,9,18,18,1604,1547,1488,-59
2016,9,18,19,1671,1593,1705,112
2016,9,18,20,1718,1661,1796,135
2016,9,18,21,1756,1720,1819,99
2016,9,18,22,1815,1787,1934,147
2016,9,18,23,1855,1867,1990,123
2016,9,19,0,1870,1903,2002,99
2016,9,19,1,1839,1894,1980,86
2016,9,19,2,1821,1884,1937,53
2016,9,19,3,1828,1847,1877,30
2016,9,19,4,1769,1718,1788,70
2016,9,19,5,1649,1564,1640,76
2016,9,19,6,1518,1427,1620,193
2016,9,19,7,1421,1341,1558,217
2016,9,19,8,1378,1288,1461,173
2016,9,19,9,1351,1259,1383,124
2016,9,19,10,1332,1244,1419,175
2016,9,19,11,1332,1259,1419,160
2016,9,19,12,1388,1326,1422,96
2016,9,19,13,1472,1447,1418,-29
2016,9,19,14,1535,1486,1603,117
2016,9,19,15,1594,1518,1597,79
2016,9,19,16,1660,1545,1578,33
2016,9,19,17,1732,1612,1679,67
2016,9,19,18,1812,1670,1793,123
2016,9,19,19,1881,1725,1896,171
2016,9,19,20,1943,1808,1988,180
2016,9,19,21,2010,1881,2090,209
2016,9,19,22,2067,1972,2179,207
2016,9,19,23,2094,2015,2189,174
2016,9,20,0,2070,2034,2185,151
2016,9,20,1,2002,1984,2083,99
2016,9,20,2,1956,1954,2050,96
2016,9,20,3,1951,1896,2007,111
2016,9,20,4,1866,1766,1932,166
2016,9,20,5,1710,1610,1774,164
2016,9,20,6,1566,1472,1610,138
2016,9,20,7,1463,1388,1514,126
2016,9,20,8,1361,1334,1370,36
2016,9,20,9,1332,1314,1358,44
2016,9,20,10,1317,1296,1350,54
2016,9,20,11,1324,1302,1352,50
2016,9,20,12,1382,1363,1354,-9
2016,9,20,13,1485,1495,1415,-80
2016,9,20,14,1566,1518,1575,57
2016,9,20,15,1621,1558,1554,-4
2016,9,20,16,1684,1602,1652,50
2016,9,20,17,1759,1659,1833,174
2016,9,20,18,1827,1694,1914,220
2016,9,20,19,1893,1762,1983,221
2016,9,20,20,1966,1833,2181,348
2016,9,20,21,2026,1886,2198,312
2016,9,20,22,2071,1935,2212,277
2016,9,20,23,2111,1949,2162,213
2016,9,21,0,2076,1915,2159,244
2016,9,21,1,2008,1894,2035,141
2016,9,21,2,1976,1950,2061,111
2016,9,21,3,1967,1933,2049,116
2016,9,21,4,1893,1828,1925,97
2016,9,21,5,1740,1674,1776,102
2016,9,21,6,1595,1538,1821,283
2016,9,21,7,1483,1453,1700,247
2016,9,21,8,1416,1389,1595,206
2016,9,21,9,1380,1344,1511,167
2016,9,21,10,1349,1324,1451,127
2016,9,21,11,1354,1334,1450,116
2016,9,21,12,1409,1398,1495,97
2016,9,21,13,1515,1535,1663,128
2016,9,21,14,1572,1582,1789,207
2016,9,21,15,1661,1634,1795,161
2016,9,21,16,1705,1695,1809,114
2016,9,21,17,1775,1760,1892,132
2016,9,21,18,1839,1824,1934,110
2016,9,21,19,1883,1890,1972,82
2016,9,21,20,1946,1969,2090,121
2016,9,21,21,2001,2027,2184,157
2016,9,21,22,2031,2071,2272,201
2016,9,21,23,2039,2101,2337,236
2016,9,22,0,2006,2060,2321,261
2016,9,22,1,1962,1999,2287,288
2016,9,22,2,1967,2019,2262,243
2016,9,22,3,1961,1994,2189,195
2016,9,22,4,1877,1898,1914,16
2016,9,22,5,1733,1725,1754,29
2016,9,22,6,1591,1577,1576,-1
2016,9,22,7,1495,1485,1540,55
2016,9,22,8,1428,1421,1462,41
2016,9,22,9,1383,1381,1338,-43
2016,9,22,10,1358,1361,1314,-47
2016,9,22,11,1363,1365,1322,-43
2016,9,22,12,1413,1432,1365,-67
2016,9,22,13,1520,1552,1499,-53
2016,9,22,14,1581,1586,1635,49
2016,9,22,15,1634,1632,1666,34
2016,9,22,16,1702,1694,1776,82
2016,9,22,17,1779,1775,1870,95
2016,9,22,18,1855,1834,1953,119
2016,9,22,19,1930,1884,1951,67
2016,9,22,20,1987,1959,2107,148
2016,9,22,21,2050,2030,2225,195
2016,9,22,22,2084,2038,2197,159
2016,9,22,23,2102,2001,2250,249
2016,9,23,0,2051,1970,2258,288
2016,9,23,1,1974,1911,2208,297
2016,9,23,2,1962,1962,2214,252
2016,9,23,3,1965,1951,2195,244
2016,9,23,4,1877,1847,2101,254
2016,9,23,5,1715,1688,1977,289
2016,9,23,6,1575,1541,1805,264
2016,9,23,7,1475,1444,1602,158
2016,9,23,8,1426,1366,1436,70
2016,9,23,9,1383,1335,1419,84
2016,9,23,10,1372,1326,1392,66
2016,9,23,11,1374,1338,1393,55
2016,9,23,12,1430,1397,1356,-41
2016,9,23,13,1537,1506,1490,-16
2016,9,23,14,1591,1547,1565,18
2016,9,23,15,1646,1598,1581,-17
2016,9,23,16,1704,1648,1643,-5
2016,9,23,17,1756,1687,1759,72
2016,9,23,18,1801,1722,1825,103
2016,9,23,19,1842,1740,1803,63
2016,9,23,20,1873,1778,1868,90
2016,9,23,21,1886,1800,1938,138
2016,9,23,22,1895,1739,2047,308
2016,9,23,23,1894,1682,2087,405
2016,9,24,0,1851,1639,2010,371
2016,9,24,1,1807,1586,1933,347
2016,9,24,2,1831,1631,1943,312
2016,9,24,3,1832,1645,1961,316
2016,9,24,4,1757,1592,1824,232
2016,9,24,5,1635,1491,1634,143
2016,9,24,6,1508,1390,1450,60
2016,9,24,7,1423,1325,1363,38
2016,9,24,8,1341,1277,1250,-27
2016,9,24,9,1308,1256,1120,-136
2016,9,24,10,1285,1245,1117,-128
2016,9,24,11,1283,1249,1099,-150
2016,9,24,12,1310,1269,1120,-149
2016,9,24,13,1339,1329,1116,-213
2016,9,24,14,1398,1337,1177,-160
2016,9,24,15,1447,1377,1317,-60
2016,9,24,16,1488,1402,1344,-58
2016,9,24,17,1525,1432,1378,-54
2016,9,24,18,1549,1434,1487,53
2016,9,24,19,1563,1446,1557,111
2016,9,24,20,1590,1459,1687,228
2016,9,24,21,1609,1483,1703,220
2016,9,24,22,1630,1508,1768,260
2016,9,24,23,1643,1539,1801,262
2016,9,25,0,1652,1566,1822,256
2016,9,25,1,1645,1568,1758,190
2016,9,25,2,1672,1638,1793,155
2016,9,25,3,1698,1630,1774,144
2016,9,25,4,1660,1574,1716,142
2016,9,25,5,1569,1483,1637,154
2016,9,25,6,1461,1388,1701,313
2016,9,25,7,1380,1327,1532,205
2016,9,25,8,1312,1277,1439,162
2016,9,25,9,1280,1241,1431,190
2016,9,25,10,1265,1223,1477,254
2016,9,25,11,1267,1226,1482,256
2016,9,25,12,1280,1240,1559,319
2016,9,25,13,1307,1277,1599,322
2016,9,25,14,1341,1297,1614,317
2016,9,25,15,1391,1348,1651,303
2016,9,25,16,1435,1396,1775,379
2016,9,25,17,1471,1417,1881,464
2016,9,25,18,1499,1436,1946,510
2016,9,25,19,1520,1452,2065,613
2016,9,25,20,1542,1474,2077,603
2016,9,25,21,1560,1498,2208,710
2016,9,25,22,1577,1527,2275,748
2016,9,25,23,1586,1560,2347,787
2016,9,26,0,1603,1594,2375,781
2016,9,26,1,1610,1598,2277,679
2016,9,26,2,1641,1686,2301,615
2016,9,26,3,1689,1677,2308,631
2016,9,26,4,1649,1600,2262,662
2016,9,26,5,1552,1484,2199,715
2016,9,26,6,1445,1358,2035,677
2016,9,26,7,1359,1299,2015,716
2016,9,26,8,1307,1264,1909,645
2016,9,26,9,1276,1239,1879,640
2016,9,26,10,1269,1231,1863,632
2016,9,26,11,1285,1256,1866,610
2016,9,26,12,1344,1325,1883,558
2016,9,26,13,1444,1451,1908,457
2016,9,26,14,1498,1492,1866,374
2016,9,26,15,1533,1517,1933,416
2016,9,26,16,1558,1518,1939,421
2016,9,26,17,1581,1540,2014,474
2016,9,26,18,1598,1551,2038,487
2016,9,26,19,1619,1567,2090,523
2016,9,26,20,1624,1601,2227,626
2016,9,26,21,1657,1603,2282,679
2016,9,26,22,1669,1599,2270,671
2016,9,26,23,1656,1613,2260,647
2016,9,27,0,1659,1628,2257,629
2016,9,27,1,1657,1628,2285,657
2016,9,27,2,1694,1687,2342,655
2016,9,27,3,1734,1686,2348,662
2016,9,27,4,1681,1601,2279,678
2016,9,27,5,1567,1478,2164,686
2016,9,27,6,1445,1357,2028,671
2016,9,27,7,1374,1282,1979,697
2016,9,27,8,1316,1243,1786,543
2016,9,27,9,1286,1228,1712,484
2016,9,27,10,1274,1217,1736,519
2016,9,27,11,1285,1241,1732,491
2016,9,27,12,1348,1309,1749,440
2016,9,27,13,1458,1446,1795,349
2016,9,27,14,1521,1494,1848,354
2016,9,27,15,1539,1504,1887,383
2016,9,27,16,1565,1501,1964,463
2016,9,27,17,1591,1523,1995,472
2016,9,27,18,1606,1566,2028,462
2016,9,27,19,1636,1579,2042,463
2016,9,27,20,1666,1617,2129,512
2016,9,27,21,1696,1643,2198,555
2016,9,27,22,1717,1690,2240,550
2016,9,27,23,1731,1730,2269,539
2016,9,28,0,1722,1739,2285,546
2016,9,28,1,1702,1721,2252,531
2016,9,28,2,1724,1774,2290,516
2016,9,28,3,1763,1768,2271,503
2016,9,28,4,1703,1675,2075,400
2016,9,28,5,1575,1531,1909,378
2016,9,28,6,1455,1407,1831,424
2016,9,28,7,1371,1328,1809,481
2016,9,28,8,1325,1282,1724,442
2016,9,28,9,1295,1249,1783,534
2016,9,28,10,1282,1241,1744,503
2016,9,28,11,1293,1260,1748,488
2016,9,28,12,1355,1321,1726,405
2016,9,28,13,1456,1459,1746,287
2016,9,28,14,1522,1497,1794,297
2016,9,28,15,1541,1514,1825,311
2016,9,28,16,1577,1548,1826,278
2016,9,28,17,1616,1588,1842,254
2016,9,28,18,1650,1629,1933,304
2016,9,28,19,1675,1681,2072,391
2016,9,28,20,1717,1726,2177,451
2016,9,28,21,1768,1788,2276,488
2016,9,28,22,1809,1843,2292,449
2016,9,28,23,1820,1874,2268,394
2016,9,29,0,1812,1849,2252,403
2016,9,29,1,1788,1812,2220,408
2016,9,29,2,1797,1879,2252,373
2016,9,29,3,1822,1849,2201,352
2016,9,29,4,1743,1756,2078,322
2016,9,29,5,1612,1604,2040,436
2016,9,29,6,1476,1468,1987,519
2016,9,29,7,1394,1383,1906,523
2016,9,29,8,1346,1338,1803,465
2016,9,29,9,1313,1308,1771,463
2016,9,29,10,1290,1289,1750,461
2016,9,29,11,1302,1307,1761,454
2016,9,29,12,1359,1385,1771,386
2016,9,29,13,1467,1509,1839,330
2016,9,29,14,1528,1555,1861,306
2016,9,29,15,1561,1581,1897,316
2016,9,29,16,1590,1623,1918,295
2016,9,29,17,1643,1668,2084,416
2016,9,29,18,1693,1721,2129,408
2016,9,29,19,1728,1759,2245,486
2016,9,29,20,1776,1802,2231,429
2016,9,29,21,1808,1831,2270,439
2016,9,29,22,1842,1877,2258,381
2016,9,29,23,1859,1901,2299,398
2016,9,30,0,1842,1874,2282,408
2016,9,30,1,1811,1824,2207,383
2016,9,30,2,1808,1829,2189,360
2016,9,30,3,1833,1803,2119,316
2016,9,30,4,1772,1704,2032,328
2016,9,30,5,1638,1553,1987,434
2016,9,30,6,1505,1426,1956,530
2016,9,30,7,1418,1352,1899,547
2016,9,30,8,1365,1307,1828,521
2016,9,30,9,1332,1278,1828,550
2016,9,30,10,1318,1272,1833,561
2016,9,30,11,1330,1288,1857,569
2016,9,30,12,1383,1351,1872,521
2016,9,30,13,1485,1473,1921,448
2016,9,30,14,1549,1512,1894,382
2016,9,30,15,1585,1541,1909,368
2016,9,30,16,1626,1561,1980,419
2016,9,30,17,1666,1584,2120,536
2016,9,30,18,1705,1614,2230,616
2016,9,30,19,1738,1632,2295,663
2016,9,30,20,1779,1687,2305,618
2016,9,30,21,1808,1738,2341,603
2016,9,30,22,1835,1769,2300,531
2016,9,30,23,1838,1790,2228,438
2016,10,1,0,1812,1785,2211,426
2016,10,1,1,1771,1743,2220,477
2016,10,1,2,1783,1774,2256,482
2016,10,1,3,1795,1749,2253,504
2016,10,1,4,1738,1676,2225,549
2016,10,1,5,1624,1556,2202,646
2016,10,1,6,1508,1446,2227,781
2016,10,1,7,1420,1364,2154,790
2016,10,1,8,1359,1312,2148,836
2016,10,1,9,1322,1285,2110,825
2016,10,1,10,1293,1272,2038,766
2016,10,1,11,1292,1279,1970,691
2016,10,1,12,1315,1307,1985,678
2016,10,1,13,1356,1354,2017,663
2016,10,1,14,1401,1373,1989,616
2016,10,1,15,1452,1420,2000,580
2016,10,1,16,1503,1477,2020,543
2016,10,1,17,1550,1526,2046,520
2016,10,1,18,1586,1569,2075,506
2016,10,1,19,1620,1608,2116,508
2016,10,1,20,1657,1640,2141,501
2016,10,1,21,1694,1670,2206,536
2016,10,1,22,1727,1695,2248,553
2016,10,1,23,1753,1729,2308,579
2016,10,2,0,1761,1747,2276,529
2016,10,2,1,1757,1737,2233,496
2016,10,2,2,1769,1787,2249,462
2016,10,2,3,1760,1745,2248,503
2016,10,2,4,1698,1667,2184,517
2016,10,2,5,1584,1554,2082,528
2016,10,2,6,1476,1438,2074,636
2016,10,2,7,1387,1363,2013,650
2016,10,2,8,1323,1309,1930,621
2016,10,2,9,1288,1272,1923,651
2016,10,2,10,1273,1258,1896,638
2016,10,2,11,1272,1257,1948,691
2016,10,2,12,1284,1272,1924,652
2016,10,2,13,1308,1308,1889,581
2016,10,2,14,1343,1321,1929,608
2016,10,2,15,1395,1371,1918,547
2016,10,2,16,1449,1427,1966,539
2016,10,2,17,1495,1482,1988,506
2016,10,2,18,1535,1542,2044,502
2016,10,2,19,1578,1598,2062,464
2016,10,2,20,1619,1651,2047,396
2016,10,2,21,1650,1689,1978,289
2016,10,2,22,1681,1734,2036,302
2016,10,2,23,1709,1775,2037,262
2016,10,3,0,1730,1805,2003,198
2016,10,3,1,1737,1804,2004,200
2016,10,3,2,1761,1849,2085,236
2016,10,3,3,1765,1799,2004,205
2016,10,3,4,1703,1691,1991,300
2016,10,3,5,1583,1550,1992,442
2016,10,3,6,1457,1427,1966,539
2016,10,3,7,1375,1345,1968,623
2016,10,3,8,1342,1303,1994,691
2016,10,3,9,1315,1280,2065,785
2016,10,3,10,1296,1272,2054,782
2016,10,3,11,1310,1295,2092,797
2016,10,3,12,1364,1355,2116,761
2016,10,3,13,1470,1481,2211,730
2016,10,3,14,1532,1537,2177,640
2016,10,3,15,1565,1567,2177,610
2016,10,3,16,1605,1610,2296,686
2016,10,3,17,1646,1646,2416,770
2016,10,3,18,1684,1674,2495,821
2016,10,3,19,1721,1687,2536,849
2016,10,3,20,1761,1711,2567,856
2016,10,3,21,1799,1741,2567,826
2016,10,3,22,1827,1759,2528,769
2016,10,3,23,1839,1773,2449,676
2016,10,4,0,1824,1746,2447,701
2016,10,4,1,1800,1730,2368,638
2016,10,4,2,1817,1801,2463,662
2016,10,4,3,1821,1765,2519,754
2016,10,4,4,1748,1669,2385,716
2016,10,4,5,1612,1535,2243,708
2016,10,4,6,1483,1408,2183,775
2016,10,4,7,1394,1326,2155,829
2016,10,4,8,1319,1283,2196,913
2016,10,4,9,1286,1255,2149,894
2016,10,4,10,1294,1239,2114,875
2016,10,4,11,1308,1262,2098,836
2016,10,4,12,1373,1329,2128,799
2016,10,4,13,1495,1464,2192,728
2016,10,4,14,1557,1500,2198,698
2016,10,4,15,1574,1515,2212,697
2016,10,4,16,1592,1435,2179,744
2016,10,4,17,1610,1523,2229,706
2016,10,4,18,1626,1532,2200,668
2016,10,4,19,1638,1366,2125,759
2016,10,4,20,1653,1546,2339,793
2016,10,4,21,1679,1571,2368,797
2016,10,4,22,1696,1594,2363,769
2016,10,4,23,1705,1618,2374,756
2016,10,5,0,1708,1623,2375,752
2016,10,5,1,1714,1625,2318,693
2016,10,5,2,1752,1706,2330,624
2016,10,5,3,1758,1695,2216,521
2016,10,5,4,1684,1612,2120,508
2016,10,5,5,1561,1475,1989,514
2016,10,5,6,1447,1363,2029,666
2016,10,5,7,1371,1299,2016,717
2016,10,5,8,1310,1261,2004,743
2016,10,5,9,1289,1246,1958,712
2016,10,5,10,1289,1243,1831,588
2016,10,5,11,1306,1266,1892,626
2016,10,5,12,1376,1341,1946,605
2016,10,5,13,1500,1483,2006,523
2016,10,5,14,1566,1528,1981,453
2016,10,5,15,1570,1532,1967,435
2016,10,5,16,1591,1528,1985,457
2016,10,5,17,1608,1533,2019,486
2016,10,5,18,1620,1535,2021,486
2016,10,5,19,1632,1549,2019,470
2016,10,5,20,1651,1561,1991,430
2016,10,5,21,1668,1589,1886,297
2016,10,5,22,1698,1617,2051,434
2016,10,5,23,1708,1646,2033,387
2016,10,6,0,1708,1648,2006,358
2016,10,6,1,1719,1667,1937,270
2016,10,6,2,1755,1748,2006,258
2016,10,6,3,1779,1723,1981,258
2016,10,6,4,1703,1633,1973,340
2016,10,6,5,1582,1497,1946,449
2016,10,6,6,1462,1387,2019,632
2016,10,6,7,1379,1315,2041,726
2016,10,6,8,1317,1274,2121,847
2016,10,6,9,1292,1244,2105,861
2016,10,6,10,1276,1241,2071,830
2016,10,6,11,1299,1266,2094,828
2016,10,6,12,1366,1339,2056,717
2016,10,6,13,1485,1467,2115,648
2016,10,6,14,1548,1512,2148,636
2016,10,6,15,1562,1520,2153,633
2016,10,6,16,1577,1532,2168,636
2016,10,6,17,1587,1535,2324,789
2016,10,6,18,1599,1542,2394,852
2016,10,6,19,1614,1552,2501,949
2016,10,6,20,1634,1572,2524,952
2016,10,6,21,1652,1605,2535,930
2016,10,6,22,1665,1617,2500,883
2016,10,6,23,1676,1635,2551,916
2016,10,7,0,1667,1629,2428,799
2016,10,7,1,1660,1638,2289,651
2016,10,7,2,1697,1717,2239,522
2016,10,7,3,1742,1695,2247,552
2016,10,7,4,1677,1616,2197,581
2016,10,7,5,1560,1493,2161,668
2016,10,7,6,1444,1373,2206,833
2016,10,7,7,1369,1308,2150,842
2016,10,7,8,1312,1270,2175,905
2016,10,7,9,1282,1245,2146,901
2016,10,7,10,1279,1237,2109,872
2016,10,7,11,1300,1262,2089,827
2016,10,7,12,1364,1327,2094,767
2016,10,7,13,1477,1451,2152,701
2016,10,7,14,1545,1494,2149,655
2016,10,7,15,1554,1511,2164,653
2016,10,7,16,1563,1514,2178,664
2016,10,7,17,1578,1526,2305,779
2016,10,7,18,1581,1527,2250,723
2016,10,7,19,1592,1524,2255,731
2016,10,7,20,1598,1537,2168,631
2016,10,7,21,1610,1546,2221,675
2016,10,7,22,1620,1568,2265,697
2016,10,7,23,1629,1578,2271,693
2016,10,8,0,1620,1588,2250,662
2016,10,8,1,1628,1593,2195,602
2016,10,8,2,1666,1661,2270,609
2016,10,8,3,1697,1657,2224,567
2016,10,8,4,1654,1612,2114,502
2016,10,8,5,1559,1514,2086,572
2016,10,8,6,1460,1413,2114,701
2016,10,8,7,1384,1347,2035,688
2016,10,8,8,1332,1302,2010,708
2016,10,8,9,1303,1278,1992,714
2016,10,8,10,1287,1266,1965,699
2016,10,8,11,1294,1275,1971,696
2016,10,8,12,1321,1307,1976,669
2016,10,8,13,1367,1365,2019,654
2016,10,8,14,1408,1401,2001,600
2016,10,8,15,1451,1480,2052,572
2016,10,8,16,1479,1487,2081,594
2016,10,8,17,1495,1501,2107,606
2016,10,8,18,1499,1508,2117,609
2016,10,8,19,1503,1497,2107,610
2016,10,8,20,1508,1490,2129,639
2016,10,8,21,1519,1491,2109,618
2016,10,8,22,1522,1489,2143,654
2016,10,8,23,1537,1511,2177,666
2016,10,9,0,1550,1537,2199,662
2016,10,9,1,1585,1595,2228,633
2016,10,9,2,1625,1649,2271,622
2016,10,9,3,1658,1630,2306,676
2016,10,9,4,1618,1569,2177,608
2016,10,9,5,1538,1473,2164,691
2016,10,9,6,1445,1384,2158,774
2016,10,9,7,1371,1308,1981,673
2016,10,9,8,1316,1262,1891,629
2016,10,9,9,1288,1235,1854,619
2016,10,9,10,1270,1222,1740,518
2016,10,9,11,1272,1235,1778,543
2016,10,9,12,1289,1256,1784,528
2016,10,9,13,1321,1300,1845,545
2016,10,9,14,1349,1345,1867,522
2016,10,9,15,1396,1375,1828,453
2016,10,9,16,1436,1431,1863,432
2016,10,9,17,1462,1447,1940,493
2016,10,9,18,1474,1455,2032,577
2016,10,9,19,1492,1456,2185,729
2016,10,9,20,1506,1468,2242,774
2016,10,9,21,1519,1484,2224,740
2016,10,9,22,1532,1510,2194,684
2016,10,9,23,1559,1553,2239,686
2016,10,10,0,1584,1584,2305,721
2016,10,10,1,1621,1580,2313,733
2016,10,10,2,1667,1616,2277,661
2016,10,10,3,1698,1589,2172,583
2016,10,10,4,1647,1545,2070,525
2016,10,10,5,1544,1444,2018,574
2016,10,10,6,1433,1356,1957,601
2016,10,10,7,1359,1298,1949,651
2016,10,10,8,1292,1256,1994,738
2016,10,10,9,1264,1232,2024,792
2016,10,10,10,1264,1230,2046,816
2016,10,10,11,1286,1247,2051,804
2016,10,10,12,1348,1307,2091,784
2016,10,10,13,1463,1422,2092,670
2016,10,10,14,1527,1479,2131,652
2016,10,10,15,1548,1497,2043,546
2016,10,10,16,1573,1504,2063,559
2016,10,10,17,1604,1526,2127,601
2016,10,10,18,1631,1538,2197,659
2016,10,10,19,1649,1551,2279,728
2016,10,10,20,1679,1561,2316,755
2016,10,10,21,1709,1595,2461,866
2016,10,10,22,1738,1624,2483,859
2016,10,10,23,1764,1659,2450,791
2016,10,11,0,1751,1668,2378,710
2016,10,11,1,1749,1687,2254,567
2016,10,11,2,1777,1746,2429,683
2016,10,11,3,1793,1713,2360,647
2016,10,11,4,1716,1618,2352,734
2016,10,11,5,1586,1496,2217,721
2016,10,11,6,1463,1384,2044,660
2016,10,11,7,1374,1314,2043,729
2016,10,11,8,1300,1277,2089,812
2016,10,11,9,1263,1251,2093,842
2016,10,11,10,1250,1238,2062,824
2016,10,11,11,1270,1266,2050,784
2016,10,11,12,1328,1326,2085,759
2016,10,11,13,1441,1464,2148,684
2016,10,11,14,1516,1507,2221,714
2016,10,11,15,1533,1526,2214,688
2016,10,11,16,1571,1595,2199,604
2016,10,11,17,1614,1566,2123,557
2016,10,11,18,1645,1603,2182,579
2016,10,11,19,1664,1615,2166,551
2016,10,11,20,1699,1649,2201,552
2016,10,11,21,1731,1673,2340,667
2016,10,11,22,1765,1704,2407,703
2016,10,11,23,1787,1735,2472,737
2016,10,12,0,1783,1735,2414,679
2016,10,12,1,1781,1747,2437,690
2016,10,12,2,1813,1792,2518,726
2016,10,12,3,1810,1748,2451,703
2016,10,12,4,1720,1636,2384,748
2016,10,12,5,1593,1490,2214,724
2016,10,12,6,1465,1372,2161,789
2016,10,12,7,1385,1304,2143,839
2016,10,12,8,1326,1252,2173,921
2016,10,12,9,1289,1231,2147,916
2016,10,12,10,1271,1226,2003,777
2016,10,12,11,1284,1241,2000,759
2016,10,12,12,1345,1320,1988,668
2016,10,12,13,1462,1463,2007,544
2016,10,12,14,1538,1510,2085,575
2016,10,12,15,1557,1518,2117,599
2016,10,12,16,1575,1528,2134,606
2016,10,12,17,1609,1557,2229,672
2016,10,12,18,1629,1585,2262,677
2016,10,12,19,1654,1603,2304,701
2016,10,12,20,1682,1638,2344,706
2016,10,12,21,1714,1677,2372,695
2016,10,12,22,1736,1712,2343,631
2016,10,12,23,1754,1736,2320,584
2016,10,13,0,1747,1716,2289,573
2016,10,13,1,1748,1729,2313,584
2016,10,13,2,1775,1771,2338,567
2016,10,13,3,1779,1741,2298,557
2016,10,13,4,1704,1651,2188,537
2016,10,13,5,1588,1513,2121,608
2016,10,13,6,1463,1391,2085,694
2016,10,13,7,1382,1331,1993,662
2016,10,13,8,1322,1281,1992,711
2016,10,13,9,1291,1254,1917,663
2016,10,13,10,1281,1251,1899,648
2016,10,13,11,1302,1272,1882,610
2016,10,13,12,1359,1346,1887,541
2016,10,13,13,1489,1488,1937,449
2016,10,13,14,1551,1537,2064,527
2016,10,13,15,1568,1541,2062,521
2016,10,13,16,1591,1543,2000,457
2016,10,13,17,1598,1554,2007,453
2016,10,13,18,1610,1565,2028,463
2016,10,13,19,1622,1580,2053,473
2016,10,13,20,1656,1611,2096,485
2016,10,13,21,1677,1648,2166,518
2016,10,13,22,1697,1681,2202,521
2016,10,13,23,1724,1698,2199,501
2016,10,14,0,1718,1698,2211,513
2016,10,14,1,1715,1706,2189,483
2016,10,14,2,1750,1758,2213,455
2016,10,14,3,1753,1716,2193,477
2016,10,14,4,1674,1627,2134,507
2016,10,14,5,1552,1497,2007,510
2016,10,14,6,1439,1382,2067,685
2016,10,14,7,1369,1310,2032,722
2016,10,14,8,1318,1272,1879,607
2016,10,14,9,1292,1244,1861,617
2016,10,14,10,1271,1237,1842,605
2016,10,14,11,1288,1256,1873,617
2016,10,14,12,1347,1327,1940,613
2016,10,14,13,1464,1460,2019,559
2016,10,14,14,1528,1514,2154,640
2016,10,14,15,1550,1512,2104,592
2016,10,14,16,1565,1516,2125,609
2016,10,14,17,1587,1532,2154,622
2016,10,14,18,1608,1554,2196,642
2016,10,14,19,1622,1571,2230,659
2016,10,14,20,1645,1593,2224,631
2016,10,14,21,1677,1626,2286,660
2016,10,14,22,1701,1651,2342,691
2016,10,14,23,1731,1676,2394,718
2016,10,15,0,1715,1668,2358,690
2016,10,15,1,1706,1662,2359,697
2016,10,15,2,1730,1703,2373,670
2016,10,15,3,1733,1680,2319,639
2016,10,15,4,1669,1603,2237,634
2016,10,15,5,1568,1500,2243,743
2016,10,15,6,1459,1400,2239,839
2016,10,15,7,1377,1325,2240,915
2016,10,15,8,1322,1281,2145,864
2016,10,15,9,1290,1257,2047,790
2016,10,15,10,1268,1237,2021,784
2016,10,15,11,1269,1244,2000,756
2016,10,15,12,1295,1280,1991,711
2016,10,15,13,1347,1335,1973,638
2016,10,15,14,1397,1360,2034,674
2016,10,15,15,1441,1408,2040,632
2016,10,15,16,1482,1435,2076,641
2016,10,15,17,1506,1453,2138,685
2016,10,15,18,1535,1471,2276,805
2016,10,15,19,1551,1485,2344,859
2016,10,15,20,1576,1513,2339,826
2016,10,15,21,1612,1548,2357,809
2016,10,15,22,1644,1592,2390,798
2016,10,15,23,1670,1643,2369,726
2016,10,16,0,1688,1665,2354,689
2016,10,16,1,1707,1674,2246,572
2016,10,16,2,1738,1714,2293,579
2016,10,16,3,1712,1658,2238,580
2016,10,16,4,1647,1584,2287,703
2016,10,16,5,1549,1487,2234,747
2016,10,16,6,1445,1390,2155,765
2016,10,16,7,1364,1322,2045,723
2016,10,16,8,1313,1277,1863,586
2016,10,16,9,1276,1248,1836,588
2016,10,16,10,1259,1229,1742,513
2016,10,16,11,1259,1230,1775,545
2016,10,16,12,1271,1250,1833,583
2016,10,16,13,1304,1291,1844,553
2016,10,16,14,1340,1299,1852,553
2016,10,16,15,1390,1345,1815,470
2016,10,16,16,1437,1385,1911,526
2016,10,16,17,1470,1408,2077,669
2016,10,16,18,1499,1450,2191,741
2016,10,16,19,1530,1484,2264,780
2016,10,16,20,1558,1522,2327,805
2016,10,16,21,1587,1561,2489,928
2016,10,16,22,1618,1605,2535,930
2016,10,16,23,1651,1645,2429,784
2016,10,17,0,1675,1673,2402,729
2016,10,17,1,1699,1705,2425,720
2016,10,17,2,1744,1754,2473,719
2016,10,17,3,1723,1700,2398,698
2016,10,17,4,1651,1606,2358,752
2016,10,17,5,1538,1475,2290,815
2016,10,17,6,1423,1363,2196,833
2016,10,17,7,1341,1295,2127,832
2016,10,17,8,1295,1258,2054,796
2016,10,17,9,1268,1234,2013,779
2016,10,17,10,1259,1224,1976,752
2016,10,17,11,1275,1242,1949,707
2016,10,17,12,1334,1314,1959,645
2016,10,17,13,1444,1455,2098,643
2016,10,17,14,1505,1516,2305,789
2016,10,17,15,1531,1530,2297,767
2016,10,17,16,1582,1534,2213,679
2016,10,17,17,1602,1559,2362,803
2016,10,17,18,1649,1581,2405,824
2016,10,17,19,1670,1610,2401,791
2016,10,17,20,1714,1650,2379,729
2016,10,17,21,1758,1693,2451,758
2016,10,17,22,1799,1734,2422,688
2016,10,17,23,1814,1770,2384,614
2016,10,18,0,1806,1770,2373,603
2016,10,18,1,1797,1780,2368,588
2016,10,18,2,1830,1814,2393,579
2016,10,18,3,1818,1767,2367,600
2016,10,18,4,1726,1668,2275,607
2016,10,18,5,1585,1524,2302,778
2016,10,18,6,1457,1406,2243,837
2016,10,18,7,1369,1333,2090,757
2016,10,18,8,1313,1273,1930,657
2016,10,18,9,1286,1249,1885,636
2016,10,18,10,1269,1238,1907,669
2016,10,18,11,1284,1253,1930,677
2016,10,18,12,1349,1316,2015,699
2016,10,18,13,1473,1448,2142,694
2016,10,18,14,1540,1494,2236,742
2016,10,18,15,1546,1506,2189,683
2016,10,18,16,1567,1513,2102,589
2016,10,18,17,1595,1553,2106,553
2016,10,18,18,1622,1573,2183,610
2016,10,18,19,1642,1598,2181,583
2016,10,18,20,1676,1640,2187,547
2016,10,18,21,1716,1682,2226,544
2016,10,18,22,1742,1707,2255,548
2016,10,18,23,1763,1734,2292,558
2016,10,19,0,1765,1725,2312,587
2016,10,19,1,1758,1739,2323,584
2016,10,19,2,1794,1768,2421,653
2016,10,19,3,1776,1725,2370,645
2016,10,19,4,1690,1624,2320,696
2016,10,19,5,1562,1487,2260,773
2016,10,19,6,1443,1291,2118,827
2016,10,19,7,1360,1293,2149,856
2016,10,19,8,1321,1246,2090,844
2016,10,19,9,1295,1230,2106,876
2016,10,19,10,1283,1220,2078,858
2016,10,19,11,1297,1240,2048,808
2016,10,19,12,1357,1303,2052,749
2016,10,19,13,1480,1440,2078,638
2016,10,19,14,1549,1487,2156,669
2016,10,19,15,1567,1495,2133,638
2016,10,19,16,1583,1510,2142,632
2016,10,19,17,1598,1515,2130,615
2016,10,19,18,1613,1526,2110,584
2016,10,19,19,1624,1536,2172,636
2016,10,19,20,1651,1561,2240,679
2016,10,19,21,1665,1585,2325,740
2016,10,19,22,1693,1605,2373,768
2016,10,19,23,1706,1616,2487,871
2016,10,20,0,1705,1614,2480,866
2016,10,20,1,1717,1658,2507,849
2016,10,20,2,1759,1699,2535,836
2016,10,20,3,1749,1662,2408,746
2016,10,20,4,1669,1583,2365,782
2016,10,20,5,1554,1419,2278,859
2016,10,20,6,1439,1338,2267,929
2016,10,20,7,1367,1290,2236,946
2016,10,20,8,1306,1209,2087,878
2016,10,20,9,1284,1218,2015,797
2016,10,20,10,1273,1222,1942,720
2016,10,20,11,1289,1241,1993,752
2016,10,20,12,1354,1314,2057,743
2016,10,20,13,1485,1467,2100,633
2016,10,20,14,1552,1532,2109,577
2016,10,20,15,1564,1519,2172,653
2016,10,20,16,1566,1513,2231,718
2016,10,20,17,1568,1512,2250,738
2016,10,20,18,1568,1506,2286,780
2016,10,20,19,1566,1510,2261,751
2016,10,20,20,1578,1519,2264,745
2016,10,20,21,1589,1534,2284,750
2016,10,20,22,1593,1546,2228,682
2016,10,20,23,1616,1558,2244,686
2016,10,21,0,1613,1572,2185,613
2016,10,21,1,1647,1622,2197,575
2016,10,21,2,1693,1676,2232,556
2016,10,21,3,1707,1660,2199,539
2016,10,21,4,1638,1591,2232,641
2016,10,21,5,1525,1469,2186,717
2016,10,21,6,1410,1363,2205,842
2016,10,21,7,1346,1299,2175,876
2016,10,21,8,1292,1264,2159,895
2016,10,21,9,1275,1245,2148,903
2016,10,21,10,1270,1233,2081,848
2016,10,21,11,1292,1264,2047,783
2016,10,21,12,1350,1331,2134,803
2016,10,21,13,1475,1467,2238,771
2016,10,21,14,1547,1531,2231,700
2016,10,21,15,1555,1525,2258,733
2016,10,21,16,1555,1505,2157,652
2016,10,21,17,1550,1513,2151,638
2016,10,21,18,1548,1499,2133,634
2016,10,21,19,1545,1500,2242,742
2016,10,21,20,1549,1514,2301,787
2016,10,21,21,1564,1525,2301,776
2016,10,21,22,1574,1545,2282,737
2016,10,21,23,1589,1552,2247,695
2016,10,22,0,1582,1569,2124,555
2016,10,22,1,1619,1610,2176,566
2016,10,22,2,1661,1649,2263,614
2016,10,22,3,1672,1612,2197,585
2016,10,22,4,1612,1554,2185,631
2016,10,22,5,1509,1465,2216,751
2016,10,22,6,1413,1369,2197,828
2016,10,22,7,1347,1306,2221,915
2016,10,22,8,1304,1257,2182,925
2016,10,22,9,1268,1240,2072,832
2016,10,22,10,1244,1235,2073,838
2016,10,22,11,1253,1239,2033,794
2016,10,22,12,1281,1231,1988,757
2016,10,22,13,1340,1335,1965,630
2016,10,22,14,1391,1369,2040,671
2016,10,22,15,1435,1402,2062,660
2016,10,22,16,1462,1423,2052,629
2016,10,22,17,1467,1434,2047,613
2016,10,22,18,1474,1441,1983,542
2016,10,22,19,1477,1446,2181,735
2016,10,22,20,1491,1457,2287,830
2016,10,22,21,1516,1482,2334,852
2016,10,22,22,1538,1516,2315,799
2016,10,22,23,1555,1558,2252,694
2016,10,23,0,1577,1587,2201,614
2016,10,23,1,1608,1631,2226,595
2016,10,23,2,1636,1665,2252,587
2016,10,23,3,1650,1620,2223,603
2016,10,23,4,1601,1548,2267,719
2016,10,23,5,1511,1458,2211,753
2016,10,23,6,1420,1354,2192,838
2016,10,23,7,1349,1293,2188,895
2016,10,23,8,1298,1248,2054,806
2016,10,23,9,1268,1233,1990,757
2016,10,23,10,1248,1218,1868,650
2016,10,23,11,1248,1222,1828,606
2016,10,23,12,1253,1243,1826,583
2016,10,23,13,1297,1291,1797,506
2016,10,23,14,1339,1317,1838,521
2016,10,23,15,1386,1352,1820,468
2016,10,23,16,1423,1384,1828,444
2016,10,23,17,1442,1415,1939,524
2016,10,23,18,1459,1445,1916,471
2016,10,23,19,1482,1467,1995,528
2016,10,23,20,1504,1505,2180,675
2016,10,23,21,1529,1530,2210,680
2016,10,23,22,1555,1576,2188,612
2016,10,23,23,1584,1623,2154,531
2016,10,24,0,1609,1657,2187,530
2016,10,24,1,1638,1710,2209,499
2016,10,24,2,1684,1732,2254,522
2016,10,24,3,1678,1671,2202,531
2016,10,24,4,1616,1585,2162,577
2016,10,24,5,1511,1464,2182,718
2016,10,24,6,1405,1351,2163,812
2016,10,24,7,1331,1283,2080,797
2016,10,24,8,1292,1246,1932,686
2016,10,24,9,1261,1221,1907,686
2016,10,24,10,1254,1226,1902,676
2016,10,24,11,1272,1249,1885,636
2016,10,24,12,1328,1328,1919,591
2016,10,24,13,1447,1468,2046,578
2016,10,24,14,1517,1531,2162,631
2016,10,24,15,1542,1518,2149,631
2016,10,24,16,1566,1518,2165,647
2016,10,24,17,1599,1492,2215,723
2016,10,24,18,1619,1515,2232,717
2016,10,24,19,1639,1538,2222,684
2016,10,24,20,1668,1575,2171,596
2016,10,24,21,1705,1608,2198,590
2016,10,24,22,1730,1637,2223,586
2016,10,24,23,1742,1675,2160,485
2016,10,25,0,1727,1660,2058,398
2016,10,25,1,1731,1721,2091,370
2016,10,25,2,1773,1736,2183,447
2016,10,25,3,1763,1703,2182,479
2016,10,25,4,1683,1614,2185,571
2016,10,25,5,1561,1477,2170,693
2016,10,25,6,1431,1359,2109,750
2016,10,25,7,1359,1291,2037,746
2016,10,25,8,1304,1243,1969,726
2016,10,25,9,1283,1223,1940,717
2016,10,25,10,1273,1218,1925,707
2016,10,25,11,1289,1245,1889,644
2016,10,25,12,1347,1324,1930,606
2016,10,25,13,1471,1421,2041,620
2016,10,25,14,1543,1543,2294,751
2016,10,25,15,1560,1524,2174,650
2016,10,25,16,1574,1539,2169,630
2016,10,25,17,1600,1556,2175,619
2016,10,25,18,1619,1547,2171,624
2016,10,25,19,1630,1571,2072,501
2016,10,25,20,1661,1594,2196,602
2016,10,25,21,1684,1631,2235,604
2016,10,25,22,1707,1632,2265,633
2016,10,25,23,1731,1635,2426,791
2016,10,26,0,1731,1625,2386,761
2016,10,26,1,1759,1670,2331,661
2016,10,26,2,1783,1713,2356,643
2016,10,26,3,1756,1682,2338,656
2016,10,26,4,1678,1598,2289,691
2016,10,26,5,1550,1471,2220,749
2016,10,26,6,1423,1352,2078,726
2016,10,26,7,1349,1286,2009,723
2016,10,26,8,1302,1244,1977,733
2016,10,26,9,1278,1217,1856,639
2016,10,26,10,1279,1212,1788,576
2016,10,26,11,1289,1230,1834,604
2016,10,26,12,1357,1303,1866,563
2016,10,26,13,1483,1459,1950,491
2016,10,26,14,1559,1518,2151,633
2016,10,26,15,1564,1517,2048,531
2016,10,26,16,1573,1511,2042,531
2016,10,26,17,1562,1525,2075,550
2016,10,26,18,1581,1530,2062,532
2016,10,26,19,1605,1560,2127,567
2016,10,26,20,1636,1555,2054,499
2016,10,26,21,1663,1618,2156,538
2016,10,26,22,1699,1650,2219,569
2016,10,26,23,1749,1663,2201,538
2016,10,27,0,1745,1675,2145,470
2016,10,27,1,1753,1717,2097,380
2016,10,27,2,1787,1736,2128,392
2016,10,27,3,1769,1699,2154,455
2016,10,27,4,1690,1598,2197,599
2016,10,27,5,1555,1472,2133,661
2016,10,27,6,1428,1363,2115,752
2016,10,27,7,1359,1283,2056,773
2016,10,27,8,1306,1228,1906,678
2016,10,27,9,1281,1233,1926,693
2016,10,27,10,1276,1225,1851,626
2016,10,27,11,1291,1243,1830,587
2016,10,27,12,1352,1326,1840,514
2016,10,27,13,1481,1475,1874,399
2016,10,27,14,1558,1530,1979,449
2016,10,27,15,1562,1529,2023,494
2016,10,27,16,1568,1545,2085,540
2016,10,27,17,1585,1550,2092,542
2016,10,27,18,1601,1563,2136,573
2016,10,27,19,1624,1582,2199,617
2016,10,27,20,1649,1616,2260,644
2016,10,27,21,1674,1640,2231,591
2016,10,27,22,1696,1662,2179,517
2016,10,27,23,1713,1687,2197,510
2016,10,28,0,1710,1670,2133,463
2016,10,28,1,1717,1726,2106,380
2016,10,28,2,1753,1745,2089,344
2016,10,28,3,1745,1705,2129,424
2016,10,28,4,1679,1611,2211,600
2016,10,28,5,1561,1497,2147,650
2016,10,28,6,1440,1384,2116,732
2016,10,28,7,1366,1317,2075,758
2016,10,28,8,1304,1270,2067,797
2016,10,28,9,1283,1248,2064,816
2016,10,28,10,1271,1242,2022,780
2016,10,28,11,1285,1261,2021,760
2016,10,28,12,1340,1328,2064,736
2016,10,28,13,1467,1452,2132,680
2016,10,28,14,1539,1525,2127,602
2016,10,28,15,1555,1523,2143,620
2016,10,28,16,1569,1531,2132,601
2016,10,28,17,1590,1539,2173,634
2016,10,28,18,1604,1551,2245,694
2016,10,28,19,1613,1556,2296,740
2016,10,28,20,1631,1569,2264,695
2016,10,28,21,1651,1579,2294,715
2016,10,28,22,1662,1603,2282,679
2016,10,28,23,1679,1610,2212,602
2016,10,29,0,1675,1577,2224,647
2016,10,29,1,1698,1652,2221,569
2016,10,29,2,1726,1630,2238,608
2016,10,29,3,1720,1644,2199,555
2016,10,29,4,1650,1593,2169,576
2016,10,29,5,1544,1496,2134,638
2016,10,29,6,1436,1390,2138,748
2016,10,29,7,1357,1326,2028,702
2016,10,29,8,1305,1286,2006,720
2016,10,29,9,1271,1259,1956,697
2016,10,29,10,1260,1245,1910,665
2016,10,29,11,1258,1247,1926,679
2016,10,29,12,1286,1281,1961,680
2016,10,29,13,1347,1333,1950,617
2016,10,29,14,1406,1378,1967,589
2016,10,29,15,1447,1409,1946,537
2016,10,29,16,1479,1436,1924,488
2016,10,29,17,1501,1461,1989,528
2016,10,29,18,1516,1472,1956,484
2016,10,29,19,1528,1492,2088,596
2016,10,29,20,1545,1519,2095,576
2016,10,29,21,1573,1545,2138,593
2016,10,29,22,1599,1574,2255,681
2016,10,29,23,1626,1600,2259,659
2016,10,30,0,1646,1620,2202,582
2016,10,30,1,1686,1678,2234,556
2016,10,30,2,1716,1682,2253,571
2016,10,30,3,1682,1636,2215,579
2016,10,30,4,1617,1572,2045,473
2016,10,30,5,1526,1480,2024,544
2016,10,30,6,1427,1385,2036,651
2016,10,30,7,1351,1316,1968,652
2016,10,30,8,1299,1269,1841,572
2016,10,30,9,1266,1238,1784,546
2016,10,30,10,1255,1231,1487,256
2016,10,30,11,1252,1243,1408,165
2016,10,30,12,1272,1263,1397,134
2016,10,30,13,1301,1304,1413,109
2016,10,30,14,1339,1328,1397,69
2016,10,30,15,1381,1360,1396,36
2016,10,30,16,1415,1405,1441,36
2016,10,30,17,1447,1421,1569,148
2016,10,30,18,1473,1451,1623,172
2016,10,30,19,1494,1475,1590,115
2016,10,30,20,1522,1500,1773,273
2016,10,30,21,1554,1500,1948,448
2016,10,30,22,1584,1547,2039,492
2016,10,30,23,1620,1575,1993,418
2016,10,31,0,1655,1595,2050,455
2016,10,31,1,1706,1677,2087,410
2016,10,31,2,1744,1699,2084,385
2016,10,31,3,1715,1669,2098,429
2016,10,31,4,1639,1589,2074,485
2016,10,31,5,1520,1481,2021,540
2016,10,31,6,1407,1372,1987,615
2016,10,31,7,1333,1301,1898,597
2016,10,31,8,1293,1258,1916,658
2016,10,31,9,1271,1237,1907,670
2016,10,31,10,1256,1236,1888,652
2016,10,31,11,1275,1254,1879,625
2016,10,31,12,1329,1321,1891,570
2016,10,31,13,1448,1458,1895,437
2016,10,31,14,1527,1540,1977,437
2016,10,31,15,1547,1529,1999,470
2016,10,31,16,1561,1549,2004,455
2016,10,31,17,1577,1567,2109,542
2016,10,31,18,1606,1587,2201,614
2016,10,31,19,1618,1598,2278,680
2016,10,31,20,1648,1613,2304,691
2016,10,31,21,1676,1622,2332,710
2016,10,31,22,1692,1633,2294,661
2016,10,31,23,1706,1633,2244,611
2016,11,1,0,1708,1619,2167,548
2016,11,1,1,1741,1661,2225,564
2016,11,1,2,1772,1637,2190,553
2016,11,1,3,1760,1621,2209,588
2016,11,1,4,1667,1576,2147,571
2016,11,1,5,1539,1456,2174,718
2016,11,1,6,1426,1303,1992,689
2016,11,1,7,1357,1301,1973,672
2016,11,1,8,1346,1256,1886,630
2016,11,1,9,1320,1241,1810,569
2016,11,1,10,1312,1237,1757,520
2016,11,1,11,1327,1260,1781,521
2016,11,1,12,1386,1327,1776,449
2016,11,1,13,1506,1469,1834,365
2016,11,1,14,1577,1539,1972,433
2016,11,1,15,1566,1519,1991,472
2016,11,1,16,1578,1511,1897,386
2016,11,1,17,1593,1547,1898,351
2016,11,1,18,1608,1541,1944,403
2016,11,1,19,1618,1538,1947,409
2016,11,1,20,1617,1553,2070,517
2016,11,1,21,1631,1555,2090,535
2016,11,1,22,1655,1548,2143,595
2016,11,1,23,1645,1564,2167,603
2016,11,2,0,1659,1575,2223,648
2016,11,2,1,1695,1661,2303,642
2016,11,2,2,1747,1704,2372,668
2016,11,2,3,1750,1672,2332,660
2016,11,2,4,1672,1589,2242,653
2016,11,2,5,1549,1463,2216,753
2016,11,2,6,1431,1365,2073,708
2016,11,2,7,1357,1298,1953,655
2016,11,2,8,1302,1246,1876,630
2016,11,2,9,1285,1249,1845,596
2016,11,2,10,1280,1244,1806,562
2016,11,2,11,1296,1272,1785,513
2016,11,2,12,1362,1347,1803,456
2016,11,2,13,1492,1486,1930,444
2016,11,2,14,1578,1547,2035,488
2016,11,2,15,1567,1516,1981,465
2016,11,2,16,1572,1509,1926,417
2016,11,2,17,1573,1503,1878,375
2016,11,2,18,1571,1513,1899,386
2016,11,2,19,1588,1516,1932,416
2016,11,2,20,1594,1524,2013,489
2016,11,2,21,1612,1554,2046,492
2016,11,2,22,1626,1571,2075,504
2016,11,2,23,1631,1579,2052,473
2016,11,3,0,1647,1584,2056,472
2016,11,3,1,1688,1678,2205,527
2016,11,3,2,1714,1710,2303,593
2016,11,3,3,1720,1675,2280,605
2016,11,3,4,1654,1601,2168,567
2016,11,3,5,1538,1488,2121,633
2016,11,3,6,1419,1377,2117,740
2016,11,3,7,1355,1303,2000,697
2016,11,3,8,1304,1259,2001,742
2016,11,3,9,1289,1237,1921,684
2016,11,3,10,1274,1201,1890,689
2016,11,3,11,1290,1202,1879,677
2016,11,3,12,1359,1338,1988,650
2016,11,3,13,1495,1487,2034,547
2016,11,3,14,1583,1560,2221,661
2016,11,3,15,1587,1548,2229,681
2016,11,3,16,1581,1558,2184,626
2016,11,3,17,1583,1544,2174,630
2016,11,3,18,1584,1546,2197,651
2016,11,3,19,1587,1524,2250,726
2016,11,3,20,1590,1537,2295,758
2016,11,3,21,1603,1532,2270,738
2016,11,3,22,1613,1534,2257,723
2016,11,3,23,1612,1546,2242,696
2016,11,4,0,1617,1566,2170,604
2016,11,4,1,1666,1653,2199,546
2016,11,4,2,1702,1689,2267,578
2016,11,4,3,1716,1667,2278,611
2016,11,4,4,1650,1589,2227,638
2016,11,4,5,1543,1462,2174,712
2016,11,4,6,1433,1372,2072,700
2016,11,4,7,1363,1304,2061,757
2016,11,4,8,1303,1267,1826,559
2016,11,4,9,1282,1250,1729,479
2016,11,4,10,1271,1228,1684,456
2016,11,4,11,1293,1214,1668,454
2016,11,4,12,1355,1281,1698,417
2016,11,4,13,1478,1450,1805,355
2016,11,4,14,1554,1526,1859,333
2016,11,4,15,1565,1523,1798,275
2016,11,4,16,1570,1550,1824,274
2016,11,4,17,1573,1543,1885,342
2016,11,4,18,1576,1531,1895,364
2016,11,4,19,1565,1540,1873,333
2016,11,4,20,1555,1567,1878,311
2016,11,4,21,1565,1559,1835,276
2016,11,4,22,1569,1548,1737,189
2016,11,4,23,1572,1557,1737,180
2016,11,5,0,1581,1590,1751,161
2016,11,5,1,1651,1660,1815,155
2016,11,5,2,1689,1657,1802,145
2016,11,5,3,1688,1630,1762,132
2016,11,5,4,1629,1571,1760,189
2016,11,5,5,1536,1496,1736,240
2016,11,5,6,1439,1398,1762,364
2016,11,5,7,1373,1332,1750,418
2016,11,5,8,1306,1292,1759,467
2016,11,5,9,1282,1262,1715,453
2016,11,5,10,1270,1252,1710,458
2016,11,5,11,1273,1255,1698,443
2016,11,5,12,1300,1280,1703,423
2016,11,5,13,1377,1323,1697,374
2016,11,5,14,1440,1391,1723,332
2016,11,5,15,1477,1440,1732,292
2016,11,5,16,1506,1476,1693,217
2016,11,5,17,1515,1506,1658,152
2016,11,5,18,1512,1501,1689,188
2016,11,5,19,1503,1486,1641,155
2016,11,5,20,1507,1465,1640,175
2016,11,5,21,1507,1472,1616,144
2016,11,5,22,1514,1460,1688,228
2016,11,5,23,1527,1493,1724,231
2016,11,6,0,1556,1520,1745,225
2016,11,6,1,1626,1622,1809,187
2016,11,6,2,1669,1637,1828,191
2016,11,6,3,1658,1613,1656,43
2016,11,6,4,1598,1564,1519,-45
2016,11,6,5,1510,1479,1499,20
2016,11,6,6,1423,1386,1496,110
2016,11,6,7,1363,1332,1491,159
2016,11,6,8,1316,1290,1466,176
2016,11,6,9,1294,1259,1424,165
2016,11,6,10,1264,1248,1418,170
2016,11,6,11,1248,1243,1387,144
2016,11,6,12,1287,1258,1362,104
2016,11,6,13,1342,1301,1209,-92
2016,11,6,14,1378,1349,1176,-173
2016,11,6,15,1407,1369,1144,-225
2016,11,6,16,1436,1421,1172,-249
2016,11,6,17,1442,1450,1214,-236
2016,11,6,18,1450,1439,1252,-187
2016,11,6,19,1461,1444,1211,-233
2016,11,6,20,1476,1445,1252,-193
2016,11,6,21,1497,1436,1304,-132
2016,11,6,22,1505,1440,1365,-75
2016,11,6,23,1543,1463,1387,-76
2016,11,7,0,1613,1483,1370,-113
2016,11,7,1,1673,1612,1377,-235
2016,11,7,2,1688,1690,1410,-280
2016,11,7,3,1641,1657,1373,-284
2016,11,7,4,1554,1611,1395,-216
2016,11,7,5,1489,1527,1440,-87
2016,11,7,6,1418,1420,1389,-31
2016,11,7,7,1346,1335,1363,28
2016,11,7,8,1297,1285,1309,24
2016,11,7,9,1287,1261,1302,41
2016,11,7,10,1280,1244,1273,29
2016,11,7,11,1297,1250,1236,-14
2016,11,7,12,1372,1276,1258,-18
2016,11,7,13,1485,1377,1275,-102
2016,11,7,14,1583,1508,1325,-183
2016,11,7,15,1595,1538,1322,-216
2016,11,7,16,1588,1511,1314,-197
2016,11,7,17,1582,1471,1283,-188
2016,11,7,18,1577,1491,1325,-166
2016,11,7,19,1569,1482,1424,-58
2016,11,7,20,1572,1486,1434,-52
2016,11,7,21,1584,1487,1494,7
2016,11,7,22,1596,1497,1528,31
2016,11,7,23,1625,1504,1581,77
2016,11,8,0,1706,1533,1617,84
2016,11,8,1,1746,1631,1793,162
2016,11,8,2,1740,1662,1794,132
2016,11,8,3,1675,1638,1758,120
2016,11,8,4,1565,1600,1750,150
2016,11,8,5,1511,1518,1729,211
2016,11,8,6,1451,1412,1734,322
2016,11,8,7,1380,1319,1712,393
2016,11,8,8,1282,1269,1669,400
2016,11,8,9,1263,1237,1612,375
2016,11,8,10,1258,1235,1555,320
2016,11,8,11,1272,1240,1537,297
2016,11,8,12,1334,1269,1469,200
2016,11,8,13,1518,1364,1443,79
2016,11,8,14,1629,1485,1455,-30
2016,11,8,15,1617,1500,1420,-80
2016,11,8,16,1622,1491,1423,-68
2016,11,8,17,1603,1486,1458,-28
2016,11,8,18,1577,1483,1517,34
2016,11,8,19,1580,1412,1440,28
2016,11,8,20,1580,1419,1428,9
2016,11,8,21,1583,1481,1486,5
2016,11,8,22,1587,1495,1499,4
2016,11,8,23,1604,1514,1521,7
2016,11,9,0,1605,1542,1558,16
2016,11,9,1,1683,1654,1614,-40
2016,11,9,2,1750,1684,1667,-17
2016,11,9,3,1740,1650,1612,-38
2016,11,9,4,1720,1631,1684,53
2016,11,9,5,1655,1562,1606,44
2016,11,9,6,1588,1473,1564,91
2016,11,9,7,1420,1391,1498,107
2016,11,9,8,1372,1324,1394,70
2016,11,9,9,1349,1290,1310,20
2016,11,9,10,1329,1272,1298,26
2016,11,9,11,1342,1273,1248,-25
2016,11,9,12,1387,1301,1281,-20
2016,11,9,13,1455,1408,1337,-71
2016,11,9,14,1578,1537,1363,-174
2016,11,9,15,1599,1543,1388,-155
2016,11,9,16,1607,1519,1358,-161
2016,11,9,17,1593,1502,1374,-128
2016,11,9,18,1571,1493,1392,-101
2016,11,9,19,1563,1476,1386,-90
2016,11,9,20,1554,1478,1381,-97
2016,11,9,21,1543,1457,1358,-99
2016,11,9,22,1538,1502,1378,-124
2016,11,9,23,1564,1535,1385,-150
2016,11,10,0,1571,1561,1393,-168
2016,11,10,1,1661,1679,1470,-209
2016,11,10,2,1715,1702,1529,-173
2016,11,10,3,1715,1699,1511,-188
2016,11,10,4,1671,1677,1471,-206
2016,11,10,5,1578,1597,1378,-219
2016,11,10,6,1474,1482,1371,-111
2016,11,10,7,1390,1393,1396,3
2016,11,10,8,1351,1341,1339,-2
2016,11,10,9,1335,1310,1301,-9
2016,11,10,10,1327,1305,1273,-32
2016,11,10,11,1337,1307,1270,-37
2016,11,10,12,1380,1345,1306,-39
2016,11,10,13,1482,1442,1315,-127
2016,11,10,14,1632,1527,1303,-224
2016,11,10,15,1617,1605,1390,-215
2016,11,10,16,1625,1586,1382,-204
2016,11,10,17,1621,1563,1365,-198
2016,11,10,18,1618,1549,1375,-174
2016,11,10,19,1545,1531,1378,-153
2016,11,10,20,1552,1529,1407,-122
2016,11,10,21,1600,1527,1417,-110
2016,11,10,22,1595,1523,1467,-56
2016,11,10,23,1587,1538,1434,-104
2016,11,11,0,1608,1542,1407,-135
2016,11,11,1,1716,1697,1498,-199
2016,11,11,2,1743,1724,1547,-177
2016,11,11,3,1743,1709,1537,-172
2016,11,11,4,1715,1691,1523,-168
2016,11,11,5,1641,1607,1381,-226
2016,11,11,6,1544,1506,1375,-131
2016,11,11,7,1464,1423,1358,-65
2016,11,11,8,1374,1359,1336,-23
2016,11,11,9,1345,1329,1323,-6
2016,11,11,10,1333,1305,1313,8
2016,11,11,11,1340,1309,1289,-20
2016,11,11,12,1376,1334,1322,-12
2016,11,11,13,1465,1405,1410,5
2016,11,11,14,1579,1500,1469,-31
2016,11,11,15,1625,1535,1479,-56
2016,11,11,16,1608,1544,1488,-56
2016,11,11,17,1594,1531,1580,49
2016,11,11,18,1579,1510,1549,39
2016,11,11,19,1563,1493,1601,108
2016,11,11,20,1554,1470,1599,129
2016,11,11,21,1543,1473,1585,112
2016,11,11,22,1557,1480,1585,105
2016,11,11,23,1566,1485,1541,56
2016,11,12,0,1591,1515,1540,25
2016,11,12,1,1682,1636,1537,-99
2016,11,12,2,1705,1672,1540,-132
2016,11,12,3,1727,1647,1506,-141
2016,11,12,4,1710,1636,1519,-117
2016,11,12,5,1655,1579,1479,-100
2016,11,12,6,1558,1494,1405,-89
2016,11,12,7,1478,1425,1419,-6
2016,11,12,8,1402,1364,1386,22
2016,11,12,9,1370,1296,1340,44
2016,11,12,10,1353,1303,1367,64
2016,11,12,11,1351,1317,1370,53
2016,11,12,12,1367,1331,1382,51
2016,11,12,13,1409,1387,1366,-21
2016,11,12,14,1481,1435,1371,-64
2016,11,12,15,1525,1452,1336,-116
2016,11,12,16,1560,1483,1351,-132
2016,11,12,17,1555,1478,1381,-97
2016,11,12,18,1544,1461,1387,-74
2016,11,12,19,1527,1456,1419,-37
2016,11,12,20,1521,1435,1433,-2
2016,11,12,21,1507,1414,1435,21
2016,11,12,22,1506,1418,1440,22
2016,11,12,23,1519,1440,1455,15
2016,11,13,0,1545,1488,1418,-70
2016,11,13,1,1649,1628,1475,-153
2016,11,13,2,1702,1651,1535,-116
2016,11,13,3,1702,1606,1519,-87
2016,11,13,4,1685,1588,1519,-69
2016,11,13,5,1630,1548,1518,-30
2016,11,13,6,1545,1469,1512,43
2016,11,13,7,1467,1407,1558,151
2016,11,13,8,1409,1344,1564,220
2016,11,13,9,1382,1313,1562,249
2016,11,13,10,1363,1294,1531,237
2016,11,13,11,1365,1293,1539,246
2016,11,13,12,1373,1301,1535,234
2016,11,13,13,1415,1346,1312,-34
2016,11,13,14,1479,1391,1151,-240
2016,11,13,15,1522,1416,1130,-286
2016,11,13,16,1537,1434,1142,-292
2016,11,13,17,1526,1434,1145,-289
2016,11,13,18,1516,1425,1244,-181
2016,11,13,19,1501,1427,1343,-84
2016,11,13,20,1501,1427,1397,-30
2016,11,13,21,1504,1423,1448,25
2016,11,13,22,1506,1435,1477,42
2016,11,13,23,1519,1450,1461,11
2016,11,14,0,1554,1521,1529,8
2016,11,14,1,1661,1656,1455,-201
2016,11,14,2,1708,1705,1595,-110
2016,11,14,3,1741,1687,1560,-127
2016,11,14,4,1704,1649,1572,-77
2016,11,14,5,1624,1563,1626,63
2016,11,14,6,1516,1478,1553,75
2016,11,14,7,1432,1390,1517,127
2016,11,14,8,1366,1338,1538,200
2016,11,14,9,1335,1309,1477,168
2016,11,14,10,1329,1310,1441,131
2016,11,14,11,1348,1316,1441,125
2016,11,14,12,1393,1355,1459,104
2016,11,14,13,1494,1443,1514,71
2016,11,14,14,1613,1588,1502,-86
2016,11,14,15,1633,1613,1456,-157
2016,11,14,16,1650,1594,1417,-177
2016,11,14,17,1631,1552,1373,-179
2016,11,14,18,1622,1548,1395,-153
2016,11,14,19,1611,1540,1418,-122
2016,11,14,20,1606,1528,1458,-70
2016,11,14,21,1604,1529,1509,-20
2016,11,14,22,1601,1529,1682,153
2016,11,14,23,1603,1540,1688,148
2016,11,15,0,1622,1583,1699,116
2016,11,15,1,1727,1713,1796,83
2016,11,15,2,1754,1736,1771,35
2016,11,15,3,1786,1713,1545,-168
2016,11,15,4,1751,1691,1510,-181
2016,11,15,5,1671,1622,1460,-162
2016,11,15,6,1549,1494,1414,-80
2016,11,15,7,1461,1380,1416,36
2016,11,15,8,1374,1346,1415,69
2016,11,15,9,1346,1314,1277,-37
2016,11,15,10,1333,1303,1261,-42
2016,11,15,11,1336,1302,1241,-61
2016,11,15,12,1380,1335,1305,-30
2016,11,15,13,1493,1431,1228,-203
2016,11,15,14,1610,1578,1286,-292
2016,11,15,15,1616,1593,1306,-287
2016,11,15,16,1592,1567,1333,-234
2016,11,15,17,1582,1542,1367,-175
2016,11,15,18,1566,1536,1389,-147
2016,11,15,19,1558,1527,1393,-134
2016,11,15,20,1532,1521,1370,-151
2016,11,15,21,1534,1528,1372,-156
2016,11,15,22,1543,1549,1376,-173
2016,11,15,23,1546,1569,1333,-236
2016,11,16,0,1605,1588,1318,-270
2016,11,16,1,1707,1715,1316,-399
2016,11,16,2,1753,1735,1337,-398
2016,11,16,3,1737,1705,1348,-357
2016,11,16,4,1706,1670,1417,-253
2016,11,16,5,1624,1590,1450,-140
2016,11,16,6,1519,1473,1449,-24
2016,11,16,7,1436,1368,1484,116
2016,11,16,8,1363,1316,1459,143
2016,11,16,9,1337,1278,1374,96
2016,11,16,10,1325,1275,1296,21
2016,11,16,11,1327,1289,1278,-11
2016,11,16,12,1367,1319,1364,45
2016,11,16,13,1450,1411,1476,65
2016,11,16,14,1580,1537,1494,-43
2016,11,16,15,1600,1544,1512,-32
2016,11,16,16,1586,1530,1546,16
2016,11,16,17,1568,1529,1542,13
2016,11,16,18,1569,1518,1558,40
2016,11,16,19,1562,1528,1553,25
2016,11,16,20,1567,1538,1532,-6
2016,11,16,21,1574,1510,1542,32
2016,11,16,22,1585,1516,1572,56
2016,11,16,23,1594,1534,1587,53
2016,11,17,0,1621,1575,1538,-37
2016,11,17,1,1718,1705,1553,-152
2016,11,17,2,1749,1736,1552,-184
2016,11,17,3,1739,1703,1502,-201
2016,11,17,4,1726,1673,1511,-162
2016,11,17,5,1653,1584,1515,-69
2016,11,17,6,1532,1464,1491,27
2016,11,17,7,1435,1372,1398,26
2016,11,17,8,1362,1318,1326,8
2016,11,17,9,1329,1288,1352,64
2016,11,17,10,1300,1287,1289,2
2016,11,17,11,1308,1250,1234,-16
2016,11,17,12,1344,1316,1264,-52
2016,11,17,13,1436,1398,1246,-152
2016,11,17,14,1565,1534,1305,-229
2016,11,17,15,1600,1558,1370,-188
2016,11,17,16,1608,1538,1416,-122
2016,11,17,17,1606,1544,1434,-110
2016,11,17,18,1611,1559,1472,-87
2016,11,17,19,1606,1535,1440,-95
2016,11,17,20,1601,1514,1404,-110
2016,11,17,21,1600,1511,1368,-143
2016,11,17,22,1610,1516,1500,-16
2016,11,17,23,1627,1546,1565,19
2016,11,18,0,1655,1596,1633,37
2016,11,18,1,1767,1739,1675,-64
2016,11,18,2,1803,1776,1613,-163
2016,11,18,3,1793,1773,1522,-251
2016,11,18,4,1771,1757,1512,-245
2016,11,18,5,1695,1675,1544,-131
2016,11,18,6,1580,1558,1454,-104
2016,11,18,7,1485,1490,1448,-42
2016,11,18,8,1442,1419,1399,-20
2016,11,18,9,1410,1391,1342,-49
2016,11,18,10,1403,1377,1373,-4
2016,11,18,11,1401,1396,1415,19
2016,11,18,12,1452,1430,1391,-39
2016,11,18,13,1533,1475,1355,-120
2016,11,18,14,1674,1662,1490,-172
2016,11,18,15,1692,1680,1491,-189
2016,11,18,16,1653,1652,1484,-168
2016,11,18,17,1621,1625,1442,-183
2016,11,18,18,1589,1592,1419,-173
2016,11,18,19,1572,1563,1413,-150
2016,11,18,20,1562,1536,1396,-140
2016,11,18,21,1543,1524,1400,-124
2016,11,18,22,1539,1515,1421,-94
2016,11,18,23,1552,1528,1378,-150
2016,11,19,0,1592,1563,1447,-116
2016,11,19,1,1715,1721,1573,-148
2016,11,19,2,1765,1757,1653,-104
2016,11,19,3,1753,1745,1687,-58
2016,11,19,4,1740,1718,1715,-3
2016,11,19,5,1691,1684,1716,32
2016,11,19,6,1596,1608,1747,139
2016,11,19,7,1516,1526,1722,196
2016,11,19,8,1492,1462,1733,271
2016,11,19,9,1463,1432,1675,243
2016,11,19,10,1452,1418,1618,200
2016,11,19,11,1448,1425,1575,150
2016,11,19,12,1476,1439,1622,183
2016,11,19,13,1521,1489,1647,158
2016,11,19,14,1593,1540,1762,222
2016,11,19,15,1610,1559,1797,238
2016,11,19,16,1601,1563,1761,198
2016,11,19,17,1591,1544,1748,204
2016,11,19,18,1573,1519,1798,279
2016,11,19,19,1541,1491,1830,339
2016,11,19,20,1521,1454,1870,416
2016,11,19,21,1500,1435,1821,386
2016,11,19,22,1500,1434,1868,434
2016,11,19,23,1512,1454,1902,448
2016,11,20,0,1552,1522,1887,365
2016,11,20,1,1670,1683,1932,249
2016,11,20,2,1717,1716,1991,275
2016,11,20,3,1748,1697,1971,274
2016,11,20,4,1715,1673,1952,279
2016,11,20,5,1667,1626,1964,338
2016,11,20,6,1576,1539,1925,386
2016,11,20,7,1513,1466,1861,395
2016,11,20,8,1434,1409,1632,223
2016,11,20,9,1402,1375,1614,239
2016,11,20,10,1389,1368,1494,126
2016,11,20,11,1393,1363,1525,162
2016,11,20,12,1405,1376,1546,170
2016,11,20,13,1434,1412,1553,141
2016,11,20,14,1504,1462,1551,89
2016,11,20,15,1537,1475,1535,60
2016,11,20,16,1541,1500,1583,83
2016,11,20,17,1536,1443,1524,81
2016,11,20,18,1525,1477,1578,101
2016,11,20,19,1511,1466,1588,122
2016,11,20,20,1506,1461,1637,176
2016,11,20,21,1496,1447,1715,268
2016,11,20,22,1502,1456,1735,279
2016,11,20,23,1514,1482,1694,212
2016,11,21,0,1559,1563,1670,107
2016,11,21,1,1681,1714,1716,2
2016,11,21,2,1742,1735,1710,-25
2016,11,21,3,1746,1714,1731,17
2016,11,21,4,1706,1673,1693,20
2016,11,21,5,1641,1601,1775,174
2016,11,21,6,1538,1487,1801,314
2016,11,21,7,1450,1388,1793,405
2016,11,21,8,1377,1329,1764,435
2016,11,21,9,1353,1307,1753,446
2016,11,21,10,1352,1291,1722,431
2016,11,21,11,1362,1299,1724,425
2016,11,21,12,1417,1321,1751,430
2016,11,21,13,1522,1415,1826,411
2016,11,21,14,1641,1548,1960,412
2016,11,21,15,1663,1611,2033,422
2016,11,21,16,1656,1625,2098,473
2016,11,21,17,1651,1638,2127,489
2016,11,21,18,1651,1622,2135,513
2016,11,21,19,1636,1582,2159,577
2016,11,21,20,1629,1569,2181,612
2016,11,21,21,1622,1579,2229,650
2016,11,21,22,1622,1582,2276,694
2016,11,21,23,1633,1617,2316,699
2016,11,22,0,1670,1657,2332,675
2016,11,22,1,1777,1775,2406,631
2016,11,22,2,1821,1799,2404,605
2016,11,22,3,1811,1764,2305,541
2016,11,22,4,1771,1742,2324,582
2016,11,22,5,1685,1658,2311,653
2016,11,22,6,1566,1533,2335,802
2016,11,22,7,1484,1441,2195,754
2016,11,22,8,1431,1376,2126,750
2016,11,22,9,1388,1348,2214,866
2016,11,22,10,1395,1338,2180,842
2016,11,22,11,1386,1337,2200,863
2016,11,22,12,1429,1369,2242,873
2016,11,22,13,1525,1453,2217,764
2016,11,22,14,1652,1588,2266,678
2016,11,22,15,1688,1625,2208,583
2016,11,22,16,1667,1638,2244,606
2016,11,22,17,1640,1627,2264,637
2016,11,22,18,1630,1623,2291,668
2016,11,22,19,1606,1613,2338,725
2016,11,22,20,1594,1594,2298,704
2016,11,22,21,1583,1564,2386,822
2016,11,22,22,1584,1567,2388,821
2016,11,22,23,1588,1573,2415,842
2016,11,23,0,1646,1610,2384,774
2016,11,23,1,1777,1766,2348,582
2016,11,23,2,1828,1760,2280,520
2016,11,23,3,1811,1764,2304,540
2016,11,23,4,1785,1774,2326,552
2016,11,23,5,1708,1704,2266,562
2016,11,23,6,1596,1599,2155,556
2016,11,23,7,1509,1509,2121,612
2016,11,23,8,1467,1444,1993,549
2016,11,23,9,1428,1413,1875,462
2016,11,23,10,1417,1400,1822,422
2016,11,23,11,1447,1408,1872,464
2016,11,23,12,1485,1434,1901,467
2016,11,23,13,1566,1524,1909,385
2016,11,23,14,1695,1638,1957,319
2016,11,23,15,1682,1663,2005,342
2016,11,23,16,1659,1666,1997,331
2016,11,23,17,1637,1647,1914,267
2016,11,23,18,1622,1596,1899,303
2016,11,23,19,1603,1556,1963,407
2016,11,23,20,1590,1527,1987,460
2016,11,23,21,1587,1510,2015,505
2016,11,23,22,1591,1497,2044,547
2016,11,23,23,1615,1475,1987,512
2016,11,24,0,1680,1560,2121,561
2016,11,24,1,1829,1712,2255,543
2016,11,24,2,1857,1738,2288,550
2016,11,24,3,1839,1732,2256,524
2016,11,24,4,1836,1726,2257,531
2016,11,24,5,1752,1680,2226,546
2016,11,24,6,1652,1598,2152,554
2016,11,24,7,1557,1512,2121,609
2016,11,24,8,1460,1449,2051,602
2016,11,24,9,1497,1406,2097,691
2016,11,24,10,1482,1389,2150,761
2016,11,24,11,1475,1395,2063,668
2016,11,24,12,1497,1404,2080,676
2016,11,24,13,1553,1451,2045,594
2016,11,24,14,1615,1515,2091,576
2016,11,24,15,1655,1545,2128,583
2016,11,24,16,1666,1566,2084,518
2016,11,24,17,1677,1588,2036,448
2016,11,24,18,1662,1578,1994,416
2016,11,24,19,1635,1555,1941,386
2016,11,24,20,1567,1499,1953,454
2016,11,24,21,1498,1411,1897,486
2016,11,24,22,1453,1361,1815,454
2016,11,24,23,1448,1384,1807,423
2016,11,25,0,1492,1416,1860,444
2016,11,25,1,1607,1528,2007,479
2016,11,25,2,1645,1573,2088,515
2016,11,25,3,1642,1583,2098,515
2016,11,25,4,1654,1596,2100,504
2016,11,25,5,1611,1574,2140,566
2016,11,25,6,1564,1521,2081,560
2016,11,25,7,1514,1470,2088,618
2016,11,25,8,1455,1431,2058,627
2016,11,25,9,1423,1396,1955,559
2016,11,25,10,1410,1390,1857,467
2016,11,25,11,1406,1399,1857,458
2016,11,25,12,1439,1422,1883,461
2016,11,25,13,1503,1473,1920,447
2016,11,25,14,1559,1535,1938,403
2016,11,25,15,1591,1546,1862,316
2016,11,25,16,1604,1546,1896,350
2016,11,25,17,1605,1533,1831,298
2016,11,25,18,1576,1505,1783,278
2016,11,25,19,1558,1468,1742,274
2016,11,25,20,1542,1443,1722,279
2016,11,25,21,1524,1435,1752,317
2016,11,25,22,1526,1425,1759,334
2016,11,25,23,1544,1453,1765,312
2016,11,26,0,1618,1521,1888,367
2016,11,26,1,1762,1688,1945,257
2016,11,26,2,1785,1690,1929,239
2016,11,26,3,1768,1647,1906,259
2016,11,26,4,1763,1699,1972,273
2016,11,26,5,1709,1670,1978,308
2016,11,26,6,1640,1587,1941,354
2016,11,26,7,1568,1517,1947,430
2016,11,26,8,1506,1460,1910,450
2016,11,26,9,1470,1435,1846,411
2016,11,26,10,1443,1415,1844,429
2016,11,26,11,1428,1412,1894,482
2016,11,26,12,1437,1435,1895,460
2016,11,26,13,1465,1477,1901,424
2016,11,26,14,1541,1533,1852,319
2016,11,26,15,1587,1563,1843,280
2016,11,26,16,1594,1560,1879,319
2016,11,26,17,1589,1571,1847,276
2016,11,26,18,1571,1593,1911,318
2016,11,26,19,1552,1564,1902,338
2016,11,26,20,1532,1550,1940,390
2016,11,26,21,1517,1535,1975,440
2016,11,26,22,1521,1541,1982,441
2016,11,26,23,1537,1582,1988,406
2016,11,27,0,1591,1653,1976,323
2016,11,27,1,1731,1773,2077,304
2016,11,27,2,1769,1764,2062,298
2016,11,27,3,1750,1751,2035,284
2016,11,27,4,1731,1685,2015,330
2016,11,27,5,1682,1641,2033,392
2016,11,27,6,1599,1567,1957,390
2016,11,27,7,1515,1491,1916,425
2016,11,27,8,1444,1423,1784,361
2016,11,27,9,1409,1382,1734,352
2016,11,27,10,1396,1361,1689,328
2016,11,27,11,1396,1353,1741,388
2016,11,27,12,1402,1360,1797,437
2016,11,27,13,1437,1385,1809,424
2016,11,27,14,1503,1442,1847,405
2016,11,27,15,1546,1467,1925,458
2016,11,27,16,1575,1501,1963,462
2016,11,27,17,1587,1513,1995,482
2016,11,27,18,1585,1525,2011,486
2016,11,27,19,1570,1542,2024,482
2016,11,27,20,1558,1537,2005,468
2016,11,27,21,1547,1516,2053,537
2016,11,27,22,1555,1507,2106,599
2016,11,27,23,1574,1538,2128,590
2016,11,28,0,1641,1625,2261,636
2016,11,28,1,1782,1815,2275,460
2016,11,28,2,1836,1866,2263,397
2016,11,28,3,1799,1846,2276,430
2016,11,28,4,1771,1793,2297,504
2016,11,28,5,1710,1712,2296,584
2016,11,28,6,1602,1559,2216,657
2016,11,28,7,1511,1486,2198,712
2016,11,28,8,1475,1444,2095,651
2016,11,28,9,1455,1404,2051,647
2016,11,28,10,1449,1393,1981,588
2016,11,28,11,1464,1399,1767,368
2016,11,28,12,1510,1422,1773,351
2016,11,28,13,1609,1532,1859,327
2016,11,28,14,1745,1701,1971,270
2016,11,28,15,1778,1738,1924,186
2016,11,28,16,1762,1718,1950,232
2016,11,28,17,1741,1703,1975,272
2016,11,28,18,1727,1698,2092,394
2016,11,28,19,1700,1686,2172,486
2016,11,28,20,1678,1699,2162,463
2016,11,28,21,1666,1744,2132,388
2016,11,28,22,1666,1753,2144,391
2016,11,28,23,1680,1773,2169,396
2016,11,29,0,1731,1807,2201,394
2016,11,29,1,1868,1960,2280,320
2016,11,29,2,1922,1975,2291,316
2016,11,29,3,1919,1955,2221,266
2016,11,29,4,1890,1926,2217,291
2016,11,29,5,1814,1845,2148,303
2016,11,29,6,1698,1703,2016,313
2016,11,29,7,1608,1600,1977,377
2016,11,29,8,1561,1528,1865,337
2016,11,29,9,1518,1484,1800,316
2016,11,29,10,1521,1481,1823,342
2016,11,29,11,1523,1487,1809,322
2016,11,29,12,1557,1523,1805,282
2016,11,29,13,1663,1628,1767,139
2016,11,29,14,1801,1786,1852,66
2016,11,29,15,1832,1817,1825,8
2016,11,29,16,1806,1808,1745,-63
2016,11,29,17,1788,1788,1776,-12
2016,11,29,18,1769,1767,1732,-35
2016,11,29,19,1742,1754,1713,-41
2016,11,29,20,1695,1739,1677,-62
2016,11,29,21,1676,1715,1657,-58
2016,11,29,22,1666,1707,1650,-57
2016,11,29,23,1676,1713,1697,-16
2016,11,30,0,1753,1766,1791,25
2016,11,30,1,1907,1948,1983,35
2016,11,30,2,1982,1984,1990,6
2016,11,30,3,1966,1972,1873,-99
2016,11,30,4,1937,1959,1916,-43
2016,11,30,5,1864,1874,1966,92
2016,11,30,6,1738,1748,1864,116
2016,11,30,7,1651,1647,1855,208
2016,11,30,8,1606,1588,1815,227
2016,11,30,9,1566,1560,1747,187
2016,11,30,10,1557,1556,1767,211
2016,11,30,11,1573,1559,1766,207
2016,11,30,12,1617,1608,1816,208
2016,11,30,13,1721,1712,1798,86
2016,11,30,14,1869,1876,1926,50
2016,11,30,15,1894,1885,1833,-52
2016,11,30,16,1861,1834,1715,-119
2016,11,30,17,1824,1782,1700,-82
2016,11,30,18,1793,1743,1775,32
2016,11,30,19,1756,1692,1844,152
2016,11,30,20,1727,1667,1848,181
2016,11,30,21,1706,1640,1834,194
2016,11,30,22,1702,1639,1827,188
2016,11,30,23,1719,1678,1832,154
2016,12,1,0,1772,1749,1886,137
2016,12,1,1,1919,1932,2012,80
2016,12,1,2,1992,1981,2078,97
2016,12,1,3,1995,1983,2069,86
2016,12,1,4,1981,1947,2023,76
2016,12,1,5,1907,1858,1927,69
2016,12,1,6,1783,1741,1831,90
2016,12,1,7,1693,1654,1700,46
2016,12,1,8,1605,1587,1625,38
2016,12,1,9,1573,1560,1547,-13
2016,12,1,10,1566,1550,1542,-8
2016,12,1,11,1582,1553,1564,11
2016,12,1,12,1620,1584,1573,-11
2016,12,1,13,1724,1694,1641,-53
2016,12,1,14,1855,1859,1753,-106
2016,12,1,15,1883,1878,1813,-65
2016,12,1,16,1862,1819,1792,-27
2016,12,1,17,1820,1780,1741,-39
2016,12,1,18,1786,1725,1704,-21
2016,12,1,19,1761,1693,1712,19
2016,12,1,20,1731,1656,1745,89
2016,12,1,21,1706,1640,1706,66
2016,12,1,22,1701,1636,1677,41
2016,12,1,23,1715,1662,1646,-16
2016,12,2,0,1766,1735,1785,50
2016,12,2,1,1911,1914,1933,19
2016,12,2,2,1978,1957,2041,84
2016,12,2,3,1965,1945,2050,105
2016,12,2,4,1956,1927,2059,132
2016,12,2,5,1881,1849,2044,195
2016,12,2,6,1761,1723,2045,322
2016,12,2,7,1648,1612,1773,161
2016,12,2,8,1583,1542,1602,60
2016,12,2,9,1564,1502,1705,203
2016,12,2,10,1556,1490,1798,308
2016,12,2,11,1560,1491,1872,381
2016,12,2,12,1603,1520,1907,387
2016,12,2,13,1709,1604,1961,357
2016,12,2,14,1840,1693,1980,287
2016,12,2,15,1860,1804,2068,264
2016,12,2,16,1835,1776,2031,255
2016,12,2,17,1807,1740,1934,194
2016,12,2,18,1779,1694,1899,205
2016,12,2,19,1743,1657,1852,195
2016,12,2,20,1711,1626,1816,190
2016,12,2,21,1688,1622,1829,207
2016,12,2,22,1683,1632,1802,170
2016,12,2,23,1705,1666,1905,239
2016,12,3,0,1759,1731,2040,309
2016,12,3,1,1909,1877,2056,179
2016,12,3,2,1966,1891,2032,141
2016,12,3,3,1949,1875,2013,138
2016,12,3,4,1935,1857,2028,171
2016,12,3,5,1876,1800,2015,215
2016,12,3,6,1770,1708,1962,254
2016,12,3,7,1681,1613,1941,328
2016,12,3,8,1581,1546,1924,378
2016,12,3,9,1547,1512,1817,305
2016,12,3,10,1529,1494,1816,322
2016,12,3,11,1520,1490,1792,302
2016,12,3,12,1527,1499,1770,271
2016,12,3,13,1569,1542,1737,195
2016,12,3,14,1638,1614,1712,98
2016,12,3,15,1705,1654,1651,-3
2016,12,3,16,1723,1692,1646,-46
2016,12,3,17,1718,1699,1645,-54
2016,12,3,18,1701,1683,1600,-83
2016,12,3,19,1675,1651,1586,-65
2016,12,3,20,1645,1567,1530,-37
2016,12,3,21,1622,1549,1528,-21
2016,12,3,22,1616,1558,1562,4
2016,12,3,23,1629,1582,1625,43
2016,12,4,0,1682,1647,1649,2
2016,12,4,1,1833,1826,1705,-121
2016,12,4,2,1900,1850,1629,-221
2016,12,4,3,1886,1840,1701,-139
2016,12,4,4,1866,1823,1724,-99
2016,12,4,5,1828,1778,1710,-68
2016,12,4,6,1738,1693,1610,-83
2016,12,4,7,1655,1614,1548,-66
2016,12,4,8,1574,1557,1458,-99
2016,12,4,9,1535,1524,1456,-68
2016,12,4,10,1528,1506,1480,-26
2016,12,4,11,1522,1507,1504,-3
2016,12,4,12,1526,1520,1508,-12
2016,12,4,13,1561,1561,1578,17
2016,12,4,14,1638,1619,1683,64
2016,12,4,15,1674,1648,1791,143
2016,12,4,16,1683,1649,1784,135
2016,12,4,17,1676,1645,1722,77
2016,12,4,18,1655,1597,1671,74
2016,12,4,19,1632,1589,1637,48
2016,12,4,20,1607,1567,1575,8
2016,12,4,21,1590,1547,1642,95
2016,12,4,22,1589,1544,1630,86
2016,12,4,23,1599,1542,1665,123
2016,12,5,0,1663,1611,1803,192
2016,12,5,1,1825,1834,1930,96
2016,12,5,2,1909,1895,2022,127
2016,12,5,3,1909,1895,1987,92
2016,12,5,4,1884,1873,1996,123
2016,12,5,5,1815,1824,2008,184
2016,12,5,6,1698,1711,1875,164
2016,12,5,7,1603,1606,1871,265
2016,12,5,8,1564,1543,1838,295
2016,12,5,9,1524,1513,1930,417
2016,12,5,10,1514,1504,1925,421
2016,12,5,11,1535,1519,1974,455
2016,12,5,12,1573,1553,2039,486
2016,12,5,13,1677,1649,2078,429
2016,12,5,14,1824,1806,2188,382
2016,12,5,15,1847,1840,2145,305
2016,12,5,16,1814,1784,2045,261
2016,12,5,17,1776,1731,1724,-7
2016,12,5,18,1741,1660,1463,-197
2016,12,5,19,1709,1624,1407,-217
2016,12,5,20,1679,1589,1413,-176
2016,12,5,21,1665,1571,1403,-168
2016,12,5,22,1660,1602,1491,-111
2016,12,5,23,1674,1626,1602,-24
2016,12,6,0,1728,1682,1746,64
2016,12,6,1,1881,1876,1879,3
2016,12,6,2,1939,1925,1900,-25
2016,12,6,3,1939,1917,1958,41
2016,12,6,4,1924,1898,2092,194
2016,12,6,5,1849,1809,2103,294
2016,12,6,6,1724,1682,1959,277
2016,12,6,7,1627,1583,1950,367
2016,12,6,8,1535,1517,1905,388
2016,12,6,9,1506,1479,1902,423
2016,12,6,10,1499,1461,1870,409
2016,12,6,11,1510,1466,1934,468
2016,12,6,12,1542,1510,1957,447
2016,12,6,13,1641,1609,1958,349
2016,12,6,14,1788,1761,2058,297
2016,12,6,15,1827,1806,2075,269
2016,12,6,16,1798,1814,2069,255
2016,12,6,17,1764,1812,2023,211
2016,12,6,18,1732,1784,1950,166
2016,12,6,19,1703,1751,1914,163
2016,12,6,20,1675,1726,1892,166
2016,12,6,21,1668,1710,1969,259
2016,12,6,22,1669,1699,1991,292
2016,12,6,23,1681,1744,2093,349
2016,12,7,0,1738,1797,2333,536
2016,12,7,1,1890,1953,2487,534
2016,12,7,2,1936,1984,2514,530
2016,12,7,3,1927,1972,2426,454
2016,12,7,4,1907,1952,2483,531
2016,12,7,5,1842,1865,2448,583
2016,12,7,6,1720,1730,2305,575
2016,12,7,7,1621,1622,2315,693
2016,12,7,8,1552,1547,2241,694
2016,12,7,9,1518,1509,2222,713
2016,12,7,10,1504,1499,2226,727
2016,12,7,11,1508,1506,2224,718
2016,12,7,12,1545,1538,2218,680
2016,12,7,13,1643,1636,2303,667
2016,12,7,14,1797,1785,2411,626
2016,12,7,15,1835,1827,2443,616
2016,12,7,16,1814,1815,2389,574
2016,12,7,17,1769,1786,2239,453
2016,12,7,18,1719,1753,2118,365
2016,12,7,19,1682,1699,1881,182
2016,12,7,20,1667,1671,1759,88
2016,12,7,21,1660,1645,1870,225
2016,12,7,22,1696,1652,1916,264
2016,12,7,23,1722,1680,1901,221
2016,12,8,0,1787,1759,1887,128
2016,12,8,1,1949,1944,2006,62
2016,12,8,2,2001,1976,1996,20
2016,12,8,3,1984,1968,2011,43
2016,12,8,4,1967,1951,2039,88
2016,12,8,5,1889,1873,1995,122
2016,12,8,6,1769,1751,1876,125
2016,12,8,7,1675,1652,1864,212
2016,12,8,8,1594,1587,1570,-17
2016,12,8,9,1566,1553,1486,-67
2016,12,8,10,1559,1558,1403,-155
2016,12,8,11,1568,1566,1373,-193
2016,12,8,12,1608,1610,1347,-263
2016,12,8,13,1712,1710,1333,-377
2016,12,8,14,1854,1867,1451,-416
2016,12,8,15,1895,1867,1560,-307
2016,12,8,16,1871,1854,1605,-249
2016,12,8,17,1829,1833,1550,-283
2016,12,8,18,1787,1800,1531,-269
2016,12,8,19,1757,1774,1460,-314
2016,12,8,20,1747,1725,1425,-300
2016,12,8,21,1724,1698,1419,-279
2016,12,8,22,1723,1665,1413,-252
2016,12,8,23,1754,1685,1548,-137
2016,12,9,0,1813,1761,1747,-14
2016,12,9,1,1972,1944,1963,19
2016,12,9,2,2028,2011,1973,-38
2016,12,9,3,2021,2012,1962,-50
2016,12,9,4,1990,1998,2012,14
2016,12,9,5,1911,1926,1976,50
2016,12,9,6,1776,1788,1922,134
2016,12,9,7,1674,1678,1899,221
2016,12,9,8,1627,1610,1801,191
2016,12,9,9,1589,1574,1814,240
2016,12,9,10,1580,1572,1811,239
2016,12,9,11,1589,1584,1830,246
2016,12,9,12,1626,1617,1867,250
2016,12,9,13,1733,1710,2036,326
2016,12,9,14,1873,1860,2227,367
2016,12,9,15,1884,1882,2318,436
2016,12,9,16,1857,1840,2339,499
2016,12,9,17,1824,1794,2139,345
2016,12,9,18,1780,1735,2065,330
2016,12,9,19,1738,1684,2040,356
2016,12,9,20,1700,1634,2036,402
2016,12,9,21,1681,1615,2042,427
2016,12,9,22,1670,1613,2001,388
2016,12,9,23,1687,1629,2000,371
2016,12,10,0,1750,1686,2126,440
2016,12,10,1,1903,1869,2193,324
2016,12,10,2,1945,1894,2158,264
2016,12,10,3,1932,1886,2123,237
2016,12,10,4,1920,1886,2140,254
2016,12,10,5,1861,1838,2114,276
2016,12,10,6,1751,1737,2075,338
2016,12,10,7,1662,1646,2011,365
2016,12,10,8,1575,1571,1899,328
2016,12,10,9,1535,1528,1869,341
2016,12,10,10,1520,1508,1891,383
2016,12,10,11,1518,1504,1916,412
2016,12,10,12,1528,1526,1941,415
2016,12,10,13,1571,1569,2064,495
2016,12,10,14,1639,1654,2044,390
2016,12,10,15,1643,1691,2079,388
2016,12,10,16,1660,1681,2098,417
2016,12,10,17,1659,1649,2075,426
2016,12,10,18,1639,1619,2029,410
2016,12,10,19,1621,1586,2064,478
2016,12,10,20,1582,1551,2022,471
2016,12,10,21,1565,1532,1958,426
2016,12,10,22,1557,1526,1941,415
2016,12,10,23,1586,1539,1997,458
2016,12,11,0,1641,1609,2071,462
2016,12,11,1,1808,1792,2228,436
2016,12,11,2,1855,1820,2241,421
2016,12,11,3,1842,1815,2200,385
2016,12,11,4,1823,1795,2195,400
2016,12,11,5,1776,1752,2189,437
2016,12,11,6,1684,1650,2050,400
2016,12,11,7,1597,1564,1816,252
2016,12,11,8,1539,1493,1498,5
2016,12,11,9,1504,1452,1374,-78
2016,12,11,10,1483,1435,1321,-114
2016,12,11,11,1473,1433,1326,-107
2016,12,11,12,1479,1444,1362,-82
2016,12,11,13,1510,1480,1464,-16
2016,12,11,14,1587,1539,1600,61
2016,12,11,15,1629,1576,1586,10
2016,12,11,16,1636,1605,1658,53
2016,12,11,17,1613,1618,1610,-8
2016,12,11,18,1594,1591,1637,46
2016,12,11,19,1580,1564,1620,56
2016,12,11,20,1557,1544,1520,-24
2016,12,11,21,1553,1529,1456,-73
2016,12,11,22,1557,1520,1489,-31
2016,12,11,23,1577,1542,1404,-138
2016,12,12,0,1648,1620,1361,-259
2016,12,12,1,1827,1823,1454,-369
2016,12,12,2,1887,1875,1465,-410
2016,12,12,3,1873,1876,1473,-403
2016,12,12,4,1843,1850,1547,-303
2016,12,12,5,1776,1777,1595,-182
2016,12,12,6,1662,1657,1546,-111
2016,12,12,7,1554,1544,1524,-20
2016,12,12,8,1528,1487,1454,-33
2016,12,12,9,1485,1458,1539,81
2016,12,12,10,1471,1451,1590,139
2016,12,12,11,1475,1464,1613,149
2016,12,12,12,1515,1501,1677,176
2016,12,12,13,1616,1603,1840,237
2016,12,12,14,1762,1754,1926,172
2016,12,12,15,1799,1754,1966,212
2016,12,12,16,1771,1780,1945,165
2016,12,12,17,1746,1721,1828,107
2016,12,12,18,1702,1705,1829,124
2016,12,12,19,1680,1684,1806,122
2016,12,12,20,1658,1626,1728,102
2016,12,12,21,1649,1594,1781,187
2016,12,12,22,1650,1602,1811,209
2016,12,12,23,1670,1627,1926,299
2016,12,13,0,1733,1691,1943,252
2016,12,13,1,1887,1855,2089,234
2016,12,13,2,1922,1896,2044,148
2016,12,13,3,1907,1888,2027,139
2016,12,13,4,1885,1860,2129,269
2016,12,13,5,1803,1772,2029,257
2016,12,13,6,1669,1645,1919,274
2016,12,13,7,1559,1547,1921,374
2016,12,13,8,1497,1474,1938,464
2016,12,13,9,1468,1427,1904,477
2016,12,13,10,1462,1436,1868,432
2016,12,13,11,1474,1440,1860,420
2016,12,13,12,1595,1471,1853,382
2016,12,13,13,1737,1565,1879,314
2016,12,13,14,1783,1709,1952,243
2016,12,13,15,1777,1735,1974,239
2016,12,13,16,1765,1692,1918,226
2016,12,13,17,1739,1680,1823,143
2016,12,13,18,1706,1615,1803,188
2016,12,13,19,1676,1574,1654,80
2016,12,13,20,1651,1543,1763,220
2016,12,13,21,1642,1532,1833,301
2016,12,13,22,1640,1535,1894,359
2016,12,13,23,1656,1560,1894,334
2016,12,14,0,1717,1614,2016,402
2016,12,14,1,1876,1802,2130,328
2016,12,14,2,1912,1833,2138,305
2016,12,14,3,1903,1828,2132,304
2016,12,14,4,1886,1814,2185,371
2016,12,14,5,1808,1733,2142,409
2016,12,14,6,1681,1592,2024,432
2016,12,14,7,1581,1486,1607,121
2016,12,14,8,1478,1419,1471,52
2016,12,14,9,1450,1388,1476,88
2016,12,14,10,1446,1380,1459,79
2016,12,14,11,1453,1342,1416,74
2016,12,14,12,1494,1419,1496,77
2016,12,14,13,1596,1481,1463,-18
2016,12,14,14,1743,1661,1437,-224
2016,12,14,15,1767,1719,1449,-270
2016,12,14,16,1752,1686,1427,-259
2016,12,14,17,1711,1648,1488,-160
2016,12,14,18,1681,1605,1547,-58
2016,12,14,19,1653,1580,1533,-47
2016,12,14,20,1623,1551,1532,-19
2016,12,14,21,1604,1549,1506,-43
2016,12,14,22,1615,1550,1504,-46
2016,12,14,23,1635,1562,1457,-105
2016,12,15,0,1700,1620,1445,-175
2016,12,15,1,1865,1793,1598,-195
2016,12,15,2,1896,1828,1706,-122
2016,12,15,3,1879,1819,1686,-133
2016,12,15,4,1864,1808,1627,-181
2016,12,15,5,1786,1738,1604,-134
2016,12,15,6,1658,1612,1545,-67
2016,12,15,7,1554,1509,1487,-22
2016,12,15,8,1480,1442,1492,50
2016,12,15,9,1444,1407,1488,81
2016,12,15,10,1434,1395,1511,116
2016,12,15,11,1440,1408,1509,101
2016,12,15,12,1482,1442,1484,42
2016,12,15,13,1582,1512,1452,-60
2016,12,15,14,1710,1701,1511,-190
2016,12,15,15,1731,1734,1517,-217
2016,12,15,16,1710,1710,1534,-176
2016,12,15,17,1659,1670,1540,-130
2016,12,15,18,1616,1635,1578,-57
2016,12,15,19,1589,1602,1590,-12
2016,12,15,20,1593,1580,1613,33
2016,12,15,21,1587,1578,1601,23
2016,12,15,22,1586,1583,1597,14
2016,12,15,23,1601,1611,1564,-47
2016,12,16,0,1663,1673,1525,-148
2016,12,16,1,1818,1830,1601,-229
2016,12,16,2,1846,1852,1649,-203
2016,12,16,3,1831,1842,1555,-287
2016,12,16,4,1809,1820,1582,-238
2016,12,16,5,1729,1744,1502,-242
2016,12,16,6,1603,1620,1513,-107
2016,12,16,7,1501,1511,1508,-3
2016,12,16,8,1400,1387,1480,93
2016,12,16,9,1396,1366,1509,143
2016,12,16,10,1382,1376,1537,161
2016,12,16,11,1386,1373,1541,168
2016,12,16,12,1422,1395,1620,225
2016,12,16,13,1508,1479,1753,274
2016,12,16,14,1662,1612,1945,333
2016,12,16,15,1699,1676,2029,353
2016,12,16,16,1685,1685,2018,333
2016,12,16,17,1673,1697,2004,307
2016,12,16,18,1655,1696,2011,315
2016,12,16,19,1635,1667,2040,373
2016,12,16,20,1623,1644,2078,434
2016,12,16,21,1624,1608,2118,510
2016,12,16,22,1620,1575,2184,609
2016,12,16,23,1628,1597,2194,597
2016,12,17,0,1678,1643,2179,536
2016,12,17,1,1818,1793,2281,488
2016,12,17,2,1822,1808,2283,475
2016,12,17,3,1803,1780,2323,543
2016,12,17,4,1773,1762,2300,538
2016,12,17,5,1701,1711,2274,563
2016,12,17,6,1594,1410,1943,533
2016,12,17,7,1507,1535,1845,310
2016,12,17,8,1481,1456,1754,298
2016,12,17,9,1438,1414,1738,324
2016,12,17,10,1427,1395,1731,336
2016,12,17,11,1418,1393,1700,307
2016,12,17,12,1423,1410,1768,358
2016,12,17,13,1457,1449,1909,460
2016,12,17,14,1555,1530,1883,353
2016,12,17,15,1622,1602,1827,225
2016,12,17,16,1672,1648,1919,271
2016,12,17,17,1696,1673,1911,238
2016,12,17,18,1683,1660,1890,230
2016,12,17,19,1668,1651,1879,228
2016,12,17,20,1641,1635,1918,283
2016,12,17,21,1626,1631,1900,269
2016,12,17,22,1632,1633,1898,265
2016,12,17,23,1662,1646,1905,259
2016,12,18,0,1738,1712,2005,293
2016,12,18,1,1908,1905,2128,223
2016,12,18,2,1935,1940,2140,200
2016,12,18,3,1912,1950,1992,42
2016,12,18,4,1891,1928,1973,45
2016,12,18,5,1837,1876,1916,40
2016,12,18,6,1735,1796,1834,38
2016,12,18,7,1648,1712,1746,34
2016,12,18,8,1652,1641,1684,43
2016,12,18,9,1536,1602,1593,-9
2016,12,18,10,1598,1584,1638,54
2016,12,18,11,1591,1580,1714,134
2016,12,18,12,1595,1574,1695,121
2016,12,18,13,1622,1613,1692,79
2016,12,18,14,1709,1685,1702,17
2016,12,18,15,1736,1730,1692,-38
2016,12,18,16,1754,1733,1667,-66
2016,12,18,17,1747,1710,1621,-89
2016,12,18,18,1717,1670,1658,-12
2016,12,18,19,1680,1621,1604,-17
2016,12,18,20,1657,1626,1660,34
2016,12,18,21,1630,1611,1658,47
2016,12,18,22,1617,1604,1633,29
2016,12,18,23,1658,1629,1623,-6
2016,12,19,0,1754,1719,1652,-67
2016,12,19,1,1959,1940,1910,-30
2016,12,19,2,2006,2007,1987,-20
2016,12,19,3,2008,2009,1971,-38
2016,12,19,4,1984,1998,1950,-48
2016,12,19,5,1900,1934,1902,-32
2016,12,19,6,1774,1823,1793,-30
2016,12,19,7,1669,1718,1516,-202
2016,12,19,8,1666,1646,1469,-177
2016,12,19,9,1628,1608,1504,-104
2016,12,19,10,1627,1596,1532,-64
2016,12,19,11,1633,1606,1584,-22
2016,12,19,12,1675,1648,1652,4
2016,12,19,13,1774,1735,1852,117
2016,12,19,14,1929,1878,1955,77
2016,12,19,15,1958,1914,2001,87
2016,12,19,16,1931,1894,1884,-10
2016,12,19,17,1889,1864,1785,-79
2016,12,19,18,1847,1831,1754,-77
2016,12,19,19,1802,1783,1777,-6
2016,12,19,20,1756,1705,1727,22
2016,12,19,21,1736,1706,1776,70
2016,12,19,22,1733,1686,1748,62
2016,12,19,23,1763,1696,1838,142
2016,12,20,0,1834,1756,1907,151
2016,12,20,1,2014,1964,2073,109
2016,12,20,2,2069,2035,2123,88
2016,12,20,3,2064,2029,2128,99
2016,12,20,4,2045,2022,2137,115
2016,12,20,5,1963,1951,2132,181
2016,12,20,6,1825,1823,2062,239
2016,12,20,7,1723,1719,1916,197
2016,12,20,8,1665,1635,1893,258
2016,12,20,9,1628,1598,1880,282
2016,12,20,10,1633,1581,1844,263
2016,12,20,11,1635,1592,1813,221
2016,12,20,12,1672,1628,1803,175
2016,12,20,13,1776,1712,1963,251
2016,12,20,14,1926,1844,2023,179
2016,12,20,15,1955,1870,2121,251
2016,12,20,16,1907,1859,2087,228
2016,12,20,17,1856,1845,1975,130
2016,12,20,18,1799,1792,1898,106
2016,12,20,19,1743,1742,1871,129
2016,12,20,20,1704,1696,1883,187
2016,12,20,21,1679,1666,1869,203
2016,12,20,22,1668,1620,1835,215
2016,12,20,23,1680,1678,1874,196
2016,12,21,0,1733,1732,1995,263
2016,12,21,1,1912,1941,2130,189
2016,12,21,2,1985,1986,2232,246
2016,12,21,3,1989,1987,2271,284
2016,12,21,4,1975,1970,2285,315
2016,12,21,5,1905,1892,2249,357
2016,12,21,6,1781,1771,2180,409
2016,12,21,7,1682,1671,1937,266
2016,12,21,8,1609,1590,1787,197
2016,12,21,9,1573,1547,1732,185
2016,12,21,10,1552,1516,1732,216
2016,12,21,11,1556,1510,1745,235
2016,12,21,12,1596,1542,1749,207
2016,12,21,13,1693,1620,1767,147
2016,12,21,14,1842,1731,1688,-43
2016,12,21,15,1867,1778,1703,-75
2016,12,21,16,1827,1784,1788,4
2016,12,21,17,1783,1749,1728,-21
2016,12,21,18,1744,1708,1568,-140
2016,12,21,19,1701,1658,1580,-78
2016,12,21,20,1663,1612,1558,-54
2016,12,21,21,1649,1596,1527,-69
2016,12,21,22,1642,1589,1591,2
2016,12,21,23,1660,1603,1613,10
2016,12,22,0,1719,1635,1711,76
2016,12,22,1,1890,1838,1938,100
2016,12,22,2,1946,1891,1992,101
2016,12,22,3,1949,1875,1963,88
2016,12,22,4,1942,1852,1974,122
2016,12,22,5,1866,1783,2058,275
2016,12,22,6,1745,1670,1969,299
2016,12,22,7,1647,1560,1779,219
2016,12,22,8,1539,1486,1741,255
2016,12,22,9,1503,1443,1685,242
2016,12,22,10,1479,1425,1641,216
2016,12,22,11,1485,1439,1591,152
2016,12,22,12,1525,1477,1558,81
2016,12,22,13,1627,1567,1624,57
2016,12,22,14,1769,1683,1662,-21
2016,12,22,15,1855,1766,1763,-3
2016,12,22,16,1857,1808,1754,-54
2016,12,22,17,1853,1831,1619,-212
2016,12,22,18,1838,1839,1659,-180
2016,12,22,19,1813,1832,1679,-153
2016,12,22,20,1792,1841,1619,-222
2016,12,22,21,1788,1836,1580,-256
2016,12,22,22,1780,1833,1594,-239
2016,12,22,23,1805,1846,1611,-235
2016,12,23,0,1857,1884,1790,-94
2016,12,23,1,2011,1992,1990,-2
2016,12,23,2,2032,1924,1947,23
2016,12,23,3,2011,1958,1946,-12
2016,12,23,4,1989,1938,1922,-16
2016,12,23,5,1904,1860,1899,39
2016,12,23,6,1777,1741,1795,54
2016,12,23,7,1670,1628,1659,31
2016,12,23,8,1541,1533,1546,13
2016,12,23,9,1523,1481,1567,86
2016,12,23,10,1503,1454,1573,119
2016,12,23,11,1399,1463,1591,128
2016,12,23,12,1444,1461,1752,291
2016,12,23,13,1541,1529,1812,283
2016,12,23,14,1669,1625,1843,218
2016,12,23,15,1764,1674,1968,294
2016,12,23,16,1761,1695,1933,238
2016,12,23,17,1744,1698,1986,288
2016,12,23,18,1718,1680,1995,315
2016,12,23,19,1681,1635,2010,375
2016,12,23,20,1650,1584,2060,476
2016,12,23,21,1632,1541,2016,475
2016,12,23,22,1588,1534,2050,516
2016,12,23,23,1615,1557,1928,371
2016,12,24,0,1653,1608,1971,363
2016,12,24,1,1802,1793,2132,339
2016,12,24,2,1840,1829,2232,403
2016,12,24,3,1835,1818,2194,376
2016,12,24,4,1838,1733,2108,375
2016,12,24,5,1782,1788,2194,406
2016,12,24,6,1706,1715,2082,367
2016,12,24,7,1613,1626,1828,202
2016,12,24,8,1580,1549,1720,171
2016,12,24,9,1539,1499,1712,213
2016,12,24,10,1520,1482,1706,224
2016,12,24,11,1506,1471,1761,290
2016,12,24,12,1541,1485,1919,434
2016,12,24,13,1622,1522,1930,408
2016,12,24,14,1698,1589,1958,369
2016,12,24,15,1742,1621,1939,318
2016,12,24,16,1779,1655,1966,311
2016,12,24,17,1791,1680,1989,309
2016,12,24,18,1768,1654,1968,314
2016,12,24,19,1733,1610,2010,400
2016,12,24,20,1688,1562,1931,369
2016,12,24,21,1652,1546,1992,446
2016,12,24,22,1626,1545,1934,389
2016,12,24,23,1634,1558,1938,380
2016,12,25,0,1695,1598,2123,525
2016,12,25,1,1835,1745,2218,473
2016,12,25,2,1826,1757,2295,538
2016,12,25,3,1801,1725,2284,559
2016,12,25,4,1793,1710,2270,560
2016,12,25,5,1755,1676,2297,621
2016,12,25,6,1704,1571,2164,593
2016,12,25,7,1650,1553,2059,506
2016,12,25,8,1547,1514,2023,509
2016,12,25,9,1518,1478,1985,507
2016,12,25,10,1517,1453,1929,476
2016,12,25,11,1503,1442,1970,528
2016,12,25,12,1516,1448,2046,598
2016,12,25,13,1560,1483,2049,566
2016,12,25,14,1614,1546,2064,518
2016,12,25,15,1645,1590,2114,524
2016,12,25,16,1665,1631,2164,533
2016,12,25,17,1665,1648,2139,491
2016,12,25,18,1649,1647,2155,508
2016,12,25,19,1597,1621,2162,541
2016,12,25,20,1560,1590,2108,518
2016,12,25,21,1528,1556,2063,507
2016,12,25,22,1517,1542,2009,467
2016,12,25,23,1543,1547,2017,470
2016,12,26,0,1608,1588,2192,604
2016,12,26,1,1768,1759,2275,516
2016,12,26,2,1819,1813,2347,534
2016,12,26,3,1818,1822,2358,536
2016,12,26,4,1822,1823,2399,576
2016,12,26,5,1765,1789,2449,660
2016,12,26,6,1703,1716,2401,685
2016,12,26,7,1640,1622,2245,623
2016,12,26,8,1590,1547,2150,603
2016,12,26,9,1555,1546,2116,570
2016,12,26,10,1540,1535,2080,545
2016,12,26,11,1533,1531,2082,551
2016,12,26,12,1541,1551,2129,578
2016,12,26,13,1572,1599,2154,555
2016,12,26,14,1636,1673,2134,461
2016,12,26,15,1670,1690,2083,393
2016,12,26,16,1692,1698,2102,404
2016,12,26,17,1684,1682,2097,415
2016,12,26,18,1660,1657,2127,470
2016,12,26,19,1634,1625,2140,515
2016,12,26,20,1602,1584,2114,530
2016,12,26,21,1588,1557,2072,515
2016,12,26,22,1589,1543,2037,494
2016,12,26,23,1620,1569,2004,435
2016,12,27,0,1712,1644,2175,531
2016,12,27,1,1915,1898,2358,460
2016,12,27,2,1974,1918,2407,489
2016,12,27,3,1975,1921,2375,454
2016,12,27,4,1935,1910,2310,400
2016,12,27,5,1844,1848,2260,412
2016,12,27,6,1753,1747,2126,379
2016,12,27,7,1664,1646,1936,290
2016,12,27,8,1597,1574,1904,330
2016,12,27,9,1568,1508,1859,351
2016,12,27,10,1558,1524,1875,351
2016,12,27,11,1557,1525,1905,380
2016,12,27,12,1594,1547,2027,480
2016,12,27,13,1692,1621,2065,444
2016,12,27,14,1851,1733,2099,366
2016,12,27,15,1891,1767,2162,395
2016,12,27,16,1853,1773,2063,290
2016,12,27,17,1816,1727,1995,268
2016,12,27,18,1770,1683,1964,281
2016,12,27,19,1729,1642,1966,324
2016,12,27,20,1686,1604,1939,335
2016,12,27,21,1663,1582,1958,376
2016,12,27,22,1659,1565,1936,371
2016,12,27,23,1677,1583,1912,329
2016,12,28,0,1752,1635,2111,476
2016,12,28,1,1966,1834,2153,319
2016,12,28,2,2013,1891,2247,356
2016,12,28,3,1998,1880,2211,331
2016,12,28,4,1979,1862,2179,317
2016,12,28,5,1898,1803,2174,371
2016,12,28,6,1769,1696,2151,455
2016,12,28,7,1659,1593,1905,312
2016,12,28,8,1567,1538,1874,336
2016,12,28,9,1534,1495,1827,332
2016,12,28,10,1520,1480,1823,343
2016,12,28,11,1524,1469,1810,341
2016,12,28,12,1553,1513,1951,438
2016,12,28,13,1642,1581,2066,485
2016,12,28,14,1780,1680,2135,455
2016,12,28,15,1804,1729,2255,526
2016,12,28,16,1784,1735,2322,587
2016,12,28,17,1749,1733,2214,481
2016,12,28,18,1732,1700,2151,451
2016,12,28,19,1686,1662,2115,453
2016,12,28,20,1646,1610,2086,476
2016,12,28,21,1628,1608,2073,465
2016,12,28,22,1615,1608,2057,449
2016,12,28,23,1638,1635,2116,481
2016,12,29,0,1699,1693,2243,550
2016,12,29,1,1902,1872,2324,452
2016,12,29,2,1948,1904,2367,463
2016,12,29,3,1946,1889,2378,489
2016,12,29,4,1940,1867,2325,458
2016,12,29,5,1884,1804,2262,458
2016,12,29,6,1759,1694,2233,539
2016,12,29,7,1656,1595,1953,358
2016,12,29,8,1557,1523,1855,332
2016,12,29,9,1520,1478,1882,404
2016,12,29,10,1498,1461,1905,444
2016,12,29,11,1500,1470,1918,448
2016,12,29,12,1537,1497,1972,475
2016,12,29,13,1627,1529,2022,493
2016,12,29,14,1763,1652,2156,504
2016,12,29,15,1801,1714,2149,435
2016,12,29,16,1787,1754,2161,407
2016,12,29,17,1757,1774,2080,306
2016,12,29,18,1723,1744,1906,162
2016,12,29,19,1687,1712,1860,148
2016,12,29,20,1656,1688,1871,183
2016,12,29,21,1654,1672,1812,140
2016,12,29,22,1647,1656,1773,117
2016,12,29,23,1671,1663,1813,150
2016,12,30,0,1736,1715,1867,152
2016,12,30,1,1917,1895,2093,198
2016,12,30,2,1963,1948,2156,208
2016,12,30,3,1956,1938,2134,196
2016,12,30,4,1948,1917,2167,250
2016,12,30,5,1883,1846,2189,343
2016,12,30,6,1764,1743,2105,362
2016,12,30,7,1658,1646,1963,317
2016,12,30,8,1596,1572,1993,421
2016,12,30,9,1554,1532,1983,451
2016,12,30,10,1535,1520,2004,484
2016,12,30,11,1536,1518,2041,523
2016,12,30,12,1568,1544,2155,611
2016,12,30,13,1634,1607,2180,573
2016,12,30,14,1773,1694,2244,550
2016,12,30,15,1815,1721,2209,488
2016,12,30,16,1810,1764,2289,525
2016,12,30,17,1783,1756,2127,371
2016,12,30,18,1749,1727,2095,368
2016,12,30,19,1709,1672,2115,443
2016,12,30,20,1662,1625,2088,463
2016,12,30,21,1645,1589,2099,510
2016,12,30,22,1640,1560,2065,505
2016,12,30,23,1661,1569,2084,515
2016,12,31,0,1717,1620,2177,557
2016,12,31,1,1886,1801,2283,482
2016,12,31,2,1916,1856,2362,506
2016,12,31,3,1896,1845,2305,460
2016,12,31,4,1892,1833,2307,474
2016,12,31,5,1845,1778,2284,506
2016,12,31,6,1751,1692,2221,529
2016,12,31,7,1655,1595,2084,489
2016,12,31,8,1557,1526,2040,514
2016,12,31,9,1518,1482,1969,487
2016,12,31,10,1500,1460,1935,475
2016,12,31,11,1497,1449,1935,486
2016,12,31,12,1503,1462,1985,523
2016,12,31,13,1532,1496,1966,470
2016,12,31,14,1595,1552,1997,445
2016,12,31,15,1648,1585,1968,383
2016,12,31,16,1692,1636,1960,324
2016,12,31,17,1700,1653,1855,202
2016,12,31,18,1701,1709,1980,271
2016,12,31,19,1668,1668,1908,240
2016,12,31,20,1639,1609,1888,279
2016,12,31,21,1624,1602,1899,297
2016,12,31,22,1617,1584,1856,272
2016,12,31,23,1646,1624,1901,277
2017,1,1,0,1706,1682,2038,356
2017,1,1,1,1880,1831,2193,362
2017,1,1,2,1919,1863,2239,376
2017,1,1,3,1898,1819,2200,381
2017,1,1,4,1875,1776,2137,361
2017,1,1,5,1828,1720,2101,381
2017,1,1,6,1741,1610,2057,447
2017,1,1,7,1655,1589,1938,349
2017,1,1,8,1565,1466,1880,414
2017,1,1,9,1527,1415,1809,394
2017,1,1,10,1508,1388,1803,415
2017,1,1,11,1499,1371,1809,438
2017,1,1,12,1504,1372,1776,404
2017,1,1,13,1531,1388,1828,440
2017,1,1,14,1605,1426,1864,438
2017,1,1,15,1659,1454,1944,490
2017,1,1,16,1648,1475,2016,541
2017,1,1,17,1650,1484,1967,483
2017,1,1,18,1637,1467,1971,504
2017,1,1,19,1616,1452,2040,588
2017,1,1,20,1593,1443,2022,579
2017,1,1,21,1578,1443,1912,469
2017,1,1,22,1568,1445,1783,338
2017,1,1,23,1598,1478,1849,371
2017,1,2,0,1660,1540,2096,556
2017,1,2,1,1829,1696,2343,647
2017,1,2,2,1883,1733,2394,661
2017,1,2,3,1872,1716,2347,631
2017,1,2,4,1852,1690,2314,624
2017,1,2,5,1782,1640,2263,623
2017,1,2,6,1683,1529,2099,570
2017,1,2,7,1583,1474,1948,474
2017,1,2,8,1476,1387,1899,512
2017,1,2,9,1446,1381,1906,525
2017,1,2,10,1430,1365,1881,516
2017,1,2,11,1419,1360,1856,496
2017,1,2,12,1427,1368,1908,540
2017,1,2,13,1465,1427,1983,556
2017,1,2,14,1531,1507,2112,605
2017,1,2,15,1573,1546,2069,523
2017,1,2,16,1654,1554,1974,420
2017,1,2,17,1652,1584,1982,398
2017,1,2,18,1632,1602,2040,438
2017,1,2,19,1612,1580,2116,536
2017,1,2,20,1588,1573,2093,520
2017,1,2,21,1574,1566,1992,426
2017,1,2,22,1572,1568,1968,400
2017,1,2,23,1596,1593,1932,339
2017,1,3,0,1664,1660,1939,279
2017,1,3,1,1840,1809,2082,273
2017,1,3,2,1890,1836,2115,279
2017,1,3,3,1882,1810,2128,318
2017,1,3,4,1858,1776,2213,437
2017,1,3,5,1763,1701,2229,528
2017,1,3,6,1668,1585,1962,377
2017,1,3,7,1581,1480,1745,265
2017,1,3,8,1529,1417,1684,267
2017,1,3,9,1497,1390,1650,260
2017,1,3,10,1442,1368,1617,249
2017,1,3,11,1448,1377,1667,290
2017,1,3,12,1492,1400,1779,379
2017,1,3,13,1590,1480,1829,349
2017,1,3,14,1726,1599,1917,318
2017,1,3,15,1764,1662,1909,247
2017,1,3,16,1754,1666,1859,193
2017,1,3,17,1731,1676,1674,-2
2017,1,3,18,1704,1631,1688,57
2017,1,3,19,1670,1594,1690,96
2017,1,3,20,1644,1563,1689,126
2017,1,3,21,1635,1539,1673,134
2017,1,3,22,1624,1538,1619,81
2017,1,3,23,1641,1571,1508,-63
2017,1,4,0,1700,1614,1497,-117
2017,1,4,1,1864,1757,1411,-346
2017,1,4,2,1916,1810,1356,-454
2017,1,4,3,1914,1821,1350,-471
2017,1,4,4,1900,1797,1390,-407
2017,1,4,5,1824,1715,1424,-291
2017,1,4,6,1695,1596,1381,-215
2017,1,4,7,1587,1484,1209,-275
2017,1,4,8,1470,1427,1203,-224
2017,1,4,9,1449,1396,1170,-226
2017,1,4,10,1420,1380,1139,-241
2017,1,4,11,1426,1366,1163,-203
2017,1,4,12,1463,1407,1306,-101
2017,1,4,13,1547,1490,1386,-104
2017,1,4,14,1670,1629,1483,-146
2017,1,4,15,1787,1667,1515,-152
2017,1,4,16,1766,1647,1521,-126
2017,1,4,17,1731,1601,1323,-278
2017,1,4,18,1699,1579,1334,-245
2017,1,4,19,1672,1555,1398,-157
2017,1,4,20,1644,1539,1421,-118
2017,1,4,21,1625,1538,1460,-78
2017,1,4,22,1619,1540,1474,-66
2017,1,4,23,1644,1568,1502,-66
2017,1,5,0,1702,1609,1697,88
2017,1,5,1,1858,1748,1798,50
2017,1,5,2,1907,1782,1816,34
2017,1,5,3,1897,1765,1809,44
2017,1,5,4,1878,1742,1827,85
2017,1,5,5,1804,1663,1690,27
2017,1,5,6,1680,1556,1478,-78
2017,1,5,7,1582,1458,1292,-166
2017,1,5,8,1439,1395,1274,-121
2017,1,5,9,1409,1359,1233,-126
2017,1,5,10,1389,1348,1207,-141
2017,1,5,11,1389,1351,1207,-144
2017,1,5,12,1423,1378,1323,-55
2017,1,5,13,1509,1469,1208,-261
2017,1,5,14,1628,1601,1217,-384
2017,1,5,15,1689,1652,1202,-450
2017,1,5,16,1689,1649,1109,-540
2017,1,5,17,1685,1636,1033,-603
2017,1,5,18,1670,1649,1094,-555
2017,1,5,19,1649,1638,1149,-489
2017,1,5,20,1624,1619,1170,-449
2017,1,5,21,1615,1604,1280,-324
2017,1,5,22,1613,1598,1310,-288
2017,1,5,23,1629,1604,1409,-195
2017,1,6,0,1679,1649,1592,-57
2017,1,6,1,1827,1781,1682,-99
2017,1,6,2,1851,1814,1742,-72
2017,1,6,3,1851,1794,1678,-116
2017,1,6,4,1830,1772,1710,-62
2017,1,6,5,1756,1707,1781,74
2017,1,6,6,1647,1592,1552,-40
2017,1,6,7,1536,1509,1377,-132
2017,1,6,8,1507,1475,1362,-113
2017,1,6,9,1473,1471,1149,-322
2017,1,6,10,1474,1477,1173,-304
2017,1,6,11,1482,1488,1220,-268
2017,1,6,12,1517,1520,1350,-170
2017,1,6,13,1601,1591,1430,-161
2017,1,6,14,1734,1710,1528,-182
2017,1,6,15,1740,1766,1583,-183
2017,1,6,16,1756,1782,1546,-236
2017,1,6,17,1764,1774,1461,-313
2017,1,6,18,1746,1753,1303,-450
2017,1,6,19,1720,1719,1277,-442
2017,1,6,20,1694,1684,1245,-439
2017,1,6,21,1686,1666,1211,-455
2017,1,6,22,1676,1645,1215,-430
2017,1,6,23,1691,1648,1237,-411
2017,1,7,0,1742,1686,1414,-272
2017,1,7,1,1892,1842,1601,-241
2017,1,7,2,1930,1916,1770,-146
2017,1,7,3,1920,1900,1635,-265
2017,1,7,4,1911,1888,1681,-207
2017,1,7,5,1858,1840,1672,-168
2017,1,7,6,1759,1763,1672,-91
2017,1,7,7,1662,1691,1467,-224
2017,1,7,8,1649,1637,1493,-144
2017,1,7,9,1620,1607,1493,-114
2017,1,7,10,1602,1592,1489,-103
2017,1,7,11,1600,1594,1455,-139
2017,1,7,12,1611,1607,1535,-72
2017,1,7,13,1639,1650,1523,-127
2017,1,7,14,1685,1716,1515,-201
2017,1,7,15,1727,1743,1530,-213
2017,1,7,16,1764,1757,1564,-193
2017,1,7,17,1764,1732,1471,-261
2017,1,7,18,1738,1710,1506,-204
2017,1,7,19,1690,1666,1556,-110
2017,1,7,20,1649,1642,1588,-54
2017,1,7,21,1636,1615,1575,-40
2017,1,7,22,1622,1616,1561,-55
2017,1,7,23,1638,1640,1591,-49
2017,1,8,0,1694,1686,1733,47
2017,1,8,1,1856,1813,1817,4
2017,1,8,2,1902,1853,1877,24
2017,1,8,3,1899,1826,1876,50
2017,1,8,4,1879,1809,1793,-16
2017,1,8,5,1824,1758,1749,-9
2017,1,8,6,1730,1676,1755,79
2017,1,8,7,1641,1601,1535,-66
2017,1,8,8,1567,1540,1494,-46
2017,1,8,9,1537,1507,1509,2
2017,1,8,10,1524,1491,1533,42
2017,1,8,11,1526,1481,1621,140
2017,1,8,12,1531,1489,1822,333
2017,1,8,13,1555,1517,1902,385
2017,1,8,14,1608,1568,1933,365
2017,1,8,15,1645,1590,1904,314
2017,1,8,16,1667,1595,1936,341
2017,1,8,17,1648,1592,1867,275
2017,1,8,18,1632,1549,1768,219
2017,1,8,19,1604,1528,1741,213
2017,1,8,20,1578,1523,1778,255
2017,1,8,21,1561,1495,1822,327
2017,1,8,22,1553,1485,1840,355
2017,1,8,23,1563,1489,1803,314
2017,1,9,0,1618,1545,1742,197
2017,1,9,1,1779,1708,1734,26
2017,1,9,2,1838,1775,1799,24
2017,1,9,3,1834,1758,1771,13
2017,1,9,4,1811,1719,1727,8
2017,1,9,5,1746,1641,1725,84
2017,1,9,6,1649,1525,1631,106
2017,1,9,7,1568,1446,1386,-60
2017,1,9,8,1460,1395,1298,-97
2017,1,9,9,1437,1378,1291,-87
2017,1,9,10,1438,1369,1258,-111
2017,1,9,11,1439,1381,1267,-114
2017,1,9,12,1480,1410,1462,52
2017,1,9,13,1568,1502,1503,1
2017,1,9,14,1695,1650,1598,-52
2017,1,9,15,1731,1685,1651,-34
2017,1,9,16,1724,1655,1611,-44
2017,1,9,17,1704,1653,1553,-100
2017,1,9,18,1674,1646,1560,-86
2017,1,9,19,1647,1637,1610,-27
2017,1,9,20,1618,1609,1683,74
2017,1,9,21,1609,1605,1655,50
2017,1,9,22,1605,1598,1667,69
2017,1,9,23,1618,1586,1715,129
2017,1,10,0,1662,1637,1821,184
2017,1,10,1,1802,1769,1954,185
2017,1,10,2,1835,1807,1984,177
2017,1,10,3,1833,1788,1955,167
2017,1,10,4,1805,1755,1961,206
2017,1,10,5,1727,1671,1917,246
2017,1,10,6,1610,1561,1845,284
2017,1,10,7,1516,1454,1685,231
2017,1,10,8,1464,1398,1700,302
2017,1,10,9,1435,1367,1688,321
2017,1,10,10,1427,1355,1673,318
2017,1,10,11,1429,1353,1670,317
2017,1,10,12,1470,1388,1736,348
2017,1,10,13,1561,1480,1902,422
2017,1,10,14,1688,1631,1876,245
2017,1,10,15,1716,1660,1869,209
2017,1,10,16,1706,1630,1805,175
2017,1,10,17,1690,1592,1786,194
2017,1,10,18,1657,1559,1704,145
2017,1,10,19,1636,1528,1753,225
2017,1,10,20,1621,1507,1759,252
2017,1,10,21,1609,1506,1814,308
2017,1,10,22,1603,1495,1791,296
2017,1,10,23,1613,1478,1709,231
2017,1,11,0,1666,1543,1753,210
2017,1,11,1,1803,1682,1797,115
2017,1,11,2,1850,1750,1843,93
2017,1,11,3,1839,1734,1874,140
2017,1,11,4,1813,1705,1905,200
2017,1,11,5,1730,1642,1913,271
2017,1,11,6,1610,1522,1897,375
2017,1,11,7,1516,1437,1728,291
2017,1,11,8,1454,1382,1704,322
2017,1,11,9,1431,1354,1782,428
2017,1,11,10,1420,1328,1800,472
2017,1,11,11,1427,1334,1865,531
2017,1,11,12,1465,1364,1924,560
2017,1,11,13,1562,1453,2053,600
2017,1,11,14,1685,1594,2166,572
2017,1,11,15,1690,1633,2110,477
2017,1,11,16,1680,1613,2062,449
2017,1,11,17,1656,1577,1913,336
2017,1,11,18,1629,1565,1917,352
2017,1,11,19,1605,1564,1941,377
2017,1,11,20,1580,1550,1963,413
2017,1,11,21,1545,1547,1985,438
2017,1,11,22,1558,1554,1977,423
2017,1,11,23,1596,1560,2000,440
2017,1,12,0,1652,1583,2131,548
2017,1,12,1,1791,1676,2169,493
2017,1,12,2,1827,1765,2220,455
2017,1,12,3,1816,1760,2207,447
2017,1,12,4,1790,1733,2214,481
2017,1,12,5,1715,1664,2152,488
2017,1,12,6,1604,1544,2079,535
2017,1,12,7,1508,1446,1913,467
2017,1,12,8,1451,1400,1853,453
2017,1,12,9,1426,1372,1865,493
2017,1,12,10,1415,1362,1816,454
2017,1,12,11,1422,1377,1786,409
2017,1,12,12,1461,1409,1816,407
2017,1,12,13,1552,1508,1947,439
2017,1,12,14,1686,1665,2058,393
2017,1,12,15,1704,1702,2079,377
2017,1,12,16,1675,1657,2078,421
2017,1,12,17,1644,1605,2021,416
2017,1,12,18,1614,1564,2020,456
2017,1,12,19,1589,1536,1949,413
2017,1,12,20,1582,1516,1929,413
2017,1,12,21,1573,1503,1926,423
2017,1,12,22,1569,1491,1883,392
2017,1,12,23,1571,1496,1880,384
2017,1,13,0,1625,1475,1905,430
2017,1,13,1,1759,1659,2130,471
2017,1,13,2,1805,1730,2285,555
2017,1,13,3,1791,1686,2223,537
2017,1,13,4,1776,1708,2262,554
2017,1,13,5,1709,1644,2303,659
2017,1,13,6,1596,1548,2230,682
2017,1,13,7,1504,1457,1992,535
2017,1,13,8,1448,1401,1901,500
2017,1,13,9,1419,1371,1907,536
2017,1,13,10,1412,1364,1913,549
2017,1,13,11,1417,1371,1897,526
2017,1,13,12,1453,1401,1928,527
2017,1,13,13,1541,1485,2019,534
2017,1,13,14,1654,1624,2122,498
2017,1,13,15,1678,1673,2180,507
2017,1,13,16,1665,1677,2206,529
2017,1,13,17,1645,1673,2171,498
2017,1,13,18,1616,1655,2113,458
2017,1,13,19,1595,1633,1938,305
2017,1,13,20,1575,1612,1799,187
2017,1,13,21,1540,1596,1817,221
2017,1,13,22,1535,1581,1771,190
2017,1,13,23,1544,1567,1784,217
2017,1,14,0,1581,1596,1871,275
2017,1,14,1,1702,1718,1959,241
2017,1,14,2,1732,1738,1905,167
2017,1,14,3,1732,1720,1860,140
2017,1,14,4,1714,1711,1891,180
2017,1,14,5,1679,1661,1845,184
2017,1,14,6,1581,1569,1764,195
2017,1,14,7,1490,1482,1555,73
2017,1,14,8,1449,1422,1381,-41
2017,1,14,9,1415,1387,1367,-20
2017,1,14,10,1396,1357,1364,7
2017,1,14,11,1391,1353,1368,15
2017,1,14,12,1402,1364,1395,31
2017,1,14,13,1436,1405,1567,162
2017,1,14,14,1507,1482,1683,201
2017,1,14,15,1536,1511,1725,214
2017,1,14,16,1561,1536,1726,190
2017,1,14,17,1556,1548,1746,198
2017,1,14,18,1540,1546,1818,272
2017,1,14,19,1529,1516,1769,253
2017,1,14,20,1522,1495,1740,245
2017,1,14,21,1509,1483,1756,273
2017,1,14,22,1506,1470,1728,258
2017,1,14,23,1521,1453,1711,258
2017,1,15,0,1581,1499,1791,292
2017,1,15,1,1731,1633,1991,358
2017,1,15,2,1766,1680,2055,375
2017,1,15,3,1735,1657,2026,369
2017,1,15,4,1713,1642,2015,373
2017,1,15,5,1660,1600,1952,352
2017,1,15,6,1570,1526,1886,360
2017,1,15,7,1486,1424,1664,240
2017,1,15,8,1444,1405,1582,177
2017,1,15,9,1410,1371,1548,177
2017,1,15,10,1388,1353,1522,169
2017,1,15,11,1375,1340,1545,205
2017,1,15,12,1380,1353,1625,272
2017,1,15,13,1409,1379,1763,384
2017,1,15,14,1472,1433,1751,318
2017,1,15,15,1533,1499,1771,272
2017,1,15,16,1600,1564,1830,266
2017,1,15,17,1627,1602,1848,246
2017,1,15,18,1646,1624,1858,234
2017,1,15,19,1655,1634,1865,231
2017,1,15,20,1631,1612,1806,194
2017,1,15,21,1601,1580,1724,144
2017,1,15,22,1611,1598,1667,69
2017,1,15,23,1631,1598,1646,48
2017,1,16,0,1668,1647,1768,121
2017,1,16,1,1801,1750,1946,196
2017,1,16,2,1842,1793,2015,222
2017,1,16,3,1805,1784,1984,200
2017,1,16,4,1771,1750,2044,294
2017,1,16,5,1704,1695,2072,377
2017,1,16,6,1601,1608,1797,189
2017,1,16,7,1521,1510,1604,94
2017,1,16,8,1481,1444,1637,193
2017,1,16,9,1446,1379,1622,243
2017,1,16,10,1422,1389,1675,286
2017,1,16,11,1429,1389,1689,300
2017,1,16,12,1467,1406,1722,316
2017,1,16,13,1547,1463,1918,455
2017,1,16,14,1674,1545,2088,543
2017,1,16,15,1719,1599,2119,520
2017,1,16,16,1720,1632,2128,496
2017,1,16,17,1697,1652,2125,473
2017,1,16,18,1685,1667,2068,401
2017,1,16,19,1672,1641,2075,434
2017,1,16,20,1651,1592,1952,360
2017,1,16,21,1638,1564,1861,297
2017,1,16,22,1635,1563,1854,291
2017,1,16,23,1649,1599,1859,260
2017,1,17,0,1692,1656,1994,338
2017,1,17,1,1845,1781,2152,371
2017,1,17,2,1864,1824,2227,403
2017,1,17,3,1847,1812,2211,399
2017,1,17,4,1827,1783,2195,412
2017,1,17,5,1758,1707,2168,461
2017,1,17,6,1646,1592,2115,523
2017,1,17,7,1549,1484,1910,426
2017,1,17,8,1497,1427,1726,299
2017,1,17,9,1459,1390,1689,299
2017,1,17,10,1452,1377,1692,315
2017,1,17,11,1455,1379,1694,315
2017,1,17,12,1491,1407,1736,329
2017,1,17,13,1559,1500,1922,422
2017,1,17,14,1684,1644,1972,328
2017,1,17,15,1726,1691,1976,285
2017,1,17,16,1719,1667,1831,164
2017,1,17,17,1711,1626,1753,127
2017,1,17,18,1698,1580,1719,139
2017,1,17,19,1677,1557,1750,193
2017,1,17,20,1653,1540,1812,272
2017,1,17,21,1638,1535,1830,295
2017,1,17,22,1631,1528,1857,329
2017,1,17,23,1641,1533,1883,350
2017,1,18,0,1688,1568,1889,321
2017,1,18,1,1838,1691,1899,208
2017,1,18,2,1831,1774,2018,244
2017,1,18,3,1824,1765,1991,226
2017,1,18,4,1805,1733,2045,312
2017,1,18,5,1732,1666,2002,336
2017,1,18,6,1626,1556,1901,345
2017,1,18,7,1530,1465,1690,225
2017,1,18,8,1495,1408,1628,220
2017,1,18,9,1464,1376,1564,188
2017,1,18,10,1456,1373,1581,208
2017,1,18,11,1464,1367,1660,293
2017,1,18,12,1506,1401,1723,322
2017,1,18,13,1563,1485,1900,415
2017,1,18,14,1702,1628,2071,443
2017,1,18,15,1741,1673,2241,568
2017,1,18,16,1724,1655,2278,623
2017,1,18,17,1700,1631,2141,510
2017,1,18,18,1680,1588,2076,488
2017,1,18,19,1646,1584,2140,556
2017,1,18,20,1606,1573,2142,569
2017,1,18,21,1590,1580,2165,585
2017,1,18,22,1589,1557,2168,611
2017,1,18,23,1629,1583,2127,544
2017,1,19,0,1683,1634,2192,558
2017,1,19,1,1816,1755,2371,616
2017,1,19,2,1871,1815,2404,589
2017,1,19,3,1857,1800,2402,602
2017,1,19,4,1834,1788,2408,620
2017,1,19,5,1761,1710,2338,628
2017,1,19,6,1645,1599,2273,674
2017,1,19,7,1552,1497,2162,665
2017,1,19,8,1503,1440,2066,626
2017,1,19,9,1474,1405,2169,764
2017,1,19,10,1466,1412,2140,728
2017,1,19,11,1470,1420,2199,779
2017,1,19,12,1512,1458,2181,723
2017,1,19,13,1602,1554,2413,859
2017,1,19,14,1725,1678,2409,731
2017,1,19,15,1764,1702,2453,751
2017,1,19,16,1726,1692,2403,711
2017,1,19,17,1703,1666,2439,773
2017,1,19,18,1674,1631,2374,743
2017,1,19,19,1653,1602,2346,744
2017,1,19,20,1616,1579,2348,769
2017,1,19,21,1595,1564,2376,812
2017,1,19,22,1586,1563,2313,750
2017,1,19,23,1590,1598,2248,650
2017,1,20,0,1645,1657,2266,609
2017,1,20,1,1778,1779,2317,538
2017,1,20,2,1855,1820,2393,573
2017,1,20,3,1846,1805,2377,572
2017,1,20,4,1827,1785,2405,620
2017,1,20,5,1750,1710,2396,686
2017,1,20,6,1635,1588,2340,752
2017,1,20,7,1539,1495,2179,684
2017,1,20,8,1486,1433,2127,694
2017,1,20,9,1453,1401,2045,644
2017,1,20,10,1446,1406,2035,629
2017,1,20,11,1447,1404,2029,625
2017,1,20,12,1479,1430,2020,590
2017,1,20,13,1566,1525,2174,649
2017,1,20,14,1702,1671,2317,646
2017,1,20,15,1725,1721,2299,578
2017,1,20,16,1735,1712,2393,681
2017,1,20,17,1731,1679,2411,732
2017,1,20,18,1707,1664,2353,689
2017,1,20,19,1658,1669,2387,718
2017,1,20,20,1640,1646,2440,794
2017,1,20,21,1644,1633,2354,721
2017,1,20,22,1633,1624,2322,698
2017,1,20,23,1648,1637,2281,644
2017,1,21,0,1698,1694,2282,588
2017,1,21,1,1827,1824,2341,517
2017,1,21,2,1853,1867,2367,500
2017,1,21,3,1895,1846,2340,494
2017,1,21,4,1865,1813,2253,440
2017,1,21,5,1810,1751,2247,496
2017,1,21,6,1712,1643,2124,481
2017,1,21,7,1617,1554,2042,488
2017,1,21,8,1526,1496,1999,503
2017,1,21,9,1494,1470,1979,509
2017,1,21,10,1478,1447,1953,506
2017,1,21,11,1459,1422,1930,508
2017,1,21,12,1465,1432,1917,485
2017,1,21,13,1521,1487,2007,520
2017,1,21,14,1589,1540,2190,650
2017,1,21,15,1628,1556,2227,671
2017,1,21,16,1678,1572,2293,721
2017,1,21,17,1684,1586,2153,567
2017,1,21,18,1658,1567,2100,533
2017,1,21,19,1632,1554,2036,482
2017,1,21,20,1624,1574,2027,453
2017,1,21,21,1569,1527,1978,451
2017,1,21,22,1554,1515,1915,400
2017,1,21,23,1599,1570,1986,416
2017,1,22,0,1641,1611,2075,464
2017,1,22,1,1766,1727,2419,692
2017,1,22,2,1846,1811,2480,669
2017,1,22,3,1825,1792,2430,638
2017,1,22,4,1796,1765,2402,637
2017,1,22,5,1741,1708,2392,684
2017,1,22,6,1653,1625,2352,727
2017,1,22,7,1571,1547,2112,565
2017,1,22,8,1511,1486,2068,582
2017,1,22,9,1484,1456,2066,610
2017,1,22,10,1458,1425,2029,604
2017,1,22,11,1457,1426,2024,598
2017,1,22,12,1464,1441,2038,597
2017,1,22,13,1503,1481,2141,660
2017,1,22,14,1570,1539,2140,601
2017,1,22,15,1608,1564,2065,501
2017,1,22,16,1618,1572,2051,479
2017,1,22,17,1611,1563,2044,481
2017,1,22,18,1592,1550,1913,363
2017,1,22,19,1574,1536,1855,319
2017,1,22,20,1516,1480,1794,314
2017,1,22,21,1546,1512,1681,169
2017,1,22,22,1544,1514,1642,128
2017,1,22,23,1569,1539,1712,173
2017,1,23,0,1620,1580,1770,190
2017,1,23,1,1761,1719,1941,222
2017,1,23,2,1845,1808,2038,230
2017,1,23,3,1838,1800,1978,178
2017,1,23,4,1815,1774,2031,257
2017,1,23,5,1737,1692,2101,409
2017,1,23,6,1616,1573,1939,366
2017,1,23,7,1531,1495,1830,335
2017,1,23,8,1488,1448,1819,371
2017,1,23,9,1442,1401,1732,331
2017,1,23,10,1429,1387,1674,287
2017,1,23,11,1430,1386,1738,352
2017,1,23,12,1463,1422,1721,299
2017,1,23,13,1552,1511,1950,439
2017,1,23,14,1704,1660,1987,327
2017,1,23,15,1718,1696,2061,365
2017,1,23,16,1657,1665,2024,359
2017,1,23,17,1633,1631,1951,320
2017,1,23,18,1605,1597,1812,215
2017,1,23,19,1573,1569,1892,323
2017,1,23,20,1577,1549,1937,388
2017,1,23,21,1569,1541,2019,478
2017,1,23,22,1542,1513,2027,514
2017,1,23,23,1587,1546,2048,502
2017,1,24,0,1616,1578,2033,455
2017,1,24,1,1727,1690,2210,520
2017,1,24,2,1823,1789,2320,531
2017,1,24,3,1815,1775,2274,499
2017,1,24,4,1800,1763,2253,490
2017,1,24,5,1721,1686,2231,545
2017,1,24,6,1606,1571,2110,539
2017,1,24,7,1517,1489,1914,425
2017,1,24,8,1491,1452,1831,379
2017,1,24,9,1457,1418,1756,338
2017,1,24,10,1441,1400,1700,300
2017,1,24,11,1440,1393,1760,367
2017,1,24,12,1482,1436,1780,344
2017,1,24,13,1568,1527,1878,351
2017,1,24,14,1717,1665,1959,294
2017,1,24,15,1768,1709,2074,365
2017,1,24,16,1752,1691,2137,446
2017,1,24,17,1729,1666,2168,502
2017,1,24,18,1723,1650,2196,546
2017,1,24,19,1700,1625,2171,546
2017,1,24,20,1695,1615,2140,525
2017,1,24,21,1670,1587,2089,502
2017,1,24,22,1668,1579,2078,499
2017,1,24,23,1681,1594,2044,450
2017,1,25,0,1696,1609,2127,518
2017,1,25,1,1838,1765,2212,447
2017,1,25,2,1922,1876,2279,403
2017,1,25,3,1945,1873,2192,319
2017,1,25,4,1922,1844,2168,324
2017,1,25,5,1847,1767,2132,365
2017,1,25,6,1724,1650,2006,356
2017,1,25,7,1629,1552,1898,346
2017,1,25,8,1567,1499,1857,358
2017,1,25,9,1541,1473,1819,346
2017,1,25,10,1542,1471,1786,315
2017,1,25,11,1544,1475,1675,200
2017,1,25,12,1587,1516,1657,141
2017,1,25,13,1681,1607,1866,259
2017,1,25,14,1825,1754,2037,283
2017,1,25,15,1856,1793,2094,301
2017,1,25,16,1814,1758,1898,140
2017,1,25,17,1782,1706,1814,108
2017,1,25,18,1774,1691,1730,39
2017,1,25,19,1748,1663,1780,117
2017,1,25,20,1707,1640,1809,169
2017,1,25,21,1733,1637,1865,228
2017,1,25,22,1728,1630,1852,222
2017,1,25,23,1732,1646,1851,205
2017,1,26,0,1759,1662,1887,225
2017,1,26,1,1880,1778,1929,151
2017,1,26,2,1972,1863,1990,127
2017,1,26,3,1985,1891,2017,126
2017,1,26,4,1967,1883,1963,80
2017,1,26,5,1895,1817,1880,63
2017,1,26,6,1774,1706,1661,-45
2017,1,26,7,1674,1619,1552,-67
2017,1,26,8,1635,1567,1631,64
2017,1,26,9,1580,1532,1645,113
2017,1,26,10,1585,1533,1592,59
2017,1,26,11,1586,1537,1586,49
2017,1,26,12,1636,1580,1581,1
2017,1,26,13,1724,1669,1784,115
2017,1,26,14,1862,1825,1940,115
2017,1,26,15,1888,1856,2047,191
2017,1,26,16,1850,1817,2001,184
2017,1,26,17,1808,1767,1917,150
2017,1,26,18,1757,1710,1796,86
2017,1,26,19,1758,1703,1742,39
2017,1,26,20,1764,1715,1754,39
2017,1,26,21,1748,1715,1815,100
2017,1,26,22,1727,1701,1854,153
2017,1,26,23,1728,1709,1909,200
2017,1,27,0,1767,1739,2000,261
2017,1,27,1,1886,1854,2188,334
2017,1,27,2,1984,1959,2367,408
2017,1,27,3,1966,1945,2363,418
2017,1,27,4,1903,1885,2331,446
2017,1,27,5,1866,1850,2338,488
2017,1,27,6,1753,1736,2229,493
2017,1,27,7,1662,1638,1946,308
2017,1,27,8,1617,1590,1852,262
2017,1,27,9,1591,1565,1810,245
2017,1,27,10,1590,1565,1806,241
2017,1,27,11,1595,1566,1802,236
2017,1,27,12,1635,1604,1832,228
2017,1,27,13,1736,1683,1989,306
2017,1,27,14,1871,1830,2102,272
2017,1,27,15,1920,1877,2118,241
2017,1,27,16,1917,1837,2147,310
2017,1,27,17,1883,1799,2133,334
2017,1,27,18,1847,1758,2155,397
2017,1,27,19,1810,1699,2047,348
2017,1,27,20,1768,1653,1939,286
2017,1,27,21,1739,1635,1917,282
2017,1,27,22,1717,1621,1913,292
2017,1,27,23,1728,1627,1886,259
2017,1,28,0,1757,1665,1932,267
2017,1,28,1,1877,1790,2060,270
2017,1,28,2,1967,1905,2111,206
2017,1,28,3,1963,1903,2164,261
2017,1,28,4,1941,1898,2274,376
2017,1,28,5,1895,1840,2195,355
2017,1,28,6,1796,1743,1950,207
2017,1,28,7,1714,1676,1808,132
2017,1,28,8,1648,1621,1779,158
2017,1,28,9,1616,1590,1777,187
2017,1,28,10,1609,1562,1803,241
2017,1,28,11,1604,1569,1783,214
2017,1,28,12,1615,1579,1766,187
2017,1,28,13,1659,1619,1896,277
2017,1,28,14,1730,1688,1911,223
2017,1,28,15,1775,1730,2079,349
2017,1,28,16,1797,1742,2117,375
2017,1,28,17,1777,1728,2078,350
2017,1,28,18,1736,1687,1951,264
2017,1,28,19,1691,1646,1881,235
2017,1,28,20,1664,1598,1837,239
2017,1,28,21,1640,1562,1801,239
2017,1,28,22,1619,1537,1779,242
2017,1,28,23,1632,1536,1774,238
2017,1,29,0,1677,1562,1791,229
2017,1,29,1,1811,1661,1904,243
2017,1,29,2,1904,1815,2167,352
2017,1,29,3,1901,1815,2224,409
2017,1,29,4,1871,1794,2222,428
2017,1,29,5,1829,1753,2167,414
2017,1,29,6,1743,1690,2072,382
2017,1,29,7,1663,1596,1964,368
2017,1,29,8,1618,1558,1889,331
2017,1,29,9,1582,1528,1871,343
2017,1,29,10,1575,1511,1877,366
2017,1,29,11,1566,1511,1773,262
2017,1,29,12,1574,1531,1777,246
2017,1,29,13,1602,1568,1952,384
2017,1,29,14,1658,1621,1954,333
2017,1,29,15,1703,1652,1958,306
2017,1,29,16,1710,1651,2127,476
2017,1,29,17,1683,1627,2030,403
2017,1,29,18,1647,1595,1893,298
2017,1,29,19,1619,1558,1849,291
2017,1,29,20,1593,1525,1836,311
2017,1,29,21,1579,1501,1783,282
2017,1,29,22,1570,1478,1770,292
2017,1,29,23,1581,1484,1760,276
2017,1,30,0,1630,1515,1883,368
2017,1,30,1,1776,1649,2086,437
2017,1,30,2,1884,1783,2245,462
2017,1,30,3,1889,1787,2257,470
2017,1,30,4,1854,1769,2288,519
2017,1,30,5,1788,1708,2201,493
2017,1,30,6,1683,1601,2091,490
2017,1,30,7,1600,1518,1937,419
2017,1,30,8,1530,1464,1921,457
2017,1,30,9,1489,1423,1890,467
2017,1,30,10,1504,1437,1959,522
2017,1,30,11,1511,1447,1975,528
2017,1,30,12,1544,1492,1986,494
2017,1,30,13,1641,1605,2134,529
2017,1,30,14,1795,1760,2279,519
2017,1,30,15,1823,1790,2317,527
2017,1,30,16,1789,1749,2276,527
2017,1,30,17,1748,1700,2206,506
2017,1,30,18,1708,1654,2200,546
2017,1,30,19,1670,1620,2149,529
2017,1,30,20,1634,1579,1994,415
2017,1,30,21,1609,1554,1951,397
2017,1,30,22,1590,1529,1926,397
2017,1,30,23,1588,1528,1936,408
2017,1,31,0,1624,1552,2037,485
2017,1,31,1,1749,1648,2239,591
2017,1,31,2,1859,1780,2350,570
2017,1,31,3,1855,1794,2386,592
2017,1,31,4,1833,1766,2322,556
2017,1,31,5,1767,1695,2290,595
2017,1,31,6,1653,1592,2242,650
2017,1,31,7,1560,1496,2100,604
2017,1,31,8,1493,1446,2034,588
2017,1,31,9,1458,1413,1995,582
2017,1,31,10,1459,1417,1937,520
2017,1,31,11,1452,1406,1902,496
2017,1,31,12,1504,1456,1981,525
2017,1,31,13,1618,1566,2200,634
2017,1,31,14,1763,1722,2317,595
2017,1,31,15,1782,1753,2348,595
2017,1,31,16,1741,1704,2216,512
2017,1,31,17,1695,1648,2157,509
2017,1,31,18,1659,1615,2154,539
2017,1,31,19,1623,1584,2189,605
2017,1,31,20,1591,1549,2169,620
2017,1,31,21,1564,1522,2160,638
2017,1,31,22,1550,1512,2137,625
2017,1,31,23,1562,1514,2138,624
2017,2,1,0,1589,1536,2119,583
2017,2,1,1,1705,1619,2190,571
2017,2,1,2,1806,1746,2338,592
2017,2,1,3,1805,1740,2328,588
2017,2,1,4,1762,1735,2370,635
2017,2,1,5,1692,1661,2350,689
2017,2,1,6,1582,1548,2286,738
2017,2,1,7,1499,1449,2179,730
2017,2,1,8,1441,1401,2058,657
2017,2,1,9,1414,1377,2101,724
2017,2,1,10,1409,1375,2087,712
2017,2,1,11,1420,1386,2074,688
2017,2,1,12,1479,1433,2122,689
2017,2,1,13,1501,1436,2143,707
2017,2,1,14,1668,1621,2302,681
2017,2,1,15,1741,1703,2359,656
2017,2,1,16,1698,1659,2262,603
2017,2,1,17,1661,1606,2229,623
2017,2,1,18,1614,1560,2110,550
2017,2,1,19,1588,1538,2049,511
2017,2,1,20,1562,1516,2027,511
2017,2,1,21,1543,1492,2013,521
2017,2,1,22,1533,1486,1994,508
2017,2,1,23,1552,1486,2031,545
2017,2,2,0,1584,1517,2126,609
2017,2,2,1,1681,1603,2111,508
2017,2,2,2,1781,1720,2275,555
2017,2,2,3,1791,1724,2332,608
2017,2,2,4,1764,1712,2334,622
2017,2,2,5,1693,1650,2335,685
2017,2,2,6,1591,1538,2267,729
2017,2,2,7,1501,1451,2124,673
2017,2,2,8,1455,1410,2132,722
2017,2,2,9,1307,1229,1891,662
2017,2,2,10,1379,1258,1917,659
2017,2,2,11,1387,1293,1895,602
2017,2,2,12,1434,1365,1921,556
2017,2,2,13,1514,1490,2041,551
2017,2,2,14,1666,1640,2181,541
2017,2,2,15,1737,1651,2250,599
2017,2,2,16,1703,1620,2123,503
2017,2,2,17,1667,1596,2015,419
2017,2,2,18,1636,1567,1951,384
2017,2,2,19,1622,1538,1938,400
2017,2,2,20,1596,1515,1894,379
2017,2,2,21,1564,1495,1852,357
2017,2,2,22,1565,1497,1852,355
2017,2,2,23,1568,1510,1889,379
2017,2,3,0,1603,1534,2019,485
2017,2,3,1,1707,1630,2196,566
2017,2,3,2,1795,1729,2335,606
2017,2,3,3,1799,1723,2303,580
2017,2,3,4,1786,1716,2309,593
2017,2,3,5,1705,1641,2278,637
2017,2,3,6,1587,1526,2137,611
2017,2,3,7,1492,1446,2143,697
2017,2,3,8,1474,1417,2136,719
2017,2,3,9,1421,1365,2091,726
2017,2,3,10,1411,1360,2030,670
2017,2,3,11,1428,1369,2020,651
2017,2,3,12,1468,1410,2020,610
2017,2,3,13,1568,1505,2027,522
2017,2,3,14,1714,1660,2204,544
2017,2,3,15,1739,1687,2102,415
2017,2,3,16,1696,1643,1931,288
2017,2,3,17,1640,1589,1797,208
2017,2,3,18,1617,1562,1793,231
2017,2,3,19,1591,1517,1798,281
2017,2,3,20,1556,1484,1788,304
2017,2,3,21,1526,1473,1760,287
2017,2,3,22,1529,1471,1746,275
2017,2,3,23,1528,1478,1892,414
2017,2,4,0,1542,1488,1995,507
2017,2,4,1,1629,1569,2105,536
2017,2,4,2,1721,1669,2174,505
2017,2,4,3,1711,1660,2141,481
2017,2,4,4,1708,1653,2152,499
2017,2,4,5,1659,1607,2153,546
2017,2,4,6,1571,1522,2093,571
2017,2,4,7,1488,1455,1970,515
2017,2,4,8,1444,1396,1947,551
2017,2,4,9,1412,1363,1980,617
2017,2,4,10,1401,1351,2031,680
2017,2,4,11,1408,1360,1994,634
2017,2,4,12,1433,1378,1993,615
2017,2,4,13,1470,1430,2089,659
2017,2,4,14,1544,1500,2141,641
2017,2,4,15,1568,1534,2087,553
2017,2,4,16,1572,1540,2056,516
2017,2,4,17,1558,1521,1989,468
2017,2,4,18,1510,1479,1993,514
2017,2,4,19,1424,1383,1917,534
2017,2,4,20,1548,1402,1896,494
2017,2,4,21,1439,1386,1874,488
2017,2,4,22,1420,1373,1866,493
2017,2,4,23,1428,1372,1896,524
2017,2,5,0,1466,1401,1969,568
2017,2,5,1,1559,1488,2069,581
2017,2,5,2,1679,1617,2174,557
2017,2,5,3,1651,1585,2155,570
2017,2,5,4,1673,1611,2189,578
2017,2,5,5,1630,1572,2218,646
2017,2,5,6,1559,1503,2110,607
2017,2,5,7,1476,1432,1997,565
2017,2,5,8,1433,1381,1948,567
2017,2,5,9,1396,1348,1807,459
2017,2,5,10,1389,1334,1824,490
2017,2,5,11,1391,1337,1890,553
2017,2,5,12,1407,1358,1877,519
2017,2,5,13,1441,1394,1927,533
2017,2,5,14,1505,1440,1972,532
2017,2,5,15,1533,1465,2054,589
2017,2,5,16,1544,1488,2121,633
2017,2,5,17,1537,1483,2032,549
2017,2,5,18,1509,1448,1984,536
2017,2,5,19,1484,1425,2005,580
2017,2,5,20,1461,1409,2036,627
2017,2,5,21,1418,1363,2010,647
2017,2,5,22,1447,1397,1983,586
2017,2,5,23,1458,1399,2007,608
2017,2,6,0,1495,1424,2078,654
2017,2,6,1,1575,1495,2099,604
2017,2,6,2,1674,1598,2151,553
2017,2,6,3,1680,1598,1955,357
2017,2,6,4,1668,1594,1819,225
2017,2,6,5,1607,1573,1774,201
2017,2,6,6,1511,1474,1514,40
2017,2,6,7,1433,1389,1313,-76
2017,2,6,8,1392,1339,1331,-8
2017,2,6,9,1377,1322,1341,19
2017,2,6,10,1368,1307,1293,-14
2017,2,6,11,1377,1310,1299,-11
2017,2,6,12,1408,1333,1405,72
2017,2,6,13,1495,1416,1635,219
2017,2,6,14,1641,1566,1692,126
2017,2,6,15,1663,1597,1733,136
2017,2,6,16,1651,1594,1783,189
2017,2,6,17,1658,1612,1890,278
2017,2,6,18,1642,1609,1848,239
2017,2,6,19,1638,1603,1865,262
2017,2,6,20,1623,1589,1806,217
2017,2,6,21,1609,1580,1684,104
2017,2,6,22,1601,1560,1665,105
2017,2,6,23,1580,1529,1704,175
2017,2,7,0,1639,1590,1710,120
2017,2,7,1,1720,1669,1758,89
2017,2,7,2,1820,1781,1839,58
2017,2,7,3,1807,1765,1832,67
2017,2,7,4,1781,1737,1852,115
2017,2,7,5,1703,1650,1813,163
2017,2,7,6,1590,1540,1587,47
2017,2,7,7,1489,1437,1515,78
2017,2,7,8,1434,1379,1470,91
2017,2,7,9,1411,1366,1418,52
2017,2,7,10,1380,1333,1367,34
2017,2,7,11,1385,1339,1327,-12
2017,2,7,12,1414,1368,1358,-10
2017,2,7,13,1518,1467,1410,-57
2017,2,7,14,1661,1613,1537,-76
2017,2,7,15,1702,1652,1526,-126
2017,2,7,16,1662,1597,1558,-39
2017,2,7,17,1622,1554,1542,-12
2017,2,7,18,1585,1517,1573,56
2017,2,7,19,1566,1494,1525,31
2017,2,7,20,1536,1475,1584,109
2017,2,7,21,1529,1472,1600,128
2017,2,7,22,1531,1469,1570,101
2017,2,7,23,1537,1477,1596,119
2017,2,8,0,1553,1490,1486,-4
2017,2,8,1,1627,1558,1468,-90
2017,2,8,2,1741,1690,1572,-118
2017,2,8,3,1737,1683,1556,-127
2017,2,8,4,1719,1661,1508,-153
2017,2,8,5,1643,1583,1442,-141
2017,2,8,6,1533,1473,1330,-143
2017,2,8,7,1445,1392,1340,-52
2017,2,8,8,1398,1344,1374,30
2017,2,8,9,1368,1311,1352,41
2017,2,8,10,1357,1297,1376,79
2017,2,8,11,1360,1307,1357,50
2017,2,8,12,1389,1334,1324,-10
2017,2,8,13,1486,1436,1418,-18
2017,2,8,14,1644,1592,1557,-35
2017,2,8,15,1667,1597,1542,-55
2017,2,8,16,1622,1547,1512,-35
2017,2,8,17,1585,1510,1536,26
2017,2,8,18,1558,1482,1473,-9
2017,2,8,19,1537,1473,1441,-32
2017,2,8,20,1522,1452,1381,-71
2017,2,8,21,1512,1448,1336,-112
2017,2,8,22,1507,1446,1303,-143
2017,2,8,23,1509,1445,1294,-151
2017,2,9,0,1531,1462,1376,-86
2017,2,9,1,1604,1531,1359,-172
2017,2,9,2,1728,1657,1445,-212
2017,2,9,3,1709,1628,1457,-171
2017,2,9,4,1704,1626,1412,-214
2017,2,9,5,1637,1573,1379,-194
2017,2,9,6,1531,1469,1356,-113
2017,2,9,7,1441,1387,1269,-118
2017,2,9,8,1393,1339,1314,-25
2017,2,9,9,1356,1299,1272,-27
2017,2,9,10,1348,1294,1237,-57
2017,2,9,11,1358,1304,1213,-91
2017,2,9,12,1401,1339,1180,-159
2017,2,9,13,1506,1439,1305,-134
2017,2,9,14,1645,1589,1406,-183
2017,2,9,15,1660,1612,1523,-89
2017,2,9,16,1630,1581,1461,-120
2017,2,9,17,1603,1531,1410,-121
2017,2,9,18,1567,1506,1332,-174
2017,2,9,19,1534,1477,1362,-115
2017,2,9,20,1517,1456,1407,-49
2017,2,9,21,1518,1459,1404,-55
2017,2,9,22,1513,1459,1448,-11
2017,2,9,23,1511,1452,1485,33
2017,2,10,0,1527,1471,1475,4
2017,2,10,1,1592,1527,1426,-101
2017,2,10,2,1704,1644,1520,-124
2017,2,10,3,1695,1632,1498,-134
2017,2,10,4,1668,1615,1492,-123
2017,2,10,5,1575,1518,1463,-55
2017,2,10,6,1489,1434,1415,-19
2017,2,10,7,1403,1344,1342,-2
2017,2,10,8,1355,1284,1298,14
2017,2,10,9,1357,1271,1315,44
2017,2,10,10,1301,1253,1432,179
2017,2,10,11,1310,1262,1425,163
2017,2,10,12,1351,1296,1452,156
2017,2,10,13,1448,1386,1508,122
2017,2,10,14,1583,1530,1562,32
2017,2,10,15,1596,1549,1567,18
2017,2,10,16,1565,1523,1511,-12
2017,2,10,17,1544,1493,1484,-9
2017,2,10,18,1509,1474,1519,45
2017,2,10,19,1492,1450,1593,143
2017,2,10,20,1471,1425,1670,245
2017,2,10,21,1492,1442,1718,276
2017,2,10,22,1477,1433,1708,275
2017,2,10,23,1494,1444,1712,268
2017,2,11,0,1507,1454,1786,332
2017,2,11,1,1567,1407,1813,406
2017,2,11,2,1641,1587,1954,367
2017,2,11,3,1605,1580,1961,381
2017,2,11,4,1590,1523,1955,432
2017,2,11,5,1534,1469,1976,507
2017,2,11,6,1457,1395,1935,540
2017,2,11,7,1377,1290,1811,521
2017,2,11,8,1336,1264,1611,347
2017,2,11,9,1295,1232,1593,361
2017,2,11,10,1274,1212,1592,380
2017,2,11,11,1268,1204,1587,383
2017,2,11,12,1283,1217,1589,372
2017,2,11,13,1329,1260,1591,331
2017,2,11,14,1409,1320,1681,361
2017,2,11,15,1454,1342,1727,385
2017,2,11,16,1453,1380,1709,329
2017,2,11,17,1451,1392,1689,297
2017,2,11,18,1436,1396,1751,355
2017,2,11,19,1430,1385,1849,464
2017,2,11,20,1425,1367,1880,513
2017,2,11,21,1429,1363,1835,472
2017,2,11,22,1435,1352,1808,456
2017,2,11,23,1448,1362,1765,403
2017,2,12,0,1476,1391,1741,350
2017,2,12,1,1520,1461,1839,378
2017,2,12,2,1621,1560,1882,322
2017,2,12,3,1610,1546,1862,316
2017,2,12,4,1584,1505,1784,279
2017,2,12,5,1516,1460,1744,284
2017,2,12,6,1434,1387,1627,240
2017,2,12,7,1360,1323,1520,197
2017,2,12,8,1336,1270,1490,220
2017,2,12,9,1274,1207,1385,178
2017,2,12,10,1290,1219,1496,277
2017,2,12,11,1274,1209,1596,387
2017,2,12,12,1279,1222,1634,412
2017,2,12,13,1305,1256,1647,391
2017,2,12,14,1372,1305,1597,292
2017,2,12,15,1415,1329,1651,322
2017,2,12,16,1476,1383,1786,403
2017,2,12,17,1433,1405,1810,405
2017,2,12,18,1438,1413,1790,377
2017,2,12,19,1438,1436,1751,315
2017,2,12,20,1453,1456,1713,257
2017,2,12,21,1453,1441,1697,256
2017,2,12,22,1455,1445,1649,204
2017,2,12,23,1474,1467,1568,101
2017,2,13,0,1524,1514,1628,114
2017,2,13,1,1633,1619,1695,76
2017,2,13,2,1749,1724,1804,80
2017,2,13,3,1739,1715,1783,68
2017,2,13,4,1725,1691,1757,66
2017,2,13,5,1662,1640,1712,72
2017,2,13,6,1580,1554,1644,90
2017,2,13,7,1498,1467,1537,70
2017,2,13,8,1449,1414,1435,21
2017,2,13,9,1424,1390,1380,-10
2017,2,13,10,1403,1361,1367,6
2017,2,13,11,1401,1358,1423,65
2017,2,13,12,1432,1384,1505,121
2017,2,13,13,1554,1490,1541,51
2017,2,13,14,1680,1619,1770,151
2017,2,13,15,1717,1669,1850,181
2017,2,13,16,1706,1678,1815,137
2017,2,13,17,1723,1698,1728,30
2017,2,13,18,1717,1681,1727,46
2017,2,13,19,1703,1668,1649,-19
2017,2,13,20,1688,1658,1647,-11
2017,2,13,21,1684,1641,1707,66
2017,2,13,22,1643,1618,1651,33
2017,2,13,23,1610,1576,1597,21
2017,2,14,0,1676,1640,1707,67
2017,2,14,1,1759,1721,1816,95
2017,2,14,2,1857,1810,1912,102
2017,2,14,3,1852,1805,1948,143
2017,2,14,4,1819,1779,1964,185
2017,2,14,5,1748,1692,1983,291
2017,2,14,6,1645,1567,1892,325
2017,2,14,7,1536,1449,1840,391
2017,2,14,8,1473,1385,1802,417
2017,2,14,9,1442,1348,1872,524
2017,2,14,10,1432,1327,1886,559
2017,2,14,11,1443,1332,1900,568
2017,2,14,12,1483,1370,1944,574
2017,2,14,13,1587,1456,1962,506
2017,2,14,14,1734,1609,2035,426
2017,2,14,15,1751,1642,2054,412
2017,2,14,16,1713,1644,2090,446
2017,2,14,17,1680,1633,2036,403
2017,2,14,18,1647,1610,2002,392
2017,2,14,19,1608,1569,1933,364
2017,2,14,20,1582,1525,2018,493
2017,2,14,21,1569,1508,2044,536
2017,2,14,22,1554,1490,2063,573
2017,2,14,23,1548,1490,2061,571
2017,2,15,0,1588,1514,1959,445
2017,2,15,1,1675,1573,1969,396
2017,2,15,2,1795,1699,2187,488
2017,2,15,3,1796,1704,2137,433
2017,2,15,4,1787,1685,2228,543
2017,2,15,5,1715,1630,2184,554
2017,2,15,6,1611,1531,2072,541
2017,2,15,7,1515,1437,1889,452
2017,2,15,8,1467,1384,1820,436
2017,2,15,9,1435,1364,1724,360
2017,2,15,10,1426,1350,1715,365
2017,2,15,11,1431,1359,1697,338
2017,2,15,12,1475,1401,1743,342
2017,2,15,13,1576,1495,1838,343
2017,2,15,14,1717,1648,1980,332
2017,2,15,15,1711,1639,2030,391
2017,2,15,16,1682,1608,1947,339
2017,2,15,17,1655,1593,1844,251
2017,2,15,18,1615,1550,1845,295
2017,2,15,19,1568,1508,1792,284
2017,2,15,20,1525,1481,1759,278
2017,2,15,21,1524,1467,1784,317
2017,2,15,22,1523,1454,1782,328
2017,2,15,23,1521,1459,1845,386
2017,2,16,0,1540,1477,1881,404
2017,2,16,1,1607,1543,1960,417
2017,2,16,2,1728,1685,2091,406
2017,2,16,3,1633,1692,2127,435
2017,2,16,4,1727,1681,2165,484
2017,2,16,5,1666,1621,2143,522
2017,2,16,6,1571,1512,2034,522
2017,2,16,7,1471,1422,1964,542
2017,2,16,8,1433,1369,1929,560
2017,2,16,9,1406,1346,1884,538
2017,2,16,10,1399,1336,1832,496
2017,2,16,11,1405,1342,1841,499
2017,2,16,12,1449,1385,1852,467
2017,2,16,13,1545,1487,1963,476
2017,2,16,14,1680,1632,2033,401
2017,2,16,15,1681,1643,2103,460
2017,2,16,16,1623,1604,2059,455
2017,2,16,17,1593,1544,2024,480
2017,2,16,18,1532,1517,2010,493
2017,2,16,19,1504,1475,2041,566
2017,2,16,20,1473,1442,2046,604
2017,2,16,21,1468,1430,2024,594
2017,2,16,22,1461,1415,2021,606
2017,2,16,23,1466,1422,2069,647
2017,2,17,0,1509,1446,1873,427
2017,2,17,1,1570,1506,1787,281
2017,2,17,2,1698,1637,1911,274
2017,2,17,3,1700,1651,1946,295
2017,2,17,4,1693,1643,1866,223
2017,2,17,5,1626,1586,1841,255
2017,2,17,6,1521,1492,1804,312
2017,2,17,7,1439,1403,1660,257
2017,2,17,8,1395,1354,1704,350
2017,2,17,9,1365,1329,1641,312
2017,2,17,10,1365,1320,1632,312
2017,2,17,11,1352,1314,1656,342
2017,2,17,12,1375,1320,1682,362
2017,2,17,13,1497,1441,1749,308
2017,2,17,14,1639,1581,1747,166
2017,2,17,15,1665,1608,1850,242
2017,2,17,16,1648,1602,1877,275
2017,2,17,17,1640,1608,1904,296
2017,2,17,18,1606,1579,1850,271
2017,2,17,19,1545,1527,1785,258
2017,2,17,20,1502,1476,1798,322
2017,2,17,21,1505,1463,1905,442
2017,2,17,22,1488,1448,1888,440
2017,2,17,23,1479,1436,1860,424
2017,2,18,0,1500,1451,1875,424
2017,2,18,1,1568,1510,1909,399
2017,2,18,2,1675,1616,1995,379
2017,2,18,3,1660,1602,2023,421
2017,2,18,4,1650,1592,2046,454
2017,2,18,5,1602,1549,2156,607
2017,2,18,6,1526,1480,2078,598
2017,2,18,7,1442,1391,1904,513
2017,2,18,8,1385,1328,1827,499
2017,2,18,9,1351,1293,1838,545
2017,2,18,10,1337,1271,1786,515
2017,2,18,11,1336,1276,1756,480
2017,2,18,12,1346,1291,1734,443
2017,2,18,13,1386,1336,1757,421
2017,2,18,14,1460,1400,1795,395
2017,2,18,15,1493,1428,1811,383
2017,2,18,16,1512,1449,1845,396
2017,2,18,17,1516,1449,1853,404
2017,2,18,18,1496,1426,1865,439
2017,2,18,19,1479,1424,1871,447
2017,2,18,20,1451,1399,1892,493
2017,2,18,21,1413,1367,1871,504
2017,2,18,22,1379,1320,1848,528
2017,2,18,23,1435,1372,1893,521
2017,2,19,0,1459,1391,1937,546
2017,2,19,1,1537,1467,2025,558
2017,2,19,2,1636,1589,2166,577
2017,2,19,3,1640,1590,2130,540
2017,2,19,4,1620,1567,2083,516
2017,2,19,5,1570,1516,2028,512
2017,2,19,6,1496,1444,2001,557
2017,2,19,7,1426,1377,1861,484
2017,2,19,8,1376,1316,1814,498
2017,2,19,9,1342,1280,1825,545
2017,2,19,10,1327,1264,1849,585
2017,2,19,11,1325,1253,1854,601
2017,2,19,12,1328,1275,1923,648
2017,2,19,13,1357,1320,1916,596
2017,2,19,14,1427,1378,1838,460
2017,2,19,15,1448,1385,1755,370
2017,2,19,16,1489,1440,1695,255
2017,2,19,17,1507,1462,1715,253
2017,2,19,18,1500,1455,1753,298
2017,2,19,19,1475,1428,1762,334
2017,2,19,20,1462,1422,1785,363
2017,2,19,21,1464,1413,1755,342
2017,2,19,22,1438,1392,1741,349
2017,2,19,23,1444,1578,1971,393
2017,2,20,0,1488,1436,1831,395
2017,2,20,1,1556,1517,1986,469
2017,2,20,2,1684,1658,2181,523
2017,2,20,3,1677,1657,2218,561
2017,2,20,4,1659,1624,2176,552
2017,2,20,5,1598,1552,2216,664
2017,2,20,6,1513,1471,2131,660
2017,2,20,7,1430,1387,1997,610
2017,2,20,8,1386,1337,1805,468
2017,2,20,9,1349,1305,1687,382
2017,2,20,10,1343,1292,1686,394
2017,2,20,11,1343,1287,1770,483
2017,2,20,12,1391,1318,1816,498
2017,2,20,13,1498,1397,1843,446
2017,2,20,14,1620,1493,1914,421
2017,2,20,15,1628,1512,1936,424
2017,2,20,16,1564,1500,1928,428
2017,2,20,17,1565,1495,1855,360
2017,2,20,18,1535,1477,1766,289
2017,2,20,19,1513,1464,1762,298
2017,2,20,20,1488,1447,1756,309
2017,2,20,21,1493,1429,1758,329
2017,2,20,22,1483,1416,1781,365
2017,2,20,23,1487,1416,1768,352
2017,2,21,0,1518,1439,1850,411
2017,2,21,1,1573,1517,2009,492
2017,2,21,2,1711,1649,2096,447
2017,2,21,3,1711,1652,2076,424
2017,2,21,4,1685,1661,2130,469
2017,2,21,5,1611,1595,2057,462
2017,2,21,6,1509,1489,1831,342
2017,2,21,7,1417,1390,1691,301
2017,2,21,8,1373,1329,1618,289
2017,2,21,9,1333,1301,1715,414
2017,2,21,10,1324,1288,1724,436
2017,2,21,11,1323,1294,1705,411
2017,2,21,12,1378,1323,1801,478
2017,2,21,13,1482,1420,1880,460
2017,2,21,14,1614,1568,2017,449
2017,2,21,15,1621,1576,2006,430
2017,2,21,16,1609,1541,1940,399
2017,2,21,17,1590,1509,1855,346
2017,2,21,18,1563,1480,1783,303
2017,2,21,19,1525,1447,1761,314
2017,2,21,20,1508,1432,1773,341
2017,2,21,21,1495,1426,1813,387
2017,2,21,22,1494,1427,1817,390
2017,2,21,23,1502,1441,1761,320
2017,2,22,0,1516,1464,1803,339
2017,2,22,1,1592,1505,1881,376
2017,2,22,2,1704,1622,1929,307
2017,2,22,3,1695,1627,1956,329
2017,2,22,4,1673,1595,2013,418
2017,2,22,5,1593,1524,1947,423
2017,2,22,6,1500,1388,1829,441
2017,2,22,7,1408,1314,1704,390
2017,2,22,8,1336,1266,1644,378
2017,2,22,9,1309,1243,1622,379
2017,2,22,10,1299,1231,1622,391
2017,2,22,11,1298,1228,1664,436
2017,2,22,12,1354,1261,1758,497
2017,2,22,13,1464,1353,1913,560
2017,2,22,14,1571,1483,1992,509
2017,2,22,15,1569,1494,1968,474
2017,2,22,16,1564,1476,1935,459
2017,2,22,17,1552,1456,1836,380
2017,2,22,18,1530,1451,1887,436
2017,2,22,19,1518,1421,1913,492
2017,2,22,20,1516,1418,1951,533
2017,2,22,21,1494,1443,1973,530
2017,2,22,22,1499,1452,2013,561
2017,2,22,23,1520,1462,1964,502
2017,2,23,0,1545,1484,1853,369
2017,2,23,1,1603,1525,1863,338
2017,2,23,2,1686,1635,1920,285
2017,2,23,3,1683,1633,1910,277
2017,2,23,4,1665,1607,1919,312
2017,2,23,5,1591,1541,1847,306
2017,2,23,6,1483,1435,1802,367
2017,2,23,7,1386,1344,1657,313
2017,2,23,8,1359,1286,1618,332
2017,2,23,9,1322,1249,1679,430
2017,2,23,10,1319,1247,1687,440
2017,2,23,11,1322,1254,1729,475
2017,2,23,12,1354,1287,1780,493
2017,2,23,13,1436,1371,1856,485
2017,2,23,14,1574,1509,1953,444
2017,2,23,15,1590,1519,1974,455
2017,2,23,16,1548,1504,1939,435
2017,2,23,17,1559,1496,1838,342
2017,2,23,18,1538,1492,1821,329
2017,2,23,19,1498,1467,1828,361
2017,2,23,20,1470,1441,1854,413
2017,2,23,21,1472,1440,1694,254
2017,2,23,22,1463,1437,1807,370
2017,2,23,23,1472,1437,1840,403
2017,2,24,0,1524,1467,1863,396
2017,2,24,1,1593,1518,1953,435
2017,2,24,2,1699,1656,2064,408
2017,2,24,3,1705,1687,2112,425
2017,2,24,4,1696,1681,2057,376
2017,2,24,5,1625,1612,2109,497
2017,2,24,6,1524,1505,1988,483
2017,2,24,7,1435,1414,1831,417
2017,2,24,8,1429,1360,1847,487
2017,2,24,9,1399,1335,1772,437
2017,2,24,10,1401,1336,1785,449
2017,2,24,11,1384,1326,1796,470
2017,2,24,12,1439,1382,1792,410
2017,2,24,13,1528,1469,1892,423
2017,2,24,14,1656,1600,2033,433
2017,2,24,15,1658,1607,2019,412
2017,2,24,16,1641,1591,2017,426
2017,2,24,17,1629,1568,1956,388
2017,2,24,18,1587,1547,1952,405
2017,2,24,19,1554,1516,1942,426
2017,2,24,20,1527,1491,1922,431
2017,2,24,21,1508,1482,1987,505
2017,2,24,22,1502,1462,2004,542
2017,2,24,23,1502,1458,1975,517
2017,2,25,0,1517,1487,2080,593
2017,2,25,1,1571,1538,2095,557
2017,2,25,2,1700,1677,2200,523
2017,2,25,3,1734,1704,2252,548
2017,2,25,4,1737,1695,2297,602
2017,2,25,5,1700,1641,2323,682
2017,2,25,6,1609,1574,2215,641
2017,2,25,7,1522,1500,2137,637
2017,2,25,8,1496,1458,2068,610
2017,2,25,9,1468,1431,2058,627
2017,2,25,10,1462,1423,2028,605
2017,2,25,11,1464,1426,2001,575
2017,2,25,12,1483,1444,1951,507
2017,2,25,13,1529,1491,1907,416
2017,2,25,14,1598,1548,1977,429
2017,2,25,15,1614,1559,2060,501
2017,2,25,16,1604,1555,2043,488
2017,2,25,17,1578,1533,1981,448
2017,2,25,18,1547,1504,1890,386
2017,2,25,19,1510,1458,1878,420
2017,2,25,20,1472,1429,1838,409
2017,2,25,21,1448,1402,1824,422
2017,2,25,22,1443,1390,1852,462
2017,2,25,23,1443,1392,1866,474
2017,2,26,0,1482,1420,1933,513
2017,2,26,1,1552,1497,1944,447
2017,2,26,2,1687,1638,2154,516
2017,2,26,3,1701,1658,2226,568
2017,2,26,4,1674,1643,2231,588
2017,2,26,5,1651,1591,2177,586
2017,2,26,6,1571,1518,2139,621
2017,2,26,7,1495,1454,2020,566
2017,2,26,8,1442,1399,1995,596
2017,2,26,9,1424,1382,1968,586
2017,2,26,10,1409,1361,1929,568
2017,2,26,11,1404,1356,1963,607
2017,2,26,12,1413,1363,1972,609
2017,2,26,13,1442,1396,1962,566
2017,2,26,14,1499,1442,1949,507
2017,2,26,15,1532,1471,1929,458
2017,2,26,16,1530,1478,2013,535
2017,2,26,17,1552,1509,2130,621
2017,2,26,18,1528,1492,2103,611
2017,2,26,19,1518,1476,2016,540
2017,2,26,20,1523,1479,1974,495
2017,2,26,21,1521,1477,1996,519
2017,2,26,22,1504,1462,1973,511
2017,2,26,23,1515,1475,1940,465
2017,2,27,0,1554,1498,1940,442
2017,2,27,1,1628,1585,2054,469
2017,2,27,2,1777,1706,2192,486
2017,2,27,3,1806,1725,2220,495
2017,2,27,4,1754,1702,2202,500
2017,2,27,5,1691,1633,2131,498
2017,2,27,6,1602,1544,2027,483
2017,2,27,7,1513,1450,1889,439
2017,2,27,8,1459,1398,1848,450
2017,2,27,9,1431,1379,1863,484
2017,2,27,10,1413,1364,1819,455
2017,2,27,11,1425,1366,1818,452
2017,2,27,12,1465,1405,1846,441
2017,2,27,13,1554,1487,2003,516
2017,2,27,14,1682,1625,2079,454
2017,2,27,15,1704,1647,2114,467
2017,2,27,16,1670,1612,2032,420
2017,2,27,17,1650,1589,2105,516
2017,2,27,18,1612,1548,2061,513
2017,2,27,19,1579,1529,2048,519
2017,2,27,20,1550,1498,2033,535
2017,2,27,21,1537,1497,2051,554
2017,2,27,22,1525,1494,2075,581
2017,2,27,23,1520,1502,2126,624
2017,2,28,0,1540,1539,2160,621
2017,2,28,1,1605,1597,2254,657
2017,2,28,2,1732,1714,2273,559
2017,2,28,3,1745,1777,2290,513
2017,2,28,4,1728,1640,2234,594
2017,2,28,5,1659,1600,2190,590
2017,2,28,6,1553,1499,2123,624
2017,2,28,7,1467,1408,1973,565
2017,2,28,8,1400,1360,1999,639
2017,2,28,9,1367,1326,2019,693
2017,2,28,10,1358,1312,1984,672
2017,2,28,11,1360,1308,1998,690
2017,2,28,12,1381,1327,2072,745
2017,2,28,13,1471,1417,2182,765
2017,2,28,14,1610,1562,2307,745
2017,2,28,15,1638,1576,2307,731
2017,2,28,16,1626,1562,2339,777
2017,2,28,17,1617,1603,2240,637
2017,2,28,18,1600,1601,2005,404
2017,2,28,19,1577,1564,1933,369
2017,2,28,20,1562,1531,1955,424
2017,2,28,21,1550,1508,2079,571
2017,2,28,22,1539,1500,2054,554
2017,2,28,23,1549,1505,2083,578
2017,3,1,0,1584,1528,2148,620
2017,3,1,1,1672,1583,2191,608
2017,3,1,2,1787,1715,2378,663
2017,3,1,3,1784,1731,2293,562
2017,3,1,4,1780,1717,2316,599
2017,3,1,5,1719,1643,2243,600
2017,3,1,6,1612,1530,2124,594
2017,3,1,7,1518,1433,1999,566
2017,3,1,8,1435,1381,1876,495
2017,3,1,9,1407,1350,1881,531
2017,3,1,10,1398,1341,1873,532
2017,3,1,11,1408,1358,1824,466
2017,3,1,12,1440,1397,1874,477
2017,3,1,13,1520,1501,1999,498
2017,3,1,14,1660,1638,2164,526
2017,3,1,15,1668,1649,2130,481
2017,3,1,16,1644,1611,1991,380
2017,3,1,17,1618,1579,1891,312
2017,3,1,18,1580,1554,1791,237
2017,3,1,19,1552,1530,1717,187
2017,3,1,20,1530,1497,1688,191
2017,3,1,21,1518,1476,1693,217
2017,3,1,22,1501,1472,1753,281
2017,3,1,23,1503,1469,1718,249
2017,3,2,0,1540,1491,1739,248
2017,3,2,1,1618,1534,1850,316
2017,3,2,2,1739,1698,1998,300
2017,3,2,3,1773,1736,2036,300
2017,3,2,4,1765,1740,2082,342
2017,3,2,5,1702,1673,2065,392
2017,3,2,6,1595,1569,2043,474
2017,3,2,7,1504,1478,1937,459
2017,3,2,8,1459,1432,1907,475
2017,3,2,9,1432,1402,1920,518
2017,3,2,10,1424,1395,1904,509
2017,3,2,11,1433,1411,1908,497
2017,3,2,12,1475,1450,1949,499
2017,3,2,13,1577,1554,2034,480
2017,3,2,14,1714,1684,2135,451
2017,3,2,15,1709,1686,2061,375
2017,3,2,16,1658,1648,2002,354
2017,3,2,17,1622,1618,2076,458
2017,3,2,18,1591,1574,2001,427
2017,3,2,19,1557,1526,1947,421
2017,3,2,20,1515,1493,1874,381
2017,3,2,21,1492,1479,1848,369
2017,3,2,22,1489,1464,1873,409
2017,3,2,23,1490,1459,1880,421
2017,3,3,0,1510,1472,1912,440
2017,3,3,1,1567,1511,1970,459
2017,3,3,2,1718,1660,2011,351
2017,3,3,3,1749,1699,2037,338
2017,3,3,4,1741,1692,2094,402
2017,3,3,5,1670,1640,2065,425
2017,3,3,6,1563,1542,2020,478
2017,3,3,7,1473,1452,1934,482
2017,3,3,8,1437,1407,1918,511
2017,3,3,9,1408,1390,1876,486
2017,3,3,10,1402,1373,1814,441
2017,3,3,11,1406,1392,1839,447
2017,3,3,12,1440,1422,1893,471
2017,3,3,13,1530,1511,1977,466
2017,3,3,14,1662,1642,2095,453
2017,3,3,15,1675,1654,2179,525
2017,3,3,16,1640,1614,2177,563
2017,3,3,17,1609,1600,2208,608
2017,3,3,18,1567,1505,2046,541
2017,3,3,19,1542,1462,1994,532
2017,3,3,20,1476,1470,2001,531
2017,3,3,21,1453,1456,2071,615
2017,3,3,22,1468,1450,2129,679
2017,3,3,23,1470,1452,2146,694
2017,3,4,0,1489,1457,2161,704
2017,3,4,1,1548,1499,2079,580
2017,3,4,2,1669,1614,2133,519
2017,3,4,3,1686,1632,2179,547
2017,3,4,4,1679,1623,2215,592
2017,3,4,5,1638,1581,2154,573
2017,3,4,6,1543,1499,2092,593
2017,3,4,7,1459,1420,2006,586
2017,3,4,8,1397,1373,1980,607
2017,3,4,9,1363,1341,1944,603
2017,3,4,10,1350,1333,1906,573
2017,3,4,11,1345,1324,1916,592
2017,3,4,12,1360,1337,1946,609
2017,3,4,13,1409,1385,1953,568
2017,3,4,14,1478,1448,1976,528
2017,3,4,15,1495,1464,2009,545
2017,3,4,16,1489,1458,2004,546
2017,3,4,17,1473,1440,1984,544
2017,3,4,18,1452,1416,1987,571
2017,3,4,19,1425,1394,1945,551
2017,3,4,20,1399,1367,1911,544
2017,3,4,21,1391,1360,1931,571
2017,3,4,22,1379,1349,1925,576
2017,3,4,23,1390,1366,1967,601
2017,3,5,0,1413,1385,2101,716
2017,3,5,1,1482,1441,2122,681
2017,3,5,2,1608,1560,2204,644
2017,3,5,3,1606,1567,2276,709
2017,3,5,4,1580,1547,2291,744
2017,3,5,5,1536,1503,2240,737
2017,3,5,6,1462,1425,2152,727
2017,3,5,7,1387,1359,2038,679
2017,3,5,8,1341,1310,1927,617
2017,3,5,9,1309,1278,1865,587
2017,3,5,10,1293,1265,1861,596
2017,3,5,11,1294,1262,1830,568
2017,3,5,12,1307,1281,1868,587
2017,3,5,13,1334,1310,1925,615
2017,3,5,14,1396,1339,1959,620
2017,3,5,15,1426,1364,1969,605
2017,3,5,16,1419,1390,1968,578
2017,3,5,17,1423,1384,2054,670
2017,3,5,18,1416,1372,2090,718
2017,3,5,19,1398,1367,2078,711
2017,3,5,20,1388,1371,2061,690
2017,3,5,21,1386,1375,1994,619
2017,3,5,22,1405,1394,2035,641
2017,3,5,23,1418,1414,2104,690
2017,3,6,0,1470,1436,2166,730
2017,3,6,1,1540,1503,2256,753
2017,3,6,2,1650,1623,2426,803
2017,3,6,3,1659,1632,2431,799
2017,3,6,4,1615,1601,2411,810
2017,3,6,5,1542,1536,2303,767
2017,3,6,6,1449,1431,2203,772
2017,3,6,7,1367,1337,2120,783
2017,3,6,8,1309,1281,2050,769
2017,3,6,9,1291,1259,2015,756
2017,3,6,10,1284,1251,1984,733
2017,3,6,11,1294,1263,1944,681
2017,3,6,12,1320,1285,2035,750
2017,3,6,13,1406,1372,2182,810
2017,3,6,14,1539,1501,2334,833
2017,3,6,15,1547,1503,2300,797
2017,3,6,16,1531,1488,2160,672
2017,3,6,17,1539,1507,2120,613
2017,3,6,18,1520,1499,2053,554
2017,3,6,19,1509,1485,2068,583
2017,3,6,20,1493,1465,2020,555
2017,3,6,21,1483,1460,2001,541
2017,3,6,22,1467,1449,2027,578
2017,3,6,23,1490,1454,2082,628
2017,3,7,0,1507,1473,2096,623
2017,3,7,1,1567,1525,2208,683
2017,3,7,2,1694,1655,2384,729
2017,3,7,3,1723,1693,2446,753
2017,3,7,4,1716,1688,2391,703
2017,3,7,5,1648,1623,2310,687
2017,3,7,6,1537,1512,2139,627
2017,3,7,7,1447,1423,1950,527
2017,3,7,8,1367,1338,1911,573
2017,3,7,9,1358,1331,1914,583
2017,3,7,10,1386,1339,1894,555
2017,3,7,11,1388,1331,1882,551
2017,3,7,12,1432,1367,1966,599
2017,3,7,13,1526,1464,2133,669
2017,3,7,14,1645,1562,2227,665
2017,3,7,15,1646,1559,2252,693
2017,3,7,16,1616,1528,2269,741
2017,3,7,17,1595,1513,2279,766
2017,3,7,18,1541,1460,2236,776
2017,3,7,19,1512,1426,2240,814
2017,3,7,20,1489,1399,2192,793
2017,3,7,21,1478,1381,2156,775
2017,3,7,22,1497,1369,2153,784
2017,3,7,23,1472,1374,2095,721
2017,3,8,0,1495,1392,2180,788
2017,3,8,1,1539,1437,2196,759
2017,3,8,2,1683,1569,2227,658
2017,3,8,3,1718,1619,2263,644
2017,3,8,4,1712,1619,2263,644
2017,3,8,5,1640,1558,2217,659
2017,3,8,6,1530,1463,2174,711
2017,3,8,7,1443,1370,1979,609
2017,3,8,8,1398,1317,1957,640
2017,3,8,9,1376,1301,1960,659
2017,3,8,10,1369,1291,1946,655
2017,3,8,11,1378,1302,1980,678
2017,3,8,12,1414,1335,2077,742
2017,3,8,13,1503,1421,2131,710
2017,3,8,14,1608,1538,2276,738
2017,3,8,15,1609,1545,2284,739
2017,3,8,16,1573,1507,2212,705
2017,3,8,17,1545,1483,2037,554
2017,3,8,18,1511,1446,1985,539
2017,3,8,19,1483,1436,2029,593
2017,3,8,20,1473,1433,2074,641
2017,3,8,21,1464,1424,2115,691
2017,3,8,22,1471,1427,2047,620
2017,3,8,23,1485,1450,1989,539
2017,3,9,0,1502,1461,2067,606
2017,3,9,1,1540,1496,2027,531
2017,3,9,2,1652,1610,2116,506
2017,3,9,3,1641,1594,2053,459
2017,3,9,4,1672,1600,2134,534
2017,3,9,5,1596,1554,2112,558
2017,3,9,6,1488,1440,2015,575
2017,3,9,7,1398,1359,1864,505
2017,3,9,8,1346,1306,1838,532
2017,3,9,9,1314,1272,1757,485
2017,3,9,10,1296,1271,1773,502
2017,3,9,11,1280,1272,1782,510
2017,3,9,12,1317,1308,1868,560
2017,3,9,13,1406,1400,1995,595
2017,3,9,14,1529,1513,2206,693
2017,3,9,15,1533,1514,2172,658
2017,3,9,16,1520,1501,2073,572
2017,3,9,17,1501,1479,2094,615
2017,3,9,18,1472,1441,2057,616
2017,3,9,19,1447,1427,2045,618
2017,3,9,20,1434,1414,2083,669
2017,3,9,21,1435,1418,2092,674
2017,3,9,22,1456,1638,2276,638
2017,3,9,23,1471,1438,2041,603
2017,3,10,0,1497,1458,2058,600
2017,3,10,1,1536,1489,2053,564
2017,3,10,2,1622,1580,2154,574
2017,3,10,3,1643,1616,2179,563
2017,3,10,4,1635,1632,2206,574
2017,3,10,5,1570,1532,2100,568
2017,3,10,6,1470,1422,2027,605
2017,3,10,7,1374,1331,1958,627
2017,3,10,8,1303,1278,1903,625
2017,3,10,9,1279,1252,1915,663
2017,3,10,10,1270,1238,1927,689
2017,3,10,11,1277,1249,1913,664
2017,3,10,12,1320,1285,1959,674
2017,3,10,13,1402,1374,2048,674
2017,3,10,14,1504,1468,2087,619
2017,3,10,15,1529,1456,2063,607
2017,3,10,16,1517,1426,2031,605
2017,3,10,17,1512,1413,2035,622
2017,3,10,18,1502,1409,2030,621
2017,3,10,19,1489,1409,2048,639
2017,3,10,20,1480,1395,2113,718
2017,3,10,21,1482,1404,2130,726
2017,3,10,22,1490,1408,2149,741
2017,3,10,23,1502,1417,2183,766
2017,3,11,0,1511,1423,2219,796
2017,3,11,1,1547,1438,2183,745
2017,3,11,2,1619,1535,2234,699
2017,3,11,3,1604,1552,2267,715
2017,3,11,4,1592,1542,2278,736
2017,3,11,5,1540,1493,2151,658
2017,3,11,6,1439,1406,2136,730
2017,3,11,7,1359,1331,1988,657
2017,3,11,8,1307,1269,1878,609
2017,3,11,9,1271,1235,1878,643
2017,3,11,10,1251,1219,1866,647
2017,3,11,11,1250,1235,1892,657
2017,3,11,12,1261,1226,1893,667
2017,3,11,13,1292,1268,2026,758
2017,3,11,14,1360,1312,2062,750
2017,3,11,15,1403,1351,2062,711
2017,3,11,16,1413,1381,2031,650
2017,3,11,17,1415,1411,2003,592
2017,3,11,18,1401,1405,2002,597
2017,3,11,19,1411,1363,2031,668
2017,3,11,20,1406,1367,2128,761
2017,3,11,21,1376,1363,2041,678
2017,3,11,22,1389,1356,1926,570
2017,3,11,23,1396,1369,1975,606
2017,3,12,0,1427,1399,2049,650
2017,3,12,1,1479,1435,2060,625
2017,3,12,2,1561,1531,2139,608
2017,3,12,3,1572,1549,2129,580
2017,3,12,4,1552,1519,2110,591
2017,3,12,5,1501,1471,2028,557
2017,3,12,6,1429,1392,1934,542
2017,3,12,7,1348,1318,1860,542
2017,3,12,8,1307,1271,1698,427
2017,3,12,9,998,1244,1719,475
2017,3,12,10,1264,1235,1688,453
2017,3,12,11,1255,1241,1724,483
2017,3,12,12,1261,1263,1737,474
2017,3,12,13,1270,1312,1754,442
2017,3,12,14,1365,1340,1818,478
2017,3,12,15,1396,1350,1876,526
2017,3,12,16,1406,1351,1796,445
2017,3,12,17,1387,1335,1867,532
2017,3,12,18,1368,1327,1970,643
2017,3,12,19,1337,1326,2056,730
2017,3,12,20,1326,1333,2090,757
2017,3,12,21,1337,1328,2084,756
2017,3,12,22,1335,1333,2065,732
2017,3,12,23,1347,1362,2058,696
2017,3,13,0,1346,1400,2083,683
2017,3,13,1,1433,1431,2023,592
2017,3,13,2,1478,1543,2100,557
2017,3,13,3,1589,1577,2145,568
2017,3,13,4,1610,1530,2075,545
2017,3,13,5,1508,1429,2015,586
2017,3,13,6,1409,1323,1983,660
2017,3,13,7,1326,1259,1973,714
2017,3,13,8,1258,1217,1864,647
2017,3,13,9,1239,1207,1827,620
2017,3,13,10,1248,1214,1814,600
2017,3,13,11,1263,1237,1831,594
2017,3,13,12,1339,1318,1858,540
2017,3,13,13,1463,1461,1906,445
2017,3,13,14,1554,1529,2003,474
2017,3,13,15,1542,1521,2087,566
2017,3,13,16,1517,1496,1959,463
2017,3,13,17,1498,1481,1924,443
2017,3,13,18,1543,1506,1966,460
2017,3,13,19,1464,1444,2028,584
2017,3,13,20,1462,1444,2113,669
2017,3,13,21,1451,1437,2063,626
2017,3,13,22,1460,1444,2138,694
2017,3,13,23,1470,1449,2207,758
2017,3,14,0,1477,1460,2145,685
2017,3,14,1,1499,1492,2061,569
2017,3,14,2,1576,1583,2152,569
2017,3,14,3,1638,1624,2222,598
2017,3,14,4,1604,1562,2177,615
2017,3,14,5,1501,1451,2076,625
2017,3,14,6,1393,1346,2032,686
2017,3,14,7,1319,1278,2039,761
2017,3,14,8,1290,1230,2025,795
2017,3,14,9,1269,1216,1994,778
2017,3,14,10,1260,1206,2003,797
2017,3,14,11,1270,1227,1962,735
2017,3,14,12,1345,1313,2037,724
2017,3,14,13,1482,1471,2099,628
2017,3,14,14,1551,1527,2070,543
2017,3,14,15,1536,1499,2096,597
2017,3,14,16,1518,1483,2035,552
2017,3,14,17,1510,1482,2041,559
2017,3,14,18,1497,1449,2073,624
2017,3,14,19,1497,1439,2064,625
2017,3,14,20,1485,1459,2101,642
2017,3,14,21,1478,1454,2114,660
2017,3,14,22,1486,1456,2154,698
2017,3,14,23,1497,1468,2084,616
2017,3,15,0,1505,1487,2057,570
2017,3,15,1,1534,1503,2002,499
2017,3,15,2,1614,1584,2083,499
2017,3,15,3,1647,1626,2135,509
2017,3,15,4,1603,1557,2121,564
2017,3,15,5,1501,1450,2088,638
2017,3,15,6,1398,1338,2109,771
2017,3,15,7,1327,1261,2065,804
2017,3,15,8,1271,1217,1936,719
2017,3,15,9,1250,1199,1902,703
2017,3,15,10,1252,1200,1849,649
2017,3,15,11,1269,1230,1834,604
2017,3,15,12,1342,1312,1853,541
2017,3,15,13,1472,1462,1936,474
2017,3,15,14,1556,1522,1915,393
2017,3,15,15,1542,1504,1918,414
2017,3,15,16,1513,1483,1882,399
2017,3,15,17,1496,1474,1879,405
2017,3,15,18,1476,1466,1918,452
2017,3,15,19,1464,1454,1903,449
2017,3,15,20,1463,1471,1927,456
2017,3,15,21,1474,1483,1916,433
2017,3,15,22,1492,1502,1908,406
2017,3,15,23,1510,1506,1947,441
2017,3,16,0,1521,1516,1975,459
2017,3,16,1,1529,1508,1958,450
2017,3,16,2,1597,1585,1989,404
2017,3,16,3,1631,1622,2147,525
2017,3,16,4,1584,1559,2113,554
2017,3,16,5,1489,1453,1974,521
2017,3,16,6,1375,1328,1915,587
2017,3,16,7,1301,1258,1947,689
2017,3,16,8,1263,1218,1835,617
2017,3,16,9,1241,1199,1708,509
2017,3,16,10,1236,1194,1661,467
2017,3,16,11,1260,1217,1629,412
2017,3,16,12,1326,1272,1596,324
2017,3,16,13,1456,1438,1693,255
2017,3,16,14,1532,1486,1749,263
2017,3,16,15,1520,1489,1754,265
2017,3,16,16,1492,1469,1689,220
2017,3,16,17,1490,1473,1660,187
2017,3,16,18,1475,1471,1664,193
2017,3,16,19,1451,1459,1711,252
2017,3,16,20,1461,1460,1765,305
2017,3,16,21,1469,1469,1783,314
2017,3,16,22,1495,1473,1763,290
2017,3,16,23,1513,1491,1786,295
2017,3,17,0,1519,1495,1796,301
2017,3,17,1,1531,1502,1840,338
2017,3,17,2,1607,1557,1881,324
2017,3,17,3,1646,1604,1960,356
2017,3,17,4,1595,1539,1914,375
2017,3,17,5,1495,1426,1755,329
2017,3,17,6,1389,1315,1724,409
2017,3,17,7,1314,1252,1679,427
2017,3,17,8,1270,1215,1609,394
2017,3,17,9,1239,1194,1573,379
2017,3,17,10,1234,1196,1580,384
2017,3,17,11,1254,1216,1595,379
2017,3,17,12,1312,1284,1653,369
2017,3,17,13,1428,1418,1806,388
2017,3,17,14,1505,1463,1887,424
2017,3,17,15,1514,1465,1909,444
2017,3,17,16,1499,1455,1801,346
2017,3,17,17,1482,1450,1745,295
2017,3,17,18,1471,1442,1739,297
2017,3,17,19,1465,1436,1802,366
2017,3,17,20,1475,1456,1837,381
2017,3,17,21,1501,1482,1842,360
2017,3,17,22,1498,1477,1887,410
2017,3,17,23,1514,1490,1930,440
2017,3,18,0,1514,1491,1956,465
2017,3,18,1,1517,1486,1981,495
2017,3,18,2,1563,1543,2045,502
2017,3,18,3,1613,1584,2119,535
2017,3,18,4,1573,1519,2077,558
2017,3,18,5,1500,1433,1962,529
2017,3,18,6,1399,1331,1937,606
2017,3,18,7,1318,1253,1781,528
2017,3,18,8,1228,1176,1714,538
2017,3,18,9,1241,1196,1661,465
2017,3,18,10,1224,1180,1617,437
2017,3,18,11,1233,1195,1555,360
2017,3,18,12,1252,1225,1601,376
2017,3,18,13,1298,1287,1591,304
2017,3,18,14,1356,1316,1536,220
2017,3,18,15,1386,1343,1571,228
2017,3,18,16,1402,1357,1595,238
2017,3,18,17,1403,1366,1631,265
2017,3,18,18,1407,1372,1654,282
2017,3,18,19,1406,1374,1688,314
2017,3,18,20,1406,1388,1690,302
2017,3,18,21,1418,1411,1801,390
2017,3,18,22,1435,1429,1907,478
2017,3,18,23,1462,1452,1897,445
2017,3,19,0,1489,1473,1879,406
2017,3,19,1,1498,1487,1903,416
2017,3,19,2,1559,1547,2001,454
2017,3,19,3,1581,1565,2088,523
2017,3,19,4,1537,1503,2009,506
2017,3,19,5,1477,1425,1888,463
2017,3,19,6,1372,1328,1972,644
2017,3,19,7,1287,1265,1889,624
2017,3,19,8,1259,1216,1814,598
2017,3,19,9,1232,1187,1779,592
2017,3,19,10,1213,1177,1753,576
2017,3,19,11,1211,1180,1708,528
2017,3,19,12,1219,1199,1703,504
2017,3,19,13,1256,1246,1715,469
2017,3,19,14,1293,1251,1716,465
2017,3,19,15,1317,1277,1720,443
2017,3,19,16,1334,1303,1726,423
2017,3,19,17,1351,1329,1738,409
2017,3,19,18,1358,1342,1829,487
2017,3,19,19,1371,1355,1922,567
2017,3,19,20,1392,1377,2049,672
2017,3,19,21,1405,1388,2091,703
2017,3,19,22,1433,1419,2087,668
2017,3,19,23,1471,1439,2015,576
2017,3,20,0,1506,1474,1959,485
2017,3,20,1,1536,1502,1958,456
2017,3,20,2,1595,1572,2061,489
2017,3,20,3,1590,1564,2042,478
2017,3,20,4,1507,1468,1941,473
2017,3,20,5,1409,1408,1833,425
2017,3,20,6,1299,1307,1800,493
2017,3,20,7,1228,1240,1755,515
2017,3,20,8,1220,1197,1678,481
2017,3,20,9,1200,1182,1657,475
2017,3,20,10,1189,1177,1643,466
2017,3,20,11,1212,1202,1636,434
2017,3,20,12,1271,1267,1687,420
2017,3,20,13,1368,1378,1746,368
2017,3,20,14,1448,1428,1792,364
2017,3,20,15,1459,1438,1794,356
2017,3,20,16,1461,1447,1728,281
2017,3,20,17,1463,1458,1781,323
2017,3,20,18,1471,1463,1844,381
2017,3,20,19,1487,1467,1885,418
2017,3,20,20,1503,1486,1973,487
2017,3,20,21,1536,1515,2080,565
2017,3,20,22,1575,1551,2136,585
2017,3,20,23,1582,1557,2061,504
2017,3,21,0,1588,1554,2084,530
2017,3,21,1,1589,1549,2051,502
2017,3,21,2,1629,1608,2221,613
2017,3,21,3,1664,1633,2317,684
2017,3,21,4,1609,1561,2292,731
2017,3,21,5,1493,1442,2058,616
2017,3,21,6,1385,1334,1811,477
2017,3,21,7,1303,1261,1751,490
2017,3,21,8,1254,1214,1767,553
2017,3,21,9,1226,1192,1763,571
2017,3,21,10,1226,1186,1736,550
2017,3,21,11,1241,1204,1661,457
2017,3,21,12,1298,1275,1651,376
2017,3,21,13,1396,1386,1695,309
2017,3,21,14,1435,1421,1736,315
2017,3,21,15,1453,1436,1728,292
2017,3,21,16,1478,1450,1717,267
2017,3,21,17,1494,1465,1806,341
2017,3,21,18,1499,1475,1796,321
2017,3,21,19,1514,1493,1768,275
2017,3,21,20,1534,1518,1820,302
2017,3,21,21,1559,1547,1862,315
2017,3,21,22,1578,1565,1905,340
2017,3,21,23,1598,1585,1909,324
2017,3,22,0,1577,1571,1893,322
2017,3,22,1,1566,1554,1908,354
2017,3,22,2,1626,1606,1889,283
2017,3,22,3,1668,1639,1925,286
2017,3,22,4,1611,1511,1857,346
2017,3,22,5,1484,1448,1835,387
2017,3,22,6,1384,1339,1838,499
2017,3,22,7,1308,1268,1797,529
2017,3,22,8,1263,1225,1796,571
2017,3,22,9,1232,1197,1689,492
2017,3,22,10,1228,1188,1651,463
2017,3,22,11,1240,1214,1616,402
2017,3,22,12,1301,1281,1690,409
2017,3,22,13,1406,1352,1754,402
2017,3,22,14,1466,1365,1740,375
2017,3,22,15,1483,1381,1857,476
2017,3,22,16,1496,1403,1800,397
2017,3,22,17,1493,1411,1780,369
2017,3,22,18,1491,1421,1798,377
2017,3,22,19,1495,1426,1834,408
2017,3,22,20,1518,1447,1882,435
2017,3,22,21,1534,1472,1924,452
2017,3,22,22,1568,1496,1995,499
2017,3,22,23,1590,1513,2052,539
2017,3,23,0,1602,1516,2023,507
2017,3,23,1,1592,1509,1938,429
2017,3,23,2,1641,1578,1942,364
2017,3,23,3,1683,1617,2071,454
2017,3,23,4,1630,1549,2034,485
2017,3,23,5,1514,1446,1947,501
2017,3,23,6,1405,1339,1878,539
2017,3,23,7,1326,1265,1840,575
2017,3,23,8,1279,1230,1831,601
2017,3,23,9,1250,1204,1799,595
2017,3,23,10,1231,1190,1753,563
2017,3,23,11,1246,1210,1765,555
2017,3,23,12,1292,1267,1792,525
2017,3,23,13,1391,1372,1832,460
2017,3,23,14,1450,1397,1911,514
2017,3,23,15,1470,1420,1917,497
2017,3,23,16,1475,1435,1900,465
2017,3,23,17,1478,1439,1973,534
2017,3,23,18,1479,1441,1967,526
2017,3,23,19,1470,1430,1976,546
2017,3,23,20,1460,1423,1902,479
2017,3,23,21,1501,1464,1767,303
2017,3,23,22,1496,1455,1629,174
2017,3,23,23,1502,1467,1577,110
2017,3,24,0,1501,1472,1532,60
2017,3,24,1,1510,1487,1550,63
2017,3,24,2,1577,1556,1621,65
2017,3,24,3,1626,1609,1805,196
2017,3,24,4,1595,1561,1774,213
2017,3,24,5,1503,1467,1818,351
2017,3,24,6,1417,1379,1822,443
2017,3,24,7,1354,1313,1820,507
2017,3,24,8,1309,1280,1815,535
2017,3,24,9,1309,1266,1567,301
2017,3,24,10,1305,1265,1396,131
2017,3,24,11,1311,1268,1405,137
2017,3,24,12,1371,1317,1391,74
2017,3,24,13,1432,1420,1480,60
2017,3,24,14,1480,1464,1592,128
2017,3,24,15,1512,1480,1625,145
2017,3,24,16,1500,1482,1623,141
2017,3,24,17,1476,1461,1725,264
2017,3,24,18,1417,1428,1886,458
2017,3,24,19,1399,1396,1825,429
2017,3,24,20,1377,1384,1748,364
2017,3,24,21,1370,1358,1734,376
2017,3,24,22,1371,1362,1756,394
2017,3,24,23,1373,1389,1729,340
2017,3,25,0,1376,1391,1727,336
2017,3,25,1,1382,1395,1697,302
2017,3,25,2,1458,1464,1805,341
2017,3,25,3,1524,1526,1906,380
2017,3,25,4,1531,1487,1860,373
2017,3,25,5,1485,1411,1757,346
2017,3,25,6,1406,1337,1601,264
2017,3,25,7,1338,1274,1514,240
2017,3,25,8,1289,1251,1618,367
2017,3,25,9,1271,1238,1590,352
2017,3,25,10,1270,1235,1627,392
2017,3,25,11,1277,1258,1658,400
2017,3,25,12,1308,1292,1711,419
2017,3,25,13,1364,1356,1760,404
2017,3,25,14,1399,1374,1702,328
2017,3,25,15,1419,1385,1705,320
2017,3,25,16,1434,1396,1710,314
2017,3,25,17,1406,1375,1724,349
2017,3,25,18,1368,1411,1830,419
2017,3,25,19,1384,1347,1743,396
2017,3,25,20,1378,1351,1749,398
2017,3,25,21,1385,1361,1781,420
2017,3,25,22,1381,1360,1817,457
2017,3,25,23,1373,1360,1798,438
2017,3,26,0,1393,1387,1864,477
2017,3,26,1,1419,1412,1913,501
2017,3,26,2,1456,1487,1985,498
2017,3,26,3,1527,1538,2238,700
2017,3,26,4,1574,1489,2252,763
2017,3,26,5,1531,1420,2245,825
2017,3,26,6,1457,1338,2057,719
2017,3,26,7,1326,1280,1953,673
2017,3,26,8,1275,1235,1828,593
2017,3,26,9,1247,1211,1792,581
2017,3,26,10,1242,1206,1830,624
2017,3,26,11,1249,1214,1820,606
2017,3,26,12,1258,1245,1868,623
2017,3,26,13,1301,1294,1936,642
2017,3,26,14,1336,1305,1982,677
2017,3,26,15,1375,1341,1970,629
2017,3,26,16,1392,1360,1897,537
2017,3,26,17,1386,1357,1886,529
2017,3,26,18,1374,1352,1820,468
2017,3,26,19,1373,1349,1752,403
2017,3,26,20,1360,1342,1729,387
2017,3,26,21,1357,1341,1704,363
2017,3,26,22,1376,1353,1769,416
2017,3,26,23,1388,1373,1844,471
2017,3,27,0,1417,1401,1875,474
2017,3,27,1,1450,1433,1900,467
2017,3,27,2,1533,1514,2028,514
2017,3,27,3,1600,1575,2202,627
2017,3,27,4,1566,1517,2142,625
2017,3,27,5,1489,1409,2092,683
2017,3,27,6,1396,1315,1957,642
2017,3,27,7,1327,1258,1818,560
2017,3,27,8,1263,1232,1775,543
2017,3,27,9,1264,1225,1751,526
2017,3,27,10,1261,1229,1727,498
2017,3,27,11,1247,1218,1659,441
2017,3,27,12,1336,1316,1673,357
2017,3,27,13,1501,1488,1889,401
2017,3,27,14,1569,1535,1928,393
2017,3,27,15,1555,1518,1939,421
2017,3,27,16,1526,1489,1989,500
2017,3,27,17,1510,1473,1986,513
2017,3,27,18,1501,1470,1998,528
2017,3,27,19,1484,1457,2013,556
2017,3,27,20,1478,1452,2005,553
2017,3,27,21,1474,1452,2087,635
2017,3,27,22,1490,1470,2098,628
2017,3,27,23,1504,1487,2073,586
2017,3,28,0,1504,1500,2103,603
2017,3,28,1,1515,1500,2127,627
2017,3,28,2,1579,1574,2261,687
2017,3,28,3,1652,1610,2357,747
2017,3,28,4,1617,1545,2163,618
2017,3,28,5,1492,1431,2046,615
2017,3,28,6,1385,1334,1938,604
2017,3,28,7,1329,1272,1846,574
2017,3,28,8,1283,1237,1820,583
2017,3,28,9,1262,1222,1759,537
2017,3,28,10,1264,1227,1691,464
2017,3,28,11,1290,1251,1698,447
2017,3,28,12,1360,1320,1744,424
2017,3,28,13,1506,1470,1986,516
2017,3,28,14,1570,1525,2069,544
2017,3,28,15,1600,1536,2016,480
2017,3,28,16,1612,1551,1962,411
2017,3,28,17,1567,1526,1752,226
2017,3,28,18,1536,1496,1517,21
2017,3,28,19,1521,1482,1609,127
2017,3,28,20,1514,1479,1693,214
2017,3,28,21,1541,1507,1811,304
2017,3,28,22,1530,1496,1672,176
2017,3,28,23,1507,1475,1642,167
2017,3,29,0,1520,1482,1537,55
2017,3,29,1,1541,1514,1594,80
2017,3,29,2,1612,1598,1792,194
2017,3,29,3,1680,1644,2009,365
2017,3,29,4,1639,1578,1879,301
2017,3,29,5,1544,1474,1911,437
2017,3,29,6,1443,1363,1855,492
2017,3,29,7,1366,1300,1793,493
2017,3,29,8,1367,1317,1760,443
2017,3,29,9,1306,1263,1797,534
2017,3,29,10,1299,1260,1773,513
2017,3,29,11,1326,1286,1831,545
2017,3,29,12,1394,1363,1952,589
2017,3,29,13,1535,1513,2119,606
2017,3,29,14,1595,1555,2109,554
2017,3,29,15,1592,1548,2124,576
2017,3,29,16,1586,1544,2093,549
2017,3,29,17,1546,1517,2076,559
2017,3,29,18,1520,1488,2034,546
2017,3,29,19,1521,1468,2017,549
2017,3,29,20,1503,1468,2012,544
2017,3,29,21,1493,1463,2033,570
2017,3,29,22,1470,1443,1987,544
2017,3,29,23,1480,1447,2054,607
2017,3,30,0,1487,1448,2024,576
2017,3,30,1,1509,1457,1979,522
2017,3,30,2,1596,1534,2063,529
2017,3,30,3,1652,1615,2141,526
2017,3,30,4,1609,1547,2127,580
2017,3,30,5,1523,1439,2025,586
2017,3,30,6,1418,1334,2059,725
2017,3,30,7,1350,1275,1882,607
2017,3,30,8,1306,1248,1929,681
2017,3,30,9,1286,1238,1930,692
2017,3,30,10,1285,1244,1886,642
2017,3,30,11,1309,1273,1916,643
2017,3,30,12,1376,1350,2007,657
2017,3,30,13,1529,1495,2168,673
2017,3,30,14,1587,1539,2176,637
2017,3,30,15,1562,1513,2158,645
2017,3,30,16,1535,1464,2067,603
2017,3,30,17,1494,1443,1999,556
2017,3,30,18,1451,1426,1962,536
2017,3,30,19,1465,1422,1988,566
2017,3,30,20,1467,1425,2007,582
2017,3,30,21,1470,1423,2032,609
2017,3,30,22,1466,1419,2052,633
2017,3,30,23,1476,1418,2057,639
2017,3,31,0,1482,1440,2015,575
2017,3,31,1,1484,1447,2005,558
2017,3,31,2,1371,1526,2202,676
2017,3,31,3,1636,1582,2316,734
2017,3,31,4,1594,1526,2307,781
2017,3,31,5,1484,1422,2185,763
2017,3,31,6,1344,1318,2090,772
2017,3,31,7,1314,1261,2000,739
2017,3,31,8,1275,1215,1870,655
2017,3,31,9,1263,1204,1869,665
2017,3,31,10,1258,1203,1753,550
2017,3,31,11,1284,1230,1731,501
2017,3,31,12,1346,1302,1845,543
2017,3,31,13,1473,1440,2046,606
2017,3,31,14,1524,1467,2074,607
2017,3,31,15,1522,1462,1780,318
2017,3,31,16,1512,1453,1613,160
2017,3,31,17,1486,1441,1559,118
2017,3,31,18,1486,1434,1655,221
2017,3,31,19,1491,1437,1683,246
2017,3,31,20,1502,1625,1985,360
2017,3,31,21,1481,1429,1921,492
2017,3,31,22,1475,1431,1888,457
2017,3,31,23,1489,1438,1901,463
2017,4,1,0,1491,1436,2005,569
2017,4,1,1,1490,1441,2014,573
2017,4,1,2,1555,1513,2054,541
2017,4,1,3,1622,1581,2118,537
2017,4,1,4,1605,1543,2164,621
2017,4,1,5,1529,1453,2105,652
2017,4,1,6,1441,1371,2001,630
2017,4,1,7,1376,1320,1959,639
2017,4,1,8,1340,1286,1859,573
2017,4,1,9,1320,1274,1825,551
2017,4,1,10,1313,1265,1705,440
2017,4,1,11,1316,1274,1768,494
2017,4,1,12,1339,1295,1855,560
2017,4,1,13,1400,1360,1884,524
2017,4,1,14,1461,1416,1941,525
2017,4,1,15,1509,1460,1975,515
2017,4,1,16,1518,1498,1959,461
2017,4,1,17,1527,1525,1967,442
2017,4,1,18,1543,1528,1962,434
2017,4,1,19,1530,1508,1942,434
2017,4,1,20,1498,1487,1877,390
2017,4,1,21,1484,1474,1893,419
2017,4,1,22,1481,1475,1853,378
2017,4,1,23,1479,1478,1839,361
2017,4,2,0,1470,1464,1830,366
2017,4,2,1,1497,1488,1955,467
2017,4,2,2,1570,1562,2054,492
2017,4,2,3,1636,1616,2131,515
2017,4,2,4,1613,1573,2125,552
2017,4,2,5,1543,1495,2051,556
2017,4,2,6,1463,1418,2010,592
2017,4,2,7,1397,1358,1903,545
2017,4,2,8,1369,1331,1797,466
2017,4,2,9,1345,1310,1692,382
2017,4,2,10,1341,1302,1662,360
2017,4,2,11,1345,1308,1653,345
2017,4,2,12,1369,1333,1647,314
2017,4,2,13,1415,1386,1761,375
2017,4,2,14,1455,1413,1819,406
2017,4,2,15,1459,1426,1781,355
2017,4,2,16,1457,1430,1771,341
2017,4,2,17,1426,1407,1657,250
2017,4,2,18,1401,1376,1625,249
2017,4,2,19,1388,1358,1621,263
2017,4,2,20,1374,1340,1643,303
2017,4,2,21,1366,1328,1672,344
2017,4,2,22,1356,1300,1659,359
2017,4,2,23,1381,1350,1657,307
2017,4,3,0,1409,1382,1731,349
2017,4,3,1,1460,1422,1772,350
2017,4,3,2,1539,1499,1870,371
2017,4,3,3,1612,1577,1948,371
2017,4,3,4,1583,1531,1925,394
2017,4,3,5,1482,1424,1887,463
2017,4,3,6,1380,1322,1861,539
2017,4,3,7,1323,1269,1776,507
2017,4,3,8,1297,1238,1819,581
2017,4,3,9,1270,1217,1801,584
2017,4,3,10,1268,1218,1807,589
2017,4,3,11,1293,1246,1807,561
2017,4,3,12,1355,1340,1847,507
2017,4,3,13,1488,1484,1962,478
2017,4,3,14,1580,1513,2063,550
2017,4,3,15,1578,1496,2060,564
2017,4,3,16,1547,1483,1977,494
2017,4,3,17,1529,1468,1957,489
2017,4,3,18,1492,1454,1877,423
2017,4,3,19,1484,1453,1900,447
2017,4,3,20,1475,1411,1866,455
2017,4,3,21,1471,1420,1852,432
2017,4,3,22,1476,1444,1869,425
2017,4,3,23,1481,1443,1954,511
2017,4,4,0,1486,1443,1974,531
2017,4,4,1,1508,1486,1974,488
2017,4,4,2,1576,1536,2031,495
2017,4,4,3,1654,1603,2111,508
2017,4,4,4,1614,1543,2126,583
2017,4,4,5,1511,1424,2024,600
2017,4,4,6,1407,1325,1862,537
2017,4,4,7,1339,1277,1774,497
2017,4,4,8,1301,1246,1804,558
2017,4,4,9,1280,1248,1813,565
2017,4,4,10,1279,1249,1787,538
2017,4,4,11,1296,1282,1819,537
2017,4,4,12,1353,1364,1643,279
2017,4,4,13,1485,1508,1834,326
2017,4,4,14,1601,1541,1894,353
2017,4,4,15,1603,1551,1804,253
2017,4,4,16,1576,1565,1775,210
2017,4,4,17,1578,1566,1756,190
2017,4,4,18,1557,1554,1669,115
2017,4,4,19,1556,1533,1653,120
2017,4,4,20,1545,1486,1682,196
2017,4,4,21,1541,1466,1688,222
2017,4,4,22,1494,1443,1720,277
2017,4,4,23,1512,1435,1620,185
2017,4,5,0,1519,1451,1652,201
2017,4,5,1,1539,1470,1709,239
2017,4,5,2,1607,1551,1819,268
2017,4,5,3,1679,1647,1948,301
2017,4,5,4,1650,1597,1947,350
2017,4,5,5,1551,1483,1866,383
2017,4,5,6,1450,1377,1779,402
2017,4,5,7,1388,1322,1716,394
2017,4,5,8,1348,1301,1664,363
2017,4,5,9,1336,1294,1583,289
2017,4,5,10,1333,1305,1505,200
2017,4,5,11,1354,1339,1423,84
2017,4,5,12,1429,1426,1483,57
2017,4,5,13,1568,1558,1641,83
2017,4,5,14,1648,1583,1713,130
2017,4,5,15,1634,1548,1743,195
2017,4,5,16,1592,1498,1696,198
2017,4,5,17,1566,1450,1656,206
2017,4,5,18,1533,1440,1706,266
2017,4,5,19,1461,1411,1660,249
2017,4,5,20,1441,1401,1677,276
2017,4,5,21,1436,1389,1676,287
2017,4,5,22,1437,1387,1672,285
2017,4,5,23,1459,1395,1729,334
2017,4,6,0,1453,1411,1791,380
2017,4,6,1,1456,1430,1836,406
2017,4,6,2,1538,1513,1940,427
2017,4,6,3,1636,1619,2012,393
2017,4,6,4,1609,1566,1979,413
2017,4,6,5,1516,1455,1929,474
2017,4,6,6,1413,1356,1842,486
2017,4,6,7,1352,1290,1798,508
2017,4,6,8,1312,1268,1830,562
2017,4,6,9,1294,1258,1826,568
2017,4,6,10,1298,1264,1804,540
2017,4,6,11,1327,1301,1828,527
2017,4,6,12,1403,1387,1898,511
2017,4,6,13,1534,1530,2026,496
2017,4,6,14,1594,1569,2061,492
2017,4,6,15,1568,1532,1986,454
2017,4,6,16,1546,1500,1865,365
2017,4,6,17,1513,1467,1892,425
2017,4,6,18,1499,1450,1852,402
2017,4,6,19,1474,1432,1901,469
2017,4,6,20,1464,1439,1898,459
2017,4,6,21,1465,1443,1972,529
2017,4,6,22,1460,1434,2008,574
2017,4,6,23,1469,1455,2006,551
2017,4,7,0,1468,1472,1944,472
2017,4,7,1,1465,1463,2035,572
2017,4,7,2,1527,1511,2105,594
2017,4,7,3,1619,1596,2170,574
2017,4,7,4,1587,1546,2141,595
2017,4,7,5,1488,1437,2020,583
2017,4,7,6,1381,1342,1915,573
2017,4,7,7,1315,1280,1899,619
2017,4,7,8,1287,1248,1770,522
2017,4,7,9,1252,1227,1757,530
2017,4,7,10,1253,1222,1739,517
2017,4,7,11,1272,1251,1811,560
2017,4,7,12,1348,1340,1816,476
2017,4,7,13,1450,1460,1970,510
2017,4,7,14,1485,1481,2019,538
2017,4,7,15,1453,1436,2014,578
2017,4,7,16,1468,1435,1972,537
2017,4,7,17,1456,1445,2043,598
2017,4,7,18,1456,1445,2100,655
2017,4,7,19,1448,1433,2084,651
2017,4,7,20,1451,1435,2096,661
2017,4,7,21,1461,1447,2101,654
2017,4,7,22,1480,1463,2105,642
2017,4,7,23,1492,1480,2052,572
2017,4,8,0,1490,1488,2021,533
2017,4,8,1,1483,1488,1937,449
2017,4,8,2,1540,1522,1974,452
2017,4,8,3,1599,1582,2066,484
2017,4,8,4,1568,1536,2032,496
2017,4,8,5,1492,1442,1976,534
2017,4,8,6,1397,1347,1863,516
2017,4,8,7,1320,1289,1803,514
2017,4,8,8,1270,1248,1762,514
2017,4,8,9,1249,1223,1728,505
2017,4,8,10,1237,1215,1659,444
2017,4,8,11,1239,1219,1703,484
2017,4,8,12,1270,1247,1735,488
2017,4,8,13,1316,1293,1812,519
2017,4,8,14,1357,1311,1974,663
2017,4,8,15,1388,1347,2004,657
2017,4,8,16,1386,1360,1957,597
2017,4,8,17,1395,1363,1941,578
2017,4,8,18,1415,1373,1877,504
2017,4,8,19,1421,1374,1892,518
2017,4,8,20,1411,1376,1905,529
2017,4,8,21,1422,1391,1905,514
2017,4,8,22,1430,1415,1958,543
2017,4,8,23,1452,1442,1991,549
2017,4,9,0,1479,1464,1995,531
2017,4,9,1,1489,1468,1995,527
2017,4,9,2,1531,1493,2043,550
2017,4,9,3,1589,1548,2224,676
2017,4,9,4,1561,1498,2154,656
2017,4,9,5,1459,1411,2103,692
2017,4,9,6,1366,1332,1881,549
2017,4,9,7,1300,1280,1814,534
2017,4,9,8,1261,1275,1737,462
2017,4,9,9,1231,1192,1598,406
2017,4,9,10,1216,1187,1679,492
2017,4,9,11,1212,1187,1674,487
2017,4,9,12,1230,1209,1681,472
2017,4,9,13,1257,1252,1748,496
2017,4,9,14,1298,1267,1771,504
2017,4,9,15,1332,1296,1803,507
2017,4,9,16,1342,1313,1819,506
2017,4,9,17,1373,1320,1867,547
2017,4,9,18,1370,1331,1873,542
2017,4,9,19,1376,1335,1853,518
2017,4,9,20,1375,1342,1859,517
2017,4,9,21,1374,1345,1822,477
2017,4,9,22,1376,1343,1769,426
2017,4,9,23,1401,1380,1792,412
2017,4,10,0,1442,1424,1901,477
2017,4,10,1,1489,1456,2016,560
2017,4,10,2,1515,1521,2073,552
2017,4,10,3,1567,1586,2151,565
2017,4,10,4,1541,1533,2089,556
2017,4,10,5,1463,1419,2020,601
2017,4,10,6,1364,1320,1947,627
2017,4,10,7,1298,1258,1903,645
2017,4,10,8,1266,1227,1735,508
2017,4,10,9,1242,1215,1670,455
2017,4,10,10,1240,1213,1624,411
2017,4,10,11,1258,1239,1657,418
2017,4,10,12,1330,1334,1745,411
2017,4,10,13,1447,1470,1950,480
2017,4,10,14,1520,1509,1996,487
2017,4,10,15,1521,1501,1962,461
2017,4,10,16,1523,1473,1844,371
2017,4,10,17,1508,1454,1817,363
2017,4,10,18,1496,1454,1834,380
2017,4,10,19,1493,1449,1836,387
2017,4,10,20,1493,1450,1851,401
2017,4,10,21,1488,1441,1861,420
2017,4,10,22,1487,1441,1867,426
2017,4,10,23,1498,1474,1908,434
2017,4,11,0,1508,1469,1985,516
2017,4,11,1,1519,1486,1993,507
2017,4,11,2,1570,1528,2085,557
2017,4,11,3,1621,1588,2150,562
2017,4,11,4,1586,1522,2138,616
2017,4,11,5,1483,1447,2052,605
2017,4,11,6,1375,1349,1957,608
2017,4,11,7,1311,1282,1835,553
2017,4,11,8,1278,1244,1791,547
2017,4,11,9,1262,1235,1818,583
2017,4,11,10,1260,1235,1752,517
2017,4,11,11,1270,1267,1759,492
2017,4,11,12,1334,1345,1826,481
2017,4,11,13,1464,1481,1994,513
2017,4,11,14,1532,1512,1983,471
2017,4,11,15,1527,1496,1951,455
2017,4,11,16,1514,1463,1875,412
2017,4,11,17,1503,1469,1855,386
2017,4,11,18,1496,1461,1879,418
2017,4,11,19,1493,1446,1865,419
2017,4,11,20,1501,1473,1917,444
2017,4,11,21,1509,1482,2041,559
2017,4,11,22,1511,1502,2088,586
2017,4,11,23,1529,1498,2043,545
2017,4,12,0,1542,1492,2017,525
2017,4,12,1,1548,1488,2004,516
2017,4,12,2,1584,1545,2107,562
2017,4,12,3,1636,1624,2213,589
2017,4,12,4,1600,1559,2156,597
2017,4,12,5,1491,1452,2031,579
2017,4,12,6,1385,1341,1920,579
2017,4,12,7,1314,1271,1847,576
2017,4,12,8,1274,1230,1748,518
2017,4,12,9,1251,1211,1736,525
2017,4,12,10,1241,1200,1701,501
2017,4,12,11,1257,1214,1658,444
2017,4,12,12,1327,1294,1702,408
2017,4,12,13,1441,1431,1844,413
2017,4,12,14,1509,1469,1958,489
2017,4,12,15,1513,1458,1937,479
2017,4,12,16,1511,1451,1850,399
2017,4,12,17,1502,1469,1835,366
2017,4,12,18,1513,1475,1872,397
2017,4,12,19,1514,1491,1949,458
2017,4,12,20,1524,1510,1992,482
2017,4,12,21,1523,1528,2015,487
2017,4,12,22,1521,1540,2024,484
2017,4,12,23,1551,1566,2038,472
2017,4,13,0,1550,1530,2129,599
2017,4,13,1,1563,1530,2136,606
2017,4,13,2,1588,1541,2241,700
2017,4,13,3,1649,1635,2300,665
2017,4,13,4,1611,1567,2241,674
2017,4,13,5,1507,1458,2080,622
2017,4,13,6,1397,1355,1838,483
2017,4,13,7,1326,1285,1775,490
2017,4,13,8,1272,1236,1763,527
2017,4,13,9,1246,1221,1715,494
2017,4,13,10,1243,1211,1646,435
2017,4,13,11,1254,1231,1665,434
2017,4,13,12,1310,1302,1722,420
2017,4,13,13,1417,1415,1768,353
2017,4,13,14,1497,1437,1786,349
2017,4,13,15,1495,1432,1830,398
2017,4,13,16,1489,1423,1792,369
2017,4,13,17,1504,1437,1817,380
2017,4,13,18,1490,1446,1832,386
2017,4,13,19,1492,1446,1849,403
2017,4,13,20,1512,1466,1817,351
2017,4,13,21,1530,1490,1854,364
2017,4,13,22,1547,1504,1923,419
2017,4,13,23,1569,1518,1920,402
2017,4,14,0,1564,1509,1970,461
2017,4,14,1,1569,1491,1967,476
2017,4,14,2,1598,1514,2018,504
2017,4,14,3,1652,1591,2128,537
2017,4,14,4,1603,1560,2112,552
2017,4,14,5,1530,1461,2006,545
2017,4,14,6,1410,1351,1859,508
2017,4,14,7,1329,1276,1790,514
2017,4,14,8,1270,1232,1606,374
2017,4,14,9,1242,1208,1568,360
2017,4,14,10,1229,1198,1550,352
2017,4,14,11,1238,1203,1503,300
2017,4,14,12,1295,1265,1501,236
2017,4,14,13,1409,1348,1515,167
2017,4,14,14,1443,1377,1534,157
2017,4,14,15,1457,1402,1627,225
2017,4,14,16,1426,1422,1626,204
2017,4,14,17,1451,1435,1627,192
2017,4,14,18,1465,1441,1650,209
2017,4,14,19,1474,1443,1716,273
2017,4,14,20,1485,1444,1746,302
2017,4,14,21,1472,1457,1695,238
2017,4,14,22,1495,1475,1754,279
2017,4,14,23,1535,1506,1855,349
2017,4,15,0,1532,1518,1844,326
2017,4,15,1,1519,1510,1774,264
2017,4,15,2,1535,1520,1785,265
2017,4,15,3,1591,1591,1922,331
2017,4,15,4,1569,1542,1925,383
2017,4,15,5,1506,1451,1833,382
2017,4,15,6,1398,1347,1795,448
2017,4,15,7,1319,1277,1787,510
2017,4,15,8,1273,1231,1681,450
2017,4,15,9,1247,1210,1656,446
2017,4,15,10,1234,1204,1633,429
2017,4,15,11,1232,1199,1594,395
2017,4,15,12,1251,1223,1589,366
2017,4,15,13,1293,1255,1665,410
2017,4,15,14,1313,1267,1634,367
2017,4,15,15,1358,1308,1615,307
2017,4,15,16,1380,1342,1612,270
2017,4,15,17,1382,1356,1657,301
2017,4,15,18,1392,1364,1681,317
2017,4,15,19,1413,1365,1699,334
2017,4,15,20,1416,1376,1736,360
2017,4,15,21,1430,1393,1746,353
2017,4,15,22,1437,1412,1747,335
2017,4,15,23,1461,1442,1914,472
2017,4,16,0,1490,1479,1922,443
2017,4,16,1,1515,1487,1865,378
2017,4,16,2,1534,1510,1854,344
2017,4,16,3,1577,1566,1913,347
2017,4,16,4,1554,1514,1906,392
2017,4,16,5,1468,1420,1799,379
2017,4,16,6,1382,1332,1679,347
2017,4,16,7,1314,1266,1644,378
2017,4,16,8,1270,1212,1618,406
2017,4,16,9,1240,1188,1538,350
2017,4,16,10,1222,1172,1558,386
2017,4,16,11,1216,1180,1525,345
2017,4,16,12,1240,1204,1520,316
2017,4,16,13,1271,1231,1535,304
2017,4,16,14,1286,1249,1546,297
2017,4,16,15,1319,1288,1545,257
2017,4,16,16,1348,1302,1555,253
2017,4,16,17,1372,1313,1541,228
2017,4,16,18,1367,1322,1531,209
2017,4,16,19,1373,1334,1621,287
2017,4,16,20,1384,1343,1632,289
2017,4,16,21,1389,1350,1629,279
2017,4,16,22,1416,1365,1616,251
2017,4,16,23,1453,1407,1615,208
2017,4,17,0,1470,1441,1597,156
2017,4,17,1,1498,1441,1664,223
2017,4,17,2,1534,1474,1723,249
2017,4,17,3,1578,1553,1823,270
2017,4,17,4,1569,1507,1806,299
2017,4,17,5,1470,1396,1700,304
2017,4,17,6,1368,1292,1651,359
2017,4,17,7,1298,1225,1564,339
2017,4,17,8,1236,1195,1520,325
2017,4,17,9,1204,1174,1516,342
2017,4,17,10,1206,1172,1553,381
2017,4,17,11,1229,1198,1566,368
2017,4,17,12,1282,1260,1598,338
2017,4,17,13,1383,1371,1627,256
2017,4,17,14,1444,1412,1628,216
2017,4,17,15,1468,1436,1631,195
2017,4,17,16,1484,1453,1622,169
2017,4,17,17,1511,1477,1687,210
2017,4,17,18,1546,1507,1727,220
2017,4,17,19,1545,1524,1715,191
2017,4,17,20,1554,1540,1719,179
2017,4,17,21,1579,1559,1718,159
2017,4,17,22,1605,1599,1729,130
2017,4,17,23,1608,1601,1722,121
2017,4,18,0,1610,1601,1798,197
2017,4,18,1,1596,1582,1804,222
2017,4,18,2,1616,1605,1812,207
2017,4,18,3,1674,1673,1918,245
2017,4,18,4,1624,1594,1943,349
2017,4,18,5,1503,1457,1806,349
2017,4,18,6,1387,1340,1760,420
2017,4,18,7,1307,1273,1745,472
2017,4,18,8,1252,1241,1669,428
2017,4,18,9,1216,1198,1582,384
2017,4,18,10,1162,1144,1512,368
2017,4,18,11,1224,1203,1573,370
2017,4,18,12,1286,1276,1549,273
2017,4,18,13,1397,1389,1643,254
2017,4,18,14,1454,1422,1664,242
2017,4,18,15,1450,1429,1669,240
2017,4,18,16,1477,1443,1646,203
2017,4,18,17,1495,1459,1372,-87
2017,4,18,18,1506,1476,1239,-237
2017,4,18,19,1525,1495,1300,-195
2017,4,18,20,1564,1534,1302,-232
2017,4,18,21,1554,1559,1321,-238
2017,4,18,22,1594,1582,1374,-208
2017,4,18,23,1631,1618,1363,-255
2017,4,19,0,1648,1631,1532,-99
2017,4,19,1,1652,1579,1485,-94
2017,4,19,2,1628,1571,1473,-98
2017,4,19,3,1685,1640,1567,-73
2017,4,19,4,1640,1565,1570,5
2017,4,19,5,1516,1426,1445,19
2017,4,19,6,1403,1322,1435,113
2017,4,19,7,1325,1270,1383,113
2017,4,19,8,1270,1229,1326,97
2017,4,19,9,1247,1208,1294,86
2017,4,19,10,1233,1202,1217,15
2017,4,19,11,1245,1211,1254,43
2017,4,19,12,1294,1268,1339,71
2017,4,19,13,1389,1371,1355,-16
2017,4,19,14,1444,1406,1366,-40
2017,4,19,15,1472,1419,1429,10
2017,4,19,16,1486,1430,1510,80
2017,4,19,17,1520,1461,1591,130
2017,4,19,18,1555,1489,1665,176
2017,4,19,19,1543,1504,1705,201
2017,4,19,20,1471,1528,1696,168
2017,4,19,21,1591,1564,1721,157
2017,4,19,22,1629,1604,1742,138
2017,4,19,23,1661,1632,1739,107
2017,4,20,0,1679,1646,1737,91
2017,4,20,1,1668,1644,1759,115
2017,4,20,2,1658,1636,1448,-188
2017,4,20,3,1717,1714,1467,-247
2017,4,20,4,1660,1630,1421,-209
2017,4,20,5,1520,1471,1286,-185
2017,4,20,6,1416,1364,1193,-171
2017,4,20,7,1337,1292,1300,8
2017,4,20,8,1286,1252,1257,5
2017,4,20,9,1260,1233,1257,24
2017,4,20,10,1238,1216,1222,6
2017,4,20,11,1249,1230,1259,29
2017,4,20,12,1302,1298,1409,111
2017,4,20,13,1408,1385,1544,159
2017,4,20,14,1466,1427,1715,288
2017,4,20,15,1478,1441,1753,312
2017,4,20,16,1492,1458,1670,212
2017,4,20,17,1511,1471,1662,191
2017,4,20,18,1525,1477,1694,217
2017,4,20,19,1534,1485,1624,139
2017,4,20,20,1559,1505,1598,93
2017,4,20,21,1577,1529,1640,111
2017,4,20,22,1605,1561,1671,110
2017,4,20,23,1633,1592,1723,131
2017,4,21,0,1641,1613,1787,174
2017,4,21,1,1632,1608,1800,192
2017,4,21,2,1640,1614,1771,157
2017,4,21,3,1669,1681,1881,200
2017,4,21,4,1619,1609,1798,189
2017,4,21,5,1506,1477,1722,245
2017,4,21,6,1388,1359,1726,367
2017,4,21,7,1312,1287,1640,353
2017,4,21,8,1279,1248,1580,332
2017,4,21,9,1245,1220,1629,409
2017,4,21,10,1236,1215,1632,417
2017,4,21,11,1240,1215,1640,425
2017,4,21,12,1291,1280,1724,444
2017,4,21,13,1390,1374,1744,370
2017,4,21,14,1448,1418,1816,398
2017,4,21,15,1466,1426,1859,433
2017,4,21,16,1491,1437,1758,321
2017,4,21,17,1486,1452,1778,326
2017,4,21,18,1483,1457,1832,375
2017,4,21,19,1471,1458,1893,435
2017,4,21,20,1487,1474,1919,445
2017,4,21,21,1492,1498,1983,485
2017,4,21,22,1499,1513,1988,475
2017,4,21,23,1517,1540,1972,432
2017,4,22,0,1508,1528,1950,422
2017,4,22,1,1514,1536,1900,364
2017,4,22,2,1538,1517,1764,247
2017,4,22,3,1559,1600,1750,150
2017,4,22,4,1554,1546,1744,198
2017,4,22,5,1493,1449,1365,-84
2017,4,22,6,1387,1350,1420,70
2017,4,22,7,1307,1283,1400,117
2017,4,22,8,1259,1238,1351,113
2017,4,22,9,1227,1214,1307,93
2017,4,22,10,1215,1201,1011,-190
2017,4,22,11,1221,1210,1033,-177
2017,4,22,12,1255,1234,1097,-137
2017,4,22,13,1299,1261,1130,-131
2017,4,22,14,1339,1294,1173,-121
2017,4,22,15,1368,1334,1223,-111
2017,4,22,16,1389,1361,1321,-40
2017,4,22,17,1406,1360,1424,64
2017,4,22,18,1398,1362,1477,115
2017,4,22,19,1397,1356,1472,116
2017,4,22,20,1391,1362,1465,103
2017,4,22,21,1393,1366,1472,106
2017,4,22,22,1407,1395,1500,105
2017,4,22,23,1434,1426,1585,159
2017,4,23,0,1461,1455,1654,199
2017,4,23,1,1490,1462,1697,235
2017,4,23,2,1504,1472,1720,248
2017,4,23,3,1567,1547,1765,218
2017,4,23,4,1542,1497,1720,223
2017,4,23,5,1467,1414,1667,253
2017,4,23,6,1377,1328,1636,308
2017,4,23,7,1309,1264,1630,366
2017,4,23,8,1270,1224,1558,334
2017,4,23,9,1241,1202,1497,295
2017,4,23,10,1227,1191,1426,235
2017,4,23,11,1223,1197,1426,229
2017,4,23,12,1245,1223,1407,184
2017,4,23,13,1287,1233,1426,193
2017,4,23,14,1314,1250,1492,242
2017,4,23,15,1339,1275,1480,205
2017,4,23,16,1363,1293,1488,195
2017,4,23,17,1372,1295,1540,245
2017,4,23,18,1360,1306,1593,287
2017,4,23,19,1364,1324,1618,294
2017,4,23,20,1371,1340,1636,296
2017,4,23,21,1380,1363,1690,327
2017,4,23,22,1405,1392,1765,373
2017,4,23,23,1432,1443,1777,334
2017,4,24,0,1469,1497,1785,288
2017,4,24,1,1496,1518,1770,252
2017,4,24,2,1526,1545,1784,239
2017,4,24,3,1593,1611,1874,263
2017,4,24,4,1559,1553,1834,281
2017,4,24,5,1467,1441,1752,311
2017,4,24,6,1359,1329,1746,417
2017,4,24,7,1286,1257,1668,411
2017,4,24,8,1243,1216,1615,399
2017,4,24,9,1219,1186,1573,387
2017,4,24,10,1210,1170,1608,438
2017,4,24,11,1223,1184,1613,429
2017,4,24,12,1277,1233,1614,381
2017,4,24,13,1364,1293,1631,338
2017,4,24,14,1433,1341,1613,272
2017,4,24,15,1455,1369,1673,304
2017,4,24,16,1479,1394,1667,273
2017,4,24,17,1502,1433,1720,287
2017,4,24,18,1524,1476,1830,354
2017,4,24,19,1539,1495,1890,395
2017,4,24,20,1570,1533,1956,423
2017,4,24,21,1589,1558,1961,403
2017,4,24,22,1611,1584,1937,353
2017,4,24,23,1638,1603,1895,292
2017,4,25,0,1647,1597,1796,199
2017,4,25,1,1631,1579,1740,161
2017,4,25,2,1634,1592,1726,134
2017,4,25,3,1680,1660,1803,143
2017,4,25,4,1632,1595,1816,221
2017,4,25,5,1517,1471,1777,306
2017,4,25,6,1395,1360,1729,369
2017,4,25,7,1312,1289,1701,412
2017,4,25,8,1276,1249,1708,459
2017,4,25,9,1251,1223,1645,422
2017,4,25,10,1238,1214,1628,414
2017,4,25,11,1254,1229,1653,424
2017,4,25,12,1310,1295,1653,358
2017,4,25,13,1418,1408,1665,257
2017,4,25,14,1490,1469,1783,314
2017,4,25,15,1491,1473,1767,294
2017,4,25,16,1534,1520,1729,209
2017,4,25,17,1533,1521,1680,159
2017,4,25,18,1537,1514,1693,179
2017,4,25,19,1519,1494,1681,187
2017,4,25,20,1533,1500,1669,169
2017,4,25,21,1513,1476,1591,115
2017,4,25,22,1514,1468,1512,44
2017,4,25,23,1522,1482,1465,-17
2017,4,26,0,1519,1482,1476,-6
2017,4,26,1,1524,1508,1451,-57
2017,4,26,2,1560,1513,1584,71
2017,4,26,3,1633,1599,1779,180
2017,4,26,4,1588,1546,1764,218
2017,4,26,5,1488,1424,1711,287
2017,4,26,6,1385,1304,1745,441
2017,4,26,7,1323,1252,1726,474
2017,4,26,8,1250,1224,1679,455
2017,4,26,9,1226,1213,1624,411
2017,4,26,10,1223,1217,1632,415
2017,4,26,11,1242,1234,1651,417
2017,4,26,12,1314,1315,1744,429
2017,4,26,13,1420,1428,1776,348
2017,4,26,14,1466,1457,1724,267
2017,4,26,15,1475,1465,1678,213
2017,4,26,16,1467,1445,1621,176
2017,4,26,17,1451,1429,1625,196
2017,4,26,18,1446,1423,1651,228
2017,4,26,19,1433,1415,1360,-55
2017,4,26,20,1443,1428,1360,-68
2017,4,26,21,1460,1444,1427,-17
2017,4,26,22,1471,1459,1395,-64
2017,4,26,23,1471,1459,1443,-16
2017,4,27,0,1484,1468,1444,-24
2017,4,27,1,1493,1472,1604,132
2017,4,27,2,1514,1494,1577,83
2017,4,27,3,1591,1573,1560,-13
2017,4,27,4,1562,1526,1559,33
2017,4,27,5,1461,1414,1524,110
2017,4,27,6,1354,1309,1629,320
2017,4,27,7,1291,1254,1663,409
2017,4,27,8,1268,1218,1711,493
2017,4,27,9,1245,1194,1680,486
2017,4,27,10,1238,1197,1661,464
2017,4,27,11,1249,1204,1650,446
2017,4,27,12,1314,1291,1752,461
2017,4,27,13,1417,1398,1786,388
2017,4,27,14,1476,1444,1796,352
2017,4,27,15,1489,1460,1827,367
2017,4,27,16,1491,1470,1880,410
2017,4,27,17,1492,1497,1962,465
2017,4,27,18,1500,1482,2102,620
2017,4,27,19,1497,1490,2149,659
2017,4,27,20,1504,1496,2159,663
2017,4,27,21,1511,1487,2260,773
2017,4,27,22,1517,1496,2267,771
2017,4,27,23,1521,1488,2245,757
2017,4,28,0,1527,1488,2254,766
2017,4,28,1,1514,1480,2175,695
2017,4,28,2,1529,1507,2096,589
2017,4,28,3,1601,1605,2135,530
2017,4,28,4,1577,1554,2072,518
2017,4,28,5,1483,1445,1969,524
2017,4,28,6,1379,1332,1906,574
2017,4,28,7,1304,1277,1690,413
2017,4,28,8,1264,1243,1667,424
2017,4,28,9,1234,1218,1637,419
2017,4,28,10,1233,1216,1546,330
2017,4,28,11,1260,1252,1555,303
2017,4,28,12,1333,1331,1614,283
2017,4,28,13,1439,1435,1741,306
2017,4,28,14,1527,1489,1809,320
2017,4,28,15,1549,1534,1805,271
2017,4,28,16,1577,1573,1840,267
2017,4,28,17,1588,1592,1873,281
2017,4,28,18,1594,1602,1914,312
2017,4,28,19,1571,1587,1948,361
2017,4,28,20,1561,1568,1999,431
2017,4,28,21,1541,1543,2000,457
2017,4,28,22,1514,1517,2058,541
2017,4,28,23,1540,1533,2085,552
2017,4,29,0,1526,1524,2067,543
2017,4,29,1,1535,1529,2076,547
2017,4,29,2,1568,1574,2068,494
2017,4,29,3,1626,1632,2081,449
2017,4,29,4,1604,1584,2061,477
2017,4,29,5,1533,1501,1985,484
2017,4,29,6,1405,1379,1916,537
2017,4,29,7,1343,1319,1767,448
2017,4,29,8,1342,1320,1768,448
2017,4,29,9,1309,1296,1710,414
2017,4,29,10,1299,1290,1701,411
2017,4,29,11,1311,1295,1675,380
2017,4,29,12,1344,1333,1754,421
2017,4,29,13,1392,1388,1788,400
2017,4,29,14,1451,1434,1857,423
2017,4,29,15,1522,1506,1815,309
2017,4,29,16,1555,1545,1770,225
2017,4,29,17,1571,1566,1776,210
2017,4,29,18,1563,1560,1816,256
2017,4,29,19,1520,1516,1725,209
2017,4,29,20,1479,1472,1709,237
2017,4,29,21,1442,1432,1666,234
2017,4,29,22,1428,1421,1709,288
2017,4,29,23,1439,1434,1745,311
2017,4,30,0,1469,1469,1776,307
2017,4,30,1,1516,1508,1833,325
2017,4,30,2,1575,1573,1824,251
2017,4,30,3,1635,1636,1909,273
2017,4,30,4,1630,1606,1777,171
2017,4,30,5,1561,1523,1651,128
2017,4,30,6,1468,1431,1484,53
2017,4,30,7,1409,1370,1418,48
2017,4,30,8,1371,1336,1400,64
2017,4,30,9,1341,1312,1373,61
2017,4,30,10,1326,1302,1405,103
2017,4,30,11,1336,1309,1404,95
2017,4,30,12,1361,1341,1398,57
2017,4,30,13,1382,1361,1436,75
2017,4,30,14,1404,1378,1485,107
2017,4,30,15,1433,1394,1508,114
2017,4,30,16,1438,1403,1570,167
2017,4,30,17,1422,1383,1594,211
2017,4,30,18,1409,1377,1625,248
2017,4,30,19,1395,1363,1623,260
2017,4,30,20,1369,1343,1635,292
2017,4,30,21,1356,1334,1664,330
2017,4,30,22,1353,1328,1661,333
2017,4,30,23,1371,1348,1675,327
2017,5,1,0,1391,1379,1784,405
2017,5,1,1,1416,1402,1758,356
2017,5,1,2,1495,1431,1738,307
2017,5,1,3,1570,1540,1867,327
2017,5,1,4,1554,1504,1885,381
2017,5,1,5,1472,1422,1806,384
2017,5,1,6,1369,1316,1670,354
2017,5,1,7,1311,1261,1361,100
2017,5,1,8,1260,1219,1200,-19
2017,5,1,9,1246,1209,1159,-50
2017,5,1,10,1254,1217,1214,-3
2017,5,1,11,1280,1247,1269,22
2017,5,1,12,1355,1324,1333,9
2017,5,1,13,1456,1434,1367,-67
2017,5,1,14,1513,1470,1343,-127
2017,5,1,15,1507,1459,1324,-135
2017,5,1,16,1493,1438,1260,-178
2017,5,1,17,1479,1422,1292,-130
2017,5,1,18,1478,1421,1339,-82
2017,5,1,19,1473,1421,1379,-42
2017,5,1,20,1480,1425,1415,-10
2017,5,1,21,1493,1456,1531,75
2017,5,1,22,1500,1462,1532,70
2017,5,1,23,1502,1462,1537,75
2017,5,2,0,1515,1473,1567,94
2017,5,2,1,1512,1473,1498,25
2017,5,2,2,1526,1483,1501,18
2017,5,2,3,1611,1577,1591,14
2017,5,2,4,1593,1520,1572,52
2017,5,2,5,1493,1406,1484,78
2017,5,2,6,1382,1292,1368,76
2017,5,2,7,1313,1227,1199,-28
2017,5,2,8,1252,1191,1192,1
2017,5,2,9,1233,1179,1170,-9
2017,5,2,10,1234,1175,1132,-43
2017,5,2,11,1253,1201,1127,-74
2017,5,2,12,1321,1278,1181,-97
2017,5,2,13,1409,1366,1220,-146
2017,5,2,14,1462,1408,1260,-148
2017,5,2,15,1468,1410,1277,-133
2017,5,2,16,1474,1411,1299,-112
2017,5,2,17,1486,1436,1358,-78
2017,5,2,18,1483,1437,1445,8
2017,5,2,19,1495,1442,1462,20
2017,5,2,20,1514,1462,1527,65
2017,5,2,21,1536,1490,1561,71
2017,5,2,22,1582,1533,1555,22
2017,5,2,23,1577,1537,1618,81
2017,5,3,0,1590,1555,1644,89
2017,5,3,1,1584,1548,1606,58
2017,5,3,2,1574,1546,1192,-354
2017,5,3,3,1678,1632,1128,-504
2017,5,3,4,1622,1570,1099,-471
2017,5,3,5,1502,1440,1071,-369
2017,5,3,6,1384,1324,1075,-249
2017,5,3,7,1311,1250,1145,-105
2017,5,3,8,1260,1210,1216,6
2017,5,3,9,1239,1186,1197,11
2017,5,3,10,1226,1175,1246,71
2017,5,3,11,1244,1191,1254,63
2017,5,3,12,1297,1266,1317,51
2017,5,3,13,1383,1346,1361,15
2017,5,3,14,1442,1383,1431,48
2017,5,3,15,1463,1402,1467,65
2017,5,3,16,1478,1415,1395,-20
2017,5,3,17,1491,1429,1330,-99
2017,5,3,18,1503,1437,1381,-56
2017,5,3,19,1508,1454,1305,-149
2017,5,3,20,1516,1471,1304,-167
2017,5,3,21,1545,1498,1338,-160
2017,5,3,22,1574,1527,1355,-172
2017,5,3,23,1601,1554,1381,-173
2017,5,4,0,1604,1568,1458,-110
2017,5,4,1,1599,1557,1495,-62
2017,5,4,2,1587,1556,1506,-50
2017,5,4,3,1651,1631,1527,-104
2017,5,4,4,1609,1551,1568,17
2017,5,4,5,1509,1435,1390,-45
2017,5,4,6,1386,1327,1311,-16
2017,5,4,7,1312,1250,1246,-4
2017,5,4,8,1249,1228,1107,-121
2017,5,4,9,1231,1207,1080,-127
2017,5,4,10,1221,1206,1052,-154
2017,5,4,11,1235,1233,968,-265
2017,5,4,12,1300,1305,1014,-291
2017,5,4,13,1380,1384,1073,-311
2017,5,4,14,1433,1420,1095,-325
2017,5,4,15,1436,1424,1098,-326
2017,5,4,16,1455,1432,1123,-309
2017,5,4,17,1500,1454,1143,-311
2017,5,4,18,1516,1463,1174,-289
2017,5,4,19,1516,1463,1241,-222
2017,5,4,20,1536,1489,1206,-283
2017,5,4,21,1564,1517,1204,-313
2017,5,4,22,1598,1555,1257,-298
2017,5,4,23,1613,1594,1266,-328
2017,5,5,0,1630,1606,1302,-304
2017,5,5,1,1623,1602,1311,-291
2017,5,5,2,1620,1593,1323,-270
2017,5,5,3,1672,1661,1388,-273
2017,5,5,4,1638,1603,1308,-295
2017,5,5,5,1529,1480,1210,-270
2017,5,5,6,1403,1359,1132,-227
2017,5,5,7,1325,1281,1088,-193
2017,5,5,8,1269,1243,1021,-222
2017,5,5,9,1240,1216,1048,-168
2017,5,5,10,1224,1204,1085,-119
2017,5,5,11,1226,1213,1085,-128
2017,5,5,12,1280,1271,1081,-190
2017,5,5,13,1349,1352,1107,-245
2017,5,5,14,1403,1396,1148,-248
2017,5,5,15,1435,1422,1154,-268
2017,5,5,16,1453,1441,1185,-256
2017,5,5,17,1498,1468,1301,-167
2017,5,5,18,1509,1487,1304,-183
2017,5,5,19,1517,1467,1283,-184
2017,5,5,20,1551,1529,1300,-229
2017,5,5,21,1593,1584,1364,-220
2017,5,5,22,1632,1628,1453,-175
2017,5,5,23,1662,1666,1398,-268
2017,5,6,0,1673,1676,1396,-280
2017,5,6,1,1654,1663,1352,-311
2017,5,6,2,1641,1632,1283,-349
2017,5,6,3,1674,1680,1395,-285
2017,5,6,4,1621,1632,1403,-229
2017,5,6,5,1525,1519,1329,-190
2017,5,6,6,1413,1404,1256,-148
2017,5,6,7,1327,1322,1198,-124
2017,5,6,8,1285,1263,1167,-96
2017,5,6,9,1241,1225,1174,-51
2017,5,6,10,1223,1199,1089,-110
2017,5,6,11,1221,1196,1097,-99
2017,5,6,12,1241,1219,1079,-140
2017,5,6,13,1247,1225,1080,-145
2017,5,6,14,1287,1271,1093,-178
2017,5,6,15,1340,1328,1077,-251
2017,5,6,16,1381,1373,1086,-287
2017,5,6,17,1425,1411,1111,-300
2017,5,6,18,1468,1459,1156,-303
2017,5,6,19,1524,1496,1193,-303
2017,5,6,20,1548,1532,1229,-303
2017,5,6,21,1583,1570,1283,-287
2017,5,6,22,1622,1604,1310,-294
2017,5,6,23,1641,1626,1308,-318
2017,5,7,0,1673,1636,1313,-323
2017,5,7,1,1675,1617,1288,-329
2017,5,7,2,1642,1601,1263,-338
2017,5,7,3,1646,1635,1344,-291
2017,5,7,4,1609,1584,1346,-238
2017,5,7,5,1526,1487,1301,-186
2017,5,7,6,1418,1400,1283,-117
2017,5,7,7,1336,1337,1172,-165
2017,5,7,8,1297,1284,1128,-156
2017,5,7,9,1261,1247,1103,-144
2017,5,7,10,1242,1220,1038,-182
2017,5,7,11,1229,1217,1007,-210
2017,5,7,12,1235,1229,1038,-191
2017,5,7,13,1233,1217,1011,-206
2017,5,7,14,1269,1246,1028,-218
2017,5,7,15,1313,1300,1069,-231
2017,5,7,16,1367,1359,1008,-351
2017,5,7,17,1421,1414,1017,-397
2017,5,7,18,1469,1463,1022,-441
2017,5,7,19,1500,1498,1044,-454
2017,5,7,20,1514,1513,1089,-424
2017,5,7,21,1544,1537,1158,-379
2017,5,7,22,1567,1559,1241,-318
2017,5,7,23,1606,1595,1323,-272
2017,5,8,0,1636,1621,1459,-162
2017,5,8,1,1642,1625,1504,-121
2017,5,8,2,1647,1609,1453,-156
2017,5,8,3,1681,1653,1533,-120
2017,5,8,4,1653,1594,1537,-57
2017,5,8,5,1515,1465,1377,-88
2017,5,8,6,1399,1344,1204,-140
2017,5,8,7,1317,1272,1174,-98
2017,5,8,8,1248,1222,1192,-30
2017,5,8,9,1221,1199,1083,-116
2017,5,8,10,1210,1182,1132,-50
2017,5,8,11,1224,1202,1102,-100
2017,5,8,12,1277,1267,1120,-147
2017,5,8,13,1355,1350,1187,-163
2017,5,8,14,1422,1402,1189,-213
2017,5,8,15,1466,1443,1160,-283
2017,5,8,16,1489,1475,1202,-273
2017,5,8,17,1527,1513,1245,-268
2017,5,8,18,1558,1548,1283,-265
2017,5,8,19,1573,1566,1313,-253
2017,5,8,20,1603,1600,1351,-249
2017,5,8,21,1626,1627,1377,-250
2017,5,8,22,1648,1650,1464,-186
2017,5,8,23,1676,1681,1499,-182
2017,5,9,0,1678,1695,1533,-162
2017,5,9,1,1667,1664,1508,-156
2017,5,9,2,1665,1637,1383,-254
2017,5,9,3,1694,1709,1425,-284
2017,5,9,4,1624,1643,1509,-134
2017,5,9,5,1504,1507,1441,-66
2017,5,9,6,1381,1378,1381,3
2017,5,9,7,1331,1311,1352,41
2017,5,9,8,1291,1269,1257,-12
2017,5,9,9,1265,1240,1232,-8
2017,5,9,10,1243,1232,1236,4
2017,5,9,11,1258,1248,1178,-70
2017,5,9,12,1308,1303,1237,-66
2017,5,9,13,1393,1388,1387,-1
2017,5,9,14,1458,1448,1424,-24
2017,5,9,15,1492,1487,1473,-14
2017,5,9,16,1517,1506,1510,4
2017,5,9,17,1543,1535,1622,87
2017,5,9,18,1574,1560,1632,72
2017,5,9,19,1564,1555,1556,1
2017,5,9,20,1582,1568,1637,69
2017,5,9,21,1602,1583,1658,75
2017,5,9,22,1603,1587,1637,50
2017,5,9,23,1584,1578,1626,48
2017,5,10,0,1584,1545,1562,17
2017,5,10,1,1586,1513,1497,-16
2017,5,10,2,1601,1521,1512,-9
2017,5,10,3,1600,1599,1565,-34
2017,5,10,4,1569,1560,1525,-35
2017,5,10,5,1470,1442,1467,25
2017,5,10,6,1358,1334,1418,84
2017,5,10,7,1294,1265,1396,131
2017,5,10,8,1242,1223,1511,288
2017,5,10,9,1224,1208,1489,281
2017,5,10,10,1212,1204,1481,277
2017,5,10,11,1228,1217,1471,254
2017,5,10,12,1277,1282,1471,189
2017,5,10,13,1375,1369,1574,205
2017,5,10,14,1447,1428,1709,281
2017,5,10,15,1465,1445,1659,214
2017,5,10,16,1478,1465,1729,264
2017,5,10,17,1487,1472,1790,318
2017,5,10,18,1496,1484,1850,366
2017,5,10,19,1468,1480,1819,339
2017,5,10,20,1464,1471,1876,405
2017,5,10,21,1470,1457,1902,445
2017,5,10,22,1473,1457,1898,441
2017,5,10,23,1474,1472,1879,407
2017,5,11,0,1484,1482,1897,415
2017,5,11,1,1487,1473,1918,445
2017,5,11,2,1513,1492,1904,412
2017,5,11,3,1584,1582,2006,424
2017,5,11,4,1560,1533,2010,477
2017,5,11,5,1474,1427,1897,470
2017,5,11,6,1354,1326,1818,492
2017,5,11,7,1285,1277,1778,501
2017,5,11,8,1268,1239,1701,462
2017,5,11,9,1233,1217,1614,397
2017,5,11,10,1230,1220,1592,372
2017,5,11,11,1246,1240,1545,305
2017,5,11,12,1307,1306,1570,264
2017,5,11,13,1410,1402,1757,355
2017,5,11,14,1474,1447,1772,325
2017,5,11,15,1489,1447,1690,243
2017,5,11,16,1486,1440,1725,285
2017,5,11,17,1484,1449,1815,366
2017,5,11,18,1482,1447,1818,371
2017,5,11,19,1485,1447,1870,423
2017,5,11,20,1494,1466,1876,410
2017,5,11,21,1508,1496,1886,390
2017,5,11,22,1540,1527,1907,380
2017,5,11,23,1560,1602,1982,380
2017,5,12,0,1565,1561,1875,314
2017,5,12,1,1562,1564,1851,287
2017,5,12,2,1583,1557,1770,213
2017,5,12,3,1654,1625,1838,213
2017,5,12,4,1621,1584,1905,321
2017,5,12,5,1510,1466,1848,382
2017,5,12,6,1406,1338,1790,452
2017,5,12,7,1321,1265,1645,380
2017,5,12,8,1257,1224,1472,248
2017,5,12,9,1230,1199,1463,264
2017,5,12,10,1221,1196,1414,218
2017,5,12,11,1240,1218,1391,173
2017,5,12,12,1287,1275,1438,163
2017,5,12,13,1374,1355,1434,79
2017,5,12,14,1438,1413,1475,62
2017,5,12,15,1453,1423,1549,126
2017,5,12,16,1476,1446,1653,207
2017,5,12,17,1495,1468,1687,219
2017,5,12,18,1513,1485,1682,197
2017,5,12,19,1535,1680,1916,236
2017,5,12,20,1565,1539,1762,223
2017,5,12,21,1586,1562,1808,246
2017,5,12,22,1612,1583,1836,253
2017,5,12,23,1633,1607,1907,300
2017,5,13,0,1645,1625,1851,226
2017,5,13,1,1627,1602,1837,235
2017,5,13,2,1614,1584,1779,195
2017,5,13,3,1662,1640,1842,202
2017,5,13,4,1639,1600,1909,309
2017,5,13,5,1540,1490,1891,401
2017,5,13,6,1426,1380,1888,508
2017,5,13,7,1344,1308,1831,523
2017,5,13,8,1294,1262,1757,495
2017,5,13,9,1253,1229,1732,503
2017,5,13,10,1231,1210,1684,474
2017,5,13,11,1219,1200,1651,451
2017,5,13,12,1237,1227,1689,462
2017,5,13,13,1264,1231,1726,495
2017,5,13,14,1309,1283,1653,370
2017,5,13,15,1364,1340,1616,276
2017,5,13,16,1398,1381,1701,320
2017,5,13,17,1434,1419,1749,330
2017,5,13,18,1469,1453,1856,403
2017,5,13,19,1503,1488,1866,378
2017,5,13,20,1530,1522,1890,368
2017,5,13,21,1565,1564,1880,316
2017,5,13,22,1607,1596,1853,257
2017,5,13,23,1637,1631,1871,240
2017,5,14,0,1652,1641,1871,230
2017,5,14,1,1645,1631,1827,196
2017,5,14,2,1624,1605,1903,298
2017,5,14,3,1659,1660,2009,349
2017,5,14,4,1643,1620,2034,414
2017,5,14,5,1550,1520,1990,470
2017,5,14,6,1444,1402,1892,490
2017,5,14,7,1359,1317,1792,475
2017,5,14,8,1280,1257,1730,473
2017,5,14,9,1249,1227,1632,405
2017,5,14,10,1214,1197,1538,341
2017,5,14,11,1200,1191,1509,318
2017,5,14,12,1216,1199,1504,305
2017,5,14,13,1239,1193,1493,300
2017,5,14,14,1265,1238,1448,210
2017,5,14,15,1321,1303,1425,122
2017,5,14,16,1372,1346,1459,113
2017,5,14,17,1414,1389,1533,144
2017,5,14,18,1456,1427,1588,161
2017,5,14,19,1504,1464,1670,206
2017,5,14,20,1543,1480,1676,196
2017,5,14,21,1556,1509,1745,236
2017,5,14,22,1570,1530,1781,251
2017,5,14,23,1594,1558,1660,102
2017,5,15,0,1625,1576,1553,-23
2017,5,15,1,1587,1553,1555,2
2017,5,15,2,1588,1553,1537,-16
2017,5,15,3,1641,1626,1587,-39
2017,5,15,4,1617,1588,1622,34
2017,5,15,5,1508,1469,1582,113
2017,5,15,6,1387,1345,1537,192
2017,5,15,7,1297,1264,1481,217
2017,5,15,8,1258,1231,1479,248
2017,5,15,9,1233,1204,1416,212
2017,5,15,10,1214,1191,1399,208
2017,5,15,11,1224,1205,1387,182
2017,5,15,12,1276,1270,1449,179
2017,5,15,13,1353,1327,1548,221
2017,5,15,14,1433,1397,1507,110
2017,5,15,15,1465,1433,1445,12
2017,5,15,16,1494,1463,1454,-9
2017,5,15,17,1527,1517,1477,-40
2017,5,15,18,1581,1551,1558,7
2017,5,15,19,1612,1570,1637,67
2017,5,15,20,1645,1601,1657,56
2017,5,15,21,1680,1635,1718,83
2017,5,15,22,1700,1668,1758,90
2017,5,15,23,1715,1697,1739,42
2017,5,16,0,1713,1711,1836,125
2017,5,16,1,1681,1698,1878,180
2017,5,16,2,1668,1665,1824,159
2017,5,16,3,1709,1709,1852,143
2017,5,16,4,1666,1657,1785,128
2017,5,16,5,1536,1517,1659,142
2017,5,16,6,1409,1385,1616,231
2017,5,16,7,1321,1300,1536,236
2017,5,16,8,1272,1248,1396,148
2017,5,16,9,1237,1219,1313,94
2017,5,16,10,1228,1202,1277,75
2017,5,16,11,1238,1214,1290,76
2017,5,16,12,1299,1273,1325,52
2017,5,16,13,1400,1343,1407,64
2017,5,16,14,1458,1398,1440,42
2017,5,16,15,1485,1440,1381,-59
2017,5,16,16,1489,1461,1410,-51
2017,5,16,17,1515,1482,1466,-16
2017,5,16,18,1534,1510,1506,-4
2017,5,16,19,1537,1491,1562,71
2017,5,16,20,1553,1511,1652,141
2017,5,16,21,1539,1503,1693,190
2017,5,16,22,1540,1492,1640,148
2017,5,16,23,1541,1474,1649,175
2017,5,17,0,1538,1489,1650,161
2017,5,17,1,1527,1485,1709,224
2017,5,17,2,1547,1475,1671,196
2017,5,17,3,1604,1567,1780,213
2017,5,17,4,1587,1534,1843,309
2017,5,17,5,1488,1433,1770,337
2017,5,17,6,1369,1328,1664,336
2017,5,17,7,1296,1266,1543,277
2017,5,17,8,1266,1242,1526,284
2017,5,17,9,1241,1218,1487,269
2017,5,17,10,1233,1220,1467,247
2017,5,17,11,1248,1238,1493,255
2017,5,17,12,1312,1304,1506,202
2017,5,17,13,1403,1380,1547,167
2017,5,17,14,1507,1419,1537,118
2017,5,17,15,1482,1428,1451,23
2017,5,17,16,1474,1432,1451,19
2017,5,17,17,1488,1435,1453,18
2017,5,17,18,1495,1430,1526,96
2017,5,17,19,1466,1440,1548,108
2017,5,17,20,1494,1455,1531,76
2017,5,17,21,1503,1472,1550,78
2017,5,17,22,1528,1487,1607,120
2017,5,17,23,1535,1509,1716,207
2017,5,18,0,1547,1531,1696,165
2017,5,18,1,1536,1528,1569,41
2017,5,18,2,1539,1526,1630,104
2017,5,18,3,1621,1608,1758,150
2017,5,18,4,1602,1568,1793,225
2017,5,18,5,1503,1461,1674,213
2017,5,18,6,1387,1346,1633,287
2017,5,18,7,1307,1284,1585,301
2017,5,18,8,1285,1247,1673,426
2017,5,18,9,1262,1232,1659,427
2017,5,18,10,1238,1214,1608,394
2017,5,18,11,1253,1231,1589,358
2017,5,18,12,1312,1288,1681,393
2017,5,18,13,1394,1374,1849,475
2017,5,18,14,1449,1425,1867,442
2017,5,18,15,1447,1419,1831,412
2017,5,18,16,1462,1435,1845,410
2017,5,18,17,1462,1445,1898,453
2017,5,18,18,1464,1449,1922,473
2017,5,18,19,1469,1457,1883,426
2017,5,18,20,1466,1452,1921,469
2017,5,18,21,1485,1471,1904,433
2017,5,18,22,1485,1477,1831,354
2017,5,18,23,1491,1489,1841,352
2017,5,19,0,1499,1482,1816,334
2017,5,19,1,1489,1485,1802,317
2017,5,19,2,1500,1495,1812,317
2017,5,19,3,1597,1578,1885,307
2017,5,19,4,1574,1560,1956,396
2017,5,19,5,1481,1450,1866,416
2017,5,19,6,1369,1352,1704,352
2017,5,19,7,1298,1288,1598,310
2017,5,19,8,1253,1253,1617,364
2017,5,19,9,1237,1237,1652,415
2017,5,19,10,1223,1223,1609,386
2017,5,19,11,1241,1243,1576,333
2017,5,19,12,1301,1310,1663,353
2017,5,19,13,1377,1386,1771,385
2017,5,19,14,1455,1457,1794,337
2017,5,19,15,1492,1496,1857,361
2017,5,19,16,1490,1496,1830,334
2017,5,19,17,1472,1471,1828,357
2017,5,19,18,1461,1450,1768,318
2017,5,19,19,1437,1441,1789,348
2017,5,19,20,1447,1448,1868,420
2017,5,19,21,1453,1454,1939,485
2017,5,19,22,1443,1442,1879,437
2017,5,19,23,1453,1453,1916,463
2017,5,20,0,1457,1460,1898,438
2017,5,20,1,1443,1454,1770,316
2017,5,20,2,1455,1448,1643,195
2017,5,20,3,1531,1540,1756,216
2017,5,20,4,1529,1540,1875,335
2017,5,20,5,1465,1459,1833,374
2017,5,20,6,1377,1361,1808,447
2017,5,20,7,1299,1305,1729,424
2017,5,20,8,1262,1266,1701,435
2017,5,20,9,1243,1247,1663,416
2017,5,20,10,1224,1227,1637,410
2017,5,20,11,1227,1236,1637,401
2017,5,20,12,1239,1262,1699,437
2017,5,20,13,1256,1275,1733,458
2017,5,20,14,1295,1308,1735,427
2017,5,20,15,1336,1344,1710,366
2017,5,20,16,1354,1359,1729,370
2017,5,20,17,1383,1368,1689,321
2017,5,20,18,1386,1368,1678,310
2017,5,20,19,1393,1374,1704,330
2017,5,20,20,1383,1369,1890,521
2017,5,20,21,1373,1373,1829,456
2017,5,20,22,1405,1400,1960,560
2017,5,20,23,1430,1431,1999,568
2017,5,21,0,1450,1466,2002,536
2017,5,21,1,1461,1481,1980,499
2017,5,21,2,1463,1487,1968,481
2017,5,21,3,1556,1540,2036,496
2017,5,21,4,1539,1524,2025,501
2017,5,21,5,1478,1450,2018,568
2017,5,21,6,1385,1352,1956,604
2017,5,21,7,1319,1283,1923,640
2017,5,21,8,1265,1238,1824,586
2017,5,21,9,1233,1209,1810,601
2017,5,21,10,1212,1195,1681,486
2017,5,21,11,1218,1200,1644,444
2017,5,21,12,1227,1217,1648,431
2017,5,21,13,1221,1207,1651,444
2017,5,21,14,1254,1230,1664,434
2017,5,21,15,1292,1265,1636,371
2017,5,21,16,1323,1300,1690,390
2017,5,21,17,1366,1334,1770,436
2017,5,21,18,1372,1357,1914,557
2017,5,21,19,1409,1379,1959,580
2017,5,21,20,1441,1414,1959,545
2017,5,21,21,1465,1441,2047,606
2017,5,21,22,1503,1489,2082,593
2017,5,21,23,1559,1547,2112,565
2017,5,22,0,1590,1609,2147,538
2017,5,22,1,1604,1625,2180,555
2017,5,22,2,1584,1623,2152,529
2017,5,22,3,1638,1668,2162,494
2017,5,22,4,1621,1634,2184,550
2017,5,22,5,1524,1503,2105,602
2017,5,22,6,1406,1384,2016,632
2017,5,22,7,1320,1284,1945,661
2017,5,22,8,1261,1232,1864,632
2017,5,22,9,1231,1207,1782,575
2017,5,22,10,1217,1193,1670,477
2017,5,22,11,1230,1207,1694,487
2017,5,22,12,1281,1273,1767,494
2017,5,22,13,1351,1341,1820,479
2017,5,22,14,1421,1413,1878,465
2017,5,22,15,1460,1452,1906,454
2017,5,22,16,1488,1486,1891,405
2017,5,22,17,1504,1534,1984,450
2017,5,22,18,1531,1574,2036,462
2017,5,22,19,1581,1589,2113,524
2017,5,22,20,1609,1616,2157,541
2017,5,22,21,1642,1633,2185,552
2017,5,22,22,1665,1653,2310,657
2017,5,22,23,1693,1673,2323,650
2017,5,23,0,1704,1660,2289,629
2017,5,23,1,1679,1621,2214,593
2017,5,23,2,1656,1637,2221,584
2017,5,23,3,1694,1686,2257,571
2017,5,23,4,1663,1658,2244,586
2017,5,23,5,1545,1527,2079,552
2017,5,23,6,1416,1396,2062,666
2017,5,23,7,1322,1311,1930,619
2017,5,23,8,1302,1266,1939,673
2017,5,23,9,1267,1234,1978,744
2017,5,23,10,1253,1223,1942,719
2017,5,23,11,1261,1233,1868,635
2017,5,23,12,1307,1282,1916,634
2017,5,23,13,1378,1354,1942,588
2017,5,23,14,1450,1417,1994,577
2017,5,23,15,1485,1465,2041,576
2017,5,23,16,1512,1484,2044,560
2017,5,23,17,1530,1503,2128,625
2017,5,23,18,1553,1520,2129,609
2017,5,23,19,1588,1537,2162,625
2017,5,23,20,1600,1563,2179,616
2017,5,23,21,1628,1613,2172,559
2017,5,23,22,1630,1645,2243,598
2017,5,23,23,1632,1680,2266,586
2017,5,24,0,1694,1681,2273,592
2017,5,24,1,1664,1666,2277,611
2017,5,24,2,1665,1627,2287,660
2017,5,24,3,1715,1666,2286,620
2017,5,24,4,1644,1638,2306,668
2017,5,24,5,1530,1512,2172,660
2017,5,24,6,1401,1387,2060,673
2017,5,24,7,1320,1301,1975,674
2017,5,24,8,1286,1250,1796,546
2017,5,24,9,1252,1214,1771,557
2017,5,24,10,1243,1194,1780,586
2017,5,24,11,1254,1210,1744,534
2017,5,24,12,1303,1279,1806,527
2017,5,24,13,1366,1345,1855,510
2017,5,24,14,1441,1402,1814,412
2017,5,24,15,1476,1436,1746,310
2017,5,24,16,1502,1465,1798,333
2017,5,24,17,1541,1504,1812,308
2017,5,24,18,1579,1531,1928,397
2017,5,24,19,1615,1557,1984,427
2017,5,24,20,1661,1622,2016,394
2017,5,24,21,1728,1686,2095,409
2017,5,24,22,1790,1755,2128,373
2017,5,24,23,1834,1799,2270,471
2017,5,25,0,1852,1821,2328,507
2017,5,25,1,1824,1811,2251,440
2017,5,25,2,1781,1781,2177,396
2017,5,25,3,1796,1810,2190,380
2017,5,25,4,1748,1744,2168,424
2017,5,25,5,1616,1608,2011,403
2017,5,25,6,1476,1447,1945,498
2017,5,25,7,1374,1370,1873,503
2017,5,25,8,1338,1306,1907,601
2017,5,25,9,1301,1277,1938,661
2017,5,25,10,1278,1261,1938,677
2017,5,25,11,1279,1271,1908,637
2017,5,25,12,1325,1320,1924,604
2017,5,25,13,1400,1385,2009,624
2017,5,25,14,1471,1464,1977,513
2017,5,25,15,1527,1513,1989,476
2017,5,25,16,1580,1567,2032,465
2017,5,25,17,1649,1605,2049,444
2017,5,25,18,1693,1647,2141,494
2017,5,25,19,1733,1693,2176,483
2017,5,25,20,1782,1750,2202,452
2017,5,25,21,1809,1786,2223,437
2017,5,25,22,1813,1800,2216,416
2017,5,25,23,1840,1825,2185,360
2017,5,26,0,1828,1821,2203,382
2017,5,26,1,1794,1786,2168,382
2017,5,26,2,1775,1754,2100,346
2017,5,26,3,1797,1781,2174,393
2017,5,26,4,1748,1720,2196,476
2017,5,26,5,1625,1582,2090,508
2017,5,26,6,1490,1441,2117,676
2017,5,26,7,1391,1349,2122,773
2017,5,26,8,1348,1284,2096,812
2017,5,26,9,1294,1255,2023,768
2017,5,26,10,1269,1236,1931,695
2017,5,26,11,1272,1240,1953,713
2017,5,26,12,1328,1279,1977,698
2017,5,26,13,1369,1320,1996,676
2017,5,26,14,1434,1395,1896,501
2017,5,26,15,1457,1446,1921,475
2017,5,26,16,1488,1486,1971,485
2017,5,26,17,1544,1547,1982,435
2017,5,26,18,1592,1584,1988,404
2017,5,26,19,1607,1607,2024,417
2017,5,26,20,1678,1652,2070,418
2017,5,26,21,1729,1697,2097,400
2017,5,26,22,1752,1756,2152,396
2017,5,26,23,1788,1781,2161,380
2017,5,27,0,1793,1784,2210,426
2017,5,27,1,1757,1759,2174,415
2017,5,27,2,1737,1714,2153,439
2017,5,27,3,1741,1733,2209,476
2017,5,27,4,1704,1694,2188,494
2017,5,27,5,1610,1570,2146,576
2017,5,27,6,1473,1434,2112,678
2017,5,27,7,1369,1346,2055,709
2017,5,27,8,1298,1280,1958,678
2017,5,27,9,1269,1244,1888,644
2017,5,27,10,1246,1221,1859,638
2017,5,27,11,1239,1220,1821,601
2017,5,27,12,1247,1229,1808,579
2017,5,27,13,1254,1225,1751,526
2017,5,27,14,1293,1276,1641,365
2017,5,27,15,1341,1336,1719,383
2017,5,27,16,1392,1375,1872,497
2017,5,27,17,1448,1418,1883,465
2017,5,27,18,1467,1451,1906,455
2017,5,27,19,1494,1483,1994,511
2017,5,27,20,1529,1517,2059,542
2017,5,27,21,1566,1572,2202,630
2017,5,27,22,1636,1607,2245,638
2017,5,27,23,1672,1655,2361,706
2017,5,28,0,1689,1679,2368,689
2017,5,28,1,1689,1676,2320,644
2017,5,28,2,1675,1645,2308,663
2017,5,28,3,1667,1659,2289,630
2017,5,28,4,1644,1617,2259,642
2017,5,28,5,1557,1500,2160,660
2017,5,28,6,1443,1394,2139,745
2017,5,28,7,1352,1302,2099,797
2017,5,28,8,1290,1237,1958,721
2017,5,28,9,1251,1208,1707,499
2017,5,28,10,1235,1187,1652,465
2017,5,28,11,1231,1175,1649,474
2017,5,28,12,1246,1177,1614,437
2017,5,28,13,1255,1184,1538,354
2017,5,28,14,1262,1227,1510,283
2017,5,28,15,1304,1281,1558,277
2017,5,28,16,1355,1323,1713,390
2017,5,28,17,1397,1361,1781,420
2017,5,28,18,1428,1395,1849,454
2017,5,28,19,1458,1435,1861,426
2017,5,28,20,1498,1475,1860,385
2017,5,28,21,1539,1517,2000,483
2017,5,28,22,1580,1563,2071,508
2017,5,28,23,1609,1611,2123,512
2017,5,29,0,1651,1657,2159,502
2017,5,29,1,1665,1651,2180,529
2017,5,29,2,1657,1631,2164,533
2017,5,29,3,1680,1656,2200,544
2017,5,29,4,1647,1632,2231,599
2017,5,29,5,1538,1523,2141,618
2017,5,29,6,1430,1410,2093,683
2017,5,29,7,1343,1325,2030,705
2017,5,29,8,1304,1264,1832,568
2017,5,29,9,1266,1230,1712,482
2017,5,29,10,1247,1213,1650,437
2017,5,29,11,1245,1218,1628,410
2017,5,29,12,1249,1234,1628,394
2017,5,29,13,1250,1229,1619,390
2017,5,29,14,1281,1266,1625,359
2017,5,29,15,1326,1316,1678,362
2017,5,29,16,1380,1368,1785,417
2017,5,29,17,1444,1441,1856,415
2017,5,29,18,1511,1496,1932,436
2017,5,29,19,1540,1551,2126,575
2017,5,29,20,1580,1590,2197,607
2017,5,29,21,1656,1636,2220,584
2017,5,29,22,1653,1631,2229,598
2017,5,29,23,1595,1585,2248,663
2017,5,30,0,1582,1570,2194,624
2017,5,30,1,1579,1561,2161,600
2017,5,30,2,1570,1548,2178,630
2017,5,30,3,1616,1607,2213,606
2017,5,30,4,1611,1592,2353,761
2017,5,30,5,1495,1474,2240,766
2017,5,30,6,1406,1361,2060,699
2017,5,30,7,1325,1218,1875,657
2017,5,30,8,1254,1230,1810,580
2017,5,30,9,1236,1227,1708,481
2017,5,30,10,1216,1208,1650,442
2017,5,30,11,1230,1219,1655,436
2017,5,30,12,1272,1268,1694,426
2017,5,30,13,1325,1314,1719,405
2017,5,30,14,1408,1383,1764,381
2017,5,30,15,1448,1426,1757,331
2017,5,30,16,1496,1478,1799,321
2017,5,30,17,1552,1545,1914,369
2017,5,30,18,1610,1587,2068,481
2017,5,30,19,1629,1637,2093,456
2017,5,30,20,1677,1682,2123,441
2017,5,30,21,1757,1742,2167,425
2017,5,30,22,1768,1772,2206,434
2017,5,30,23,1794,1801,2254,453
2017,5,31,0,1772,1766,2289,523
2017,5,31,1,1744,1733,2226,493
2017,5,31,2,1711,1694,2157,463
2017,5,31,3,1738,1732,2131,399
2017,5,31,4,1721,1698,2197,499
2017,5,31,5,1592,1567,2105,538
2017,5,31,6,1458,1440,2071,631
2017,5,31,7,1369,1349,1970,621
2017,5,31,8,1310,1283,1879,596
2017,5,31,9,1276,1248,1860,612
2017,5,31,10,1257,1230,1675,445
2017,5,31,11,1266,1244,1629,385
2017,5,31,12,1312,1300,1644,344
2017,5,31,13,1362,1349,1687,338
2017,5,31,14,1431,1406,1696,290
2017,5,31,15,1488,1464,1731,267
2017,5,31,16,1534,1510,1776,266
2017,5,31,17,1581,1554,1836,282
2017,5,31,18,1624,1611,1999,388
2017,5,31,19,1650,1646,2102,456
2017,5,31,20,1662,1661,2134,473
2017,5,31,21,1664,1656,2231,575
2017,5,31,22,1677,1663,2149,486
2017,5,31,23,1693,1674,2157,483
2017,6,1,0,1662,1644,2035,391
2017,6,1,1,1638,1612,1992,380
2017,6,1,2,1582,1560,1952,392
2017,6,1,3,1615,1608,2000,392
2017,6,1,4,1637,1614,2055,441
2017,6,1,5,1535,1503,1956,453
2017,6,1,6,1416,1382,1961,579
2017,6,1,7,1323,1306,1916,610
2017,6,1,8,1269,1260,1829,569
2017,6,1,9,1260,1240,1665,425
2017,6,1,10,1247,1231,1609,378
2017,6,1,11,1250,1237,1606,369
2017,6,1,12,1296,1287,1652,365
2017,6,1,13,1348,1335,1714,379
2017,6,1,14,1412,1406,1708,302
2017,6,1,15,1455,1453,1751,298
2017,6,1,16,1524,1502,1781,279
2017,6,1,17,1571,1547,1913,366
2017,6,1,18,1609,1599,2010,411
2017,6,1,19,1651,1644,2058,414
2017,6,1,20,1700,1695,2042,347
2017,6,1,21,1744,1733,2238,505
2017,6,1,22,1800,1789,2221,432
2017,6,1,23,1800,1789,2265,476
2017,6,2,0,1758,1741,2204,463
2017,6,2,1,1721,1701,2112,411
2017,6,2,2,1686,1665,2082,417
2017,6,2,3,1718,1707,2106,399
2017,6,2,4,1703,1677,2151,474
2017,6,2,5,1611,1556,1981,425
2017,6,2,6,1482,1420,1900,480
2017,6,2,7,1384,1340,1844,504
2017,6,2,8,1293,1282,1763,481
2017,6,2,9,1258,1247,1712,465
2017,6,2,10,1243,1227,1692,465
2017,6,2,11,1250,1240,1686,446
2017,6,2,12,1265,1292,1730,438
2017,6,2,13,1318,1341,1727,386
2017,6,2,14,1420,1412,1752,340
2017,6,2,15,1467,1466,1751,285
2017,6,2,16,1507,1527,1792,265
2017,6,2,17,1543,1571,1837,266
2017,6,2,18,1590,1612,1991,379
2017,6,2,19,1620,1652,2081,429
2017,6,2,20,1654,1698,2198,500
2017,6,2,21,1683,1729,2265,536
2017,6,2,22,1760,1724,2286,562
2017,6,2,23,1768,1682,2300,618
2017,6,3,0,1752,1640,2173,533
2017,6,3,1,1716,1591,2213,622
2017,6,3,2,1687,1551,2064,513
2017,6,3,3,1713,1618,2168,550
2017,6,3,4,1690,1614,2202,588
2017,6,3,5,1605,1540,2143,603
2017,6,3,6,1476,1442,2043,601
2017,6,3,7,1379,1372,1979,607
2017,6,3,8,1332,1314,1928,614
2017,6,3,9,1292,1283,1863,580
2017,6,3,10,1268,1259,1808,549
2017,6,3,11,1254,1251,1786,535
2017,6,3,12,1266,1259,1773,514
2017,6,3,13,1273,1257,1726,469
2017,6,3,14,1327,1316,1682,366
2017,6,3,15,1394,1387,1729,342
2017,6,3,16,1456,1447,1933,486
2017,6,3,17,1508,1498,2028,530
2017,6,3,18,1558,1555,2072,517
2017,6,3,19,1603,1617,2144,527
2017,6,3,20,1637,1649,2181,532
2017,6,3,21,1711,1691,2237,546
2017,6,3,22,1745,1743,2290,547
2017,6,3,23,1762,1781,2391,610
2017,6,4,0,1768,1797,2380,583
2017,6,4,1,1772,1796,2366,570
2017,6,4,2,1740,1770,2286,516
2017,6,4,3,1747,1782,2296,514
2017,6,4,4,1717,1750,2307,557
2017,6,4,5,1624,1642,2245,603
2017,6,4,6,1507,1526,2085,559
2017,6,4,7,1405,1429,2001,572
2017,6,4,8,1337,1361,1866,505
2017,6,4,9,1288,1307,1807,500
2017,6,4,10,1260,1283,1727,444
2017,6,4,11,1254,1272,1747,475
2017,6,4,12,1261,1273,1743,470
2017,6,4,13,1285,1251,1692,441
2017,6,4,14,1320,1303,1617,314
2017,6,4,15,1396,1364,1704,340
2017,6,4,16,1472,1444,1851,407
2017,6,4,17,1537,1530,2041,511
2017,6,4,18,1603,1604,2095,491
2017,6,4,19,1675,1675,2134,459
2017,6,4,20,1763,1742,2214,472
2017,6,4,21,1820,1804,2228,424
2017,6,4,22,1880,1852,2349,497
2017,6,4,23,1920,1899,2392,493
2017,6,5,0,1949,1942,2434,492
2017,6,5,1,1936,1952,2400,448
2017,6,5,2,1903,1924,2368,444
2017,6,5,3,1883,1907,2380,473
2017,6,5,4,1825,1863,2371,508
2017,6,5,5,1715,1708,2209,501
2017,6,5,6,1573,1555,2133,578
2017,6,5,7,1463,1458,2035,577
2017,6,5,8,1412,1393,1971,578
2017,6,5,9,1370,1354,1920,566
2017,6,5,10,1346,1330,1871,541
2017,6,5,11,1338,1326,1837,511
2017,6,5,12,1378,1368,1820,452
2017,6,5,13,1429,1416,1850,434
2017,6,5,14,1519,1513,1895,382
2017,6,5,15,1595,1593,1924,331
2017,6,5,16,1705,1680,1989,309
2017,6,5,17,1777,1777,2053,276
2017,6,5,18,1869,1862,2176,314
2017,6,5,19,1937,1940,2328,388
2017,6,5,20,2025,2029,2456,427
2017,6,5,21,2092,2087,2426,339
2017,6,5,22,2109,2105,2473,368
2017,6,5,23,2143,2144,2501,357
2017,6,6,0,2150,2144,2572,428
2017,6,6,1,2095,2086,2575,489
2017,6,6,2,2025,2008,2528,520
2017,6,6,3,2013,2002,2608,606
2017,6,6,4,1929,1904,2539,635
2017,6,6,5,1770,1754,2408,654
2017,6,6,6,1630,1601,2321,720
2017,6,6,7,1516,1500,2155,655
2017,6,6,8,1460,1432,2045,613
2017,6,6,9,1413,1392,1978,586
2017,6,6,10,1381,1364,1916,552
2017,6,6,11,1382,1362,1891,529
2017,6,6,12,1340,1314,1842,528
2017,6,6,13,1431,1394,1861,467
2017,6,6,14,1561,1527,1966,439
2017,6,6,15,1619,1609,1985,376
2017,6,6,16,1711,1692,2070,378
2017,6,6,17,1802,1799,2243,444
2017,6,6,18,1884,1868,2311,443
2017,6,6,19,1968,1951,2372,421
2017,6,6,20,2048,2036,2465,429
2017,6,6,21,2070,2049,2533,484
2017,6,6,22,2021,2000,2497,497
2017,6,6,23,2018,1980,2517,537
2017,6,7,0,2001,1953,2522,569
2017,6,7,1,1959,1944,2425,481
2017,6,7,2,1941,1890,2351,461
2017,6,7,3,1931,1897,2377,480
2017,6,7,4,1861,1853,2366,513
2017,6,7,5,1729,1691,2305,614
2017,6,7,6,1607,1549,2159,610
2017,6,7,7,1504,1447,2019,572
2017,6,7,8,1486,1480,2024,544
2017,6,7,9,1388,1341,1976,635
2017,6,7,10,1356,1321,1902,581
2017,6,7,11,1356,1321,1836,515
2017,6,7,12,1393,1361,1904,543
2017,6,7,13,1440,1401,1927,526
2017,6,7,14,1527,1488,1977,489
2017,6,7,15,1600,1560,1993,433
2017,6,7,16,1695,1637,2109,472
2017,6,7,17,1765,1724,2207,483
2017,6,7,18,1854,1808,2368,560
2017,6,7,19,1924,1881,2472,591
2017,6,7,20,1983,1932,2492,560
2017,6,7,21,2084,2024,2495,471
2017,6,7,22,2143,2080,2523,443
2017,6,7,23,2149,2047,2440,393
2017,6,8,0,2089,1945,2043,98
2017,6,8,1,1974,1880,2070,190
2017,6,8,2,1948,1847,1967,120
2017,6,8,3,1940,1899,2039,140
2017,6,8,4,1888,1847,2038,191
2017,6,8,5,1746,1681,1969,288
2017,6,8,6,1597,1535,1892,357
2017,6,8,7,1486,1420,1840,420
2017,6,8,8,1430,1397,1821,424
2017,6,8,9,1375,1336,1771,435
2017,6,8,10,1347,1310,1716,406
2017,6,8,11,1347,1302,1730,428
2017,6,8,12,1376,1355,1767,412
2017,6,8,13,1443,1386,1799,413
2017,6,8,14,1506,1464,1831,367
2017,6,8,15,1581,1545,1852,307
2017,6,8,16,1663,1619,1912,293
2017,6,8,17,1750,1706,2033,327
2017,6,8,18,1836,1775,2174,399
2017,6,8,19,1915,1851,2236,385
2017,6,8,20,1975,1938,2325,387
2017,6,8,21,2063,2018,2423,405
2017,6,8,22,2127,2089,2462,373
2017,6,8,23,2153,2140,2459,319
2017,6,9,0,2168,2138,2463,325
2017,6,9,1,2120,2087,2456,369
2017,6,9,2,2085,2026,2454,428
2017,6,9,3,2060,2022,2506,484
2017,6,9,4,1982,1942,2386,444
2017,6,9,5,1826,1770,2195,425
2017,6,9,6,1662,1608,2110,502
2017,6,9,7,1539,1487,1858,371
2017,6,9,8,1442,1413,1609,196
2017,6,9,9,1392,1367,1514,147
2017,6,9,10,1357,1332,1497,165
2017,6,9,11,1343,1324,1509,185
2017,6,9,12,1371,1359,1475,116
2017,6,9,13,1406,1393,1534,141
2017,6,9,14,1485,1482,1558,76
2017,6,9,15,1567,1566,1607,41
2017,6,9,16,1652,1657,1713,56
2017,6,9,17,1754,1745,1783,38
2017,6,9,18,1842,1827,1914,87
2017,6,9,19,1903,1901,2025,124
2017,6,9,20,1994,1982,2031,49
2017,6,9,21,2071,2060,2114,54
2017,6,9,22,2149,2124,2150,26
2017,6,9,23,2196,2177,2191,14
2017,6,10,0,2205,2185,2191,6
2017,6,10,1,2138,2138,2170,32
2017,6,10,2,2066,2068,2112,44
2017,6,10,3,2051,2035,2130,95
2017,6,10,4,1999,1970,2185,215
2017,6,10,5,1872,1810,2043,233
2017,6,10,6,1712,1657,2077,420
2017,6,10,7,1584,1534,1994,460
2017,6,10,8,1474,1447,1935,488
2017,6,10,9,1419,1384,1953,569
2017,6,10,10,1379,1348,1928,580
2017,6,10,11,1356,1329,1844,515
2017,6,10,12,1353,1322,1734,412
2017,6,10,13,1340,1313,1710,397
2017,6,10,14,1404,1391,1669,278
2017,6,10,15,1504,1480,1736,256
2017,6,10,16,1609,1568,1857,289
2017,6,10,17,1707,1660,1993,333
2017,6,10,18,1794,1743,2072,329
2017,6,10,19,1864,1828,2249,421
2017,6,10,20,1946,1917,2327,410
2017,6,10,21,2022,1993,2368,375
2017,6,10,22,2084,2063,2431,368
2017,6,10,23,2151,2111,2436,325
2017,6,11,0,2132,2119,2477,358
2017,6,11,1,2112,2103,2475,372
2017,6,11,2,2058,2040,2365,325
2017,6,11,3,2028,2011,2393,382
2017,6,11,4,1969,1950,2455,505
2017,6,11,5,1826,1783,2417,634
2017,6,11,6,1701,1582,2222,640
2017,6,11,7,1579,1410,2064,654
2017,6,11,8,1387,1346,1852,506
2017,6,11,9,1349,1313,1797,484
2017,6,11,10,1319,1287,1735,448
2017,6,11,11,1300,1272,1752,480
2017,6,11,12,1290,1267,1726,459
2017,6,11,13,1274,1245,1625,380
2017,6,11,14,1319,1301,1589,288
2017,6,11,15,1406,1383,1671,288
2017,6,11,16,1493,1468,1801,333
2017,6,11,17,1597,1554,1871,317
2017,6,11,18,1672,1622,2076,454
2017,6,11,19,1760,1700,2129,429
2017,6,11,20,1818,1759,2185,426
2017,6,11,21,1882,1824,2329,505
2017,6,11,22,1952,1896,2384,488
2017,6,11,23,2021,1965,2400,435
2017,6,12,0,2062,2008,2388,380
2017,6,12,1,2049,2017,2358,341
2017,6,12,2,2015,1988,2403,415
2017,6,12,3,1965,1949,2462,513
2017,6,12,4,1907,1880,2471,591
2017,6,12,5,1753,1707,2407,700
2017,6,12,6,1610,1551,2253,702
2017,6,12,7,1483,1432,2091,659
2017,6,12,8,1386,1358,1944,586
2017,6,12,9,1336,1313,1887,574
2017,6,12,10,1312,1284,1867,583
2017,6,12,11,1310,1288,1844,556
2017,6,12,12,1342,1327,1810,483
2017,6,12,13,1384,1368,1856,488
2017,6,12,14,1475,1460,1856,396
2017,6,12,15,1549,1530,1862,332
2017,6,12,16,1626,1611,1894,283
2017,6,12,17,1706,1695,2044,349
2017,6,12,18,1780,1763,2221,458
2017,6,12,19,1842,1817,2303,486
2017,6,12,20,1923,1900,2388,488
2017,6,12,21,1997,1974,2503,529
2017,6,12,22,2083,2058,2489,431
2017,6,12,23,2136,2126,2572,446
2017,6,13,0,2155,2152,2633,481
2017,6,13,1,2126,2123,2594,471
2017,6,13,2,2068,2060,2540,480
2017,6,13,3,2024,2021,2495,474
2017,6,13,4,1952,1942,2517,575
2017,6,13,5,1789,1759,2361,602
2017,6,13,6,1623,1575,2164,589
2017,6,13,7,1499,1462,2095,633
2017,6,13,8,1400,1389,2089,700
2017,6,13,9,1351,1341,1958,617
2017,6,13,10,1327,1312,1866,554
2017,6,13,11,1316,1305,1854,549
2017,6,13,12,1351,1339,1882,543
2017,6,13,13,1406,1391,1919,528
2017,6,13,14,1481,1475,1953,478
2017,6,13,15,1558,1542,2014,472
2017,6,13,16,1622,1609,2008,399
2017,6,13,17,1652,1631,2043,412
2017,6,13,18,1702,1676,2155,479
2017,6,13,19,1770,1747,2253,506
2017,6,13,20,1830,1806,2163,357
2017,6,13,21,1889,1871,2204,333
2017,6,13,22,1947,1926,2238,312
2017,6,13,23,1985,1972,2307,335
2017,6,14,0,2003,1981,2382,401
2017,6,14,1,1978,1961,2352,391
2017,6,14,2,1929,1909,2261,352
2017,6,14,3,1909,1886,2176,290
2017,6,14,4,1845,1815,2219,404
2017,6,14,5,1694,1642,2135,493
2017,6,14,6,1540,1483,2069,586
2017,6,14,7,1432,1381,2014,633
2017,6,14,8,1345,1307,1932,625
2017,6,14,9,1299,1262,1833,571
2017,6,14,10,1275,1239,1789,550
2017,6,14,11,1281,1236,1819,583
2017,6,14,12,1319,1291,1815,524
2017,6,14,13,1365,1332,1784,452
2017,6,14,14,1438,1417,1958,541
2017,6,14,15,1492,1465,1919,454
2017,6,14,16,1553,1525,1958,433
2017,6,14,17,1640,1609,2029,420
2017,6,14,18,1720,1693,2224,531
2017,6,14,19,1789,1766,2314,548
2017,6,14,20,1863,1843,2428,585
2017,6,14,21,1953,1936,2514,578
2017,6,14,22,2024,2013,2641,628
2017,6,14,23,2081,2070,2694,624
2017,6,15,0,2131,2098,2637,539
2017,6,15,1,2116,2080,2616,536
2017,6,15,2,2055,2015,2520,505
2017,6,15,3,1995,1977,2437,460
2017,6,15,4,1923,1892,2374,482
2017,6,15,5,1751,1700,2212,512
2017,6,15,6,1585,1531,2079,548
2017,6,15,7,1463,1418,2014,596
2017,6,15,8,1383,1347,1950,603
2017,6,15,9,1334,1303,1891,588
2017,6,15,10,1304,1270,1844,574
2017,6,15,11,1302,1269,1795,526
2017,6,15,12,1339,1314,1832,518
2017,6,15,13,1374,1350,1843,493
2017,6,15,14,1454,1444,1899,455
2017,6,15,15,1519,1514,1901,387
2017,6,15,16,1617,1611,1987,376
2017,6,15,17,1710,1721,2156,435
2017,6,15,18,1797,1806,2311,505
2017,6,15,19,1892,1910,2540,630
2017,6,15,20,1983,1992,2683,691
2017,6,15,21,2066,2082,2683,601
2017,6,15,22,2169,2160,2808,648
2017,6,15,23,2225,2216,2834,618
2017,6,16,0,2201,2219,2773,554
2017,6,16,1,2187,2206,2793,587
2017,6,16,2,2134,2146,2685,539
2017,6,16,3,2083,2095,2579,484
2017,6,16,4,1993,1989,2572,583
2017,6,16,5,1816,1793,2460,667
2017,6,16,6,1639,1611,2375,764
2017,6,16,7,1507,1492,2215,723
2017,6,16,8,1418,1407,2081,674
2017,6,16,9,1359,1349,2026,677
2017,6,16,10,1321,1312,1963,651
2017,6,16,11,1314,1307,1974,667
2017,6,16,12,1339,1339,1997,658
2017,6,16,13,1384,1382,2036,654
2017,6,16,14,1453,1458,2008,550
2017,6,16,15,1544,1550,2004,454
2017,6,16,16,1665,1645,2123,478
2017,6,16,17,1738,1926,2441,515
2017,6,16,18,1839,1861,2392,531
2017,6,16,19,1940,1955,2558,603
2017,6,16,20,2042,2062,2620,558
2017,6,16,21,2121,2142,2742,600
2017,6,16,22,2208,2223,2685,462
2017,6,16,23,2268,2279,2717,438
2017,6,17,0,2265,2299,2741,442
2017,6,17,1,2219,2255,2693,438
2017,6,17,2,2144,2181,2658,477
2017,6,17,3,2092,2114,2579,465
2017,6,17,4,2023,2023,2564,541
2017,6,17,5,1877,1841,2430,589
2017,6,17,6,1699,1650,2369,719
2017,6,17,7,1563,1540,2222,682
2017,6,17,8,1454,1443,2062,619
2017,6,17,9,1396,1389,2082,693
2017,6,17,10,1354,1347,2056,709
2017,6,17,11,1329,1328,1996,668
2017,6,17,12,1333,1335,2017,682
2017,6,17,13,1325,1321,1970,649
2017,6,17,14,1387,1393,1879,486
2017,6,17,15,1492,1498,1887,389
2017,6,17,16,1617,1609,2037,428
2017,6,17,17,1734,1724,2246,522
2017,6,17,18,1840,1839,2255,416
2017,6,17,19,1977,1943,2100,157
2017,6,17,20,2056,2051,2178,127
2017,6,17,21,2158,2148,2284,136
2017,6,17,22,2229,2221,2455,234
2017,6,17,23,2318,2283,2508,225
2017,6,18,0,2343,2321,2557,236
2017,6,18,1,2323,2304,2560,256
2017,6,18,2,2251,2248,2565,317
2017,6,18,3,2171,2173,2580,407
2017,6,18,4,2100,2085,2592,507
2017,6,18,5,1947,1909,2523,614
2017,6,18,6,1769,1736,2410,674
2017,6,18,7,1627,1607,2288,681
2017,6,18,8,1548,1519,2148,629
2017,6,18,9,1478,1453,2127,674
2017,6,18,10,1431,1403,2172,769
2017,6,18,11,1408,1382,2144,762
2017,6,18,12,1404,1376,2127,751
2017,6,18,13,1391,1365,2048,683
2017,6,18,14,1446,1432,2086,654
2017,6,18,15,1548,1533,2104,571
2017,6,18,16,1650,1639,2246,607
2017,6,18,17,1755,1743,2335,592
2017,6,18,18,1882,1842,2419,577
2017,6,18,19,1942,1922,2476,554
2017,6,18,20,2038,2012,2484,472
2017,6,18,21,2115,2090,2579,489
2017,6,18,22,2187,2161,2690,529
2017,6,18,23,2225,2233,2703,470
2017,6,19,0,2287,2261,2703,442
2017,6,19,1,2300,2210,2660,450
2017,6,19,2,2272,2222,2724,502
2017,6,19,3,2235,2172,2659,487
2017,6,19,4,2190,2116,2651,535
2017,6,19,5,2002,1960,2497,537
2017,6,19,6,1822,1789,2302,513
2017,6,19,7,1683,1650,2292,642
2017,6,19,8,1593,1558,2204,646
2017,6,19,9,1525,1495,2139,644
2017,6,19,10,1475,1449,2067,618
2017,6,19,11,1464,1440,2071,631
2017,6,19,12,1492,1470,2057,587
2017,6,19,13,1543,1522,1995,473
2017,6,19,14,1653,1649,2111,462
2017,6,19,15,1786,1767,2186,419
2017,6,19,16,1896,1879,2235,356
2017,6,19,17,2020,2003,2374,371
2017,6,19,18,2102,2109,2546,437
2017,6,19,19,2203,2210,2646,436
2017,6,19,20,2295,2296,2670,374
2017,6,19,21,2375,2434,2742,308
2017,6,19,22,2431,2358,2626,268
2017,6,19,23,2468,2424,2869,445
2017,6,20,0,2439,2421,2843,422
2017,6,20,1,2363,2360,2796,436
2017,6,20,2,2333,2304,2811,507
2017,6,20,3,2289,2315,2772,457
2017,6,20,4,2205,2245,2778,533
2017,6,20,5,2015,2066,2514,448
2017,6,20,6,1814,1861,2352,491
2017,6,20,7,1673,1747,2221,474
2017,6,20,8,1759,1650,2109,459
2017,6,20,9,1599,1583,2112,529
2017,6,20,10,1558,1546,2089,543
2017,6,20,11,1529,1515,2053,538
2017,6,20,12,1559,1558,2086,528
2017,6,20,13,1609,1601,2136,535
2017,6,20,14,1723,1729,2156,427
2017,6,20,15,1847,1856,2194,338
2017,6,20,16,1968,1978,2351,373
2017,6,20,17,2061,2102,2489,387
2017,6,20,18,2174,2199,2567,368
2017,6,20,19,2275,2284,2550,266
2017,6,20,20,2368,2357,2554,197
2017,6,20,21,2447,2397,2627,230
2017,6,20,22,2477,2451,2658,207
2017,6,20,23,2568,2487,2780,293
2017,6,21,0,2542,2480,2759,279
2017,6,21,1,2489,2464,2734,270
2017,6,21,2,2407,2408,2659,251
2017,6,21,3,2374,2365,2675,310
2017,6,21,4,2259,2290,2658,368
2017,6,21,5,2086,2070,2474,404
2017,6,21,6,1923,1873,2310,437
2017,6,21,7,1782,1737,2319,582
2017,6,21,8,1680,1657,2234,577
2017,6,21,9,1608,1589,2130,541
2017,6,21,10,1562,1547,2075,528
2017,6,21,11,1538,1530,2038,508
2017,6,21,12,1566,1557,2027,470
2017,6,21,13,1614,1603,1964,361
2017,6,21,14,1721,1725,1968,243
2017,6,21,15,1851,1841,2061,220
2017,6,21,16,1961,1963,2295,332
2017,6,21,17,2100,2079,2410,331
2017,6,21,18,2208,2191,2444,253
2017,6,21,19,2315,2299,2498,199
2017,6,21,20,2430,2410,2342,-68
2017,6,21,21,2524,2500,2405,-95
2017,6,21,22,2596,2571,2462,-109
2017,6,21,23,2570,2541,2426,-115
2017,6,22,0,2563,2476,2378,-98
2017,6,22,1,2514,2428,2438,10
2017,6,22,2,2393,2370,2379,9
2017,6,22,3,2416,2373,2409,36
2017,6,22,4,2309,2294,2477,183
2017,6,22,5,2105,2086,2363,277
2017,6,22,6,1914,1887,2261,374
2017,6,22,7,1786,1755,2137,382
2017,6,22,8,1673,1659,2078,419
2017,6,22,9,1603,1593,2061,468
2017,6,22,10,1559,1561,2060,499
2017,6,22,11,1554,1552,2106,554
2017,6,22,12,1585,1603,2076,473
2017,6,22,13,1650,1618,1975,357
2017,6,22,14,1732,1729,1965,236
2017,6,22,15,1861,1833,2041,208
2017,6,22,16,2015,1954,2211,257
2017,6,22,17,2144,2079,2343,264
2017,6,22,18,2266,2188,2414,226
2017,6,22,19,2353,2298,2478,180
2017,6,22,20,2459,2414,2493,79
2017,6,22,21,2526,2469,2475,6
2017,6,22,22,2567,2531,2586,55
2017,6,22,23,2596,2553,2585,32
2017,6,23,0,2568,2539,2549,10
2017,6,23,1,2506,2493,2525,32
2017,6,23,2,2504,2420,2389,-31
2017,6,23,3,2483,2383,2301,-82
2017,6,23,4,2354,2273,2300,27
2017,6,23,5,2158,2051,2246,195
2017,6,23,6,1957,1854,2208,354
2017,6,23,7,1808,1714,2102,388
2017,6,23,8,1634,1619,2114,495
2017,6,23,9,1549,1529,2049,520
2017,6,23,10,1497,1473,2020,547
2017,6,23,11,1488,1477,2008,531
2017,6,23,12,1512,1501,2034,533
2017,6,23,13,1552,1535,2005,470
2017,6,23,14,1631,1628,2173,545
2017,6,23,15,1718,1718,2246,528
2017,6,23,16,1824,1813,2232,419
2017,6,23,17,1937,1916,2355,439
2017,6,23,18,2046,2029,2487,458
2017,6,23,19,2166,2148,2499,351
2017,6,23,20,2288,2268,2536,268
2017,6,23,21,2367,2358,2705,347
2017,6,23,22,2428,2424,2728,304
2017,6,23,23,2467,2458,2753,295
2017,6,24,0,2479,2445,2779,334
2017,6,24,1,2407,2374,2790,416
2017,6,24,2,2307,2283,2679,396
2017,6,24,3,2236,2232,2570,338
2017,6,24,4,2170,2160,2640,480
2017,6,24,5,2027,1995,2511,516
2017,6,24,6,1854,1824,2313,489
2017,6,24,7,1728,1699,2277,578
2017,6,24,8,1617,1604,2231,627
2017,6,24,9,1552,1549,2218,669
2017,6,24,10,1515,1510,2221,711
2017,6,24,11,1486,1480,2130,650
2017,6,24,12,1461,1477,2132,655
2017,6,24,13,1458,1471,2119,648
2017,6,24,14,1513,1541,2184,643
2017,6,24,15,1607,1640,2250,610
2017,6,24,16,1709,1742,2247,505
2017,6,24,17,1798,1823,2326,503
2017,6,24,18,1874,1891,2341,450
2017,6,24,19,1942,1962,2376,414
2017,6,24,20,2027,2040,2386,346
2017,6,24,21,2092,2107,2407,300
2017,6,24,22,2156,2165,2466,301
2017,6,24,23,2192,2195,2496,301
2017,6,25,0,2179,2130,2451,321
2017,6,25,1,2166,2100,2433,333
2017,6,25,2,2103,2021,2404,383
2017,6,25,3,2006,1947,2346,399
2017,6,25,4,1950,1905,2304,399
2017,6,25,5,1838,1776,2122,346
2017,6,25,6,1695,1631,1735,104
2017,6,25,7,1586,1534,1612,78
2017,6,25,8,1482,1464,1523,59
2017,6,25,9,1426,1413,1450,37
2017,6,25,10,1390,1384,1458,74
2017,6,25,11,1375,1367,1414,47
2017,6,25,12,1373,1368,1393,25
2017,6,25,13,1366,1351,1343,-8
2017,6,25,14,1418,1416,1353,-63
2017,6,25,15,1511,1511,1386,-125
2017,6,25,16,1606,1616,1479,-137
2017,6,25,17,1694,1707,1691,-16
2017,6,25,18,1791,1804,1718,-86
2017,6,25,19,1878,1894,1783,-111
2017,6,25,20,1981,1978,1837,-141
2017,6,25,21,2049,2064,2025,-39
2017,6,25,22,2093,2105,2209,104
2017,6,25,23,2060,2066,2265,199
2017,6,26,0,2022,1955,2256,301
2017,6,26,1,1973,1868,2129,261
2017,6,26,2,1949,1806,2054,248
2017,6,26,3,1910,1808,2201,393
2017,6,26,4,1857,1798,2260,462
2017,6,26,5,1740,1689,2076,387
2017,6,26,6,1605,1556,1961,405
2017,6,26,7,1501,1455,1826,371
2017,6,26,8,1424,1389,1859,470
2017,6,26,9,1380,1352,1780,428
2017,6,26,10,1351,1333,1517,184
2017,6,26,11,1349,1339,1417,78
2017,6,26,12,1393,1392,1396,4
2017,6,26,13,1449,1454,1395,-59
2017,6,26,14,1531,1544,1454,-90
2017,6,26,15,1676,1593,1441,-152
2017,6,26,16,1713,1717,1623,-94
2017,6,26,17,1804,1826,1689,-137
2017,6,26,18,1891,1898,1760,-138
2017,6,26,19,1979,1970,1887,-83
2017,6,26,20,2052,2050,1900,-150
2017,6,26,21,2124,2122,1914,-208
2017,6,26,22,2175,2186,1926,-260
2017,6,26,23,2300,2221,1921,-300
2017,6,27,0,2281,2192,1924,-268
2017,6,27,1,2137,2063,1813,-250
2017,6,27,2,2029,1988,1822,-166
2017,6,27,3,2011,1942,1785,-157
2017,6,27,4,1962,1887,1831,-56
2017,6,27,5,1804,1736,1771,35
2017,6,27,6,1637,1582,1676,94
2017,6,27,7,1519,1479,1571,92
2017,6,27,8,1454,1408,1558,150
2017,6,27,9,1409,1370,1566,196
2017,6,27,10,1382,1352,1536,184
2017,6,27,11,1380,1347,1492,145
2017,6,27,12,1415,1386,1574,188
2017,6,27,13,1475,1436,1621,185
2017,6,27,14,1565,1525,1600,75
2017,6,27,15,1575,1592,1660,68
2017,6,27,16,1702,1683,1785,102
2017,6,27,17,1799,1772,1830,58
2017,6,27,18,1900,1851,1938,87
2017,6,27,19,1957,1960,2001,41
2017,6,27,20,2079,2059,1890,-169
2017,6,27,21,2171,2182,1923,-259
2017,6,27,22,2242,2213,1916,-297
2017,6,27,23,2298,2240,2060,-180
2017,6,28,0,2304,2239,2120,-119
2017,6,28,1,2238,2181,2099,-82
2017,6,28,2,2184,2079,2107,28
2017,6,28,3,2133,2046,2106,60
2017,6,28,4,2065,1997,2180,183
2017,6,28,5,1885,1827,2203,376
2017,6,28,6,1702,1655,2139,484
2017,6,28,7,1575,1467,1905,438
2017,6,28,8,1510,1469,1965,496
2017,6,28,9,1454,1418,1911,493
2017,6,28,10,1414,1383,1831,448
2017,6,28,11,1406,1378,1844,466
2017,6,28,12,1441,1401,1875,474
2017,6,28,13,1497,1440,1811,371
2017,6,28,14,1552,1530,1784,254
2017,6,28,15,1646,1608,1790,182
2017,6,28,16,1746,1687,1813,126
2017,6,28,17,1842,1767,2024,257
2017,6,28,18,1943,1857,2106,249
2017,6,28,19,2032,1917,2151,234
2017,6,28,20,2166,2045,2249,204
2017,6,28,21,2203,2141,2312,171
2017,6,28,22,2270,2222,2376,154
2017,6,28,23,2323,2274,2466,192
2017,6,29,0,2327,2284,2446,162
2017,6,29,1,2308,2248,2431,183
2017,6,29,2,2237,2186,2321,135
2017,6,29,3,2200,2125,2126,1
2017,6,29,4,2128,2037,2145,108
2017,6,29,5,1946,1858,2060,202
2017,6,29,6,1762,1677,1987,310
2017,6,29,7,1627,1545,1966,421
2017,6,29,8,1519,1482,1818,336
2017,6,29,9,1460,1431,1752,321
2017,6,29,10,1429,1399,1762,363
2017,6,29,11,1409,1391,1757,366
2017,6,29,12,1438,1429,1785,356
2017,6,29,13,1481,1471,1823,352
2017,6,29,14,1562,1555,1876,321
2017,6,29,15,1653,1647,1977,330
2017,6,29,16,1775,1753,2075,322
2017,6,29,17,1887,1858,2212,354
2017,6,29,18,1996,2000,2301,301
2017,6,29,19,2103,2060,2268,208
2017,6,29,20,2200,2154,2229,75
2017,6,29,21,2280,2244,2264,20
2017,6,29,22,2339,2321,2362,41
2017,6,29,23,2393,2374,2398,24
2017,6,30,0,2378,2377,2366,-11
2017,6,30,1,2323,2341,2337,-4
2017,6,30,2,2244,2268,2244,-24
2017,6,30,3,2194,2204,2226,22
2017,6,30,4,2126,2109,2158,49
2017,6,30,5,1961,1907,1964,57
2017,6,30,6,1779,1712,1932,220
2017,6,30,7,1643,1579,1781,202
2017,6,30,8,1517,1491,1710,219
2017,6,30,9,1459,1434,1676,242
2017,6,30,10,1412,1391,1699,308
2017,6,30,11,1407,1387,1700,313
2017,6,30,12,1428,1417,1715,298
2017,6,30,13,1461,1445,1694,249
2017,6,30,14,1542,1539,1676,137
2017,6,30,15,1631,1629,1865,236
2017,6,30,16,1732,1720,1963,243
2017,6,30,17,1861,1832,2048,216
2017,6,30,18,1963,1940,2126,186
2017,6,30,19,2031,2027,2121,94
2017,6,30,20,2127,2117,2058,-59
2017,6,30,21,2206,2199,2125,-74
2017,6,30,22,2268,2267,2148,-119
2017,6,30,23,2323,2303,2198,-105
2017,7,1,0,2311,2294,2159,-135
2017,7,1,1,2251,2240,2095,-145
2017,7,1,2,2169,2170,2073,-97
2017,7,1,3,2120,2141,2155,14
2017,7,1,4,2065,2090,2263,173
2017,7,1,5,1948,1921,2163,242
2017,7,1,6,1772,1767,2145,378
2017,7,1,7,1641,1646,2038,392
2017,7,1,8,1570,1562,2077,515
2017,7,1,9,1505,1500,2147,647
2017,7,1,10,1460,1458,2146,688
2017,7,1,11,1440,1437,2088,651
2017,7,1,12,1432,1433,2066,633
2017,7,1,13,1424,1419,1971,552
2017,7,1,14,1439,1458,1979,521
2017,7,1,15,1514,1533,2060,527
2017,7,1,16,1672,1683,2204,521
2017,7,1,17,1790,1778,2310,532
2017,7,1,18,1867,1856,2395,539
2017,7,1,19,1952,1936,2439,503
2017,7,1,20,2022,2010,2472,462
2017,7,1,21,2097,2072,2501,429
2017,7,1,22,2178,2143,2490,347
2017,7,1,23,2218,2184,2505,321
2017,7,2,0,2210,2122,2498,376
2017,7,2,1,2176,2015,2435,420
2017,7,2,2,2119,1963,2329,366
2017,7,2,3,1962,1939,2421,482
2017,7,2,4,1909,1900,2484,584
2017,7,2,5,1817,1772,2280,508
2017,7,2,6,1680,1640,2194,554
2017,7,2,7,1560,1539,2019,480
2017,7,2,8,1488,1461,2098,637
2017,7,2,9,1429,1401,2091,690
2017,7,2,10,1434,1410,2092,682
2017,7,2,11,1363,1346,2077,731
2017,7,2,12,1369,1350,2060,710
2017,7,2,13,1344,1328,2077,749
2017,7,2,14,1382,1383,2089,706
2017,7,2,15,1472,1470,2152,682
2017,7,2,16,1583,1576,2175,599
2017,7,2,17,1683,1673,2278,605
2017,7,2,18,1790,1770,2391,621
2017,7,2,19,1887,1873,2450,577
2017,7,2,20,1990,1975,2545,570
2017,7,2,21,2066,2053,2604,551
2017,7,2,22,2143,2125,2641,516
2017,7,2,23,2185,2166,2619,453
2017,7,3,0,2203,2182,2657,475
2017,7,3,1,2174,2136,2587,451
2017,7,3,2,2116,2051,2512,461
2017,7,3,3,2058,2020,2367,347
2017,7,3,4,1982,1974,2382,408
2017,7,3,5,1854,1817,2252,435
2017,7,3,6,1693,1684,2147,463
2017,7,3,7,1574,1531,2050,519
2017,7,3,8,1525,1458,2059,601
2017,7,3,9,1447,1417,2010,593
2017,7,3,10,1409,1391,1953,562
2017,7,3,11,1399,1390,1890,500
2017,7,3,12,1406,1420,1853,433
2017,7,3,13,1417,1444,1884,440
2017,7,3,14,1507,1533,1870,337
2017,7,3,15,1600,1633,2076,443
2017,7,3,16,1716,1740,2218,478
2017,7,3,17,1831,1854,2363,509
2017,7,3,18,1938,1972,2429,457
2017,7,3,19,2037,2076,2502,426
2017,7,3,20,2133,2157,2583,426
2017,7,3,21,2223,2187,2493,306
2017,7,3,22,2295,2248,2533,285
2017,7,3,23,2345,2279,2433,154
2017,7,4,0,2345,2282,2488,206
2017,7,4,1,2290,2258,2557,299
2017,7,4,2,2212,2192,2536,344
2017,7,4,3,2168,2138,2559,421
2017,7,4,4,2113,2073,2525,452
2017,7,4,5,1940,1892,2447,555
2017,7,4,6,1799,1722,2446,724
2017,7,4,7,1666,1613,2374,761
2017,7,4,8,1563,1535,2182,647
2017,7,4,9,1492,1479,2114,635
2017,7,4,10,1443,1426,2082,656
2017,7,4,11,1423,1411,2035,624
2017,7,4,12,1419,1415,2032,617
2017,7,4,13,1420,1398,1993,595
2017,7,4,14,1468,1460,2014,554
2017,7,4,15,1561,1540,2056,516
2017,7,4,16,1686,1655,2180,525
2017,7,4,17,1800,1784,2265,481
2017,7,4,18,1911,1919,2312,393
2017,7,4,19,2014,2032,2419,387
2017,7,4,20,2112,2148,2458,310
2017,7,4,21,2195,2223,2598,375
2017,7,4,22,2267,2280,2648,368
2017,7,4,23,2316,2302,2673,371
2017,7,5,0,2326,2299,2702,403
2017,7,5,1,2319,2253,2672,419
2017,7,5,2,2260,2168,2631,463
2017,7,5,3,2201,2116,2641,525
2017,7,5,4,2125,2041,2636,595
2017,7,5,5,1957,1935,2566,631
2017,7,5,6,1808,1755,2432,677
2017,7,5,7,1680,1652,2382,730
2017,7,5,8,1584,1580,2284,704
2017,7,5,9,1523,1521,2220,699
2017,7,5,10,1485,1489,2147,658
2017,7,5,11,1465,1479,2104,625
2017,7,5,12,1498,1505,2105,600
2017,7,5,13,1541,1538,2054,516
2017,7,5,14,1619,1643,2144,501
2017,7,5,15,1721,1738,2199,461
2017,7,5,16,1840,1855,2306,451
2017,7,5,17,1963,1976,2480,504
2017,7,5,18,2080,2090,2571,481
2017,7,5,19,2171,2195,2632,437
2017,7,5,20,2265,2256,2649,393
2017,7,5,21,2354,2332,2732,400
2017,7,5,22,2420,2330,2709,379
2017,7,5,23,2455,2319,2686,367
2017,7,6,0,2436,2316,2708,392
2017,7,6,1,2330,2301,2681,380
2017,7,6,2,2266,2246,2724,478
2017,7,6,3,2236,2218,2746,528
2017,7,6,4,2164,2136,2675,539
2017,7,6,5,1994,1959,2471,512
2017,7,6,6,1814,1774,2387,613
2017,7,6,7,1677,1637,2166,529
2017,7,6,8,1559,1549,1999,450
2017,7,6,9,1491,1492,1960,468
2017,7,6,10,1440,1459,1880,421
2017,7,6,11,1426,1451,1840,389
2017,7,6,12,1467,1484,1829,345
2017,7,6,13,1523,1526,1805,279
2017,7,6,14,1632,1644,1899,255
2017,7,6,15,1728,1744,1961,217
2017,7,6,16,1856,1867,1945,78
2017,7,6,17,1982,1984,2059,75
2017,7,6,18,2081,2100,2169,69
2017,7,6,19,2191,2211,2343,132
2017,7,6,20,2293,2300,2364,64
2017,7,6,21,2415,2388,2433,45
2017,7,6,22,2452,2474,2557,83
2017,7,6,23,2476,2500,2635,135
2017,7,7,0,2486,2490,2678,188
2017,7,7,1,2425,2428,2550,122
2017,7,7,2,2344,2316,2423,107
2017,7,7,3,2296,2276,2426,150
2017,7,7,4,2235,2184,2459,275
2017,7,7,5,2053,1994,2358,364
2017,7,7,6,1868,1814,2350,536
2017,7,7,7,1723,1694,2234,540
2017,7,7,8,1612,1611,2115,504
2017,7,7,9,1541,1548,2101,553
2017,7,7,10,1503,1508,2057,549
2017,7,7,11,1509,1491,2050,559
2017,7,7,12,1533,1528,2020,492
2017,7,7,13,1569,1558,2026,468
2017,7,7,14,1670,1671,2101,430
2017,7,7,15,1752,1779,2247,468
2017,7,7,16,1877,1897,2373,476
2017,7,7,17,2007,2004,2517,513
2017,7,7,18,2108,2107,2658,551
2017,7,7,19,2200,2171,2639,468
2017,7,7,20,2291,2257,2581,324
2017,7,7,21,2359,2345,2477,132
2017,7,7,22,2380,2402,2641,239
2017,7,7,23,2400,2428,2672,244
2017,7,8,0,2386,2391,2639,248
2017,7,8,1,2291,2296,2573,277
2017,7,8,2,2209,2198,2452,254
2017,7,8,3,2181,2176,2452,276
2017,7,8,4,2111,2117,2444,327
2017,7,8,5,1994,1968,2317,349
2017,7,8,6,1830,1807,2202,395
2017,7,8,7,1700,1694,2133,439
2017,7,8,8,1625,1617,1980,363
2017,7,8,9,1557,1555,1933,378
2017,7,8,10,1507,1522,1918,396
2017,7,8,11,1479,1499,1822,323
2017,7,8,12,1467,1506,1782,276
2017,7,8,13,1468,1486,1772,286
2017,7,8,14,1552,1546,1752,206
2017,7,8,15,1642,1657,1882,225
2017,7,8,16,1801,1780,1959,179
2017,7,8,17,1904,1875,2121,246
2017,7,8,18,2012,1987,2257,270
2017,7,8,19,2075,2074,2283,209
2017,7,8,20,2170,2130,2261,131
2017,7,8,21,2241,2171,2339,168
2017,7,8,22,2247,2223,2459,236
2017,7,8,23,2214,2228,2513,285
2017,7,9,0,2210,2161,2438,277
2017,7,9,1,2095,2084,2364,280
2017,7,9,2,2034,2014,2341,327
2017,7,9,3,2001,2003,2342,339
2017,7,9,4,1948,1970,2317,347
2017,7,9,5,1847,1832,2195,363
2017,7,9,6,1721,1704,2162,458
2017,7,9,7,1614,1611,2110,499
2017,7,9,8,1537,1529,1996,467
2017,7,9,9,1482,1474,1931,457
2017,7,9,10,1437,1438,1837,399
2017,7,9,11,1412,1416,1812,396
2017,7,9,12,1406,1415,1805,390
2017,7,9,13,1388,1399,1766,367
2017,7,9,14,1444,1446,1745,299
2017,7,9,15,1532,1548,1827,279
2017,7,9,16,1648,1663,1878,215
2017,7,9,17,1754,1763,2164,401
2017,7,9,18,1873,1873,2409,536
2017,7,9,19,1955,1968,2489,521
2017,7,9,20,2059,2065,2592,527
2017,7,9,21,2147,2139,2707,568
2017,7,9,22,2236,2201,2848,647
2017,7,9,23,2271,2236,2860,624
2017,7,10,0,2245,2260,2905,645
2017,7,10,1,2181,2190,2885,695
2017,7,10,2,2122,2093,2748,655
2017,7,10,3,2081,2057,2745,688
2017,7,10,4,2017,1998,2718,720
2017,7,10,5,1887,1843,2478,635
2017,7,10,6,1733,1682,2349,667
2017,7,10,7,1621,1564,2210,646
2017,7,10,8,1527,1491,2104,613
2017,7,10,9,1478,1447,2031,584
2017,7,10,10,1448,1416,2006,590
2017,7,10,11,1445,1413,1974,561
2017,7,10,12,1475,1453,1927,474
2017,7,10,13,1520,1490,1964,474
2017,7,10,14,1614,1588,2020,432
2017,7,10,15,1702,1684,2082,398
2017,7,10,16,1835,1797,2169,372
2017,7,10,17,1905,1887,2318,431
2017,7,10,18,2045,2016,2457,441
2017,7,10,19,2156,2123,2614,491
2017,7,10,20,2232,2223,2590,367
2017,7,10,21,2303,2280,2699,419
2017,7,10,22,2365,2336,2802,466
2017,7,10,23,2386,2379,2809,430
2017,7,11,0,2392,2377,2783,406
2017,7,11,1,2388,2369,2853,484
2017,7,11,2,2318,2288,2748,460
2017,7,11,3,2306,2293,2705,412
2017,7,11,4,2223,2204,2648,444
2017,7,11,5,2058,2015,2418,403
2017,7,11,6,1872,1828,2249,421
2017,7,11,7,1730,1702,2125,423
2017,7,11,8,1629,1606,2106,500
2017,7,11,9,1545,1535,2069,534
2017,7,11,10,1509,1491,1973,482
2017,7,11,11,1489,1476,1931,455
2017,7,11,12,1527,1518,2089,571
2017,7,11,13,1574,1558,2139,581
2017,7,11,14,1667,1651,2222,571
2017,7,11,15,1780,1768,2336,568
2017,7,11,16,1893,1859,2398,539
2017,7,11,17,2027,1980,2475,495
2017,7,11,18,2101,2090,2624,534
2017,7,11,19,2225,2209,2702,493
2017,7,11,20,2336,2296,2658,362
2017,7,11,21,2410,2369,2733,364
2017,7,11,22,2441,2424,2830,406
2017,7,11,23,2494,2459,2865,406
2017,7,12,0,2474,2451,2869,418
2017,7,12,1,2426,2404,2851,447
2017,7,12,2,2358,2323,2846,523
2017,7,12,3,2337,2303,2801,498
2017,7,12,4,2256,2220,2756,536
2017,7,12,5,2095,2034,2516,482
2017,7,12,6,1895,1835,2411,576
2017,7,12,7,1743,1702,2256,554
2017,7,12,8,1652,1610,2189,579
2017,7,12,9,1582,1544,2147,603
2017,7,12,10,1527,1494,2117,623
2017,7,12,11,1517,1489,2104,615
2017,7,12,12,1545,1522,2109,587
2017,7,12,13,1567,1551,2079,528
2017,7,12,14,1647,1650,2178,528
2017,7,12,15,1773,1779,2292,513
2017,7,12,16,1873,1877,2412,535
2017,7,12,17,1984,1972,2526,554
2017,7,12,18,2083,2083,2607,524
2017,7,12,19,2178,2167,2644,477
2017,7,12,20,2273,2265,2634,369
2017,7,12,21,2358,2330,2663,333
2017,7,12,22,2447,2384,2718,334
2017,7,12,23,2477,2421,2749,328
2017,7,13,0,2423,2384,2743,359
2017,7,13,1,2362,2335,2667,332
2017,7,13,2,2264,2223,2609,386
2017,7,13,3,2226,2181,2575,394
2017,7,13,4,2152,2084,2557,473
2017,7,13,5,1999,1925,2348,423
2017,7,13,6,1824,1754,2239,485
2017,7,13,7,1693,1642,2207,565
2017,7,13,8,1612,1559,2155,596
2017,7,13,9,1562,1510,2088,578
2017,7,13,10,1512,1474,2064,590
2017,7,13,11,1518,1489,2040,551
2017,7,13,12,1565,1541,2047,506
2017,7,13,13,1607,1576,2094,518
2017,7,13,14,1667,1641,2152,511
2017,7,13,15,1726,1708,2240,532
2017,7,13,16,1819,1806,2327,521
2017,7,13,17,1941,1932,2480,548
2017,7,13,18,2038,2033,2628,595
2017,7,13,19,2128,2131,2759,628
2017,7,13,20,2219,2222,2770,548
2017,7,13,21,2282,2269,2431,162
2017,7,13,22,2341,2329,2402,73
2017,7,13,23,2374,2357,2382,25
2017,7,14,0,2299,2248,2315,67
2017,7,14,1,2143,2109,2172,63
2017,7,14,2,2064,2022,2138,116
2017,7,14,3,2059,2020,2221,201
2017,7,14,4,2005,1962,2182,220
2017,7,14,5,1866,1823,2134,311
2017,7,14,6,1717,1671,2145,474
2017,7,14,7,1595,1574,2091,517
2017,7,14,8,1539,1505,2113,608
2017,7,14,9,1494,1465,2105,640
2017,7,14,10,1473,1452,2065,613
2017,7,14,11,1460,1448,2073,625
2017,7,14,12,1496,1490,2117,627
2017,7,14,13,1547,1552,2139,587
2017,7,14,14,1626,1640,2163,523
2017,7,14,15,1722,1732,2206,474
2017,7,14,16,1818,1821,2358,537
2017,7,14,17,1923,1927,2491,564
2017,7,14,18,2007,2006,2617,611
2017,7,14,19,2086,2073,2692,619
2017,7,14,20,2137,2119,2653,534
2017,7,14,21,2177,2171,2688,517
2017,7,14,22,2211,2202,2768,566
2017,7,14,23,2206,2189,2708,519
2017,7,15,0,2207,2143,2722,579
2017,7,15,1,2143,2088,2752,664
2017,7,15,2,2079,2015,2638,623
2017,7,15,3,2065,2022,2596,574
2017,7,15,4,2008,1994,2648,654
2017,7,15,5,1874,1856,2517,661
2017,7,15,6,1727,1715,2385,670
2017,7,15,7,1610,1613,2308,695
2017,7,15,8,1539,1533,2227,694
2017,7,15,9,1473,1488,2097,609
2017,7,15,10,1441,1456,2028,572
2017,7,15,11,1419,1430,1998,568
2017,7,15,12,1416,1448,2044,596
2017,7,15,13,1399,1446,2056,610
2017,7,15,14,1441,1505,2119,614
2017,7,15,15,1531,1618,2226,608
2017,7,15,16,1688,1711,2225,514
2017,7,15,17,1819,1808,2276,468
2017,7,15,18,1901,1901,2316,415
2017,7,15,19,2008,1979,2472,493
2017,7,15,20,2086,2047,2556,509
2017,7,15,21,2140,2121,2604,483
2017,7,15,22,2151,2170,2631,461
2017,7,15,23,2180,2199,2640,441
2017,7,16,0,2170,2194,2634,440
2017,7,16,1,2113,2136,2631,495
2017,7,16,2,2051,2052,2624,572
2017,7,16,3,2029,2041,2577,536
2017,7,16,4,1984,1976,2605,629
2017,7,16,5,1877,1852,2376,524
2017,7,16,6,1742,1711,2202,491
2017,7,16,7,1625,1604,2066,462
2017,7,16,8,1517,1512,2054,542
2017,7,16,9,1465,1458,2033,575
2017,7,16,10,1424,1429,2043,614
2017,7,16,11,1403,1407,2012,605
2017,7,16,12,1398,1409,1957,548
2017,7,16,13,1387,1374,1909,535
2017,7,16,14,1453,1428,1926,498
2017,7,16,15,1526,1537,2025,488
2017,7,16,16,1634,1656,2138,482
2017,7,16,17,1741,1764,2266,502
2017,7,16,18,1854,1859,2435,576
2017,7,16,19,1942,1958,2534,576
2017,7,16,20,2010,2028,2548,520
2017,7,16,21,2094,2070,2551,481
2017,7,16,22,2157,2089,2599,510
2017,7,16,23,2171,2116,2637,521
2017,7,17,0,2146,2124,2726,602
2017,7,17,1,2102,2102,2643,541
2017,7,17,2,2052,2062,2625,563
2017,7,17,3,2026,2051,2561,510
2017,7,17,4,2021,2001,2553,552
2017,7,17,5,1893,1847,2392,545
2017,7,17,6,1735,1699,2285,586
2017,7,17,7,1617,1587,2183,596
2017,7,17,8,1537,1507,2145,638
2017,7,17,9,1499,1468,2150,682
2017,7,17,10,1474,1445,2150,705
2017,7,17,11,1471,1453,2148,695
2017,7,17,12,1516,1500,2140,640
2017,7,17,13,1570,1554,2153,599
2017,7,17,14,1673,1664,2209,545
2017,7,17,15,1771,1758,2219,461
2017,7,17,16,1885,1871,2254,383
2017,7,17,17,1996,1992,2386,394
2017,7,17,18,2081,2079,2538,459
2017,7,17,19,2157,2145,2649,504
2017,7,17,20,2241,2210,2611,401
2017,7,17,21,2296,2312,2719,407
2017,7,17,22,2319,2382,2806,424
2017,7,17,23,2336,2311,2681,370
2017,7,18,0,2302,2187,2536,349
2017,7,18,1,2188,2073,2421,348
2017,7,18,2,2065,1998,2336,338
2017,7,18,3,2058,2038,2423,385
2017,7,18,4,2011,1990,2535,545
2017,7,18,5,1895,1837,2389,552
2017,7,18,6,1740,1680,2286,606
2017,7,18,7,1616,1567,2165,598
2017,7,18,8,1524,1509,2106,597
2017,7,18,9,1481,1467,2049,582
2017,7,18,10,1458,1441,2107,666
2017,7,18,11,1455,1438,2091,653
2017,7,18,12,1488,1481,2084,603
2017,7,18,13,1542,1530,2099,569
2017,7,18,14,1636,1629,2097,468
2017,7,18,15,1743,1741,2107,366
2017,7,18,16,1861,1853,2237,384
2017,7,18,17,1975,1960,2334,374
2017,7,18,18,2072,2053,2438,385
2017,7,18,19,2156,2136,2505,369
2017,7,18,20,2226,2202,2580,378
2017,7,18,21,2263,2236,2626,390
2017,7,18,22,2345,2275,2662,387
2017,7,18,23,2366,2322,2735,413
2017,7,19,0,2337,2320,2817,497
2017,7,19,1,2280,2286,2784,498
2017,7,19,2,2247,2221,2662,441
2017,7,19,3,2254,2205,2717,512
2017,7,19,4,2175,2134,2709,575
2017,7,19,5,2005,1945,2523,578
2017,7,19,6,1829,1759,2390,631
2017,7,19,7,1694,1638,2231,593
2017,7,19,8,1613,1567,2113,546
2017,7,19,9,1547,1508,1975,467
2017,7,19,10,1509,1473,1940,467
2017,7,19,11,1490,1461,1903,442
2017,7,19,12,1538,1507,1914,407
2017,7,19,13,1589,1551,1883,332
2017,7,19,14,1681,1648,1912,264
2017,7,19,15,1777,1751,2008,257
2017,7,19,16,1899,1849,2125,276
2017,7,19,17,2016,1974,2340,366
2017,7,19,18,2107,2085,2453,368
2017,7,19,19,2199,2172,2468,296
2017,7,19,20,2270,2253,2491,238
2017,7,19,21,2348,2324,2500,176
2017,7,19,22,2405,2370,2538,168
2017,7,19,23,2425,2383,2623,240
2017,7,20,0,2443,2395,2634,239
2017,7,20,1,2382,2335,2571,236
2017,7,20,2,2297,2247,2546,299
2017,7,20,3,2275,2209,2564,355
2017,7,20,4,2206,2121,2383,262
2017,7,20,5,2041,1929,2216,287
2017,7,20,6,1826,1756,2145,389
2017,7,20,7,1693,1634,1947,313
2017,7,20,8,1597,1543,1920,377
2017,7,20,9,1535,1499,1946,447
2017,7,20,10,1497,1458,1661,203
2017,7,20,11,1479,1460,1595,135
2017,7,20,12,1518,1502,1612,110
2017,7,20,13,1568,1556,1605,49
2017,7,20,14,1647,1651,1685,34
2017,7,20,15,1735,1752,1803,51
2017,7,20,16,1839,1835,1957,122
2017,7,20,17,1936,1920,2004,84
2017,7,20,18,2025,2009,2052,43
2017,7,20,19,2095,2100,2160,60
2017,7,20,20,2177,2174,2213,39
2017,7,20,21,2259,2242,2276,34
2017,7,20,22,2293,2294,2333,39
2017,7,20,23,2316,2310,2332,22
2017,7,21,0,2291,2287,2232,-55
2017,7,21,1,2235,2202,2156,-46
2017,7,21,2,2166,2110,2069,-41
2017,7,21,3,2140,2112,2087,-25
2017,7,21,4,2084,2050,2104,54
2017,7,21,5,1921,1888,1960,72
2017,7,21,6,1754,1729,1929,200
2017,7,21,7,1626,1612,1864,252
2017,7,21,8,1539,1543,1654,111
2017,7,21,9,1488,1491,1604,113
2017,7,21,10,1448,1456,1547,91
2017,7,21,11,1433,1449,1526,77
2017,7,21,12,1468,1489,1505,16
2017,7,21,13,1523,1540,1479,-61
2017,7,21,14,1607,1646,1525,-121
2017,7,21,15,1701,1738,1572,-166
2017,7,21,16,1818,1840,1680,-160
2017,7,21,17,1936,1920,1754,-166
2017,7,21,18,2021,2016,1829,-187
2017,7,21,19,2091,2098,1979,-119
2017,7,21,20,2166,2167,2025,-142
2017,7,21,21,2253,2234,2114,-120
2017,7,21,22,2285,2277,2181,-96
2017,7,21,23,2312,2303,2265,-38
2017,7,22,0,2299,2280,2264,-16
2017,7,22,1,2232,2207,2152,-55
2017,7,22,2,2160,2137,2086,-51
2017,7,22,3,2151,2140,2062,-78
2017,7,22,4,2092,2071,2123,52
2017,7,22,5,1949,1916,1994,78
2017,7,22,6,1807,1774,1825,51
2017,7,22,7,1683,1654,1778,124
2017,7,22,8,1612,1567,1697,130
2017,7,22,9,1561,1522,1614,92
2017,7,22,10,1515,1486,1512,26
2017,7,22,11,1492,1463,1533,70
2017,7,22,12,1495,1475,1514,39
2017,7,22,13,1487,1468,1472,4
2017,7,22,14,1550,1541,1513,-28
2017,7,22,15,1655,1640,1555,-85
2017,7,22,16,1760,1741,1594,-147
2017,7,22,17,1866,1853,1691,-162
2017,7,22,18,1961,1964,1910,-54
2017,7,22,19,2058,2042,1918,-124
2017,7,22,20,2138,2120,1930,-190
2017,7,22,21,2195,2182,1966,-216
2017,7,22,22,2227,2212,2050,-162
2017,7,22,23,2276,2249,2116,-133
2017,7,23,0,2284,2258,2082,-176
2017,7,23,1,2233,2203,2065,-138
2017,7,23,2,2131,2091,1923,-168
2017,7,23,3,2058,2036,1842,-194
2017,7,23,4,2015,1974,1899,-75
2017,7,23,5,1877,1832,1902,70
2017,7,23,6,1748,1696,1847,151
2017,7,23,7,1639,1592,1785,193
2017,7,23,8,1561,1529,1626,97
2017,7,23,9,1512,1467,1624,157
2017,7,23,10,1455,1414,1429,15
2017,7,23,11,1447,1413,1459,46
2017,7,23,12,1443,1406,1436,30
2017,7,23,13,1412,1395,1344,-51
2017,7,23,14,1457,1454,1383,-71
2017,7,23,15,1553,1550,1407,-143
2017,7,23,16,1668,1660,1510,-150
2017,7,23,17,1752,1764,1666,-98
2017,7,23,18,1844,1851,1795,-56
2017,7,23,19,1952,1939,1810,-129
2017,7,23,20,2008,1981,1860,-121
2017,7,23,21,1990,1981,1948,-33
2017,7,23,22,2039,2023,2037,14
2017,7,23,23,2075,2104,2211,107
2017,7,24,0,1932,1933,2072,139
2017,7,24,1,1991,1959,2104,145
2017,7,24,2,1963,1931,2036,105
2017,7,24,3,1972,1956,2008,52
2017,7,24,4,1942,1920,1987,67
2017,7,24,5,1822,1787,1858,71
2017,7,24,6,1675,1649,1698,49
2017,7,24,7,1561,1537,1621,84
2017,7,24,8,1454,1437,1470,33
2017,7,24,9,1469,1455,1475,20
2017,7,24,10,1444,1434,1457,23
2017,7,24,11,1444,1432,1437,5
2017,7,24,12,1485,1486,1436,-50
2017,7,24,13,1542,1536,1411,-125
2017,7,24,14,1620,1628,1449,-179
2017,7,24,15,1705,1707,1629,-78
2017,7,24,16,1798,1815,1751,-64
2017,7,24,17,1901,1913,1804,-109
2017,7,24,18,1995,2007,1854,-153
2017,7,24,19,2083,2085,2026,-59
2017,7,24,20,2150,2151,2072,-79
2017,7,24,21,2211,2202,2185,-17
2017,7,24,22,2264,2255,2267,12
2017,7,24,23,2282,2289,2251,-38
2017,7,25,0,2296,2271,2288,17
2017,7,25,1,2245,2237,2248,11
2017,7,25,2,2179,2150,2169,19
2017,7,25,3,2146,2145,2180,35
2017,7,25,4,2079,2073,2151,78
2017,7,25,5,1943,1918,1955,37
2017,7,25,6,1776,1755,1776,21
2017,7,25,7,1641,1650,1647,-3
2017,7,25,8,1578,1572,1612,40
2017,7,25,9,1528,1526,1724,198
2017,7,25,10,1496,1494,1704,210
2017,7,25,11,1488,1494,1770,276
2017,7,25,12,1527,1537,1817,280
2017,7,25,13,1576,1596,1897,301
2017,7,25,14,1663,1682,1925,243
2017,7,25,15,1764,1777,1943,166
2017,7,25,16,1869,1881,1943,62
2017,7,25,17,1973,1980,1814,-166
2017,7,25,18,2064,2071,1906,-165
2017,7,25,19,2168,2140,2030,-110
2017,7,25,20,2244,2216,2014,-202
2017,7,25,21,2294,2283,2202,-81
2017,7,25,22,2295,2279,2287,8
2017,7,25,23,2264,2238,2274,36
2017,7,26,0,2239,2216,2283,67
2017,7,26,1,2188,2178,2307,129
2017,7,26,2,2139,2121,2235,114
2017,7,26,3,2148,2136,2221,85
2017,7,26,4,2067,2062,2139,77
2017,7,26,5,1926,1906,1925,19
2017,7,26,6,1758,1736,1827,91
2017,7,26,7,1638,1616,1818,202
2017,7,26,8,1551,1538,1829,291
2017,7,26,9,1501,1491,1716,225
2017,7,26,10,1471,1462,1684,222
2017,7,26,11,1459,1463,1717,254
2017,7,26,12,1508,1510,1747,237
2017,7,26,13,1554,1562,1710,148
2017,7,26,14,1631,1650,1678,28
2017,7,26,15,1730,1761,1687,-74
2017,7,26,16,1850,1846,1655,-191
2017,7,26,17,1959,1952,1765,-187
2017,7,26,18,2080,2075,1947,-128
2017,7,26,19,2167,2138,2091,-47
2017,7,26,20,2258,2214,2079,-135
2017,7,26,21,2312,2303,2229,-74
2017,7,26,22,2374,2347,2227,-120
2017,7,26,23,2423,2354,2239,-115
2017,7,27,0,2410,2353,2247,-106
2017,7,27,1,2324,2303,2254,-49
2017,7,27,2,2280,2256,2197,-59
2017,7,27,3,2265,2276,2189,-87
2017,7,27,4,2195,2169,2195,26
2017,7,27,5,2024,2030,2117,87
2017,7,27,6,1849,1850,2023,173
2017,7,27,7,1716,1715,1915,200
2017,7,27,8,1655,1632,1779,147
2017,7,27,9,1590,1576,1687,111
2017,7,27,10,1557,1543,1678,135
2017,7,27,11,1546,1532,1661,129
2017,7,27,12,1603,1601,1713,112
2017,7,27,13,1658,1661,1745,84
2017,7,27,14,1726,1732,1705,-27
2017,7,27,15,1784,1793,1748,-45
2017,7,27,16,1850,1859,1842,-17
2017,7,27,17,1917,1933,1893,-40
2017,7,27,18,1956,1967,2082,115
2017,7,27,19,1995,1995,2066,71
2017,7,27,20,2050,2038,2151,113
2017,7,27,21,2143,2121,2209,88
2017,7,27,22,2218,2189,2264,75
2017,7,27,23,2274,2242,2369,127
2017,7,28,0,2279,2239,2353,114
2017,7,28,1,2185,2146,2299,153
2017,7,28,2,2100,2056,2225,169
2017,7,28,3,2062,2027,2250,223
2017,7,28,4,2010,1942,2225,283
2017,7,28,5,1896,1786,1987,201
2017,7,28,6,1744,1649,1885,236
2017,7,28,7,1626,1560,1785,225
2017,7,28,8,1538,1499,1654,155
2017,7,28,9,1487,1452,1626,174
2017,7,28,10,1452,1423,1585,162
2017,7,28,11,1452,1431,1583,152
2017,7,28,12,1494,1479,1601,122
2017,7,28,13,1543,1531,1627,96
2017,7,28,14,1624,1607,1635,28
2017,7,28,15,1690,1673,1651,-22
2017,7,28,16,1753,1763,1801,38
2017,7,28,17,1825,1841,1966,125
2017,7,28,18,1933,1925,2082,157
2017,7,28,19,2014,2005,2123,118
2017,7,28,20,2066,2078,2117,39
2017,7,28,21,2151,2126,2201,75
2017,7,28,22,2207,2178,2233,55
2017,7,28,23,2233,2211,2279,68
2017,7,29,0,2241,2196,2193,-3
2017,7,29,1,2194,2133,2170,37
2017,7,29,2,2127,2058,2161,103
2017,7,29,3,2072,2040,2171,131
2017,7,29,4,2015,1972,2100,128
2017,7,29,5,1898,1834,2004,170
2017,7,29,6,1753,1701,1829,128
2017,7,29,7,1633,1598,1742,144
2017,7,29,8,1563,1527,1727,200
2017,7,29,9,1513,1482,1562,80
2017,7,29,10,1477,1435,1428,-7
2017,7,29,11,1454,1428,1406,-22
2017,7,29,12,1464,1443,1392,-51
2017,7,29,13,1457,1432,1366,-66
2017,7,29,14,1508,1496,1409,-87
2017,7,29,15,1604,1586,1452,-134
2017,7,29,16,1700,1680,1551,-129
2017,7,29,17,1815,1786,1682,-104
2017,7,29,18,1910,1882,1815,-67
2017,7,29,19,1998,1973,1880,-93
2017,7,29,20,2061,2034,1878,-156
2017,7,29,21,2107,2082,1936,-146
2017,7,29,22,2138,2112,1888,-224
2017,7,29,23,2156,2092,1822,-270
2017,7,30,0,2155,2059,1826,-233
2017,7,30,1,2124,1988,1849,-139
2017,7,30,2,2024,1921,1725,-196
2017,7,30,3,1994,1922,1784,-138
2017,7,30,4,1948,1858,1694,-164
2017,7,30,5,1845,1746,1526,-220
2017,7,30,6,1724,1630,1448,-182
2017,7,30,7,1611,1538,1414,-124
2017,7,30,8,1538,1477,1389,-88
2017,7,30,9,1485,1433,1358,-75
2017,7,30,10,1458,1409,1371,-38
2017,7,30,11,1441,1394,1285,-109
2017,7,30,12,1438,1399,1323,-76
2017,7,30,13,1431,1393,1361,-32
2017,7,30,14,1462,1436,1364,-72
2017,7,30,15,1546,1517,1391,-126
2017,7,30,16,1648,1609,1433,-176
2017,7,30,17,1767,1734,1486,-248
2017,7,30,18,1885,1843,1550,-293
2017,7,30,19,1966,1916,1700,-216
2017,7,30,20,2045,1991,1777,-214
2017,7,30,21,2092,2031,1871,-160
2017,7,30,22,2109,2044,1956,-88
2017,7,30,23,2144,2041,1939,-102
2017,7,31,0,2124,2046,1867,-179
2017,7,31,1,2065,1958,1851,-107
2017,7,31,2,1979,1894,1759,-135
2017,7,31,3,1922,1900,1655,-245
2017,7,31,4,1877,1842,1746,-96
2017,7,31,5,1775,1731,1569,-162
2017,7,31,6,1650,1598,1493,-105
2017,7,31,7,1547,1502,1460,-42
2017,7,31,8,1488,1446,1466,20
2017,7,31,9,1463,1420,1489,69
2017,7,31,10,1433,1406,1488,82
2017,7,31,11,1439,1406,1503,97
2017,7,31,12,1488,1467,1507,40
2017,7,31,13,1539,1524,1527,3
2017,7,31,14,1615,1595,1566,-29
2017,7,31,15,1694,1659,1617,-42
2017,7,31,16,1768,1740,1704,-36
2017,7,31,17,1859,1835,1804,-31
2017,7,31,18,1944,1909,1966,57
2017,7,31,19,2040,1996,2084,88
2017,7,31,20,2126,2095,2132,37
2017,7,31,21,2197,2175,2251,76
2017,7,31,22,2184,2133,2279,146
2017,7,31,23,2164,2020,2127,107
2017,8,1,0,2095,1921,2086,165
2017,8,1,1,2002,1823,1966,143
2017,8,1,2,1944,1786,1949,163
2017,8,1,3,2110,1836,1987,151
2017,8,1,4,1965,1803,2161,358
2017,8,1,5,1713,1676,2096,420
2017,8,1,6,1594,1555,1937,382
2017,8,1,7,1491,1466,1831,365
2017,8,1,8,1450,1415,1711,296
2017,8,1,9,1415,1381,1613,232
2017,8,1,10,1398,1377,1561,184
2017,8,1,11,1404,1388,1563,175
2017,8,1,12,1452,1437,1675,238
2017,8,1,13,1521,1502,1724,222
2017,8,1,14,1587,1566,1761,195
2017,8,1,15,1665,1642,1817,175
2017,8,1,16,1734,1704,1937,233
2017,8,1,17,1820,1788,2070,282
2017,8,1,18,1887,1845,2131,286
2017,8,1,19,1946,1899,2194,295
2017,8,1,20,2017,1959,2214,255
2017,8,1,21,2077,2017,2379,362
2017,8,1,22,2124,2055,2441,386
2017,8,1,23,2118,2051,2496,445
2017,8,2,0,2091,2039,2563,524
2017,8,2,1,2029,1990,2476,486
2017,8,2,2,1979,1925,2387,462
2017,8,2,3,2009,1932,2365,433
2017,8,2,4,1935,1876,2216,340
2017,8,2,5,1783,1742,2035,293
2017,8,2,6,1646,1605,1834,229
2017,8,2,7,1538,1507,1602,95
2017,8,2,8,1482,1441,1421,-20
2017,8,2,9,1427,1392,1340,-52
2017,8,2,10,1405,1364,1304,-60
2017,8,2,11,1398,1378,1293,-85
2017,8,2,12,1543,1429,1313,-116
2017,8,2,13,1512,1482,1446,-36
2017,8,2,14,1592,1564,1641,77
2017,8,2,15,1661,1644,1800,156
2017,8,2,16,1750,1731,1898,167
2017,8,2,17,1844,1826,1988,162
2017,8,2,18,1907,1883,2126,243
2017,8,2,19,1991,1966,2227,261
2017,8,2,20,2066,2029,2287,258
2017,8,2,21,2026,2100,2347,247
2017,8,2,22,2199,2171,2402,231
2017,8,2,23,2222,2222,2387,165
2017,8,3,0,2215,2221,2407,186
2017,8,3,1,2172,2195,2338,143
2017,8,3,2,2126,2115,2272,157
2017,8,3,3,2125,2102,2329,227
2017,8,3,4,2062,2000,2329,329
2017,8,3,5,1910,1863,2109,246
2017,8,3,6,1730,1667,1849,182
2017,8,3,7,1614,1562,1728,166
2017,8,3,8,1545,1489,1728,239
2017,8,3,9,1487,1435,1756,321
2017,8,3,10,1453,1401,1726,325
2017,8,3,11,1446,1358,1667,309
2017,8,3,12,1490,1453,1751,298
2017,8,3,13,1512,1499,1761,262
2017,8,3,14,1600,1578,1841,263
2017,8,3,15,1709,1670,1944,274
2017,8,3,16,1799,1762,1995,233
2017,8,3,17,1893,1853,2136,283
2017,8,3,18,1976,1948,2330,382
2017,8,3,19,2069,2026,2544,518
2017,8,3,20,2141,2106,2674,568
2017,8,3,21,2174,2166,2795,629
2017,8,3,22,2251,2208,2798,590
2017,8,3,23,2280,2188,2738,550
2017,8,4,0,2247,2052,2612,560
2017,8,4,1,2145,1983,2655,672
2017,8,4,2,2077,1931,2663,732
2017,8,4,3,2056,1955,2606,651
2017,8,4,4,1921,1899,2599,700
2017,8,4,5,1828,1766,2398,632
2017,8,4,6,1678,1628,2276,648
2017,8,4,7,1565,1539,2044,505
2017,8,4,8,1512,1476,1915,439
2017,8,4,9,1467,1438,1904,466
2017,8,4,10,1439,1409,1886,477
2017,8,4,11,1426,1402,1848,446
2017,8,4,12,1468,1452,1860,408
2017,8,4,13,1516,1501,1880,379
2017,8,4,14,1587,1578,1998,420
2017,8,4,15,1673,1663,2058,395
2017,8,4,16,1749,1738,2102,364
2017,8,4,17,1831,1811,2173,362
2017,8,4,18,1904,1885,2350,465
2017,8,4,19,1957,1937,2455,518
2017,8,4,20,2021,2008,2454,446
2017,8,4,21,2101,2092,2523,431
2017,8,4,22,2085,2063,2536,473
2017,8,4,23,1977,1947,2536,589
2017,8,5,0,1923,1863,2535,672
2017,8,5,1,1917,1797,2479,682
2017,8,5,2,1847,1779,2416,637
2017,8,5,3,1888,1837,2475,638
2017,8,5,4,1869,1803,2409,606
2017,8,5,5,1764,1703,2332,629
2017,8,5,6,1633,1583,2195,612
2017,8,5,7,1534,1493,2236,743
2017,8,5,8,1468,1422,2103,681
2017,8,5,9,1418,1386,2084,698
2017,8,5,10,1389,1360,2081,721
2017,8,5,11,1385,1357,2022,665
2017,8,5,12,1406,1383,2075,692
2017,8,5,13,1411,1394,2066,672
2017,8,5,14,1452,1440,2115,675
2017,8,5,15,1525,1514,2207,693
2017,8,5,16,1611,1595,2318,723
2017,8,5,17,1691,1679,2421,742
2017,8,5,18,1780,1768,2587,819
2017,8,5,19,1857,1844,2686,842
2017,8,5,20,1920,1899,2654,755
2017,8,5,21,1976,1956,2599,643
2017,8,5,22,2025,2009,2635,626
2017,8,5,23,2064,2058,2595,537
2017,8,6,0,2056,2037,2568,531
2017,8,6,1,2001,1970,2532,562
2017,8,6,2,1919,1894,2415,521
2017,8,6,3,1924,1901,2229,328
2017,8,6,4,1878,1846,2222,376
2017,8,6,5,1781,1728,2084,356
2017,8,6,6,1658,1603,1932,329
2017,8,6,7,1554,1509,1868,359
2017,8,6,8,1482,1437,1726,289
2017,8,6,9,1433,1395,1715,320
2017,8,6,10,1393,1359,1729,370
2017,8,6,11,1377,1344,1707,363
2017,8,6,12,1384,1357,1711,354
2017,8,6,13,1376,1351,1742,391
2017,8,6,14,1401,1391,1797,406
2017,8,6,15,1490,1480,1952,472
2017,8,6,16,1576,1569,2042,473
2017,8,6,17,1657,1652,2244,592
2017,8,6,18,1766,1760,2361,601
2017,8,6,19,1869,1849,2403,554
2017,8,6,20,1956,1940,2406,466
2017,8,6,21,2026,2005,2435,430
2017,8,6,22,2073,2055,2495,440
2017,8,6,23,2082,2065,2511,446
2017,8,7,0,2045,2026,2480,454
2017,8,7,1,2021,1992,2448,456
2017,8,7,2,1977,1947,2409,462
2017,8,7,3,1981,1963,2430,467
2017,8,7,4,1942,1910,2390,480
2017,8,7,5,1817,1767,2291,524
2017,8,7,6,1676,1624,2173,549
2017,8,7,7,1567,1517,2074,557
2017,8,7,8,1484,1452,2043,591
2017,8,7,9,1452,1423,2012,589
2017,8,7,10,1434,1406,2007,601
2017,8,7,11,1429,1406,1977,571
2017,8,7,12,1477,1460,1994,534
2017,8,7,13,1540,1521,2035,514
2017,8,7,14,1609,1598,1998,400
2017,8,7,15,1697,1688,2056,368
2017,8,7,16,1791,1768,2096,328
2017,8,7,17,1895,1874,2145,271
2017,8,7,18,1986,1965,2250,285
2017,8,7,19,2073,2047,2432,385
2017,8,7,20,2160,2132,2509,377
2017,8,7,21,2225,2195,2551,356
2017,8,7,22,2272,2248,2650,402
2017,8,7,23,2303,2276,2750,474
2017,8,8,0,2288,2272,2707,435
2017,8,8,1,2244,2227,2782,555
2017,8,8,2,2155,2135,2658,523
2017,8,8,3,2138,2100,2559,459
2017,8,8,4,2071,1994,2457,463
2017,8,8,5,1921,1751,2238,487
2017,8,8,6,1753,1635,2243,608
2017,8,8,7,1633,1530,2186,656
2017,8,8,8,1503,1462,2102,640
2017,8,8,9,1455,1420,2033,613
2017,8,8,10,1434,1398,1978,580
2017,8,8,11,1436,1403,1934,531
2017,8,8,12,1485,1460,1973,513
2017,8,8,13,1547,1523,2027,504
2017,8,8,14,1617,1587,2033,446
2017,8,8,15,1700,1672,2097,425
2017,8,8,16,1788,1756,2129,373
2017,8,8,17,1881,1853,2178,325
2017,8,8,18,1968,1942,2287,345
2017,8,8,19,2033,2005,2423,418
2017,8,8,20,2092,2061,2546,485
2017,8,8,21,2160,2136,2642,506
2017,8,8,22,2210,2189,2695,506
2017,8,8,23,2228,2210,2748,538
2017,8,9,0,2212,2197,2783,586
2017,8,9,1,2172,2152,2768,616
2017,8,9,2,2121,2096,2723,627
2017,8,9,3,2099,2096,2686,590
2017,8,9,4,2037,1996,2676,680
2017,8,9,5,1869,1842,2408,566
2017,8,9,6,1715,1682,2280,598
2017,8,9,7,1601,1557,2269,712
2017,8,9,8,1538,1489,2251,762
2017,8,9,9,1483,1437,2172,735
2017,8,9,10,1451,1415,2085,670
2017,8,9,11,1451,1422,2059,637
2017,8,9,12,1499,1476,2076,600
2017,8,9,13,1559,1526,2003,477
2017,8,9,14,1634,1602,2121,519
2017,8,9,15,1714,1686,2223,537
2017,8,9,16,1801,1778,2275,497
2017,8,9,17,1891,1870,2363,493
2017,8,9,18,2015,1976,2452,476
2017,8,9,19,2066,2034,2536,502
2017,8,9,20,2158,2119,2584,465
2017,8,9,21,2215,2176,2699,523
2017,8,9,22,2285,2243,2753,510
2017,8,9,23,2330,2290,2779,489
2017,8,10,0,2328,2288,2756,468
2017,8,10,1,2290,2251,2641,390
2017,8,10,2,2221,2185,2589,404
2017,8,10,3,2210,2173,2586,413
2017,8,10,4,2128,2076,2522,446
2017,8,10,5,1969,1900,2303,403
2017,8,10,6,1799,1723,2192,469
2017,8,10,7,1669,1621,2085,464
2017,8,10,8,1592,1546,1931,385
2017,8,10,9,1541,1496,1856,360
2017,8,10,10,1501,1464,1796,332
2017,8,10,11,1502,1469,1716,247
2017,8,10,12,1555,1523,1718,195
2017,8,10,13,1620,1598,1709,111
2017,8,10,14,1687,1670,1723,53
2017,8,10,15,1777,1769,1765,-4
2017,8,10,16,1873,1862,1795,-67
2017,8,10,17,1989,1967,1903,-64
2017,8,10,18,2108,2066,1914,-152
2017,8,10,19,2173,2126,1808,-318
2017,8,10,20,2228,2201,1692,-509
2017,8,10,21,2285,2258,1823,-435
2017,8,10,22,2346,2313,2008,-305
2017,8,10,23,2365,2305,2038,-267
2017,8,11,0,2325,2239,2021,-218
2017,8,11,1,2266,2175,1802,-373
2017,8,11,2,2178,2080,1847,-233
2017,8,11,3,2165,2086,1882,-204
2017,8,11,4,2109,2002,1759,-243
2017,8,11,5,1963,1869,1280,-589
2017,8,11,6,1791,1711,1201,-510
2017,8,11,7,1665,1592,1229,-363
2017,8,11,8,1574,1531,1339,-192
2017,8,11,9,1511,1483,1423,-60
2017,8,11,10,1485,1457,1455,-2
2017,8,11,11,1477,1454,1530,76
2017,8,11,12,1518,1506,1608,102
2017,8,11,13,1587,1585,1706,121
2017,8,11,14,1649,1651,1862,211
2017,8,11,15,1730,1729,1863,134
2017,8,11,16,1815,1806,1980,174
2017,8,11,17,1925,1911,2074,163
2017,8,11,18,2011,1994,2177,183
2017,8,11,19,2088,2071,2219,148
2017,8,11,20,2155,2134,2172,38
2017,8,11,21,2149,2126,2157,31
2017,8,11,22,2096,1982,2122,140
2017,8,11,23,2033,1906,2062,156
2017,8,12,0,1925,1867,1948,81
2017,8,12,1,1839,1806,1795,-11
2017,8,12,2,1885,1794,1767,-27
2017,8,12,3,1917,1809,1762,-47
2017,8,12,4,1904,1751,1788,37
2017,8,12,5,1767,1637,1662,25
2017,8,12,6,1637,1541,1602,61
2017,8,12,7,1529,1458,1517,59
2017,8,12,8,1467,1398,1348,-50
2017,8,12,9,1428,1361,1302,-59
2017,8,12,10,1398,1338,1261,-77
2017,8,12,11,1388,1340,1270,-70
2017,8,12,12,1407,1360,1341,-19
2017,8,12,13,1407,1367,1348,-19
2017,8,12,14,1447,1406,1400,-6
2017,8,12,15,1518,1480,1505,25
2017,8,12,16,1608,1558,1595,37
2017,8,12,17,1682,1626,1608,-18
2017,8,12,18,1741,1684,1595,-89
2017,8,12,19,1805,1746,1640,-106
2017,8,12,20,1867,1807,1614,-193
2017,8,12,21,1933,1877,1728,-149
2017,8,12,22,2001,1954,1734,-220
2017,8,12,23,2055,2016,1757,-259
2017,8,13,0,2061,2050,1774,-276
2017,8,13,1,2047,2032,1790,-242
2017,8,13,2,1972,1966,1766,-200
2017,8,13,3,2022,1965,1774,-191
2017,8,13,4,1953,1894,1721,-173
2017,8,13,5,1838,1757,1713,-44
2017,8,13,6,1713,1630,1692,62
2017,8,13,7,1604,1533,1623,90
2017,8,13,8,1514,1466,1558,92
2017,8,13,9,1456,1417,1428,11
2017,8,13,10,1432,1387,1440,53
2017,8,13,11,1421,1376,1422,46
2017,8,13,12,1417,1381,1364,-17
2017,8,13,13,1411,1374,1349,-25
2017,8,13,14,1433,1402,1411,9
2017,8,13,15,1512,1480,1111,-369
2017,8,13,16,1607,1584,1216,-368
2017,8,13,17,1692,1671,1282,-389
2017,8,13,18,1776,1756,1433,-323
2017,8,13,19,1853,1830,1513,-317
2017,8,13,20,1923,1901,1538,-363
2017,8,13,21,1992,1977,1600,-377
2017,8,13,22,2058,2035,1632,-403
2017,8,13,23,2090,2065,1586,-479
2017,8,14,0,2090,2087,1576,-511
2017,8,14,1,2069,2042,1621,-421
2017,8,14,2,2022,1993,1566,-427
2017,8,14,3,1988,2015,1686,-329
2017,8,14,4,1944,1914,1720,-194
2017,8,14,5,1850,1753,1602,-151
2017,8,14,6,1684,1606,1413,-193
2017,8,14,7,1569,1514,1308,-206
2017,8,14,8,1496,1451,1321,-130
2017,8,14,9,1445,1413,1353,-60
2017,8,14,10,1425,1398,1348,-50
2017,8,14,11,1435,1414,1360,-54
2017,8,14,12,1481,1478,1427,-51
2017,8,14,13,1558,1566,1465,-101
2017,8,14,14,1632,1629,1438,-191
2017,8,14,15,1716,1709,1509,-200
2017,8,14,16,1811,1796,1592,-204
2017,8,14,17,1905,1884,1597,-287
2017,8,14,18,2001,1970,1626,-344
2017,8,14,19,2084,2054,1747,-307
2017,8,14,20,2170,2136,1891,-245
2017,8,14,21,2232,2187,2043,-144
2017,8,14,22,2304,2226,2102,-124
2017,8,14,23,2327,2273,2107,-166
2017,8,15,0,2279,2233,2100,-133
2017,8,15,1,2208,2115,2069,-46
2017,8,15,2,2137,2036,2021,-15
2017,8,15,3,2121,2026,2020,-6
2017,8,15,4,1998,1905,1989,84
2017,8,15,5,1851,1715,1865,150
2017,8,15,6,1695,1571,1710,139
2017,8,15,7,1587,1475,1573,98
2017,8,15,8,1487,1412,1481,69
2017,8,15,9,1443,1371,1459,88
2017,8,15,10,1424,1342,1508,166
2017,8,15,11,1422,1350,1547,197
2017,8,15,12,1474,1412,1589,177
2017,8,15,13,1554,1495,1673,178
2017,8,15,14,1580,1548,1759,211
2017,8,15,15,1650,1616,1725,109
2017,8,15,16,1733,1680,1663,-17
2017,8,15,17,1820,1754,1787,33
2017,8,15,18,1901,1821,1836,15
2017,8,15,19,1956,1888,1846,-42
2017,8,15,20,2041,1946,1865,-81
2017,8,15,21,2107,2021,1959,-62
2017,8,15,22,2165,2079,2110,31
2017,8,15,23,2195,2110,2241,131
2017,8,16,0,2166,2070,2314,244
2017,8,16,1,2029,2013,2275,262
2017,8,16,2,1984,1931,2199,268
2017,8,16,3,1962,1936,2202,266
2017,8,16,4,1888,1840,2195,355
2017,8,16,5,1741,1675,2083,408
2017,8,16,6,1598,1525,2006,481
2017,8,16,7,1498,1459,1909,450
2017,8,16,8,1485,1364,2023,659
2017,8,16,9,1434,1318,2000,682
2017,8,16,10,1403,1295,1860,565
2017,8,16,11,1398,1300,1834,534
2017,8,16,12,1446,1353,1866,513
2017,8,16,13,1521,1432,1957,525
2017,8,16,14,1594,1495,1963,468
2017,8,16,15,1663,1555,2013,458
2017,8,16,16,1746,1616,2081,465
2017,8,16,17,1746,1697,2209,512
2017,8,16,18,1829,1768,2240,472
2017,8,16,19,1904,1831,2314,483
2017,8,16,20,1976,1915,2275,360
2017,8,16,21,2044,1990,2344,354
2017,8,16,22,2104,2068,2363,295
2017,8,16,23,2139,2138,2420,282
2017,8,17,0,2163,2157,2403,246
2017,8,17,1,2115,2117,2374,257
2017,8,17,2,2041,2031,2293,262
2017,8,17,3,2017,2023,2311,288
2017,8,17,4,1948,1907,2319,412
2017,8,17,5,1796,1726,2188,462
2017,8,17,6,1637,1558,2055,497
2017,8,17,7,1537,1447,2021,574
2017,8,17,8,1463,1380,1931,551
2017,8,17,9,1413,1330,1932,602
2017,8,17,10,1385,1325,1977,652
2017,8,17,11,1383,1338,1933,595
2017,8,17,12,1431,1395,1966,571
2017,8,17,13,1499,1489,2014,525
2017,8,17,14,1562,1541,1999,458
2017,8,17,15,1629,1618,2022,404
2017,8,17,16,1715,1707,2080,373
2017,8,17,17,1814,1791,2141,350
2017,8,17,18,1885,1874,2173,299
2017,8,17,19,1959,1956,2180,224
2017,8,17,20,2068,2042,2308,266
2017,8,17,21,2146,2121,2393,272
2017,8,17,22,2215,2182,2486,304
2017,8,17,23,2261,2218,2553,335
2017,8,18,0,2239,2221,2540,319
2017,8,18,1,2190,2160,2500,340
2017,8,18,2,2108,2083,2428,345
2017,8,18,3,2075,2055,2473,418
2017,8,18,4,2001,1937,2383,446
2017,8,18,5,1854,1752,2234,482
2017,8,18,6,1694,1593,2053,460
2017,8,18,7,1578,1488,1997,509
2017,8,18,8,1491,1419,1928,509
2017,8,18,9,1443,1377,1962,585
2017,8,18,10,1417,1347,1994,647
2017,8,18,11,1413,1352,2009,657
2017,8,18,12,1452,1406,2029,623
2017,8,18,13,1499,1483,1990,507
2017,8,18,14,1580,1539,1991,452
2017,8,18,15,1648,1624,1989,365
2017,8,18,16,1723,1693,1971,278
2017,8,18,17,1816,1783,2055,272
2017,8,18,18,1908,1873,2164,291
2017,8,18,19,1998,1962,2366,404
2017,8,18,20,2091,2071,2469,398
2017,8,18,21,2185,2175,2526,351
2017,8,18,22,2276,2236,2549,313
2017,8,18,23,2310,2281,2563,282
2017,8,19,0,2294,2267,2513,246
2017,8,19,1,2230,2188,2422,234
2017,8,19,2,2134,2094,2353,259
2017,8,19,3,2091,2081,2311,230
2017,8,19,4,2013,1986,2292,306
2017,8,19,5,1873,1832,2261,429
2017,8,19,6,1725,1671,2070,399
2017,8,19,7,1612,1559,1952,393
2017,8,19,8,1561,1486,1819,333
2017,8,19,9,1498,1441,1818,377
2017,8,19,10,1468,1403,1818,415
2017,8,19,11,1445,1394,1840,446
2017,8,19,12,1445,1409,1826,417
2017,8,19,13,1449,1398,1735,337
2017,8,19,14,1471,1471,1903,432
2017,8,19,15,1585,1554,1944,390
2017,8,19,16,1695,1633,1989,356
2017,8,19,17,1790,1744,1899,155
2017,8,19,18,1853,1843,1894,51
2017,8,19,19,1947,1929,1995,66
2017,8,19,20,2026,2013,2185,172
2017,8,19,21,2099,2066,2342,276
2017,8,19,22,2131,2114,2338,224
2017,8,19,23,2152,2135,2359,224
2017,8,20,0,2122,2108,2384,276
2017,8,20,1,2066,2012,2266,254
2017,8,20,2,2002,1949,2149,200
2017,8,20,3,1979,1962,2101,139
2017,8,20,4,1909,1880,2081,201
2017,8,20,5,1796,1753,1951,198
2017,8,20,6,1671,1605,1900,295
2017,8,20,7,1573,1512,1764,252
2017,8,20,8,1479,1445,1536,91
2017,8,20,9,1433,1400,1554,154
2017,8,20,10,1401,1365,1566,201
2017,8,20,11,1387,1348,1562,214
2017,8,20,12,1397,1364,1596,232
2017,8,20,13,1389,1375,1697,322
2017,8,20,14,1421,1388,1778,390
2017,8,20,15,1476,1456,1870,414
2017,8,20,16,1551,1541,1912,371
2017,8,20,17,1635,1610,2036,426
2017,8,20,18,1692,1662,2046,384
2017,8,20,19,1745,1688,2091,403
2017,8,20,20,1804,1694,2201,507
2017,8,20,21,1778,1690,2190,500
2017,8,20,22,1735,1685,2253,568
2017,8,20,23,1745,1691,2299,608
2017,8,21,0,1743,1705,2315,610
2017,8,21,1,1705,1710,2303,593
2017,8,21,2,1703,1725,2346,621
2017,8,21,3,1730,1769,2344,575
2017,8,21,4,1705,1710,2273,563
2017,8,21,5,1620,1584,2044,460
2017,8,21,6,1500,1451,1880,429
2017,8,21,7,1421,1382,1775,393
2017,8,21,8,1377,1344,1692,348
2017,8,21,9,1344,1317,1725,408
2017,8,21,10,1336,1312,1725,413
2017,8,21,11,1343,1322,1721,399
2017,8,21,12,1393,1378,1729,351
2017,8,21,13,1482,1486,1750,264
2017,8,21,14,1559,1545,1904,359
2017,8,21,15,1612,1599,1925,326
2017,8,21,16,1668,1647,1938,291
2017,8,21,17,1716,1694,2005,311
2017,8,21,18,1757,1728,1957,229
2017,8,21,19,1759,1707,1960,253
2017,8,21,20,1790,1736,2067,331
2017,8,21,21,1843,1784,2166,382
2017,8,21,22,1894,1849,2288,439
2017,8,21,23,1956,1909,2313,404
2017,8,22,0,1983,1940,2312,372
2017,8,22,1,1966,1921,2293,372
2017,8,22,2,1935,1889,2269,380
2017,8,22,3,1960,1929,2326,397
2017,8,22,4,1894,1826,2287,461
2017,8,22,5,1724,1666,2061,395
2017,8,22,6,1576,1531,1931,400
2017,8,22,7,1476,1436,1771,335
2017,8,22,8,1414,1376,1600,224
2017,8,22,9,1369,1340,1555,215
2017,8,22,10,1353,1320,1524,204
2017,8,22,11,1347,1327,1502,175
2017,8,22,12,1399,1383,1493,110
2017,8,22,13,1492,1465,1511,46
2017,8,22,14,1553,1513,1625,112
2017,8,22,15,1616,1581,1713,132
2017,8,22,16,1680,1637,1773,136
2017,8,22,17,1770,1725,1841,116
2017,8,22,18,1847,1798,1945,147
2017,8,22,19,1930,1884,1993,109
2017,8,22,20,2012,1971,2052,81
2017,8,22,21,2086,2045,2136,91
2017,8,22,22,2150,2120,2237,117
2017,8,22,23,2176,2158,2275,117
2017,8,23,0,2154,2127,2316,189
2017,8,23,1,2098,2070,2305,235
2017,8,23,2,2036,1991,2336,345
2017,8,23,3,2044,1999,2326,327
2017,8,23,4,1953,1890,2224,334
2017,8,23,5,1796,1729,2023,294
2017,8,23,6,1630,1577,1879,302
2017,8,23,7,1526,1476,1711,235
2017,8,23,8,1451,1413,1628,215
2017,8,23,9,1408,1377,1611,234
2017,8,23,10,1388,1348,1700,352
2017,8,23,11,1398,1354,1690,336
2017,8,23,12,1446,1416,1768,352
2017,8,23,13,1538,1519,1818,299
2017,8,23,14,1580,1567,1860,293
2017,8,23,15,1655,1628,1877,249
2017,8,23,16,1732,1691,1887,196
2017,8,23,17,1811,1779,2104,325
2017,8,23,18,1881,1856,2161,305
2017,8,23,19,1955,1928,2249,321
2017,8,23,20,2040,2016,2285,269
2017,8,23,21,2124,2099,2340,241
2017,8,23,22,2177,2137,2409,272
2017,8,23,23,2190,2149,2380,231
2017,8,24,0,2101,2035,2272,237
2017,8,24,1,2013,1941,2170,229
2017,8,24,2,1968,1907,2077,170
2017,8,24,3,1967,1906,2120,214
2017,8,24,4,1860,1792,2096,304
2017,8,24,5,1731,1642,1922,280
2017,8,24,6,1585,1499,1936,437
2017,8,24,7,1478,1404,1885,481
2017,8,24,8,1405,1347,1852,505
2017,8,24,9,1363,1306,1806,500
2017,8,24,10,1343,1286,1750,464
2017,8,24,11,1355,1300,1738,438
2017,8,24,12,1409,1371,1749,378
2017,8,24,13,1513,1501,1804,303
2017,8,24,14,1575,1559,1875,316
2017,8,24,15,1612,1590,1883,293
2017,8,24,16,1644,1621,1822,201
2017,8,24,17,1698,1675,1873,198
2017,8,24,18,1733,1703,1965,262
2017,8,24,19,1752,1709,2051,342
2017,8,24,20,1786,1744,2000,256
2017,8,24,21,1800,1756,2062,306
2017,8,24,22,1808,1759,2054,295
2017,8,24,23,1815,1768,2105,337
2017,8,25,0,1798,1753,2163,410
2017,8,25,1,1799,1750,2044,294
2017,8,25,2,1786,1753,2025,272
2017,8,25,3,1841,1805,2069,264
2017,8,25,4,1780,1731,2122,391
2017,8,25,5,1660,1599,2134,535
2017,8,25,6,1489,1472,2030,558
2017,8,25,7,1399,1388,1949,561
2017,8,25,8,1376,1342,2016,674
2017,8,25,9,1348,1319,2072,753
2017,8,25,10,1324,1304,2122,818
2017,8,25,11,1323,1307,2102,795
2017,8,25,12,1369,1367,2090,723
2017,8,25,13,1449,1456,2101,645
2017,8,25,14,1522,1496,2113,617
2017,8,25,15,1569,1563,2113,550
2017,8,25,16,1602,1638,2184,546
2017,8,25,17,1698,1709,2262,553
2017,8,25,18,1756,1786,2295,509
2017,8,25,19,1816,1848,2348,500
2017,8,25,20,1884,1920,2417,497
2017,8,25,21,1955,1989,2511,522
2017,8,25,22,2014,2061,2564,503
2017,8,25,23,2035,2091,2518,427
2017,8,26,0,2058,2083,2562,479
2017,8,26,1,1993,2027,2529,502
2017,8,26,2,1961,1955,2412,457
2017,8,26,3,1958,1978,2448,470
2017,8,26,4,1889,1890,2392,502
2017,8,26,5,1762,1752,2216,464
2017,8,26,6,1619,1618,2171,553
2017,8,26,7,1508,1523,2074,551
2017,8,26,8,1414,1447,2083,636
2017,8,26,9,1365,1404,2069,665
2017,8,26,10,1334,1384,2121,737
2017,8,26,11,1353,1349,2083,734
2017,8,26,12,1368,1372,2073,701
2017,8,26,13,1385,1396,2105,709
2017,8,26,14,1419,1421,2068,647
2017,8,26,15,1501,1513,2134,621
2017,8,26,16,1585,1599,2253,654
2017,8,26,17,1661,1702,2310,608
2017,8,26,18,1734,1801,2334,533
2017,8,26,19,1826,1892,2410,518
2017,8,26,20,1895,1975,2466,491
2017,8,26,21,1954,2055,2576,521
2017,8,26,22,2077,2115,2656,541
2017,8,26,23,2104,2138,2634,496
2017,8,27,0,2098,2112,2612,500
2017,8,27,1,2080,2007,2535,528
2017,8,27,2,2009,1945,2455,510
2017,8,27,3,1981,1931,2379,448
2017,8,27,4,1866,1838,2314,476
2017,8,27,5,1756,1702,2166,464
2017,8,27,6,1624,1599,2069,470
2017,8,27,7,1520,1513,1961,448
2017,8,27,8,1427,1443,1892,449
2017,8,27,9,1386,1394,1842,448
2017,8,27,10,1349,1361,1756,395
2017,8,27,11,1324,1346,1820,474
2017,8,27,12,1331,1356,1855,499
2017,8,27,13,1361,1351,1810,459
2017,8,27,14,1387,1374,1900,526
2017,8,27,15,1469,1460,2000,540
2017,8,27,16,1562,1564,2076,512
2017,8,27,17,1659,1673,2208,535
2017,8,27,18,1765,1778,2422,644
2017,8,27,19,1852,1883,2556,673
2017,8,27,20,1938,1963,2589,626
2017,8,27,21,1944,2049,2697,648
2017,8,27,22,2063,2084,2791,707
2017,8,27,23,2095,2070,2756,686
2017,8,28,0,2091,2029,2722,693
2017,8,28,1,1943,1992,2710,718
2017,8,28,2,1914,1948,2696,748
2017,8,28,3,1943,1962,2672,710
2017,8,28,4,1875,1855,2563,708
2017,8,28,5,1746,1686,2284,598
2017,8,28,6,1610,1547,2178,631
2017,8,28,7,1510,1450,2111,661
2017,8,28,8,1421,1385,2153,768
2017,8,28,9,1387,1360,2122,762
2017,8,28,10,1358,1346,2093,747
2017,8,28,11,1371,1352,2079,727
2017,8,28,12,1428,1415,2045,630
2017,8,28,13,1507,1528,2100,572
2017,8,28,14,1579,1577,2141,564
2017,8,28,15,1664,1641,2122,481
2017,8,28,16,1743,1708,2126,418
2017,8,28,17,1813,1782,2145,363
2017,8,28,18,1900,1880,2284,404
2017,8,28,19,1966,1970,2440,470
2017,8,28,20,2047,2061,2573,512
2017,8,28,21,2133,2140,2746,606
2017,8,28,22,2193,2195,2869,674
2017,8,28,23,2210,2151,2867,716
2017,8,29,0,2159,2059,2732,673
2017,8,29,1,2028,1946,2670,724
2017,8,29,2,1962,1912,2545,633
2017,8,29,3,1964,1926,2564,638
2017,8,29,4,1879,1815,2526,711
2017,8,29,5,1726,1683,2308,625
2017,8,29,6,1584,1544,2211,667
2017,8,29,7,1483,1453,2104,651
2017,8,29,8,1437,1400,2021,621
2017,8,29,9,1393,1360,1971,611
2017,8,29,10,1364,1335,1947,612
2017,8,29,11,1367,1337,1981,644
2017,8,29,12,1428,1395,1995,600
2017,8,29,13,1495,1497,2027,530
2017,8,29,14,1555,1529,2061,532
2017,8,29,15,1630,1559,2178,619
2017,8,29,16,1670,1636,2226,590
2017,8,29,17,1746,1704,2323,619
2017,8,29,18,1843,1786,2490,704
2017,8,29,19,1912,1868,2647,779
2017,8,29,20,1983,1950,2696,746
2017,8,29,21,2051,2033,2768,735
2017,8,29,22,2122,2110,2843,733
2017,8,29,23,2149,2169,3040,871
2017,8,30,0,2139,2073,3000,927
2017,8,30,1,1975,1952,2824,872
2017,8,30,2,1933,1912,2712,800
2017,8,30,3,1933,1916,2742,826
2017,8,30,4,1857,1808,2728,920
2017,8,30,5,1713,1666,2526,860
2017,8,30,6,1578,1516,2223,707
2017,8,30,7,1485,1426,2113,687
2017,8,30,8,1420,1370,2051,681
2017,8,30,9,1375,1345,1956,611
2017,8,30,10,1355,1320,1948,628
2017,8,30,11,1359,1326,1945,619
2017,8,30,12,1399,1386,1936,550
2017,8,30,13,1483,1481,1970,489
2017,8,30,14,1543,1525,2079,554
2017,8,30,15,1603,1584,2127,543
2017,8,30,16,1667,1646,2172,526
2017,8,30,17,1780,1732,2324,592
2017,8,30,18,1855,1812,2387,575
2017,8,30,19,1924,1877,2469,592
2017,8,30,20,2002,1949,2565,616
2017,8,30,21,2061,2032,2684,652
2017,8,30,22,2113,2107,2791,684
2017,8,30,23,2150,2165,2921,756
2017,8,31,0,2128,2171,2891,720
2017,8,31,1,2079,2115,2811,696
2017,8,31,2,2017,2052,2810,758
2017,8,31,3,2012,2039,2792,753
2017,8,31,4,1927,1915,2564,649
2017,8,31,5,1793,1740,2202,462
2017,8,31,6,1630,1585,2108,523
2017,8,31,7,1523,1475,2054,579
2017,8,31,8,1441,1406,1889,483
2017,8,31,9,1395,1361,1866,505
2017,8,31,10,1380,1336,1844,508
2017,8,31,11,1375,1345,1847,502
2017,8,31,12,1402,1387,1881,494
2017,8,31,13,1513,1486,1968,482
2017,8,31,14,1574,1527,1940,413
2017,8,31,15,1630,1599,2010,411
2017,8,31,16,1695,1668,2109,441
2017,8,31,17,1756,1746,2180,434
2017,8,31,18,1838,1823,2298,475
2017,8,31,19,1911,1900,2358,458
2017,8,31,20,2006,1977,2398,421
2017,8,31,21,2078,2059,2551,492
2017,8,31,22,2143,2123,2589,466
2017,8,31,23,2181,2159,2673,514
2017,9,1,0,2159,2150,2731,581
2017,9,1,1,2131,2084,2748,664
2017,9,1,2,2075,2032,2728,696
2017,9,1,3,2050,2029,2698,669
2017,9,1,4,1960,1904,2527,623
2017,9,1,5,1811,1731,2271,540
2017,9,1,6,1654,1580,2123,543
2017,9,1,7,1534,1477,2018,541
2017,9,1,8,1456,1400,1895,495
2017,9,1,9,1408,1352,1869,517
2017,9,1,10,1390,1337,1898,561
2017,9,1,11,1389,1341,1941,600
2017,9,1,12,1430,1394,1968,574
2017,9,1,13,1501,1476,2026,550
2017,9,1,14,1562,1517,2065,548
2017,9,1,15,1637,1581,2080,499
2017,9,1,16,1714,1649,2201,552
2017,9,1,17,1771,1713,2293,580
2017,9,1,18,1849,1786,2444,658
2017,9,1,19,1933,1866,2539,673
2017,9,1,20,1992,1951,2682,731
2017,9,1,21,2063,2028,2802,774
2017,9,1,22,2125,2097,2956,859
2017,9,1,23,2156,2137,3013,876
2017,9,2,0,2134,2129,3008,879
2017,9,2,1,2064,2047,2971,924
2017,9,2,2,2007,1990,2918,928
2017,9,2,3,1991,1972,2909,937
2017,9,2,4,1922,1880,2744,864
2017,9,2,5,1786,1748,2467,719
2017,9,2,6,1642,1614,2426,812
2017,9,2,7,1543,1516,2221,705
2017,9,2,8,1477,1439,2108,669
2017,9,2,9,1424,1390,2047,657
2017,9,2,10,1398,1354,1983,629
2017,9,2,11,1384,1345,1971,626
2017,9,2,12,1382,1355,2025,670
2017,9,2,13,1402,1376,2060,684
2017,9,2,14,1435,1385,2109,724
2017,9,2,15,1511,1469,2262,793
2017,9,2,16,1559,1540,2372,832
2017,9,2,17,1646,1641,2455,814
2017,9,2,18,1738,1736,2500,764
2017,9,2,19,1815,1816,2572,756
2017,9,2,20,1898,1890,2762,872
2017,9,2,21,1975,1951,2831,880
2017,9,2,22,2044,2016,2886,870
2017,9,2,23,2085,2073,2898,825
2017,9,3,0,2079,2069,2939,870
2017,9,3,1,2016,2024,2892,868
2017,9,3,2,1965,1983,2839,856
2017,9,3,3,1950,1955,2842,887
2017,9,3,4,1883,1853,2628,775
2017,9,3,5,1766,1722,2488,766
2017,9,3,6,1632,1589,2338,749
2017,9,3,7,1537,1490,2254,764
2017,9,3,8,1456,1416,2179,763
2017,9,3,9,1408,1368,2111,743
2017,9,3,10,1377,1336,2138,802
2017,9,3,11,1356,1318,2099,781
2017,9,3,12,1362,1325,2126,801
2017,9,3,13,1365,1333,2105,772
2017,9,3,14,1377,1338,2042,704
2017,9,3,15,1460,1410,2170,760
2017,9,3,16,1548,1499,2251,752
2017,9,3,17,1617,1591,2337,746
2017,9,3,18,1713,1692,2393,701
2017,9,3,19,1792,1793,2517,724
2017,9,3,20,1878,1878,2653,775
2017,9,3,21,1966,1972,2803,831
2017,9,3,22,2043,2055,2889,834
2017,9,3,23,2097,2113,2871,758
2017,9,4,0,2114,2128,2879,751
2017,9,4,1,2077,2089,2850,761
2017,9,4,2,2025,2039,2763,724
2017,9,4,3,2002,1995,2741,746
2017,9,4,4,1926,1889,2535,646
2017,9,4,5,1785,1757,2424,667
2017,9,4,6,1649,1619,2384,765
2017,9,4,7,1542,1516,2223,707
2017,9,4,8,1484,1444,2195,751
2017,9,4,9,1426,1395,2209,814
2017,9,4,10,1386,1356,2223,867
2017,9,4,11,1371,1341,2197,856
2017,9,4,12,1371,1346,2139,793
2017,9,4,13,1384,1368,2133,765
2017,9,4,14,1394,1376,2142,766
2017,9,4,15,1458,1439,2251,812
2017,9,4,16,1543,1532,2297,765
2017,9,4,17,1659,1658,2337,679
2017,9,4,18,1767,1771,2376,605
2017,9,4,19,1871,1876,2526,650
2017,9,4,20,1965,1966,2675,709
2017,9,4,21,2059,2066,2824,758
2017,9,4,22,2126,2131,2889,758
2017,9,4,23,2169,2174,2868,694
2017,9,5,0,2198,2176,2888,712
2017,9,5,1,2151,2120,2799,679
2017,9,5,2,2091,2079,2756,677
2017,9,5,3,2068,2055,2817,762
2017,9,5,4,1958,1922,2565,643
2017,9,5,5,1785,1737,2371,634
2017,9,5,6,1660,1579,2211,632
2017,9,5,7,1559,1479,2144,665
2017,9,5,8,1454,1415,2140,725
2017,9,5,9,1402,1363,2162,799
2017,9,5,10,1386,1346,2218,872
2017,9,5,11,1388,1354,2271,917
2017,9,5,12,1435,1405,2361,956
2017,9,5,13,1534,1511,2458,947
2017,9,5,14,1571,1539,2463,924
2017,9,5,15,1626,1595,2510,915
2017,9,5,16,1703,1677,2541,864
2017,9,5,17,1782,1749,2596,847
2017,9,5,18,1854,1812,2643,831
2017,9,5,19,1924,1889,2579,690
2017,9,5,20,2008,1975,2713,738
2017,9,5,21,2074,2051,2737,686
2017,9,5,22,2120,2100,2805,705
2017,9,5,23,2152,2142,2771,629
2017,9,6,0,2137,2119,2798,679
2017,9,6,1,2075,2046,2763,717
2017,9,6,2,2038,2016,2746,730
2017,9,6,3,2014,1999,2752,753
2017,9,6,4,1911,1870,2567,697
2017,9,6,5,1754,1691,2381,690
2017,9,6,6,1602,1544,2273,729
2017,9,6,7,1504,1443,2173,730
2017,9,6,8,1431,1392,2202,810
2017,9,6,9,1362,1328,2162,834
2017,9,6,10,1316,1289,2086,797
2017,9,6,11,1362,1333,1953,620
2017,9,6,12,1412,1385,1898,513
2017,9,6,13,1516,1482,1895,413
2017,9,6,14,1568,1503,1937,434
2017,9,6,15,1613,1557,1988,431
2017,9,6,16,1661,1605,2124,519
2017,9,6,17,1735,1674,2181,507
2017,9,6,18,1788,1740,2242,502
2017,9,6,19,1838,1812,2266,454
2017,9,6,20,1927,1899,2294,395
2017,9,6,21,2025,2002,2428,426
2017,9,6,22,2107,2083,2533,450
2017,9,6,23,2162,2145,2616,471
2017,9,7,0,2130,2110,2606,496
2017,9,7,1,2053,2025,2676,651
2017,9,7,2,2036,2012,2658,646
2017,9,7,3,2021,1997,2652,655
2017,9,7,4,1927,1886,2563,677
2017,9,7,5,1766,1711,2446,735
2017,9,7,6,1609,1586,2357,771
2017,9,7,7,1502,1501,2184,683
2017,9,7,8,1449,1420,2126,706
2017,9,7,9,1406,1378,2093,715
2017,9,7,10,1376,1353,2119,766
2017,9,7,11,1387,1361,2131,770
2017,9,7,12,1435,1414,2175,761
2017,9,7,13,1545,1534,2267,733
2017,9,7,14,1591,1566,2263,697
2017,9,7,15,1642,1601,2200,599
2017,9,7,16,1697,1659,2256,597
2017,9,7,17,1786,1747,2328,581
2017,9,7,18,1865,1845,2464,619
2017,9,7,19,1959,1950,2538,588
2017,9,7,20,2014,2013,2588,575
2017,9,7,21,2130,2120,2752,632
2017,9,7,22,2117,2106,2746,640
2017,9,7,23,2105,2101,2755,654
2017,9,8,0,2053,2037,2640,603
2017,9,8,1,1977,1950,2580,630
2017,9,8,2,1963,1949,2572,623
2017,9,8,3,1962,1949,2420,471
2017,9,8,4,1881,1844,2317,473
2017,9,8,5,1736,1683,2138,455
2017,9,8,6,1594,1543,2049,506
2017,9,8,7,1490,1450,1864,414
2017,9,8,8,1421,1387,1799,412
2017,9,8,9,1373,1337,1796,459
2017,9,8,10,1355,1317,1782,465
2017,9,8,11,1360,1335,1823,488
2017,9,8,12,1404,1377,1846,469
2017,9,8,13,1494,1482,1878,396
2017,9,8,14,1557,1524,1925,401
2017,9,8,15,1606,1568,1954,386
2017,9,8,16,1663,1631,2011,380
2017,9,8,17,1741,1705,2130,425
2017,9,8,18,1813,1782,2259,477
2017,9,8,19,1885,1864,2311,447
2017,9,8,20,1960,1945,2370,425
2017,9,8,21,2047,2025,2467,442
2017,9,8,22,2103,2094,2568,474
2017,9,8,23,2139,2119,2605,486
2017,9,9,0,2112,2102,2607,505
2017,9,9,1,2038,2016,2448,432
2017,9,9,2,2013,1962,2376,414
2017,9,9,3,1997,1957,2406,449
2017,9,9,4,1915,1870,2270,400
2017,9,9,5,1778,1741,2140,399
2017,9,9,6,1637,1609,2040,431
2017,9,9,7,1534,1515,1971,456
2017,9,9,8,1461,1443,1927,484
2017,9,9,9,1407,1392,1890,498
2017,9,9,10,1372,1362,1852,490
2017,9,9,11,1369,1338,1822,484
2017,9,9,12,1373,1367,1806,439
2017,9,9,13,1395,1400,1832,432
2017,9,9,14,1427,1411,1857,446
2017,9,9,15,1495,1480,1924,444
2017,9,9,16,1573,1550,1969,419
2017,9,9,17,1650,1620,2110,490
2017,9,9,18,1724,1706,2117,411
2017,9,9,19,1796,1799,2215,416
2017,9,9,20,1891,1883,2311,428
2017,9,9,21,1960,1937,2390,453
2017,9,9,22,2017,2000,2394,394
2017,9,9,23,2048,2020,2418,398
2017,9,10,0,2061,1990,2435,445
2017,9,10,1,1988,1919,2347,428
2017,9,10,2,1939,1907,2300,393
2017,9,10,3,1925,1874,2311,437
2017,9,10,4,1864,1779,2236,457
2017,9,10,5,1750,1660,2078,418
2017,9,10,6,1615,1543,2022,479
2017,9,10,7,1517,1456,1912,456
2017,9,10,8,1435,1386,1742,356
2017,9,10,9,1387,1345,1719,374
2017,9,10,10,1351,1310,1771,461
2017,9,10,11,1337,1297,1740,443
2017,9,10,12,1349,1308,1728,420
2017,9,10,13,1346,1319,1728,409
2017,9,10,14,1368,1322,1685,363
2017,9,10,15,1429,1403,1809,406
2017,9,10,16,1497,1468,1788,320
2017,9,10,17,1577,1556,1833,277
2017,9,10,18,1662,1642,1877,235
2017,9,10,19,1744,1730,1958,228
2017,9,10,20,1823,1819,2097,278
2017,9,10,21,1919,1902,2215,313
2017,9,10,22,1984,1972,2075,103
2017,9,10,23,2071,2038,2026,-12
2017,9,11,0,2092,2063,2135,72
2017,9,11,1,2057,2043,2134,91
2017,9,11,2,2031,2011,2132,121
2017,9,11,3,2004,1980,2141,161
2017,9,11,4,1929,1828,2059,231
2017,9,11,5,1797,1668,1954,286
2017,9,11,6,1643,1544,1847,303
2017,9,11,7,1531,1446,1782,336
2017,9,11,8,1418,1379,1730,351
2017,9,11,9,1368,1324,1705,381
2017,9,11,10,1356,1314,1683,369
2017,9,11,11,1355,1317,1666,349
2017,9,11,12,1404,1380,1601,221
2017,9,11,13,1493,1472,1489,17
2017,9,11,14,1550,1509,1447,-62
2017,9,11,15,1599,1562,1583,21
2017,9,11,16,1653,1619,1605,-14
2017,9,11,17,1729,1698,1774,76
2017,9,11,18,1810,1773,1785,12
2017,9,11,19,1890,1850,1912,62
2017,9,11,20,1974,1941,2011,70
2017,9,11,21,2074,2041,2062,21
2017,9,11,22,2154,2121,2128,7
2017,9,11,23,2198,2166,2154,-12
2017,9,12,0,2178,2158,2139,-19
2017,9,12,1,2115,2102,2117,15
2017,9,12,2,2064,2067,2114,47
2017,9,12,3,2042,2037,2071,34
2017,9,12,4,1926,1900,2033,133
2017,9,12,5,1764,1723,1830,107
2017,9,12,6,1617,1564,1707,143
2017,9,12,7,1513,1467,1597,130
2017,9,12,8,1436,1393,1487,94
2017,9,12,9,1389,1342,1435,93
2017,9,12,10,1361,1312,1402,90
2017,9,12,11,1355,1313,1398,85
2017,9,12,12,1410,1373,1448,75
2017,9,12,13,1510,1479,1301,-178
2017,9,12,14,1557,1512,1129,-383
2017,9,12,15,1606,1557,1259,-298
2017,9,12,16,1664,1565,1355,-210
2017,9,12,17,1741,1666,1469,-197
2017,9,12,18,1849,1765,1648,-117
2017,9,12,19,1925,1843,1817,-26
2017,9,12,20,2012,1922,1884,-38
2017,9,12,21,2104,2012,2019,7
2017,9,12,22,2172,2091,2099,8
2017,9,12,23,2211,2127,2112,-15
2017,9,13,0,2183,2036,2019,-17
2017,9,13,1,2095,1933,1980,47
2017,9,13,2,2001,1945,1927,-18
2017,9,13,3,1984,1939,1878,-61
2017,9,13,4,1899,1824,1811,-13
2017,9,13,5,1740,1658,1640,-18
2017,9,13,6,1593,1517,1569,52
2017,9,13,7,1497,1429,1352,-77
2017,9,13,8,1417,1364,1251,-113
2017,9,13,9,1372,1325,1309,-16
2017,9,13,10,1352,1298,1296,-2
2017,9,13,11,1356,1300,1297,-3
2017,9,13,12,1406,1355,1326,-29
2017,9,13,13,1511,1473,1395,-78
2017,9,13,14,1557,1510,1439,-71
2017,9,13,15,1601,1560,1405,-155
2017,9,13,16,1673,1642,1451,-191
2017,9,13,17,1756,1737,1581,-156
2017,9,13,18,1843,1815,1553,-262
2017,9,13,19,1931,1913,1722,-191
2017,9,13,20,2022,2003,1881,-122
2017,9,13,21,2113,2093,1961,-132
2017,9,13,22,2187,2125,2034,-91
2017,9,13,23,2230,2158,1993,-165
2017,9,14,0,2197,2096,1905,-191
2017,9,14,1,2071,1992,1837,-155
2017,9,14,2,2007,1983,1819,-164
2017,9,14,3,2029,1964,1832,-132
2017,9,14,4,1912,1828,1813,-15
2017,9,14,5,1730,1664,1555,-109
2017,9,14,6,1569,1518,1519,1
2017,9,14,7,1464,1429,1493,64
2017,9,14,8,1398,1378,1545,167
2017,9,14,9,1353,1341,1501,160
2017,9,14,10,1326,1314,1482,168
2017,9,14,11,1326,1316,1473,157
2017,9,14,12,1379,1379,1513,134
2017,9,14,13,1477,1479,1523,44
2017,9,14,14,1530,1512,1511,-1
2017,9,14,15,1552,1565,1500,-65
2017,9,14,16,1665,1632,1593,-39
2017,9,14,17,1706,1677,1750,73
2017,9,14,18,1730,1711,1642,-69
2017,9,14,19,1745,1730,1781,51
2017,9,14,20,1771,1743,1827,84
2017,9,14,21,1841,1790,1846,56
2017,9,14,22,1878,1854,1906,52
2017,9,14,23,1882,1851,1601,-250
2017,9,15,0,1878,1829,1495,-334
2017,9,15,1,1847,1791,1576,-215
2017,9,15,2,1839,1795,1528,-267
2017,9,15,3,1842,1777,1524,-253
2017,9,15,4,1769,1687,1578,-109
2017,9,15,5,1612,1557,1417,-140
2017,9,15,6,1503,1449,1354,-95
2017,9,15,7,1411,1368,1197,-171
2017,9,15,8,1346,1320,1220,-100
2017,9,15,9,1304,1281,1206,-75
2017,9,15,10,1279,1271,1260,-11
2017,9,15,11,1288,1282,1305,23
2017,9,15,12,1333,1342,1276,-66
2017,9,15,13,1429,1451,1244,-207
2017,9,15,14,1483,1484,1304,-180
2017,9,15,15,1536,1528,1369,-159
2017,9,15,16,1589,1583,1480,-103
2017,9,15,17,1644,1629,1573,-56
2017,9,15,18,1696,1678,1544,-134
2017,9,15,19,1704,1698,1569,-129
2017,9,15,20,1786,1773,1619,-154
2017,9,15,21,1851,1835,1739,-96
2017,9,15,22,1887,1872,1789,-83
2017,9,15,23,1919,1895,1811,-84
2017,9,16,0,1913,1879,1832,-47
2017,9,16,1,1859,1828,1826,-2
2017,9,16,2,1842,1823,1858,35
2017,9,16,3,1856,1823,1856,33
2017,9,16,4,1797,1671,1742,71
2017,9,16,5,1689,1589,1702,113
2017,9,16,6,1559,1482,1700,218
2017,9,16,7,1460,1392,1699,307
2017,9,16,8,1371,1328,1741,413
2017,9,16,9,1334,1293,1739,446
2017,9,16,10,1299,1262,1658,396
2017,9,16,11,1297,1255,1634,379
2017,9,16,12,1311,1282,1561,279
2017,9,16,13,1329,1310,1493,183
2017,9,16,14,1356,1336,1363,27
2017,9,16,15,1415,1402,1307,-95
2017,9,16,16,1477,1459,1371,-88
2017,9,16,17,1540,1528,1433,-95
2017,9,16,18,1594,1579,1539,-40
2017,9,16,19,1640,1632,1551,-81
2017,9,16,20,1692,1689,1571,-118
2017,9,16,21,1749,1740,1606,-134
2017,9,16,22,1806,1786,1638,-148
2017,9,16,23,1849,1830,1639,-191
2017,9,17,0,1850,1839,1695,-144
2017,9,17,1,1822,1805,1666,-139
2017,9,17,2,1807,1795,1675,-120
2017,9,17,3,1790,1761,1681,-80
2017,9,17,4,1724,1670,1620,-50
2017,9,17,5,1631,1549,1577,28
2017,9,17,6,1516,1433,1596,163
2017,9,17,7,1429,1367,1513,146
2017,9,17,8,1331,1312,1332,20
2017,9,17,9,1287,1272,1311,39
2017,9,17,10,1273,1256,1245,-11
2017,9,17,11,1267,1249,1223,-26
2017,9,17,12,1274,1262,1279,17
2017,9,17,13,1290,1283,1317,34
2017,9,17,14,1301,1276,1354,78
2017,9,17,15,1354,1334,1372,38
2017,9,17,16,1419,1405,1383,-22
2017,9,17,17,1473,1471,1599,128
2017,9,17,18,1549,1551,1708,157
2017,9,17,19,1629,1626,1820,194
2017,9,17,20,1694,1684,1810,126
2017,9,17,21,1775,1765,1938,173
2017,9,17,22,1809,1795,2034,239
2017,9,17,23,1846,1834,2054,220
2017,9,18,0,1854,1845,2094,249
2017,9,18,1,1826,1814,2063,249
2017,9,18,2,1834,1838,2079,241
2017,9,18,3,1818,1824,2095,271
2017,9,18,4,1745,1713,2024,311
2017,9,18,5,1626,1571,1992,421
2017,9,18,6,1495,1432,1899,467
2017,9,18,7,1404,1353,1816,463
2017,9,18,8,1323,1307,1789,482
2017,9,18,9,1299,1283,1745,462
2017,9,18,10,1276,1267,1697,430
2017,9,18,11,1276,1274,1638,364
2017,9,18,12,1327,1328,1653,325
2017,9,18,13,1427,1434,1647,213
2017,9,18,14,1481,1469,1595,126
2017,9,18,15,1518,1501,1589,88
2017,9,18,16,1568,1546,1600,54
2017,9,18,17,1622,1605,1608,3
2017,9,18,18,1678,1666,1696,30
2017,9,18,19,1725,1719,1863,144
2017,9,18,20,1791,1777,1940,163
2017,9,18,21,1850,1840,2039,199
2017,9,18,22,1922,1910,2078,168
2017,9,18,23,1978,1960,2150,190
2017,9,19,0,1971,1970,2138,168
2017,9,19,1,1920,1920,2093,173
2017,9,19,2,1890,1904,2086,182
2017,9,19,3,1918,1867,2102,235
2017,9,19,4,1829,1738,2029,291
2017,9,19,5,1674,1572,1894,322
2017,9,19,6,1529,1432,1806,374
2017,9,19,7,1442,1347,1781,434
2017,9,19,8,1325,1300,1820,520
2017,9,19,9,1305,1277,1798,521
2017,9,19,10,1278,1254,1768,514
2017,9,19,11,1283,1265,1747,482
2017,9,19,12,1338,1321,1810,489
2017,9,19,13,1442,1433,1974,541
2017,9,19,14,1464,1459,1925,466
2017,9,19,15,1491,1490,1917,427
2017,9,19,16,1534,1530,1947,417
2017,9,19,17,1581,1576,2040,464
2017,9,19,18,1631,1622,2065,443
2017,9,19,19,1682,1669,2138,469
2017,9,19,20,1742,1731,2287,556
2017,9,19,21,1816,1800,2299,499
2017,9,19,22,1880,1862,2333,471
2017,9,19,23,1934,1904,2390,486
2017,9,20,0,1940,1905,2343,438
2017,9,20,1,1901,1865,2272,407
2017,9,20,2,1878,1869,2302,433
2017,9,20,3,1863,1845,2284,439
2017,9,20,4,1805,1730,2070,340
2017,9,20,5,1665,1569,1977,408
2017,9,20,6,1524,1444,1806,362
2017,9,20,7,1432,1375,1711,336
2017,9,20,8,1340,1313,1671,358
2017,9,20,9,1309,1282,1728,446
2017,9,20,10,1287,1261,1699,438
2017,9,20,11,1290,1274,1642,368
2017,9,20,12,1345,1334,1679,345
2017,9,20,13,1449,1445,1809,364
2017,9,20,14,1505,1480,1852,372
2017,9,20,15,1537,1518,1810,292
2017,9,20,16,1569,1559,1850,291
2017,9,20,17,1620,1613,1920,307
2017,9,20,18,1675,1654,1889,235
2017,9,20,19,1724,1708,1957,249
2017,9,20,20,1782,1765,1937,172
2017,9,20,21,1848,1843,2047,204
2017,9,20,22,1922,1901,2082,181
2017,9,20,23,1967,1944,2100,156
2017,9,21,0,1964,1958,2088,130
2017,9,21,1,1915,1907,2101,194
2017,9,21,2,1904,1890,2146,256
2017,9,21,3,1908,1841,2044,203
2017,9,21,4,1816,1728,1900,172
2017,9,21,5,1666,1577,1852,275
2017,9,21,6,1526,1441,1755,314
2017,9,21,7,1432,1361,1668,307
2017,9,21,8,1350,1303,1688,385
2017,9,21,9,1322,1281,1686,405
2017,9,21,10,1302,1261,1612,351
2017,9,21,11,1300,1267,1583,316
2017,9,21,12,1364,1322,1585,263
2017,9,21,13,1458,1437,1715,278
2017,9,21,14,1495,1462,1733,271
2017,9,21,15,1546,1514,1708,194
2017,9,21,16,1595,1567,1708,141
2017,9,21,17,1646,1625,1892,267
2017,9,21,18,1700,1696,2015,319
2017,9,21,19,1761,1730,2017,287
2017,9,21,20,1832,1800,2063,263
2017,9,21,21,1895,1860,2216,356
2017,9,21,22,1962,1924,2208,284
2017,9,21,23,1980,1978,2252,274
2017,9,22,0,1983,1969,2284,315
2017,9,22,1,1945,1929,2323,394
2017,9,22,2,1915,1937,2367,430
2017,9,22,3,1897,1907,2407,500
2017,9,22,4,1852,1788,2336,548
2017,9,22,5,1704,1636,2193,557
2017,9,22,6,1562,1495,2132,637
2017,9,22,7,1468,1402,2035,633
2017,9,22,8,1391,1348,2044,696
2017,9,22,9,1347,1307,2064,757
2017,9,22,10,1323,1284,2074,790
2017,9,22,11,1323,1286,2049,763
2017,9,22,12,1363,1331,2077,746
2017,9,22,13,1462,1440,2142,702
2017,9,22,14,1507,1468,2182,714
2017,9,22,15,1553,1514,2108,594
2017,9,22,16,1596,1567,2196,629
2017,9,22,17,1652,1604,2242,638
2017,9,22,18,1713,1614,2170,556
2017,9,22,19,1764,1722,2327,605
2017,9,22,20,1832,1766,2433,667
2017,9,22,21,1897,1819,2496,677
2017,9,22,22,1941,1850,2491,641
2017,9,22,23,1959,1845,2471,626
2017,9,23,0,1950,1817,2424,607
2017,9,23,1,1908,1760,2372,612
2017,9,23,2,1874,1806,2432,626
2017,9,23,3,1859,1802,2382,580
2017,9,23,4,1789,1716,2276,560
2017,9,23,5,1676,1598,2238,640
2017,9,23,6,1549,1480,2179,699
2017,9,23,7,1456,1396,2117,721
2017,9,23,8,1377,1337,2089,752
2017,9,23,9,1343,1303,2132,829
2017,9,23,10,1323,1287,2087,800
2017,9,23,11,1314,1284,2137,853
2017,9,23,12,1324,1302,2134,832
2017,9,23,13,1367,1354,2216,862
2017,9,23,14,1396,1372,2251,879
2017,9,23,15,1456,1434,2223,789
2017,9,23,16,1506,1490,2134,644
2017,9,23,17,1551,1527,2130,603
2017,9,23,18,1577,1555,2213,658
2017,9,23,19,1601,1572,2112,540
2017,9,23,20,1628,1600,2175,575
2017,9,23,21,1683,1649,2260,611
2017,9,23,22,1696,1653,2168,515
2017,9,23,23,1692,1641,2267,626
2017,9,24,0,1684,1618,2320,702
2017,9,24,1,1649,1610,2325,715
2017,9,24,2,1665,1643,2337,694
2017,9,24,3,1677,1630,2299,669
2017,9,24,4,1624,1563,2257,694
2017,9,24,5,1539,1484,2155,671
2017,9,24,6,1440,1389,2188,799
2017,9,24,7,1371,1312,2165,853
2017,9,24,8,1312,1265,2023,758
2017,9,24,9,1277,1236,1956,720
2017,9,24,10,1255,1219,1942,723
2017,9,24,11,1248,1212,1957,745
2017,9,24,12,1234,1207,1933,726
2017,9,24,13,1274,1256,1942,686
2017,9,24,14,1284,1262,1954,692
2017,9,24,15,1327,1304,1959,655
2017,9,24,16,1364,1340,1842,502
2017,9,24,17,1409,1381,1878,497
2017,9,24,18,1439,1415,1929,514
2017,9,24,19,1464,1430,1930,500
2017,9,24,20,1495,1465,1963,498
2017,9,24,21,1527,1484,2039,555
2017,9,24,22,1577,1541,2064,523
2017,9,24,23,1626,1596,2131,535
2017,9,25,0,1648,1637,2126,489
2017,9,25,1,1687,1651,2062,411
2017,9,25,2,1704,1693,2240,547
2017,9,25,3,1729,1672,2290,618
2017,9,25,4,1661,1582,2251,669
2017,9,25,5,1559,1447,2209,762
2017,9,25,6,1430,1342,2121,779
2017,9,25,7,1353,1267,2058,791
2017,9,25,8,1287,1229,1999,770
2017,9,25,9,1260,1215,1947,732
2017,9,25,10,1250,1209,1905,696
2017,9,25,11,1260,1221,1929,708
2017,9,25,12,1325,1282,1945,663
2017,9,25,13,1434,1410,2042,632
2017,9,25,14,1489,1446,2055,609
2017,9,25,15,1506,1462,2065,603
2017,9,25,16,1514,1476,1989,513
2017,9,25,17,1534,1499,1968,469
2017,9,25,18,1545,1531,2014,483
2017,9,25,19,1556,1551,2089,538
2017,9,25,20,1564,1579,2121,542
2017,9,25,21,1602,1615,2196,581
2017,9,25,22,1624,1650,2229,579
2017,9,25,23,1637,1684,2274,590
2017,9,26,0,1632,1689,2455,766
2017,9,26,1,1635,1663,2453,790
2017,9,26,2,1705,1701,2462,761
2017,9,26,3,1729,1665,2475,810
2017,9,26,4,1666,1563,2393,830
2017,9,26,5,1542,1453,2259,806
2017,9,26,6,1424,1353,2207,854
2017,9,26,7,1348,1282,2172,890
2017,9,26,8,1287,1246,2186,940
2017,9,26,9,1262,1230,2138,908
2017,9,26,10,1249,1212,2114,902
2017,9,26,11,1258,1235,2170,935
2017,9,26,12,1312,1295,2234,939
2017,9,26,13,1411,1425,2308,883
2017,9,26,14,1469,1454,2365,911
2017,9,26,15,1486,1473,2308,835
2017,9,26,16,1502,1486,2242,756
2017,9,26,17,1530,1503,2201,698
2017,9,26,18,1544,1526,2210,684
2017,9,26,19,1550,1555,2239,684
2017,9,26,20,1567,1589,2268,679
2017,9,26,21,1618,1633,2348,715
2017,9,26,22,1627,1647,2422,775
2017,9,26,23,1633,1647,2488,841
2017,9,27,0,1620,1646,2490,844
2017,9,27,1,1661,1657,2502,845
2017,9,27,2,1675,1691,2520,829
2017,9,27,3,1776,1649,2435,786
2017,9,27,4,1703,1566,2325,759
2017,9,27,5,1503,1443,2208,765
2017,9,27,6,1401,1346,2166,820
2017,9,27,7,1329,1285,2173,888
2017,9,27,8,1291,1246,2168,922
2017,9,27,9,1267,1216,2161,945
2017,9,27,10,1255,1204,2142,938
2017,9,27,11,1255,1215,2184,969
2017,9,27,12,1328,1292,2218,926
2017,9,27,13,1437,1418,2273,855
2017,9,27,14,1489,1469,2339,870
2017,9,27,15,1515,1487,2343,856
2017,9,27,16,1532,1502,2340,838
2017,9,27,17,1544,1543,2330,787
2017,9,27,18,1552,1564,2295,731
2017,9,27,19,1562,1544,2281,737
2017,9,27,20,1580,1539,2321,782
2017,9,27,21,1593,1552,2391,839
2017,9,27,22,1596,1554,2415,861
2017,9,27,23,1593,1557,2447,890
2017,9,28,0,1609,1579,2464,885
2017,9,28,1,1623,1593,2510,917
2017,9,28,2,1635,1621,2474,853
2017,9,28,3,1663,1588,2406,818
2017,9,28,4,1607,1509,2374,865
2017,9,28,5,1501,1395,2362,967
2017,9,28,6,1397,1315,2275,960
2017,9,28,7,1328,1258,2203,945
2017,9,28,8,1285,1213,2160,947
2017,9,28,9,1256,1196,2126,930
2017,9,28,10,1241,1185,2109,924
2017,9,28,11,1250,1217,2092,875
2017,9,28,12,1311,1284,2141,857
2017,9,28,13,1416,1411,2204,793
2017,9,28,14,1482,1450,2234,784
2017,9,28,15,1499,1459,2211,752
2017,9,28,16,1506,1479,2144,665
2017,9,28,17,1507,1495,2167,672
2017,9,28,18,1551,1491,2209,718
2017,9,28,19,1557,1498,2223,725
2017,9,28,20,1559,1529,2257,728
2017,9,28,21,1579,1532,2334,802
2017,9,28,22,1590,1543,2368,825
2017,9,28,23,1594,1554,2441,887
2017,9,29,0,1609,1538,2437,899
2017,9,29,1,1627,1559,2474,915
2017,9,29,2,1645,1625,2503,878
2017,9,29,3,1659,1605,2442,837
2017,9,29,4,1601,1534,2375,841
2017,9,29,5,1491,1419,2363,944
2017,9,29,6,1392,1314,2372,1058
2017,9,29,7,1320,1248,2408,1160
2017,9,29,8,1280,1213,2284,1071
2017,9,29,9,1228,1195,2266,1071
2017,9,29,10,1217,1185,2212,1027
2017,9,29,11,1233,1194,2195,1001
2017,9,29,12,1288,1262,2181,919
2017,9,29,13,1392,1385,2294,909
2017,9,29,14,1440,1440,2286,846
2017,9,29,15,1454,1460,2240,780
2017,9,29,16,1500,1482,2184,702
2017,9,29,17,1518,1502,2160,658
2017,9,29,18,1538,1480,2165,685
2017,9,29,19,1542,1491,2245,754
2017,9,29,20,1540,1525,2312,787
2017,9,29,21,1548,1534,2348,814
2017,9,29,22,1557,1558,2380,822
2017,9,29,23,1570,1560,2359,799
2017,9,30,0,1576,1551,2354,803
2017,9,30,1,1585,1534,2273,739
2017,9,30,2,1604,1575,2234,659
2017,9,30,3,1623,1575,2216,641
2017,9,30,4,1582,1517,2245,728
2017,9,30,5,1492,1424,2342,918
2017,9,30,6,1386,1328,2371,1043
2017,9,30,7,1326,1264,2214,950
2017,9,30,8,1275,1225,2193,968
2017,9,30,9,1250,1180,2125,945
2017,9,30,10,1233,1148,2066,918
2017,9,30,11,1235,1161,2048,887
2017,9,30,12,1250,1195,2055,860
2017,9,30,13,1298,1254,2100,846
2017,9,30,14,1339,1293,2127,834
2017,9,30,15,1390,1343,2121,778
2017,9,30,16,1429,1382,2109,727
2017,9,30,17,1461,1406,2178,772
2017,9,30,18,1462,1402,2210,808
2017,9,30,19,1457,1391,2220,829
2017,9,30,20,1458,1399,2215,816
2017,9,30,21,1485,1423,2301,878
2017,9,30,22,1516,1458,2360,902
2017,9,30,23,1546,1482,2414,932
2017,10,1,0,1579,1501,2478,977
2017,10,1,1,1587,1491,2442,951
2017,10,1,2,1600,1548,2446,898
2017,10,1,3,1619,1532,2432,900
2017,10,1,4,1573,1477,2411,934
2017,10,1,5,1485,1361,2367,1006
2017,10,1,6,1388,1280,2318,1038
2017,10,1,7,1323,1217,2164,947
2017,10,1,8,1261,1172,2067,895
2017,10,1,9,1243,1167,2052,885
2017,10,1,10,1223,1170,2047,877
2017,10,1,11,1216,1176,2044,868
2017,10,1,12,1238,1197,2008,811
2017,10,1,13,1264,1232,2106,874
2017,10,1,14,1285,1245,2267,1022
2017,10,1,15,1322,1290,2214,924
2017,10,1,16,1366,1337,2153,816
2017,10,1,17,1405,1375,2267,892
2017,10,1,18,1429,1404,2354,950
2017,10,1,19,1455,1427,2441,1014
2017,10,1,20,1480,1458,2381,923
2017,10,1,21,1514,1487,2403,916
2017,10,1,22,1557,1534,2464,930
2017,10,1,23,1595,1579,2505,926
2017,10,2,0,1626,1614,2522,908
2017,10,2,1,1642,1625,2537,912
2017,10,2,2,1662,1684,2613,929
2017,10,2,3,1671,1649,2585,936
2017,10,2,4,1599,1559,2512,953
2017,10,2,5,1492,1443,2480,1037
2017,10,2,6,1381,1333,2377,1044
2017,10,2,7,1307,1267,2348,1081
2017,10,2,8,1240,1212,2312,1100
2017,10,2,9,1195,1184,2263,1079
2017,10,2,10,1168,1183,2158,975
2017,10,2,11,1195,1199,2199,1000
2017,10,2,12,1261,1265,2247,982
2017,10,2,13,1371,1390,2450,1060
2017,10,2,14,1440,1422,2483,1061
2017,10,2,15,1441,1425,2419,994
2017,10,2,16,1459,1436,2369,933
2017,10,2,17,1477,1466,2458,992
2017,10,2,18,1502,1497,2472,975
2017,10,2,19,1531,1529,2494,965
2017,10,2,20,1564,1557,2517,960
2017,10,2,21,1593,1590,2565,975
2017,10,2,22,1633,1632,2599,967
2017,10,2,23,1677,1677,2630,953
2017,10,3,0,1707,1698,2623,925
2017,10,3,1,1692,1670,2571,901
2017,10,3,2,1716,1710,2604,894
2017,10,3,3,1715,1686,2515,829
2017,10,3,4,1635,1591,2452,861
2017,10,3,5,1510,1458,2356,898
2017,10,3,6,1393,1346,2252,906
2017,10,3,7,1313,1276,2182,906
2017,10,3,8,1262,1235,2184,949
2017,10,3,9,1233,1203,2235,1032
2017,10,3,10,1220,1192,2200,1008
2017,10,3,11,1236,1213,2196,983
2017,10,3,12,1285,1275,2217,942
2017,10,3,13,1407,1408,2299,891
2017,10,3,14,1460,1431,2337,906
2017,10,3,15,1469,1428,2230,802
2017,10,3,16,1488,1434,2084,650
2017,10,3,17,1515,1464,2080,616
2017,10,3,18,1544,1498,2126,628
2017,10,3,19,1575,1525,2225,700
2017,10,3,20,1613,1578,2354,776
2017,10,3,21,1660,1632,2390,758
2017,10,3,22,1710,1685,2421,736
2017,10,3,23,1739,1718,2470,752
2017,10,4,0,1747,1723,2470,747
2017,10,4,1,1732,1703,2495,792
2017,10,4,2,1763,1749,2501,752
2017,10,4,3,1763,1732,2420,688
2017,10,4,4,1697,1650,2422,772
2017,10,4,5,1572,1518,2409,891
2017,10,4,6,1451,1403,2358,955
2017,10,4,7,1371,1332,2267,935
2017,10,4,8,1319,1285,2328,1043
2017,10,4,9,1293,1258,2257,999
2017,10,4,10,1276,1244,2251,1007
2017,10,4,11,1295,1268,2249,981
2017,10,4,12,1363,1343,2277,934
2017,10,4,13,1486,1467,2365,898
2017,10,4,14,1541,1507,2322,815
2017,10,4,15,1572,1541,2274,733
2017,10,4,16,1611,1579,2285,706
2017,10,4,17,1639,1611,2193,582
2017,10,4,18,1680,1656,2264,608
2017,10,4,19,1713,1686,2319,633
2017,10,4,20,1759,1728,2347,619
2017,10,4,21,1785,1762,2466,704
2017,10,4,22,1831,1807,2504,697
2017,10,4,23,1840,1819,2512,693
2017,10,5,0,1791,1764,2468,704
2017,10,5,1,1756,1721,2430,709
2017,10,5,2,1781,1763,2400,637
2017,10,5,3,1777,1740,2387,647
2017,10,5,4,1709,1659,2341,682
2017,10,5,5,1579,1530,2316,786
2017,10,5,6,1465,1416,2322,906
2017,10,5,7,1381,1340,2317,977
2017,10,5,8,1339,1295,2257,962
2017,10,5,9,1306,1273,2189,916
2017,10,5,10,1288,1256,2134,878
2017,10,5,11,1301,1270,2158,888
2017,10,5,12,1362,1335,2218,883
2017,10,5,13,1474,1461,2275,814
2017,10,5,14,1538,1509,2263,754
2017,10,5,15,1572,1544,2243,699
2017,10,5,16,1608,1592,2285,693
2017,10,5,17,1650,1628,2295,667
2017,10,5,18,1667,1643,2272,629
2017,10,5,19,1664,1641,2310,669
2017,10,5,20,1710,1684,2433,749
2017,10,5,21,1754,1727,2486,759
2017,10,5,22,1750,1725,2414,689
2017,10,5,23,1753,1725,2414,689
2017,10,6,0,1741,1708,2432,724
2017,10,6,1,1730,1700,2460,760
2017,10,6,2,1773,1758,2449,691
2017,10,6,3,1766,1735,2367,632
2017,10,6,4,1683,1648,2247,599
2017,10,6,5,1561,1526,2161,635
2017,10,6,6,1451,1405,2250,845
2017,10,6,7,1370,1330,2206,876
2017,10,6,8,1313,1280,2293,1013
2017,10,6,9,1287,1252,2250,998
2017,10,6,10,1274,1242,2218,976
2017,10,6,11,1281,1254,2245,991
2017,10,6,12,1330,1316,2239,923
2017,10,6,13,1430,1430,2338,908
2017,10,6,14,1480,1472,2367,895
2017,10,6,15,1509,1506,2402,896
2017,10,6,16,1557,1537,2358,821
2017,10,6,17,1590,1550,2249,699
2017,10,6,18,1622,1584,2306,722
2017,10,6,19,1656,1614,2391,777
2017,10,6,20,1685,1639,2405,766
2017,10,6,21,1688,1649,2431,782
2017,10,6,22,1703,1658,2498,840
2017,10,6,23,1713,1648,2523,875
2017,10,7,0,1695,1611,2564,953
2017,10,7,1,1660,1574,2663,1089
2017,10,7,2,1656,1626,2592,966
2017,10,7,3,1656,1602,2588,986
2017,10,7,4,1606,1536,2506,970
2017,10,7,5,1530,1434,2479,1045
2017,10,7,6,1426,1342,2406,1064
2017,10,7,7,1351,1274,2302,1028
2017,10,7,8,1282,1228,2120,892
2017,10,7,9,1258,1206,2158,952
2017,10,7,10,1244,1203,2120,917
2017,10,7,11,1250,1202,2070,868
2017,10,7,12,1274,1237,2020,783
2017,10,7,13,1320,1289,2063,774
2017,10,7,14,1380,1312,2009,697
2017,10,7,15,1409,1338,2023,685
2017,10,7,16,1439,1353,1984,631
2017,10,7,17,1419,1359,1911,552
2017,10,7,18,1427,1365,1901,536
2017,10,7,19,1443,1367,1957,590
2017,10,7,20,1459,1386,2082,696
2017,10,7,21,1478,1406,2163,757
2017,10,7,22,1502,1448,2242,794
2017,10,7,23,1517,1484,2239,755
2017,10,8,0,1536,1519,2237,718
2017,10,8,1,1544,1535,2273,738
2017,10,8,2,1584,1595,2290,695
2017,10,8,3,1595,1566,2280,714
2017,10,8,4,1572,1503,2333,830
2017,10,8,5,1482,1406,2351,945
2017,10,8,6,1397,1326,2305,979
2017,10,8,7,1332,1271,2310,1039
2017,10,8,8,1278,1227,2361,1134
2017,10,8,9,1253,1210,2318,1108
2017,10,8,10,1235,1193,2367,1174
2017,10,8,11,1239,1204,2326,1122
2017,10,8,12,1255,1223,2317,1094
2017,10,8,13,1287,1255,2333,1078
2017,10,8,14,1313,1268,2258,990
2017,10,8,15,1342,1295,2247,952
2017,10,8,16,1373,1301,2252,951
2017,10,8,17,1389,1327,2126,799
2017,10,8,18,1361,1343,2184,841
2017,10,8,19,1376,1366,2282,916
2017,10,8,20,1401,1395,2349,954
2017,10,8,21,1425,1428,2396,968
2017,10,8,22,1460,1468,2453,985
2017,10,8,23,1489,1505,2476,971
2017,10,9,0,1528,1546,2498,952
2017,10,9,1,1562,1573,2524,951
2017,10,9,2,1629,1641,2649,1008
2017,10,9,3,1647,1606,2578,972
2017,10,9,4,1592,1524,2508,984
2017,10,9,5,1489,1420,2473,1053
2017,10,9,6,1381,1316,2491,1175
2017,10,9,7,1311,1254,2402,1148
2017,10,9,8,1291,1248,2404,1156
2017,10,9,9,1245,1202,2297,1095
2017,10,9,10,1236,1196,2267,1071
2017,10,9,11,1249,1210,2334,1124
2017,10,9,12,1306,1268,2381,1113
2017,10,9,13,1416,1385,2392,1007
2017,10,9,14,1458,1417,2380,963
2017,10,9,15,1479,1430,2350,920
2017,10,9,16,1478,1432,2191,759
2017,10,9,17,1483,1450,2243,793
2017,10,9,18,1491,1464,2251,787
2017,10,9,19,1496,1461,2230,769
2017,10,9,20,1491,1468,2287,819
2017,10,9,21,1487,1468,2329,861
2017,10,9,22,1510,1484,2439,955
2017,10,9,23,1543,1499,2537,1038
2017,10,10,0,1556,1513,2568,1055
2017,10,10,1,1576,1547,2597,1050
2017,10,10,2,1622,1630,2568,938
2017,10,10,3,1650,1628,2536,908
2017,10,10,4,1602,1545,2453,908
2017,10,10,5,1503,1433,2322,889
2017,10,10,6,1402,1339,2282,943
2017,10,10,7,1332,1282,2176,894
2017,10,10,8,1291,1247,2200,953
2017,10,10,9,1269,1233,2180,947
2017,10,10,10,1272,1230,2139,909
2017,10,10,11,1292,1257,2105,848
2017,10,10,12,1359,1336,2147,811
2017,10,10,13,1484,1478,2192,714
2017,10,10,14,1549,1525,2207,682
2017,10,10,15,1537,1509,2142,633
2017,10,10,16,1516,1480,2049,569
2017,10,10,17,1496,1460,2039,579
2017,10,10,18,1492,1458,2103,645
2017,10,10,19,1480,1445,2090,645
2017,10,10,20,1477,1446,2108,662
2017,10,10,21,1513,1465,2127,662
2017,10,10,22,1523,1476,2153,677
2017,10,10,23,1531,1482,2200,718
2017,10,11,0,1543,1508,2212,704
2017,10,11,1,1566,1543,2183,640
2017,10,11,2,1641,1626,2269,643
2017,10,11,3,1688,1614,2308,694
2017,10,11,4,1632,1546,2254,708
2017,10,11,5,1527,1430,2189,759
2017,10,11,6,1427,1328,2171,843
2017,10,11,7,1354,1271,2058,787
2017,10,11,8,1278,1236,2198,962
2017,10,11,9,1270,1230,2191,961
2017,10,11,10,1271,1230,2198,968
2017,10,11,11,1287,1259,2227,968
2017,10,11,12,1346,1331,2277,946
2017,10,11,13,1479,1469,2383,914
2017,10,11,14,1536,1498,2383,885
2017,10,11,15,1524,1483,2336,853
2017,10,11,16,1497,1445,2215,770
2017,10,11,17,1535,1428,2211,783
2017,10,11,18,1501,1417,2280,863
2017,10,11,19,1487,1409,2244,835
2017,10,11,20,1492,1427,2314,887
2017,10,11,21,1504,1449,2378,929
2017,10,11,22,1530,1476,2373,897
2017,10,11,23,1538,1510,2077,567
2017,10,12,0,1547,1522,2074,552
2017,10,12,1,1565,1558,2076,518
2017,10,12,2,1635,1633,2214,581
2017,10,12,3,1672,1615,2231,616
2017,10,12,4,1614,1541,2118,577
2017,10,12,5,1503,1428,2039,611
2017,10,12,6,1395,1331,1916,585
2017,10,12,7,1322,1269,1707,438
2017,10,12,8,1269,1225,1576,351
2017,10,12,9,1243,1204,1544,340
2017,10,12,10,1233,1182,1462,280
2017,10,12,11,1243,1224,1497,273
2017,10,12,12,1307,1289,1529,240
2017,10,12,13,1417,1410,1576,166
2017,10,12,14,1479,1446,1599,153
2017,10,12,15,1493,1448,1650,202
2017,10,12,16,1498,1446,1601,155
2017,10,12,17,1484,1470,1719,249
2017,10,12,18,1496,1473,1721,248
2017,10,12,19,1508,1487,1752,265
2017,10,12,20,1533,1521,1779,258
2017,10,12,21,1566,1546,1830,284
2017,10,12,22,1623,1582,1923,341
2017,10,12,23,1638,1622,1982,360
2017,10,13,0,1646,1620,1952,332
2017,10,13,1,1648,1627,1910,283
2017,10,13,2,1675,1681,1977,296
2017,10,13,3,1698,1665,1971,306
2017,10,13,4,1637,1588,1883,295
2017,10,13,5,1524,1472,1812,340
2017,10,13,6,1413,1360,1719,359
2017,10,13,7,1337,1296,1605,309
2017,10,13,8,1276,1247,1463,216
2017,10,13,9,1246,1222,1397,175
2017,10,13,10,1237,1218,1322,104
2017,10,13,11,1240,1226,1306,80
2017,10,13,12,1288,1281,1345,64
2017,10,13,13,1383,1387,1463,76
2017,10,13,14,1447,1426,1468,42
2017,10,13,15,1456,1446,1514,68
2017,10,13,16,1468,1467,1501,34
2017,10,13,17,1490,1496,1535,39
2017,10,13,18,1513,1519,1586,67
2017,10,13,19,1536,1543,1717,174
2017,10,13,20,1579,1582,1923,341
2017,10,13,21,1638,1625,1981,356
2017,10,13,22,1665,1654,2020,366
2017,10,13,23,1676,1665,2045,380
2017,10,14,0,1642,1630,2069,439
2017,10,14,1,1646,1627,1983,356
2017,10,14,2,1673,1654,1916,262
2017,10,14,3,1694,1651,1972,321
2017,10,14,4,1640,1585,2030,445
2017,10,14,5,1539,1486,2036,550
2017,10,14,6,1444,1385,1944,559
2017,10,14,7,1346,1318,1902,584
2017,10,14,8,1299,1262,1886,624
2017,10,14,9,1270,1237,1849,612
2017,10,14,10,1254,1224,1802,578
2017,10,14,11,1253,1225,1760,535
2017,10,14,12,1262,1236,1781,545
2017,10,14,13,1307,1284,1826,542
2017,10,14,14,1341,1310,1885,575
2017,10,14,15,1372,1337,1904,567
2017,10,14,16,1408,1373,1878,505
2017,10,14,17,1430,1399,2026,627
2017,10,14,18,1446,1415,2132,717
2017,10,14,19,1475,1438,2203,765
2017,10,14,20,1495,1457,2230,773
2017,10,14,21,1527,1496,2284,788
2017,10,14,22,1566,1530,2336,806
2017,10,14,23,1592,1557,2327,770
2017,10,15,0,1605,1573,2218,645
2017,10,15,1,1600,1575,2098,523
2017,10,15,2,1629,1608,2069,461
2017,10,15,3,1614,1568,2005,437
2017,10,15,4,1564,1508,1997,489
2017,10,15,5,1477,1422,2012,590
2017,10,15,6,1395,1333,1974,641
2017,10,15,7,1327,1269,1950,681
2017,10,15,8,1276,1230,1875,645
2017,10,15,9,1251,1206,1780,574
2017,10,15,10,1237,1195,1674,479
2017,10,15,11,1249,1201,1608,407
2017,10,15,12,1264,1219,1658,439
2017,10,15,13,1304,1266,1665,399
2017,10,15,14,1338,1288,1638,350
2017,10,15,15,1372,1322,1620,298
2017,10,15,16,1381,1327,1604,277
2017,10,15,17,1376,1508,1759,251
2017,10,15,18,1387,1338,1629,291
2017,10,15,19,1395,1341,1635,294
2017,10,15,20,1409,1352,1556,204
2017,10,15,21,1426,1368,1625,257
2017,10,15,22,1447,1395,1547,152
2017,10,15,23,1482,1434,1592,158
2017,10,16,0,1513,1477,1692,215
2017,10,16,1,1557,1529,1785,256
2017,10,16,2,1613,1595,1839,244
2017,10,16,3,1600,1566,1823,257
2017,10,16,4,1549,1495,1722,227
2017,10,16,5,1447,1390,1643,253
2017,10,16,6,1367,1285,1607,322
2017,10,16,7,1303,1243,1598,355
2017,10,16,8,1257,1214,1638,424
2017,10,16,9,1240,1200,1633,433
2017,10,16,10,1247,1203,1632,429
2017,10,16,11,1272,1230,1596,366
2017,10,16,12,1324,1300,1630,330
2017,10,16,13,1446,1444,1684,240
2017,10,16,14,1529,1502,1799,297
2017,10,16,15,1555,1484,1790,306
2017,10,16,16,1545,1465,1700,235
2017,10,16,17,1535,1459,1672,213
2017,10,16,18,1517,1449,1711,262
2017,10,16,19,1532,1455,1770,315
2017,10,16,20,1539,1463,1781,318
2017,10,16,21,1563,1490,1800,310
2017,10,16,22,1577,1509,1822,313
2017,10,16,23,1595,1529,1825,296
2017,10,17,0,1625,1540,1840,300
2017,10,17,1,1633,1576,1896,320
2017,10,17,2,1610,1632,1932,300
2017,10,17,3,1699,1612,1918,306
2017,10,17,4,1637,1526,1938,412
2017,10,17,5,1523,1413,1905,492
2017,10,17,6,1374,1319,1900,581
2017,10,17,7,1322,1260,1899,639
2017,10,17,8,1259,1222,1861,639
2017,10,17,9,1241,1213,1852,639
2017,10,17,10,1234,1209,1800,591
2017,10,17,11,1260,1235,1787,552
2017,10,17,12,1319,1310,1787,477
2017,10,17,13,1446,1453,1885,432
2017,10,17,14,1513,1495,1992,497
2017,10,17,15,1499,1477,1990,513
2017,10,17,16,1485,1460,1843,383
2017,10,17,17,1489,1451,1848,397
2017,10,17,18,1508,1475,1881,406
2017,10,17,19,1506,1471,1959,488
2017,10,17,20,1518,1485,1991,506
2017,10,17,21,1544,1503,2022,519
2017,10,17,22,1564,1531,2046,515
2017,10,17,23,1583,1559,2062,503
2017,10,18,0,1592,1570,1985,415
2017,10,18,1,1615,1601,1950,349
2017,10,18,2,1650,1645,2001,356
2017,10,18,3,1655,1617,1993,376
2017,10,18,4,1576,1531,1988,457
2017,10,18,5,1469,1414,1889,475
2017,10,18,6,1367,1320,1896,576
2017,10,18,7,1297,1268,1872,604
2017,10,18,8,1262,1235,1919,684
2017,10,18,9,1236,1218,1863,645
2017,10,18,10,1235,1212,1824,612
2017,10,18,11,1247,1229,1807,578
2017,10,18,12,1314,1305,1825,520
2017,10,18,13,1433,1435,1867,432
2017,10,18,14,1507,1484,1984,500
2017,10,18,15,1499,1467,1966,499
2017,10,18,16,1501,1473,1862,389
2017,10,18,17,1514,1477,1924,447
2017,10,18,18,1510,1463,1972,509
2017,10,18,19,1511,1457,1999,542
2017,10,18,20,1525,1491,1968,477
2017,10,18,21,1541,1522,1993,471
2017,10,18,22,1574,1553,1983,430
2017,10,18,23,1594,1578,1973,395
2017,10,19,0,1597,1569,1965,396
2017,10,19,1,1624,1603,1948,345
2017,10,19,2,1655,1646,1957,311
2017,10,19,3,1655,1615,1921,306
2017,10,19,4,1582,1526,1912,386
2017,10,19,5,1499,1416,1815,399
2017,10,19,6,1391,1312,1727,415
2017,10,19,7,1318,1266,1649,383
2017,10,19,8,1261,1235,1665,430
2017,10,19,9,1244,1224,1667,443
2017,10,19,10,1234,1219,1655,436
2017,10,19,11,1248,1235,1642,407
2017,10,19,12,1318,1308,1656,348
2017,10,19,13,1444,1436,1729,293
2017,10,19,14,1522,1490,1787,297
2017,10,19,15,1528,1483,1762,279
2017,10,19,16,1511,1480,1744,264
2017,10,19,17,1519,1479,1767,288
2017,10,19,18,1530,1491,1877,386
2017,10,19,19,1534,1497,1895,398
2017,10,19,20,1564,1529,1923,394
2017,10,19,21,1580,1552,1991,439
2017,10,19,22,1599,1571,1972,401
2017,10,19,23,1513,1479,1902,423
2017,10,20,0,1598,1564,1852,288
2017,10,20,1,1624,1608,1982,374
2017,10,20,2,1648,1639,2078,439
2017,10,20,3,1612,1579,1975,396
2017,10,20,4,1553,1526,2025,499
2017,10,20,5,1452,1434,1933,499
2017,10,20,6,1354,1325,1919,594
2017,10,20,7,1287,1259,1868,609
2017,10,20,8,1254,1221,2011,790
2017,10,20,9,1228,1195,1995,800
2017,10,20,10,1228,1201,2035,834
2017,10,20,11,1233,1212,1986,774
2017,10,20,12,1311,1267,2109,842
2017,10,20,13,1365,1316,2214,898
2017,10,20,14,1451,1409,2267,858
2017,10,20,15,1480,1451,2343,892
2017,10,20,16,1489,1463,2346,883
2017,10,20,17,1482,1452,2350,898
2017,10,20,18,1483,1467,2390,923
2017,10,20,19,1487,1479,2444,965
2017,10,20,20,1512,1500,2504,1004
2017,10,20,21,1552,1516,2562,1046
2017,10,20,22,1568,1524,2577,1053
2017,10,20,23,1587,1546,2607,1061
2017,10,21,0,1604,1522,2545,1023
2017,10,21,1,1610,1549,2518,969
2017,10,21,2,1641,1588,2547,959
2017,10,21,3,1634,1577,2540,963
2017,10,21,4,1580,1518,2558,1040
2017,10,21,5,1490,1437,2576,1139
2017,10,21,6,1395,1351,2501,1150
2017,10,21,7,1325,1284,2489,1205
2017,10,21,8,1276,1244,2483,1239
2017,10,21,9,1250,1217,2410,1193
2017,10,21,10,1234,1206,2325,1119
2017,10,21,11,1242,1209,2331,1122
2017,10,21,12,1264,1236,2353,1117
2017,10,21,13,1287,1261,2323,1062
2017,10,21,14,1306,1263,2193,930
2017,10,21,15,1387,1342,2104,762
2017,10,21,16,1410,1368,2020,652
2017,10,21,17,1425,1380,1986,606
2017,10,21,18,1422,1377,1968,591
2017,10,21,19,1416,1372,2051,679
2017,10,21,20,1414,1361,2089,728
2017,10,21,21,1412,1367,2247,880
2017,10,21,22,1428,1377,2305,928
2017,10,21,23,1449,1395,2296,901
2017,10,22,0,1469,1419,2337,918
2017,10,22,1,1500,1475,2343,868
2017,10,22,2,1551,1535,2365,830
2017,10,22,3,1555,1514,2294,780
2017,10,22,4,1517,1470,2191,721
2017,10,22,5,1447,1391,2179,788
2017,10,22,6,1270,1315,2096,781
2017,10,22,7,1311,1269,2018,749
2017,10,22,8,1282,1242,1959,717
2017,10,22,9,1260,1222,1957,735
2017,10,22,10,1239,1209,1968,759
2017,10,22,11,1247,1205,2079,874
2017,10,22,12,1274,1240,2207,967
2017,10,22,13,1320,1294,2256,962
2017,10,22,14,1383,1337,2329,992
2017,10,22,15,1390,1365,2291,926
2017,10,22,16,1392,1353,2211,858
2017,10,22,17,1389,1345,2190,845
2017,10,22,18,1390,1339,2195,856
2017,10,22,19,1385,1332,2203,871
2017,10,22,20,1387,1335,2268,933
2017,10,22,21,1396,1347,2334,987
2017,10,22,22,1422,1371,2399,1028
2017,10,22,23,1447,1415,2461,1046
2017,10,23,0,1477,1462,2466,1004
2017,10,23,1,1523,1540,2513,973
2017,10,23,2,1608,1607,2527,920
2017,10,23,3,1628,1574,2536,962
2017,10,23,4,1571,1502,2541,1039
2017,10,23,5,1470,1398,2475,1077
2017,10,23,6,1373,1299,2410,1111
2017,10,23,7,1308,1242,2328,1086
2017,10,23,8,1254,1199,2293,1094
2017,10,23,9,1237,1191,2288,1097
2017,10,23,10,1238,1202,2272,1070
2017,10,23,11,1254,1223,2285,1062
2017,10,23,12,1311,1293,2349,1056
2017,10,23,13,1438,1434,2453,1019
2017,10,23,14,1512,1486,2492,1006
2017,10,23,15,1503,1469,2400,931
2017,10,23,16,1495,1467,2205,738
2017,10,23,17,1489,1463,2312,849
2017,10,23,18,1490,1461,2245,784
2017,10,23,19,1499,1469,2318,849
2017,10,23,20,1453,1473,2344,871
2017,10,23,21,1495,1475,2320,845
2017,10,23,22,1548,1501,2373,872
2017,10,23,23,1560,1531,2386,855
2017,10,24,0,1570,1543,2382,839
2017,10,24,1,1606,1596,2391,795
2017,10,24,2,1655,1650,2474,824
2017,10,24,3,1663,1623,2472,849
2017,10,24,4,1595,1540,2482,942
2017,10,24,5,1485,1424,2426,1002
2017,10,24,6,1380,1320,2397,1077
2017,10,24,7,1306,1263,2258,995
2017,10,24,8,1249,1225,2258,1033
2017,10,24,9,1224,1197,2207,1010
2017,10,24,10,1208,1190,2146,956
2017,10,24,11,1234,1212,2132,920
2017,10,24,12,1304,1292,2155,863
2017,10,24,13,1435,1437,2242,805
2017,10,24,14,1511,1500,2262,762
2017,10,24,15,1504,1473,2230,757
2017,10,24,16,1490,1454,2119,665
2017,10,24,17,1481,1444,2238,794
2017,10,24,18,1476,1444,2218,774
2017,10,24,19,1465,1440,2228,788
2017,10,24,20,1464,1436,2255,819
2017,10,24,21,1479,1460,2286,826
2017,10,24,22,1508,1481,2308,827
2017,10,24,23,1512,1500,2287,787
2017,10,25,0,1526,1515,2255,740
2017,10,25,1,1562,1567,2333,766
2017,10,25,2,1624,1613,2443,830
2017,10,25,3,1648,1587,2467,880
2017,10,25,4,1576,1509,2416,907
2017,10,25,5,1469,1409,2238,829
2017,10,25,6,1362,1314,2136,822
2017,10,25,7,1294,1260,2071,811
2017,10,25,8,1245,1238,2068,830
2017,10,25,9,1232,1223,2056,833
2017,10,25,10,1236,1227,2043,816
2017,10,25,11,1255,1251,2067,816
2017,10,25,12,1331,1337,2102,765
2017,10,25,13,1462,1478,2244,766
2017,10,25,14,1534,1530,2271,741
2017,10,25,15,1537,1507,2263,756
2017,10,25,16,1511,1475,2181,706
2017,10,25,17,1491,1472,2318,846
2017,10,25,18,1496,1460,2356,896
2017,10,25,19,1488,1454,2401,947
2017,10,25,20,1491,1461,2425,964
2017,10,25,21,1498,1466,2444,978
2017,10,25,22,1517,1475,2547,1072
2017,10,25,23,1530,1499,2484,985
2017,10,26,0,1540,1514,2444,930
2017,10,26,1,1575,1575,2460,885
2017,10,26,2,1646,1627,2582,955
2017,10,26,3,1643,1597,2502,905
2017,10,26,4,1573,1527,2460,933
2017,10,26,5,1474,1423,2397,974
2017,10,26,6,1371,1323,2283,960
2017,10,26,7,1302,1267,2164,897
2017,10,26,8,1267,1234,2221,987
2017,10,26,9,1242,1232,2225,993
2017,10,26,10,1238,1232,2212,980
2017,10,26,11,1253,1259,2219,960
2017,10,26,12,1330,1330,2274,944
2017,10,26,13,1450,1476,2404,928
2017,10,26,14,1522,1523,2468,945
2017,10,26,15,1525,1495,2343,848
2017,10,26,16,1507,1481,2199,718
2017,10,26,17,1497,1473,2176,703
2017,10,26,18,1487,1462,2161,699
2017,10,26,19,1483,1472,2188,716
2017,10,26,20,1488,1485,2213,728
2017,10,26,21,1516,1492,2282,790
2017,10,26,22,1532,1510,2377,867
2017,10,26,23,1562,1528,2422,894
2017,10,27,0,1567,1534,2401,867
2017,10,27,1,1594,1576,2449,873
2017,10,27,2,1640,1618,2521,903
2017,10,27,3,1573,1599,2536,937
2017,10,27,4,1579,1530,2485,955
2017,10,27,5,1479,1424,2394,970
2017,10,27,6,1381,1337,2311,974
2017,10,27,7,1345,1276,2276,1000
2017,10,27,8,1283,1246,2274,1028
2017,10,27,9,1257,1227,2294,1067
2017,10,27,10,1260,1234,2277,1043
2017,10,27,11,1280,1256,2270,1014
2017,10,27,12,1347,1330,2290,960
2017,10,27,13,1455,1462,2328,866
2017,10,27,14,1547,1521,2319,798
2017,10,27,15,1551,1506,2302,796
2017,10,27,16,1534,1500,2273,773
2017,10,27,17,1527,1482,2254,772
2017,10,27,18,1518,1429,2266,837
2017,10,27,19,1526,1449,2280,831
2017,10,27,20,1486,1445,2238,793
2017,10,27,21,1483,1432,2234,802
2017,10,27,22,1497,1434,2235,801
2017,10,27,23,1493,1436,2306,870
2017,10,28,0,1504,1451,2285,834
2017,10,28,1,1552,1523,2368,845
2017,10,28,2,1589,1559,2411,852
2017,10,28,3,1598,1550,2405,855
2017,10,28,4,1560,1511,2416,905
2017,10,28,5,1484,1444,2329,885
2017,10,28,6,1407,1365,2322,957
2017,10,28,7,1348,1306,2344,1038
2017,10,28,8,1315,1283,2263,980
2017,10,28,9,1301,1265,2231,966
2017,10,28,10,1292,1263,2194,931
2017,10,28,11,1309,1274,2177,903
2017,10,28,12,1340,1314,2227,913
2017,10,28,13,1395,1383,2190,807
2017,10,28,14,1436,1442,2160,718
2017,10,28,15,1451,1462,2142,680
2017,10,28,16,1487,1460,2154,694
2017,10,28,17,1478,1430,2118,688
2017,10,28,18,1462,1401,2153,752
2017,10,28,19,1444,1374,2213,839
2017,10,28,20,1415,1361,2208,847
2017,10,28,21,1402,1359,2204,845
2017,10,28,22,1416,1365,2232,867
2017,10,28,23,1425,1394,2258,864
2017,10,29,0,1460,1432,2241,809
2017,10,29,1,1532,1517,2320,803
2017,10,29,2,1574,1556,2337,781
2017,10,29,3,1574,1540,2274,734
2017,10,29,4,1535,1497,2313,816
2017,10,29,5,1470,1424,2297,873
2017,10,29,6,1397,1339,2274,935
2017,10,29,7,1337,1286,2258,972
2017,10,29,8,1299,1255,2192,937
2017,10,29,9,1278,1236,2214,978
2017,10,29,10,1275,1233,2227,994
2017,10,29,11,1280,1240,2231,991
2017,10,29,12,1302,1272,2232,960
2017,10,29,13,1349,1328,2258,930
2017,10,29,14,1390,1367,2323,956
2017,10,29,15,1411,1387,2349,962
2017,10,29,16,1413,1391,2308,917
2017,10,29,17,1399,1375,2274,899
2017,10,29,18,1388,1363,2283,920
2017,10,29,19,1381,1353,2293,940
2017,10,29,20,1373,1347,2337,990
2017,10,29,21,1380,1349,2366,1017
2017,10,29,22,1395,1360,2370,1010
2017,10,29,23,1429,1402,2403,1001
2017,10,30,0,1474,1445,2381,936
2017,10,30,1,1563,1542,2468,926
2017,10,30,2,1598,1581,2505,924
2017,10,30,3,1590,1550,2460,910
2017,10,30,4,1540,1501,2412,911
2017,10,30,5,1452,1405,2330,925
2017,10,30,6,1359,1316,2309,993
2017,10,30,7,1299,1255,2231,976
2017,10,30,8,1252,1221,2212,991
2017,10,30,9,1246,1209,2186,977
2017,10,30,10,1244,1215,2143,928
2017,10,30,11,1262,1250,2166,916
2017,10,30,12,1318,1321,2246,925
2017,10,30,13,1432,1462,2336,874
2017,10,30,14,1518,1533,2473,940
2017,10,30,15,1558,1511,2428,917
2017,10,30,16,1539,1478,2282,804
2017,10,30,17,1521,1469,2302,833
2017,10,30,18,1481,1460,2296,836
2017,10,30,19,1469,1452,2318,866
2017,10,30,20,1461,1454,2287,833
2017,10,30,21,1484,1460,2258,798
2017,10,30,22,1486,1478,2282,804
2017,10,30,23,1508,1484,2391,907
2017,10,31,0,1532,1501,2437,936
2017,10,31,1,1602,1603,2521,918
2017,10,31,2,1658,1641,2517,876
2017,10,31,3,1661,1618,2485,867
2017,10,31,4,1612,1551,2510,959
2017,10,31,5,1517,1446,2303,857
2017,10,31,6,1404,1354,2274,920
2017,10,31,7,1332,1300,2227,927
2017,10,31,8,1294,1269,2165,896
2017,10,31,9,1272,1255,2049,794
2017,10,31,10,1269,1247,2034,787
2017,10,31,11,1286,1276,2048,772
2017,10,31,12,1353,1358,2121,763
2017,10,31,13,1470,1502,2267,765
2017,10,31,14,1560,1557,2339,782
2017,10,31,15,1582,1542,2273,731
2017,10,31,16,1559,1522,2142,620
2017,10,31,17,1544,1501,2240,739
2017,10,31,18,1536,1444,2239,795
2017,10,31,19,1510,1423,2239,816
2017,10,31,20,1501,1410,2197,787
2017,10,31,21,1502,1412,2164,752
2017,10,31,22,1470,1418,2097,679
2017,10,31,23,1475,1435,2097,662
2017,11,1,0,1500,1450,2091,641
2017,11,1,1,1557,1511,2152,641
2017,11,1,2,1597,1515,2140,625
2017,11,1,3,1617,1513,2195,682
2017,11,1,4,1535,1479,2230,751
2017,11,1,5,1447,1394,2163,769
2017,11,1,6,1359,1306,2141,835
2017,11,1,7,1299,1255,2067,812
2017,11,1,8,1284,1227,2106,879
2017,11,1,9,1268,1210,2091,881
2017,11,1,10,1263,1209,2060,851
2017,11,1,11,1284,1234,2071,837
2017,11,1,12,1348,1303,2156,853
2017,11,1,13,1460,1432,2211,779
2017,11,1,14,1531,1499,2188,689
2017,11,1,15,1537,1471,2212,741
2017,11,1,16,1521,1441,2102,661
2017,11,1,17,1503,1430,2137,707
2017,11,1,18,1485,1422,2164,742
2017,11,1,19,1477,1398,2206,808
2017,11,1,20,1474,1410,2233,823
2017,11,1,21,1477,1410,2252,842
2017,11,1,22,1499,1435,2300,865
2017,11,1,23,1513,1449,2356,907
2017,11,2,0,1526,1470,2211,741
2017,11,2,1,1573,1549,2250,701
2017,11,2,2,1612,1585,2319,734
2017,11,2,3,1620,1555,2211,656
2017,11,2,4,1563,1492,2150,658
2017,11,2,5,1467,1392,2064,672
2017,11,2,6,1372,1303,2080,777
2017,11,2,7,1304,1243,2035,792
2017,11,2,8,1266,1214,2040,826
2017,11,2,9,1243,1194,2046,852
2017,11,2,10,1235,1199,1961,762
2017,11,2,11,1263,1236,1977,741
2017,11,2,12,1324,1313,2085,772
2017,11,2,13,1456,1451,2177,726
2017,11,2,14,1534,1513,2181,668
2017,11,2,15,1512,1480,2176,696
2017,11,2,16,1502,1464,2177,713
2017,11,2,17,1483,1457,2188,731
2017,11,2,18,1467,1414,2169,755
2017,11,2,19,1449,1392,2206,814
2017,11,2,20,1448,1416,2195,779
2017,11,2,21,1460,1435,2195,760
2017,11,2,22,1485,1453,2084,631
2017,11,2,23,1503,1474,2098,624
2017,11,3,0,1518,1496,2086,590
2017,11,3,1,1567,1565,2210,645
2017,11,3,2,1602,1591,2158,567
2017,11,3,3,1610,1565,2106,541
2017,11,3,4,1554,1486,2095,609
2017,11,3,5,1467,1389,2058,669
2017,11,3,6,1370,1301,2045,744
2017,11,3,7,1301,1245,1955,710
2017,11,3,8,1245,1221,1883,662
2017,11,3,9,1228,1211,1870,659
2017,11,3,10,1226,1222,1911,689
2017,11,3,11,1247,1247,1945,698
2017,11,3,12,1312,1322,1976,654
2017,11,3,13,1435,1459,2031,572
2017,11,3,14,1523,1536,2031,495
2017,11,3,15,1505,1504,2031,527
2017,11,3,16,1474,1478,1969,491
2017,11,3,17,1458,1447,2024,577
2017,11,3,18,1444,1432,2025,593
2017,11,3,19,1444,1424,2072,648
2017,11,3,20,1439,1427,2202,775
2017,11,3,21,1442,1437,2197,760
2017,11,3,22,1456,1449,2211,762
2017,11,3,23,1474,1466,2189,723
2017,11,4,0,1488,1467,2113,646
2017,11,4,1,1539,1537,2164,627
2017,11,4,2,1570,1548,2152,604
2017,11,4,3,1559,1534,2054,520
2017,11,4,4,1514,1492,2057,565
2017,11,4,5,1441,1414,2072,658
2017,11,4,6,1368,1333,2027,694
2017,11,4,7,1304,1272,1994,722
2017,11,4,8,1244,1237,1917,680
2017,11,4,9,1206,1220,1907,687
2017,11,4,10,1212,1218,1991,773
2017,11,4,11,1202,1219,2079,860
2017,11,4,12,1239,1256,2069,813
2017,11,4,13,1283,1305,2049,744
2017,11,4,14,1342,1352,2006,654
2017,11,4,15,1373,1376,2035,659
2017,11,4,16,1398,1401,2103,702
2017,11,4,17,1424,1431,2119,688
2017,11,4,18,1426,1426,2073,647
2017,11,4,19,1417,1411,2040,629
2017,11,4,20,1397,1401,2026,625
2017,11,4,21,1401,1390,2061,671
2017,11,4,22,1402,1395,2084,689
2017,11,4,23,1425,1407,2108,701
2017,11,5,0,1454,1434,2086,652
2017,11,5,1,1505,1528,2128,600
2017,11,5,2,1527,1554,2103,549
2017,11,5,3,1517,1533,2081,548
2017,11,5,4,1477,1479,2091,612
2017,11,5,5,1416,1409,2043,634
2017,11,5,6,1334,1325,2105,780
2017,11,5,7,1275,1266,2126,860
2017,11,5,8,1248,1235,2043,808
2017,11,5,9,1229,1216,2073,857
2017,11,5,10,1229,1200,1988,788
2017,11,5,11,1222,1188,1935,747
2017,11,5,12,1231,1192,1944,752
2017,11,5,13,1259,1222,1995,773
2017,11,5,14,1310,1262,1983,721
2017,11,5,15,1337,1286,1998,712
2017,11,5,16,1358,1322,2015,693
2017,11,5,17,1373,1345,2081,736
2017,11,5,18,1395,1361,2156,795
2017,11,5,19,1372,1361,2131,770
2017,11,5,20,1371,1366,2167,801
2017,11,5,21,1385,1370,2153,783
2017,11,5,22,1407,1387,2204,817
2017,11,5,23,1478,1410,2211,801
2017,11,6,0,1551,1446,2180,734
2017,11,6,1,1587,1572,2239,667
2017,11,6,2,1576,1601,2262,661
2017,11,6,3,1535,1575,2259,684
2017,11,6,4,1442,1527,2178,651
2017,11,6,5,1404,1448,2206,758
2017,11,6,6,1394,1352,2169,817
2017,11,6,7,1314,1270,2101,831
2017,11,6,8,1245,1226,2143,917
2017,11,6,9,1226,1204,2248,1044
2017,11,6,10,1257,1192,2242,1050
2017,11,6,11,1265,1192,2206,1014
2017,11,6,12,1289,1227,2171,944
2017,11,6,13,1374,1313,2163,850
2017,11,6,14,1468,1432,2209,777
2017,11,6,15,1477,1456,2125,669
2017,11,6,16,1480,1444,2066,622
2017,11,6,17,1481,1445,2096,651
2017,11,6,18,1490,1448,1982,534
2017,11,6,19,1460,1450,1956,506
2017,11,6,20,1477,1437,2006,569
2017,11,6,21,1495,1438,2055,617
2017,11,6,22,1526,1457,2025,568
2017,11,6,23,1550,1473,2119,646
2017,11,7,0,1613,1503,2135,632
2017,11,7,1,1650,1600,2224,624
2017,11,7,2,1627,1624,2255,631
2017,11,7,3,1566,1599,2204,605
2017,11,7,4,1585,1550,2129,579
2017,11,7,5,1499,1473,1923,450
2017,11,7,6,1407,1371,1711,340
2017,11,7,7,1325,1297,1665,368
2017,11,7,8,1286,1244,1634,390
2017,11,7,9,1262,1222,1654,432
2017,11,7,10,1246,1207,1652,445
2017,11,7,11,1250,1209,1648,439
2017,11,7,12,1278,1235,1646,411
2017,11,7,13,1393,1321,1635,314
2017,11,7,14,1490,1438,1713,275
2017,11,7,15,1485,1466,1830,364
2017,11,7,16,1492,1483,1801,318
2017,11,7,17,1490,1496,1902,406
2017,11,7,18,1488,1479,2000,521
2017,11,7,19,1462,1482,2023,541
2017,11,7,20,1463,1463,1977,514
2017,11,7,21,1473,1484,1924,440
2017,11,7,22,1480,1485,1807,322
2017,11,7,23,1486,1505,1638,133
2017,11,8,0,1497,1533,1629,96
2017,11,8,1,1617,1640,1766,126
2017,11,8,2,1631,1650,1776,126
2017,11,8,3,1648,1627,1708,81
2017,11,8,4,1605,1589,1723,134
2017,11,8,5,1526,1501,1646,145
2017,11,8,6,1429,1404,1592,188
2017,11,8,7,1348,1320,1542,222
2017,11,8,8,1289,1277,1467,190
2017,11,8,9,1273,1252,1429,177
2017,11,8,10,1257,1239,1430,191
2017,11,8,11,1261,1237,1437,200
2017,11,8,12,1305,1271,1448,177
2017,11,8,13,1407,1357,1454,97
2017,11,8,14,1510,1483,1509,26
2017,11,8,15,1523,1502,1535,33
2017,11,8,16,1504,1467,1584,117
2017,11,8,17,1495,1450,1591,141
2017,11,8,18,1481,1447,1635,188
2017,11,8,19,1472,1435,1678,243
2017,11,8,20,1463,1405,1751,346
2017,11,8,21,1475,1412,1775,363
2017,11,8,22,1496,1418,1745,327
2017,11,8,23,1505,1439,1733,294
2017,11,9,0,1530,1475,1791,316
2017,11,9,1,1608,1600,1935,335
2017,11,9,2,1648,1640,1987,347
2017,11,9,3,1654,1625,1970,345
2017,11,9,4,1619,1610,1963,353
2017,11,9,5,1543,1540,1893,353
2017,11,9,6,1451,1443,1826,383
2017,11,9,7,1374,1357,1778,421
2017,11,9,8,645,1307,1804,497
2017,11,9,9,1323,1287,1731,444
2017,11,9,10,1313,1274,1688,414
2017,11,9,11,1322,1281,1688,407
2017,11,9,12,1370,1315,1722,407
2017,11,9,13,1470,1411,1847,436
2017,11,9,14,1579,1542,1887,345
2017,11,9,15,1585,1553,1640,87
2017,11,9,16,1551,1552,1595,43
2017,11,9,17,1546,1526,1567,41
2017,11,9,18,1522,1518,1630,112
2017,11,9,19,1508,1484,1610,126
2017,11,9,20,1476,1448,1657,209
2017,11,9,21,1487,1453,1650,197
2017,11,9,22,1492,1474,1638,164
2017,11,9,23,1510,1474,1656,182
2017,11,10,0,1537,1498,1644,146
2017,11,10,1,1640,1609,1644,35
2017,11,10,2,1680,1646,1633,-13
2017,11,10,3,1674,1622,1666,44
2017,11,10,4,1653,1597,1665,68
2017,11,10,5,1582,1530,1678,148
2017,11,10,6,1486,1431,1714,283
2017,11,10,7,1396,1347,1724,377
2017,11,10,8,1338,1297,1665,368
2017,11,10,9,1311,1273,1670,397
2017,11,10,10,1294,1262,1638,376
2017,11,10,11,1298,1267,1621,354
2017,11,10,12,1334,1296,1639,343
2017,11,10,13,1415,1369,1650,281
2017,11,10,14,1505,1475,1655,180
2017,11,10,15,1524,1490,1683,193
2017,11,10,16,1511,1473,1623,150
2017,11,10,17,1495,1448,1524,76
2017,11,10,18,1480,1431,1483,52
2017,11,10,19,1436,1402,1541,139
2017,11,10,20,1419,1388,1570,182
2017,11,10,21,1417,1405,1580,175
2017,11,10,22,1427,1414,1587,173
2017,11,10,23,1438,1438,1589,151
2017,11,11,0,1473,1468,1587,119
2017,11,11,1,1562,1565,1612,47
2017,11,11,2,1613,1578,1619,41
2017,11,11,3,1592,1554,1681,127
2017,11,11,4,1592,1535,1683,148
2017,11,11,5,1544,1485,1629,144
2017,11,11,6,1464,1410,1623,213
2017,11,11,7,1381,1328,1647,319
2017,11,11,8,1335,1280,1651,371
2017,11,11,9,1303,1248,1636,388
2017,11,11,10,1284,1231,1636,405
2017,11,11,11,1281,1225,1633,408
2017,11,11,12,1292,1239,1618,379
2017,11,11,13,1318,1270,1648,378
2017,11,11,14,1391,1319,1636,317
2017,11,11,15,1426,1346,1667,321
2017,11,11,16,1405,1358,1743,385
2017,11,11,17,1406,1372,1759,387
2017,11,11,18,1414,1359,1733,374
2017,11,11,19,1406,1356,1741,385
2017,11,11,20,1396,1352,1722,370
2017,11,11,21,1400,1350,1735,385
2017,11,11,22,1412,1359,1776,417
2017,11,11,23,1434,1387,1701,314
2017,11,12,0,1471,1426,1756,330
2017,11,12,1,1565,1544,1781,237
2017,11,12,2,1598,1561,1770,209
2017,11,12,3,1573,1536,1825,289
2017,11,12,4,1550,1502,1901,399
2017,11,12,5,1502,1448,1847,399
2017,11,12,6,1432,1384,1768,384
2017,11,12,7,1352,1318,1788,470
2017,11,12,8,1325,1282,1778,496
2017,11,12,9,1294,1244,1734,490
2017,11,12,10,1278,1227,1768,541
2017,11,12,11,1278,1227,1740,513
2017,11,12,12,1285,1241,1751,510
2017,11,12,13,1305,1281,1824,543
2017,11,12,14,1359,1324,1793,469
2017,11,12,15,1376,1343,1734,391
2017,11,12,16,1392,1352,1697,345
2017,11,12,17,1397,1354,1732,378
2017,11,12,18,1386,1352,1713,361
2017,11,12,19,1382,1352,1747,395
2017,11,12,20,1382,1362,1702,340
2017,11,12,21,1386,1366,1670,304
2017,11,12,22,1400,1383,1598,215
2017,11,12,23,1428,1407,1671,264
2017,11,13,0,1480,1454,1767,313
2017,11,13,1,1593,1589,1824,235
2017,11,13,2,1637,1607,1797,190
2017,11,13,3,1618,1575,1693,118
2017,11,13,4,1582,1539,1703,164
2017,11,13,5,1508,1463,1693,230
2017,11,13,6,1430,1371,1631,260
2017,11,13,7,1348,1282,1660,378
2017,11,13,8,1277,1238,1683,445
2017,11,13,9,1252,1213,1694,481
2017,11,13,10,1242,1198,1634,436
2017,11,13,11,1243,1194,1693,499
2017,11,13,12,1270,1229,1707,478
2017,11,13,13,1355,1317,1699,382
2017,11,13,14,1476,1437,1836,399
2017,11,13,15,1512,1463,1824,361
2017,11,13,16,1501,1448,1814,366
2017,11,13,17,1496,1427,1661,234
2017,11,13,18,1483,1408,1726,318
2017,11,13,19,1491,1432,1778,346
2017,11,13,20,1484,1431,1867,436
2017,11,13,21,1493,1446,1812,366
2017,11,13,22,1512,1473,1848,375
2017,11,13,23,1517,1478,1755,277
2017,11,14,0,1545,1509,1710,201
2017,11,14,1,1656,1626,1755,129
2017,11,14,2,1663,1632,1787,155
2017,11,14,3,1643,1604,1707,103
2017,11,14,4,1611,1566,1799,233
2017,11,14,5,1541,1494,1734,240
2017,11,14,6,1428,1381,1669,288
2017,11,14,7,1339,1292,1651,359
2017,11,14,8,1283,1246,1638,392
2017,11,14,9,1256,1220,1694,474
2017,11,14,10,1245,1212,1728,516
2017,11,14,11,1244,1215,1743,528
2017,11,14,12,1277,1238,1744,506
2017,11,14,13,1362,1321,1791,470
2017,11,14,14,1488,1456,1815,359
2017,11,14,15,1510,1476,1784,308
2017,11,14,16,1488,1441,1774,333
2017,11,14,17,1468,1429,1767,338
2017,11,14,18,1465,1422,1796,374
2017,11,14,19,1465,1421,1866,445
2017,11,14,20,1471,1424,1887,463
2017,11,14,21,1482,1435,1927,492
2017,11,14,22,1494,1451,1929,478
2017,11,14,23,1511,1474,1940,466
2017,11,15,0,1542,1505,1890,385
2017,11,15,1,1654,1617,1942,325
2017,11,15,2,1669,1635,1928,293
2017,11,15,3,1635,1599,1917,318
2017,11,15,4,1621,1574,1878,304
2017,11,15,5,1539,1504,1885,381
2017,11,15,6,1434,1395,1848,453
2017,11,15,7,1348,1301,1801,500
2017,11,15,8,1285,1261,1805,544
2017,11,15,9,1258,1230,1907,677
2017,11,15,10,1263,1227,1856,629
2017,11,15,11,1258,1232,1864,632
2017,11,15,12,1306,1273,1866,593
2017,11,15,13,1398,1371,1928,557
2017,11,15,14,1520,1497,1996,499
2017,11,15,15,1533,1509,1992,483
2017,11,15,16,1517,1486,1989,503
2017,11,15,17,1473,1464,1944,480
2017,11,15,18,1436,1447,1868,421
2017,11,15,19,1448,1446,1795,349
2017,11,15,20,1447,1443,1771,328
2017,11,15,21,1445,1440,1780,340
2017,11,15,22,1469,1459,1753,294
2017,11,15,23,1485,1475,1645,170
2017,11,16,0,1533,1511,1655,144
2017,11,16,1,1648,1628,1796,168
2017,11,16,2,1683,1652,1803,151
2017,11,16,3,1657,1628,1776,148
2017,11,16,4,1615,1592,1816,224
2017,11,16,5,1545,1518,1816,298
2017,11,16,6,1450,1432,1847,415
2017,11,16,7,1361,1333,1857,524
2017,11,16,8,1292,1289,1808,519
2017,11,16,9,1268,1264,1731,467
2017,11,16,10,1257,1255,1695,440
2017,11,16,11,1263,1260,1684,424
2017,11,16,12,1297,1294,1683,389
2017,11,16,13,1381,1387,1688,301
2017,11,16,14,1529,1526,1752,226
2017,11,16,15,1543,1532,1800,268
2017,11,16,16,1520,1502,1854,352
2017,11,16,17,1496,1479,1890,411
2017,11,16,18,1469,1471,1905,434
2017,11,16,19,1452,1448,1908,460
2017,11,16,20,1454,1449,1923,474
2017,11,16,21,1460,1458,1862,404
2017,11,16,22,1482,1480,1758,278
2017,11,16,23,1493,1492,1538,46
2017,11,17,0,1534,1529,1541,12
2017,11,17,1,1640,1629,1594,-35
2017,11,17,2,1654,1633,1596,-37
2017,11,17,3,1632,1608,1600,-8
2017,11,17,4,1601,1581,1581,0
2017,11,17,5,1526,1502,1433,-69
2017,11,17,6,1431,1400,1410,10
2017,11,17,7,1340,1307,1393,86
2017,11,17,8,1255,1216,1372,156
2017,11,17,9,1255,1215,1395,180
2017,11,17,10,1251,1207,1398,191
2017,11,17,11,1256,1212,1383,171
2017,11,17,12,1281,1239,1370,131
2017,11,17,13,1359,1309,1452,143
2017,11,17,14,1488,1427,1600,173
2017,11,17,15,1510,1455,1719,264
2017,11,17,16,1509,1462,1745,283
2017,11,17,17,1501,1450,1816,366
2017,11,17,18,1493,1482,1827,345
2017,11,17,19,1483,1474,1870,396
2017,11,17,20,1476,1484,1886,402
2017,11,17,21,1477,1516,1934,418
2017,11,17,22,1486,1504,2007,503
2017,11,17,23,1539,1508,1929,421
2017,11,18,0,1558,1531,1962,431
2017,11,18,1,1641,1614,2016,402
2017,11,18,2,1649,1604,1969,365
2017,11,18,3,1629,1582,1944,362
2017,11,18,4,1610,1566,1945,379
2017,11,18,5,1550,1515,1859,344
2017,11,18,6,1466,1429,1914,485
2017,11,18,7,1378,1377,2007,630
2017,11,18,8,1312,1310,1940,630
2017,11,18,9,1294,1280,1887,607
2017,11,18,10,1287,1265,1888,623
2017,11,18,11,1286,1255,1847,592
2017,11,18,12,1297,1274,1831,557
2017,11,18,13,1331,1327,1879,552
2017,11,18,14,1405,1385,1981,596
2017,11,18,15,1441,1407,1915,508
2017,11,18,16,1487,1424,1850,426
2017,11,18,17,1479,1430,1866,436
2017,11,18,18,1483,1418,1797,379
2017,11,18,19,1446,1398,1768,370
2017,11,18,20,1436,1376,1750,374
2017,11,18,21,1423,1363,1737,374
2017,11,18,22,1419,1365,1709,344
2017,11,18,23,1418,1388,1681,293
2017,11,19,0,1479,1448,1691,243
2017,11,19,1,1612,1606,1790,184
2017,11,19,2,1613,1631,1801,170
2017,11,19,3,1631,1610,1762,152
2017,11,19,4,1628,1616,1851,235
2017,11,19,5,1574,1550,1803,253
2017,11,19,6,1497,1505,1777,272
2017,11,19,7,1424,1434,1805,371
2017,11,19,8,1386,1391,1734,343
2017,11,19,9,1369,1363,1682,319
2017,11,19,10,1358,1349,1691,342
2017,11,19,11,1364,1322,1669,347
2017,11,19,12,1372,1367,1767,400
2017,11,19,13,1405,1405,1805,400
2017,11,19,14,1465,1460,1797,337
2017,11,19,15,1479,1473,1796,323
2017,11,19,16,1473,1469,1800,331
2017,11,19,17,1452,1461,1736,275
2017,11,19,18,1428,1439,1707,268
2017,11,19,19,1413,1420,1651,231
2017,11,19,20,1399,1395,1639,244
2017,11,19,21,1391,1400,1651,251
2017,11,19,22,1395,1390,1645,255
2017,11,19,23,1422,1418,1704,286
2017,11,20,0,1480,1485,1760,275
2017,11,20,1,1614,1660,1870,210
2017,11,20,2,1675,1703,1972,269
2017,11,20,3,1699,1688,1976,288
2017,11,20,4,1675,1664,2009,345
2017,11,20,5,1607,1603,1963,360
2017,11,20,6,1519,1505,1995,490
2017,11,20,7,1434,1428,1918,490
2017,11,20,8,1410,1387,1910,523
2017,11,20,9,1393,1363,1916,553
2017,11,20,10,1392,1358,1870,512
2017,11,20,11,1395,1370,1892,522
2017,11,20,12,1431,1405,1894,489
2017,11,20,13,1521,1492,1898,406
2017,11,20,14,1645,1615,1937,322
2017,11,20,15,1661,1630,1932,302
2017,11,20,16,1634,1614,1864,250
2017,11,20,17,1596,1578,1805,227
2017,11,20,18,1564,1537,1947,410
2017,11,20,19,1534,1499,1912,413
2017,11,20,20,1509,1484,1914,430
2017,11,20,21,1497,1469,1918,449
2017,11,20,22,1505,1481,1928,447
2017,11,20,23,1516,1491,1960,469
2017,11,21,0,1560,1534,1940,406
2017,11,21,1,1682,1671,2068,397
2017,11,21,2,1743,1680,2066,386
2017,11,21,3,1732,1712,2060,348
2017,11,21,4,1716,1680,2045,365
2017,11,21,5,1649,1611,2024,413
2017,11,21,6,1547,1510,1965,455
2017,11,21,7,1455,1409,1901,492
2017,11,21,8,1390,1354,1882,528
2017,11,21,9,1360,1324,1893,569
2017,11,21,10,1343,1303,1879,576
2017,11,21,11,1349,1308,1897,589
2017,11,21,12,1384,1343,1931,588
2017,11,21,13,1467,1425,1927,502
2017,11,21,14,1586,1547,1946,399
2017,11,21,15,1609,1570,1956,386
2017,11,21,16,1589,1551,1981,430
2017,11,21,17,1563,1522,1976,454
2017,11,21,18,1542,1501,2014,513
2017,11,21,19,1524,1475,2029,554
2017,11,21,20,1506,1469,2192,723
2017,11,21,21,1503,1469,2246,777
2017,11,21,22,1511,1477,2253,776
2017,11,21,23,1520,1486,2288,802
2017,11,22,0,1555,1511,2305,794
2017,11,22,1,1660,1646,2369,723
2017,11,22,2,1703,1663,2283,620
2017,11,22,3,1711,1635,2178,543
2017,11,22,4,1683,1610,1724,114
2017,11,22,5,1575,1551,1426,-125
2017,11,22,6,1474,1458,1439,-19
2017,11,22,7,1386,1363,1372,9
2017,11,22,8,1342,1322,1314,-8
2017,11,22,9,1308,1289,1344,55
2017,11,22,10,1301,1276,1348,72
2017,11,22,11,1322,1291,1364,73
2017,11,22,12,1348,1320,1474,154
2017,11,22,13,1430,1394,1520,126
2017,11,22,14,1531,1485,1711,226
2017,11,22,15,1557,1516,1781,265
2017,11,22,16,1566,1532,1509,-23
2017,11,22,17,1541,1517,1510,-7
2017,11,22,18,1511,1495,1590,95
2017,11,22,19,1474,1455,1581,126
2017,11,22,20,1464,1433,1524,91
2017,11,22,21,1457,1422,1623,201
2017,11,22,22,1454,1408,1734,326
2017,11,22,23,1470,1421,1782,361
2017,11,23,0,1508,1471,1847,376
2017,11,23,1,1621,1589,1886,297
2017,11,23,2,1658,1606,1780,174
2017,11,23,3,1650,1585,1853,268
2017,11,23,4,1625,1567,1792,225
2017,11,23,5,1547,1521,1831,310
2017,11,23,6,1463,1441,1814,373
2017,11,23,7,1392,1368,1708,340
2017,11,23,8,1339,1308,1617,309
2017,11,23,9,1305,1275,1675,400
2017,11,23,10,1293,1260,1684,424
2017,11,23,11,1292,1259,1690,431
2017,11,23,12,1309,1268,1688,420
2017,11,23,13,1356,1319,1724,405
2017,11,23,14,1408,1375,1749,374
2017,11,23,15,1443,1409,1772,363
2017,11,23,16,1473,1440,1835,395
2017,11,23,17,1500,1449,1962,513
2017,11,23,18,1509,1443,2065,622
2017,11,23,19,1494,1423,2123,700
2017,11,23,20,1429,1387,2131,744
2017,11,23,21,1371,1357,2107,750
2017,11,23,22,1337,1325,2047,722
2017,11,23,23,1350,1317,2029,712
2017,11,24,0,1387,1338,2036,698
2017,11,24,1,1486,1416,2075,659
2017,11,24,2,1507,1436,2080,644
2017,11,24,3,1511,1429,2083,654
2017,11,24,4,1518,1430,2059,629
2017,11,24,5,1485,1409,2114,705
2017,11,24,6,1437,1367,2140,773
2017,11,24,7,1383,1301,2050,749
2017,11,24,8,1294,1265,2007,742
2017,11,24,9,1269,1245,1971,726
2017,11,24,10,1254,1238,1990,752
2017,11,24,11,1262,1238,1981,743
2017,11,24,12,1292,1256,2022,766
2017,11,24,13,1341,1305,2071,766
2017,11,24,14,1397,1376,2137,761
2017,11,24,15,1414,1381,1914,533
2017,11,24,16,1421,1386,1860,474
2017,11,24,17,1409,1374,1861,487
2017,11,24,18,1392,1356,1866,510
2017,11,24,19,1388,1341,1927,586
2017,11,24,20,1373,1329,1974,645
2017,11,24,21,1384,1329,2004,675
2017,11,24,22,1386,1326,2028,702
2017,11,24,23,1428,1353,2009,656
2017,11,25,0,1483,1412,1934,522
2017,11,25,1,1602,1543,1976,433
2017,11,25,2,1596,1542,2039,497
2017,11,25,3,1584,1525,1979,454
2017,11,25,4,1575,1514,1899,385
2017,11,25,5,1538,1483,1879,396
2017,11,25,6,1463,1417,1962,545
2017,11,25,7,1399,1350,1932,582
2017,11,25,8,1338,1302,1938,636
2017,11,25,9,1301,1272,1818,546
2017,11,25,10,1282,1251,1798,547
2017,11,25,11,1276,1246,1516,270
2017,11,25,12,1288,1258,1458,200
2017,11,25,13,1333,1303,1496,193
2017,11,25,14,1388,1358,1500,142
2017,11,25,15,1403,1374,1597,223
2017,11,25,16,1425,1395,1717,322
2017,11,25,17,1417,1366,1700,334
2017,11,25,18,1407,1346,1759,413
2017,11,25,19,1401,1344,1776,432
2017,11,25,20,1389,1333,1796,463
2017,11,25,21,1389,1352,1826,474
2017,11,25,22,1400,1364,1817,453
2017,11,25,23,1423,1386,1810,424
2017,11,26,0,1469,1434,1786,352
2017,11,26,1,1588,1560,1943,383
2017,11,26,2,1612,1582,1937,355
2017,11,26,3,1590,1557,1863,306
2017,11,26,4,1564,1536,1923,387
2017,11,26,5,1524,1501,1933,432
2017,11,26,6,1450,1423,1865,442
2017,11,26,7,1375,1350,1880,530
2017,11,26,8,1320,1297,1853,556
2017,11,26,9,1297,1271,1823,552
2017,11,26,10,1284,1259,1817,558
2017,11,26,11,1278,1254,1800,546
2017,11,26,12,1290,1269,1838,569
2017,11,26,13,1320,1298,1818,520
2017,11,26,14,1373,1348,1795,447
2017,11,26,15,1387,1355,1801,446
2017,11,26,16,1399,1367,1843,476
2017,11,26,17,1398,1366,1850,484
2017,11,26,18,1393,1358,1961,603
2017,11,26,19,1393,1363,2021,658
2017,11,26,20,1407,1377,2032,655
2017,11,26,21,1405,1377,2028,651
2017,11,26,22,1408,1383,2025,642
2017,11,26,23,1440,1405,1982,577
2017,11,27,0,1501,1464,2031,567
2017,11,27,1,1646,1619,2106,487
2017,11,27,2,1675,1646,2145,499
2017,11,27,3,1654,1628,2091,463
2017,11,27,4,1625,1596,2027,431
2017,11,27,5,1551,1519,1957,438
2017,11,27,6,1444,1420,1926,506
2017,11,27,7,1368,1350,1941,591
2017,11,27,8,1319,1294,1933,639
2017,11,27,9,1299,1268,1903,635
2017,11,27,10,1291,1259,1866,607
2017,11,27,11,1298,1259,1889,630
2017,11,27,12,1329,1299,1891,592
2017,11,27,13,1427,1392,2019,627
2017,11,27,14,1555,1535,2162,627
2017,11,27,15,1580,1558,2074,516
2017,11,27,16,1548,1519,2107,588
2017,11,27,17,1503,1496,2069,573
2017,11,27,18,1472,1465,2124,659
2017,11,27,19,1464,1460,2192,732
2017,11,27,20,1449,1454,2224,770
2017,11,27,21,1471,1459,2231,772
2017,11,27,22,1491,1468,2277,809
2017,11,27,23,1514,1491,2175,684
2017,11,28,0,1566,1536,2175,639
2017,11,28,1,1686,1670,2289,619
2017,11,28,2,1713,1676,2271,595
2017,11,28,3,1688,1654,2230,576
2017,11,28,4,1653,1616,2189,573
2017,11,28,5,1575,1537,2178,641
2017,11,28,6,1471,1429,2057,628
2017,11,28,7,1384,1331,2117,786
2017,11,28,8,1329,1284,2042,758
2017,11,28,9,1287,1243,2105,862
2017,11,28,10,1280,1235,2010,775
2017,11,28,11,1292,1246,1942,696
2017,11,28,12,1328,1276,1814,538
2017,11,28,13,1409,1352,1847,495
2017,11,28,14,1534,1482,1998,516
2017,11,28,15,1557,1511,1987,476
2017,11,28,16,1546,1500,1988,488
2017,11,28,17,1536,1486,1982,496
2017,11,28,18,1515,1473,2034,561
2017,11,28,19,1508,1470,2040,570
2017,11,28,20,1489,1461,2048,587
2017,11,28,21,1493,1456,2048,592
2017,11,28,22,1495,1456,2023,567
2017,11,28,23,1511,1483,2009,526
2017,11,29,0,1561,1533,1890,357
2017,11,29,1,1689,1680,1987,307
2017,11,29,2,1726,1705,1951,246
2017,11,29,3,1711,1701,1886,185
2017,11,29,4,1681,1675,1928,253
2017,11,29,5,1606,1595,2040,445
2017,11,29,6,1508,1489,1932,443
2017,11,29,7,1423,1392,1988,596
2017,11,29,8,1363,1341,1885,544
2017,11,29,9,1343,1317,1715,398
2017,11,29,10,1333,1313,1649,336
2017,11,29,11,1341,1317,1618,301
2017,11,29,12,1382,1352,1701,349
2017,11,29,13,1471,1444,1796,352
2017,11,29,14,1607,1586,1970,384
2017,11,29,15,1612,1598,2018,420
2017,11,29,16,1593,1580,2107,527
2017,11,29,17,1549,1532,2089,557
2017,11,29,18,1526,1508,2158,650
2017,11,29,19,1509,1498,2156,658
2017,11,29,20,1479,1468,2104,636
2017,11,29,21,1483,1464,2129,665
2017,11,29,22,1491,1469,2147,678
2017,11,29,23,1518,1489,2101,612
2017,11,30,0,1570,1560,2085,525
2017,11,30,1,1715,1710,2144,434
2017,11,30,2,1749,1736,2127,391
2017,11,30,3,1724,1708,2102,394
2017,11,30,4,1720,1680,2078,398
2017,11,30,5,1644,1609,2021,412
2017,11,30,6,1539,1497,1914,417
2017,11,30,7,1442,1395,1828,433
2017,11,30,8,1375,1337,1836,499
2017,11,30,9,1342,1308,1831,523
2017,11,30,10,1327,1294,1877,583
2017,11,30,11,1331,1293,1855,562
2017,11,30,12,1366,1322,1910,588
2017,11,30,13,1454,1403,1999,596
2017,11,30,14,1578,1544,2014,470
2017,11,30,15,1561,1536,2043,507
2017,11,30,16,1578,1544,2038,494
2017,11,30,17,1562,1521,1946,425
2017,11,30,18,1556,1537,1908,371
2017,11,30,19,1547,1529,1927,398
2017,11,30,20,1531,1510,1913,403
2017,11,30,21,1518,1513,1830,317
2017,11,30,22,1527,1520,1840,320
2017,11,30,23,1542,1533,1780,247
2017,12,1,0,1605,1587,1821,234
2017,12,1,1,1732,1741,1904,163
2017,12,1,2,1753,1733,1865,132
2017,12,1,3,1733,1709,1839,130
2017,12,1,4,1714,1692,1828,136
2017,12,1,5,1631,1608,1912,304
2017,12,1,6,1529,1499,1841,342
2017,12,1,7,1437,1397,1908,511
2017,12,1,8,1322,1342,1933,591
2017,12,1,9,1269,1297,1847,550
2017,12,1,10,1254,1281,1866,585
2017,12,1,11,1303,1281,1871,590
2017,12,1,12,1357,1310,1886,576
2017,12,1,13,1434,1392,1925,533
2017,12,1,14,1560,1516,1884,368
2017,12,1,15,1580,1521,1885,364
2017,12,1,16,1577,1507,1768,261
2017,12,1,17,1579,1535,1913,378
2017,12,1,18,1557,1477,1922,445
2017,12,1,19,1534,1468,1865,397
2017,12,1,20,1521,1453,1926,473
2017,12,1,21,1503,1405,1813,408
2017,12,1,22,1458,1461,1877,416
2017,12,1,23,1513,1485,1923,438
2017,12,2,0,1560,1527,1903,376
2017,12,2,1,1690,1645,1992,347
2017,12,2,2,1701,1648,1964,316
2017,12,2,3,1663,1634,1919,285
2017,12,2,4,1649,1631,1813,182
2017,12,2,5,1606,1586,1843,257
2017,12,2,6,1565,1507,1805,298
2017,12,2,7,1458,1405,1816,411
2017,12,2,8,1374,1348,1790,442
2017,12,2,9,1347,1321,1770,449
2017,12,2,10,1330,1306,1756,450
2017,12,2,11,1331,1301,1752,451
2017,12,2,12,1360,1316,1759,443
2017,12,2,13,1385,1358,1779,421
2017,12,2,14,1457,1423,1780,357
2017,12,2,15,1481,1448,1819,371
2017,12,2,16,1500,1472,1853,381
2017,12,2,17,1503,1471,1831,360
2017,12,2,18,1513,1470,1825,355
2017,12,2,19,1487,1444,1784,340
2017,12,2,20,1449,1410,1804,394
2017,12,2,21,1433,1384,1802,418
2017,12,2,22,1454,1414,1808,394
2017,12,2,23,1472,1437,1861,424
2017,12,3,0,1518,1496,1859,363
2017,12,3,1,1649,1632,1951,319
2017,12,3,2,1713,1646,1974,328
2017,12,3,3,1683,1623,1959,336
2017,12,3,4,1657,1606,1948,342
2017,12,3,5,1606,1552,2008,456
2017,12,3,6,1491,1477,1919,442
2017,12,3,7,1414,1395,1829,434
2017,12,3,8,1386,1342,1776,434
2017,12,3,9,1348,1311,1798,487
2017,12,3,10,1333,1294,1767,473
2017,12,3,11,1330,1285,1767,482
2017,12,3,12,1340,1297,1789,492
2017,12,3,13,1367,1325,1787,462
2017,12,3,14,1433,1389,1849,460
2017,12,3,15,1434,1401,1826,425
2017,12,3,16,1418,1411,1782,371
2017,12,3,17,1404,1397,1771,374
2017,12,3,18,1394,1385,1820,435
2017,12,3,19,1375,1367,1804,437
2017,12,3,20,1375,1375,1838,463
2017,12,3,21,1399,1397,1819,422
2017,12,3,22,1441,1417,1838,421
2017,12,3,23,1451,1438,1933,495
2017,12,4,0,1515,1507,1965,458
2017,12,4,1,1663,1671,2150,479
2017,12,4,2,1696,1707,2179,472
2017,12,4,3,1679,1682,2186,504
2017,12,4,4,1650,1651,2246,595
2017,12,4,5,1583,1577,2182,605
2017,12,4,6,1487,1473,2154,681
2017,12,4,7,1395,1371,2112,741
2017,12,4,8,1350,1313,2039,726
2017,12,4,9,1325,1285,2011,726
2017,12,4,10,1317,1278,1981,703
2017,12,4,11,1327,1280,2050,770
2017,12,4,12,1363,1320,2093,773
2017,12,4,13,1441,1398,2192,794
2017,12,4,14,1575,1537,2288,751
2017,12,4,15,1596,1560,2315,755
2017,12,4,16,1571,1544,2296,752
2017,12,4,17,1548,1552,2354,802
2017,12,4,18,1505,1516,2452,936
2017,12,4,19,1499,1473,2375,902
2017,12,4,20,1475,1451,2242,791
2017,12,4,21,1466,1454,2281,827
2017,12,4,22,1476,1460,2339,879
2017,12,4,23,1508,1489,2244,755
2017,12,5,0,1568,1567,2139,572
2017,12,5,1,1719,1750,2258,508
2017,12,5,2,1807,1786,2287,501
2017,12,5,3,1779,1781,2275,494
2017,12,5,4,1760,1746,2233,487
2017,12,5,5,1692,1666,2233,567
2017,12,5,6,1582,1553,2249,696
2017,12,5,7,1482,1444,2210,766
2017,12,5,8,1426,1397,2176,779
2017,12,5,9,1396,1364,2144,780
2017,12,5,10,1383,1352,2140,788
2017,12,5,11,1382,1347,2134,787
2017,12,5,12,1432,1387,2137,750
2017,12,5,13,1523,1479,2145,666
2017,12,5,14,1671,1638,2159,521
2017,12,5,15,1649,1644,2075,431
2017,12,5,16,1705,1681,2093,412
2017,12,5,17,1669,1658,2141,483
2017,12,5,18,1649,1639,2040,401
2017,12,5,19,1603,1597,2026,429
2017,12,5,20,1573,1572,1985,413
2017,12,5,21,1566,1557,1959,402
2017,12,5,22,1557,1545,1945,400
2017,12,5,23,1589,1573,1993,420
2017,12,6,0,1654,1641,2004,363
2017,12,6,1,1809,1815,2146,331
2017,12,6,2,1859,1845,2212,367
2017,12,6,3,1848,1832,2177,345
2017,12,6,4,1827,1814,2162,348
2017,12,6,5,1753,1735,2100,365
2017,12,6,6,1644,1615,2068,453
2017,12,6,7,1542,1509,1992,483
2017,12,6,8,1485,1458,1968,510
2017,12,6,9,1459,1430,1984,554
2017,12,6,10,1450,1417,1949,532
2017,12,6,11,1460,1432,1964,532
2017,12,6,12,1499,1470,1992,522
2017,12,6,13,1601,1562,2007,445
2017,12,6,14,1742,1701,2061,360
2017,12,6,15,1763,1715,2104,389
2017,12,6,16,1721,1670,2224,554
2017,12,6,17,1705,1636,2234,598
2017,12,6,18,1663,1602,2230,628
2017,12,6,19,1620,1562,2204,642
2017,12,6,20,1582,1528,2128,600
2017,12,6,21,1567,1510,2029,519
2017,12,6,22,1562,1501,2007,506
2017,12,6,23,1590,1527,2052,525
2017,12,7,0,1650,1610,2072,462
2017,12,7,1,1819,1805,2224,419
2017,12,7,2,1876,1863,2297,434
2017,12,7,3,1859,1871,2284,413
2017,12,7,4,1877,1856,2331,475
2017,12,7,5,1818,1779,2301,522
2017,12,7,6,1691,1661,2167,506
2017,12,7,7,1586,1555,2229,674
2017,12,7,8,1543,1494,2190,696
2017,12,7,9,1518,1465,2129,664
2017,12,7,10,1512,1451,2109,658
2017,12,7,11,1517,1455,2136,681
2017,12,7,12,1551,1497,2195,698
2017,12,7,13,1639,1590,2212,622
2017,12,7,14,1791,1740,2203,463
2017,12,7,15,1825,1771,2184,413
2017,12,7,16,1806,1751,2147,396
2017,12,7,17,1791,1718,2052,334
2017,12,7,18,1769,1701,2011,310
2017,12,7,19,1736,1691,1971,280
2017,12,7,20,1705,1656,1962,306
2017,12,7,21,1691,1645,2023,378
2017,12,7,22,1688,1625,2014,389
2017,12,7,23,1713,1637,2018,381
2017,12,8,0,1771,1721,2108,387
2017,12,8,1,1929,1901,2244,343
2017,12,8,2,1986,1949,2293,344
2017,12,8,3,1972,1950,2298,348
2017,12,8,4,1956,1924,2321,397
2017,12,8,5,1879,1842,2280,438
2017,12,8,6,1763,1727,2244,517
2017,12,8,7,1650,1607,2218,611
2017,12,8,8,1585,1554,2213,659
2017,12,8,9,1561,1527,2142,615
2017,12,8,10,1547,1513,2141,628
2017,12,8,11,1559,1517,2201,684
2017,12,8,12,1597,1553,2216,663
2017,12,8,13,1685,1639,2238,599
2017,12,8,14,1814,1788,2272,484
2017,12,8,15,1831,1818,2327,509
2017,12,8,16,1775,1760,2287,527
2017,12,8,17,1733,1715,2172,457
2017,12,8,18,1653,1659,2156,497
2017,12,8,19,1617,1613,2146,533
2017,12,8,20,1571,1572,2136,564
2017,12,8,21,1536,1547,2143,596
2017,12,8,22,1524,1538,2130,592
2017,12,8,23,1542,1543,2065,522
2017,12,9,0,1647,1615,2153,538
2017,12,9,1,1813,1788,2205,417
2017,12,9,2,1881,1816,2272,456
2017,12,9,3,1870,1807,2265,458
2017,12,9,4,1869,1815,2199,384
2017,12,9,5,1818,1773,2180,407
2017,12,9,6,1706,1687,2160,473
2017,12,9,7,1612,1598,2158,560
2017,12,9,8,1566,1535,2138,603
2017,12,9,9,1535,1507,2108,601
2017,12,9,10,1514,1487,2064,577
2017,12,9,11,1523,1487,2058,571
2017,12,9,12,1574,1504,2078,574
2017,12,9,13,1618,1533,2084,551
2017,12,9,14,1690,1606,1997,391
2017,12,9,15,1706,1637,2003,366
2017,12,9,16,1692,1630,1991,361
2017,12,9,17,1663,1606,1954,348
2017,12,9,18,1622,1562,1930,368
2017,12,9,19,1582,1509,1982,473
2017,12,9,20,1539,1469,1940,471
2017,12,9,21,1506,1442,1923,481
2017,12,9,22,1494,1431,1901,470
2017,12,9,23,1511,1457,1988,531
2017,12,10,0,1566,1538,2031,493
2017,12,10,1,1707,1725,2158,433
2017,12,10,2,1785,1760,2269,509
2017,12,10,3,1797,1754,2246,492
2017,12,10,4,1779,1747,2237,490
2017,12,10,5,1726,1706,2250,544
2017,12,10,6,1646,1631,2227,596
2017,12,10,7,1558,1552,2298,746
2017,12,10,8,1515,1499,2184,685
2017,12,10,9,1486,1472,2155,683
2017,12,10,10,1471,1461,2065,604
2017,12,10,11,1475,1461,2036,575
2017,12,10,12,1490,1473,2054,581
2017,12,10,13,1528,1511,2099,588
2017,12,10,14,1594,1574,2106,532
2017,12,10,15,1615,1589,2076,487
2017,12,10,16,1604,1590,2022,432
2017,12,10,17,1593,1574,2013,439
2017,12,10,18,1553,1541,2005,464
2017,12,10,19,1524,1514,2000,486
2017,12,10,20,1501,1482,1968,486
2017,12,10,21,1481,1463,1982,519
2017,12,10,22,1482,1455,1974,519
2017,12,10,23,1514,1488,1958,470
2017,12,11,0,1614,1582,1986,404
2017,12,11,1,1806,1787,2180,393
2017,12,11,2,1855,1845,2161,316
2017,12,11,3,1848,1849,2128,279
2017,12,11,4,1825,1828,2141,313
2017,12,11,5,1764,1755,2050,295
2017,12,11,6,1658,1629,2008,379
2017,12,11,7,1558,1526,1909,383
2017,12,11,8,1507,1475,1793,318
2017,12,11,9,1483,1456,1712,256
2017,12,11,10,1479,1454,1688,234
2017,12,11,11,1489,1467,1680,213
2017,12,11,12,1523,1498,1695,197
2017,12,11,13,1607,1587,1660,73
2017,12,11,14,1745,1741,1740,-1
2017,12,11,15,1758,1783,1792,9
2017,12,11,16,1715,1737,1744,7
2017,12,11,17,1692,1695,1686,-9
2017,12,11,18,1642,1651,1613,-38
2017,12,11,19,1600,1606,1615,9
2017,12,11,20,1535,1580,1592,12
2017,12,11,21,1515,1559,1596,37
2017,12,11,22,1513,1561,1597,36
2017,12,11,23,1578,1590,1640,50
2017,12,12,0,1655,1657,1651,-6
2017,12,12,1,1812,1828,1858,30
2017,12,12,2,1907,1871,1865,-6
2017,12,12,3,1899,1866,1860,-6
2017,12,12,4,1887,1846,1885,39
2017,12,12,5,1814,1768,1861,93
2017,12,12,6,1696,1648,1852,204
2017,12,12,7,1583,1543,1874,331
2017,12,12,8,1485,1484,1863,379
2017,12,12,9,1460,1455,1752,297
2017,12,12,10,1456,1455,1714,259
2017,12,12,11,1464,1461,1685,224
2017,12,12,12,1504,1508,1662,154
2017,12,12,13,1598,1607,1669,62
2017,12,12,14,1772,1756,1778,22
2017,12,12,15,1775,1786,1789,3
2017,12,12,16,1735,1727,1662,-65
2017,12,12,17,1700,1658,1673,15
2017,12,12,18,1644,1610,1681,71
2017,12,12,19,1603,1569,1695,126
2017,12,12,20,1568,1532,1655,123
2017,12,12,21,1550,1541,1646,105
2017,12,12,22,1545,1584,1640,56
2017,12,12,23,1568,1573,1688,115
2017,12,13,0,1634,1592,1722,130
2017,12,13,1,1790,1784,1929,145
2017,12,13,2,1857,1840,2087,247
2017,12,13,3,1851,1844,2040,196
2017,12,13,4,1841,1834,2035,201
2017,12,13,5,1767,1766,1914,148
2017,12,13,6,1645,1638,1832,194
2017,12,13,7,1545,1527,1812,285
2017,12,13,8,1486,1478,1805,327
2017,12,13,9,1459,1455,1833,378
2017,12,13,10,1452,1450,1833,383
2017,12,13,11,1461,1460,1825,365
2017,12,13,12,1506,1495,1772,277
2017,12,13,13,1596,1589,1780,191
2017,12,13,14,1736,1730,1865,135
2017,12,13,15,1750,1744,1674,-70
2017,12,13,16,1709,1691,1541,-150
2017,12,13,17,1667,1630,1518,-112
2017,12,13,18,1632,1590,1512,-78
2017,12,13,19,1584,1554,1606,52
2017,12,13,20,1563,1479,1563,84
2017,12,13,21,1540,1478,1605,127
2017,12,13,22,1553,1473,1525,52
2017,12,13,23,1575,1495,1549,54
2017,12,14,0,1628,1567,1672,105
2017,12,14,1,1788,1750,1824,74
2017,12,14,2,1846,1802,1872,70
2017,12,14,3,1842,1802,1851,49
2017,12,14,4,1831,1787,1899,112
2017,12,14,5,1761,1714,1868,154
2017,12,14,6,1640,1610,1829,219
2017,12,14,7,1539,1522,1853,331
2017,12,14,8,1493,1460,1688,228
2017,12,14,9,1471,1435,1653,218
2017,12,14,10,1463,1427,1680,253
2017,12,14,11,1466,1434,1647,213
2017,12,14,12,1508,1473,1588,115
2017,12,14,13,1620,1573,1716,143
2017,12,14,14,1750,1708,1907,199
2017,12,14,15,1782,1740,2046,306
2017,12,14,16,1751,1705,1943,238
2017,12,14,17,1730,1682,1886,204
2017,12,14,18,1681,1644,1917,273
2017,12,14,19,1650,1607,1826,219
2017,12,14,20,1632,1587,1640,53
2017,12,14,21,1603,1558,1579,21
2017,12,14,22,1598,1553,1515,-38
2017,12,14,23,1609,1569,1540,-29
2017,12,15,0,1688,1635,1598,-37
2017,12,15,1,1858,1822,1656,-166
2017,12,15,2,1897,1869,1717,-152
2017,12,15,3,1886,1872,1736,-136
2017,12,15,4,1882,1866,1760,-106
2017,12,15,5,1815,1793,1723,-70
2017,12,15,6,1714,1670,1703,33
2017,12,15,7,1610,1558,1547,-11
2017,12,15,8,1493,1474,1483,9
2017,12,15,9,1497,1470,1731,261
2017,12,15,10,1519,1487,1804,317
2017,12,15,11,1516,1496,1809,313
2017,12,15,12,1566,1540,1888,348
2017,12,15,13,1656,1629,2029,400
2017,12,15,14,1791,1773,2182,409
2017,12,15,15,1808,1790,2252,462
2017,12,15,16,1767,1735,2142,407
2017,12,15,17,1671,1655,2039,384
2017,12,15,18,1656,1639,2093,454
2017,12,15,19,1607,1600,2091,491
2017,12,15,20,1577,1557,2069,512
2017,12,15,21,1543,1535,2073,538
2017,12,15,22,1537,1516,2095,579
2017,12,15,23,1560,1532,2151,619
2017,12,16,0,1615,1606,2362,756
2017,12,16,1,1783,1787,2486,699
2017,12,16,2,1834,1818,2487,669
2017,12,16,3,1830,1809,2461,652
2017,12,16,4,1831,1820,2513,693
2017,12,16,5,1787,1789,2467,678
2017,12,16,6,1720,1707,2284,577
2017,12,16,7,1623,1618,2204,586
2017,12,16,8,1553,1558,2207,649
2017,12,16,9,1521,1519,2135,616
2017,12,16,10,1527,1506,2078,572
2017,12,16,11,1526,1499,1897,398
2017,12,16,12,1546,1517,1889,372
2017,12,16,13,1586,1558,1940,382
2017,12,16,14,1668,1627,1990,363
2017,12,16,15,1699,1662,2038,376
2017,12,16,16,1700,1656,2043,387
2017,12,16,17,1673,1629,2083,454
2017,12,16,18,1650,1593,2085,492
2017,12,16,19,1612,1550,2084,534
2017,12,16,20,1576,1508,2064,556
2017,12,16,21,1543,1491,2047,556
2017,12,16,22,1533,1474,2015,541
2017,12,16,23,1554,1501,1973,472
2017,12,17,0,1618,1596,2057,461
2017,12,17,1,1782,1784,2228,444
2017,12,17,2,1839,1820,2287,467
2017,12,17,3,1866,1811,2305,494
2017,12,17,4,1833,1795,2287,492
2017,12,17,5,1785,1743,2208,465
2017,12,17,6,1697,1657,2107,450
2017,12,17,7,1602,1563,2007,444
2017,12,17,8,1528,1497,1947,450
2017,12,17,9,1495,1455,1918,463
2017,12,17,10,1475,1435,1946,511
2017,12,17,11,1471,1425,1955,530
2017,12,17,12,1479,1439,1915,476
2017,12,17,13,1508,1473,1929,456
2017,12,17,14,1583,1535,1839,304
2017,12,17,15,1620,1564,1822,258
2017,12,17,16,1618,1599,1961,362
2017,12,17,17,1622,1565,1907,342
2017,12,17,18,1601,1532,1894,362
2017,12,17,19,1582,1507,1873,366
2017,12,17,20,1562,1484,1705,221
2017,12,17,21,1548,1465,1676,211
2017,12,17,22,1544,1456,1717,261
2017,12,17,23,1576,1479,1735,256
2017,12,18,0,1658,1556,1797,241
2017,12,18,1,1849,1761,1970,209
2017,12,18,2,1899,1814,2021,207
2017,12,18,3,1885,1809,1979,170
2017,12,18,4,1864,1786,1935,149
2017,12,18,5,1768,1725,1944,219
2017,12,18,6,1658,1627,1869,242
2017,12,18,7,1555,1525,1814,289
2017,12,18,8,1498,1472,1747,275
2017,12,18,9,1476,1435,1698,263
2017,12,18,10,1468,1423,1652,229
2017,12,18,11,1473,1431,1650,219
2017,12,18,12,1512,1459,1672,213
2017,12,18,13,1600,1542,1662,120
2017,12,18,14,1742,1682,1726,44
2017,12,18,15,1768,1723,1702,-21
2017,12,18,16,1735,1736,1733,-3
2017,12,18,17,1717,1709,1701,-8
2017,12,18,18,1678,1662,1685,23
2017,12,18,19,1641,1647,1753,106
2017,12,18,20,1613,1622,1746,124
2017,12,18,21,1595,1588,1787,199
2017,12,18,22,1587,1558,1788,230
2017,12,18,23,1605,1584,1867,283
2017,12,19,0,1674,1642,1924,282
2017,12,19,1,1851,1827,2076,249
2017,12,19,2,1921,1876,2101,225
2017,12,19,3,1917,1864,2094,230
2017,12,19,4,1906,1847,2129,282
2017,12,19,5,1829,1778,2094,316
2017,12,19,6,1707,1649,1974,325
2017,12,19,7,1597,1558,1874,316
2017,12,19,8,1519,1494,1765,271
2017,12,19,9,1492,1461,1729,268
2017,12,19,10,1485,1452,1676,224
2017,12,19,11,1496,1456,1696,240
2017,12,19,12,1538,1498,1711,213
2017,12,19,13,1639,1582,1805,223
2017,12,19,14,1783,1704,1882,178
2017,12,19,15,1806,1752,1888,136
2017,12,19,16,1761,1717,1894,177
2017,12,19,17,1707,1662,1858,196
2017,12,19,18,1667,1614,1849,235
2017,12,19,19,1627,1571,1825,254
2017,12,19,20,1594,1535,1760,225
2017,12,19,21,1575,1526,1735,209
2017,12,19,22,1570,1525,1678,153
2017,12,19,23,1584,1544,1737,193
2017,12,20,0,1647,1612,1770,158
2017,12,20,1,1819,1803,1906,103
2017,12,20,2,1878,1857,1931,74
2017,12,20,3,1868,1849,1983,134
2017,12,20,4,1850,1842,2020,178
2017,12,20,5,1776,1780,2003,223
2017,12,20,6,1653,1671,1864,193
2017,12,20,7,1555,1563,1765,202
2017,12,20,8,1498,1488,1646,158
2017,12,20,9,1474,1479,1672,193
2017,12,20,10,1465,1438,1646,208
2017,12,20,11,1471,1451,1663,212
2017,12,20,12,1517,1475,1778,303
2017,12,20,13,1619,1561,1894,333
2017,12,20,14,1759,1683,1949,266
2017,12,20,15,1778,1715,1977,262
2017,12,20,16,1736,1695,1949,254
2017,12,20,17,1674,1646,1896,250
2017,12,20,18,1623,1606,1828,222
2017,12,20,19,1590,1560,1834,274
2017,12,20,20,1560,1528,1693,165
2017,12,20,21,1540,1511,1757,246
2017,12,20,22,1541,1505,1784,279
2017,12,20,23,1564,1525,1765,240
2017,12,21,0,1632,1570,1796,226
2017,12,21,1,1801,1752,1809,57
2017,12,21,2,1844,1800,1872,72
2017,12,21,3,1835,1792,1886,94
2017,12,21,4,1825,1777,1891,114
2017,12,21,5,1758,1727,1851,124
2017,12,21,6,1642,1614,1747,133
2017,12,21,7,1542,1500,1624,124
2017,12,21,8,1487,1445,1538,93
2017,12,21,9,1458,1407,1520,113
2017,12,21,10,1448,1386,1511,125
2017,12,21,11,1457,1390,1531,141
2017,12,21,12,1497,1416,1454,38
2017,12,21,13,1591,1499,1525,26
2017,12,21,14,1733,1611,1553,-58
2017,12,21,15,1768,1664,1690,26
2017,12,21,16,1734,1654,1782,128
2017,12,21,17,1695,1622,1718,96
2017,12,21,18,1611,1582,1768,186
2017,12,21,19,1577,1554,1757,203
2017,12,21,20,1559,1521,1633,112
2017,12,21,21,1551,1503,1562,59
2017,12,21,22,1559,1507,1526,19
2017,12,21,23,1583,1530,1559,29
2017,12,22,0,1628,1594,1650,56
2017,12,22,1,1811,1775,1708,-67
2017,12,22,2,1865,1819,1698,-121
2017,12,22,3,1873,1811,1759,-52
2017,12,22,4,1874,1808,1714,-94
2017,12,22,5,1821,1762,1673,-89
2017,12,22,6,1701,1658,1567,-91
2017,12,22,7,1592,1560,1472,-88
2017,12,22,8,1533,1496,1446,-50
2017,12,22,9,1505,1459,1442,-17
2017,12,22,10,1495,1451,1471,20
2017,12,22,11,1500,1457,1518,61
2017,12,22,12,1537,1495,1536,41
2017,12,22,13,1625,1570,1576,6
2017,12,22,14,1749,1684,1549,-135
2017,12,22,15,1767,1744,1643,-101
2017,12,22,16,1752,1738,1740,2
2017,12,22,17,1712,1720,1688,-32
2017,12,22,18,1677,1679,1727,48
2017,12,22,19,1640,1623,1744,121
2017,12,22,20,1614,1569,1720,151
2017,12,22,21,1592,1538,1728,190
2017,12,22,22,1581,1513,1747,234
2017,12,22,23,1563,1535,1802,267
2017,12,23,0,1620,1605,1884,279
2017,12,23,1,1792,1790,2020,230
2017,12,23,2,1846,1844,1965,121
2017,12,23,3,1849,1832,1917,85
2017,12,23,4,1857,1841,1954,113
2017,12,23,5,1810,1802,1895,93
2017,12,23,6,1715,1722,1816,94
2017,12,23,7,1619,1629,1800,171
2017,12,23,8,1559,1599,1733,134
2017,12,23,9,1522,1565,1715,150
2017,12,23,10,1506,1515,1679,164
2017,12,23,11,1505,1502,1670,168
2017,12,23,12,1521,1515,1661,146
2017,12,23,13,1561,1554,1751,197
2017,12,23,14,1630,1618,1862,244
2017,12,23,15,1671,1647,1907,260
2017,12,23,16,1674,1648,1932,284
2017,12,23,17,1650,1635,1989,354
2017,12,23,18,1611,1615,1984,369
2017,12,23,19,1564,1572,1980,408
2017,12,23,20,1526,1530,2023,493
2017,12,23,21,1494,1514,1869,355
2017,12,23,22,1480,1499,1889,390
2017,12,23,23,1505,1512,1916,404
2017,12,24,0,1576,1582,1975,393
2017,12,24,1,1766,1768,2067,299
2017,12,24,2,1804,1809,2068,259
2017,12,24,3,1794,1804,2030,226
2017,12,24,4,1782,1793,2070,277
2017,12,24,5,1723,1750,2077,327
2017,12,24,6,1655,1667,2013,346
2017,12,24,7,1589,1574,1936,362
2017,12,24,8,1530,1507,1827,320
2017,12,24,9,1496,1457,1746,289
2017,12,24,10,1474,1435,1730,295
2017,12,24,11,1462,1433,1744,311
2017,12,24,12,1488,1439,1755,316
2017,12,24,13,1550,1477,1717,240
2017,12,24,14,1583,1526,1731,205
2017,12,24,15,1621,1574,1815,241
2017,12,24,16,1647,1598,1823,225
2017,12,24,17,1660,1593,1776,183
2017,12,24,18,1641,1531,1703,172
2017,12,24,19,1606,1485,1674,189
2017,12,24,20,1562,1464,1726,262
2017,12,24,21,1541,1456,1719,263
2017,12,24,22,1448,1456,1733,277
2017,12,24,23,1459,1466,1698,232
2017,12,25,0,1534,1518,1734,216
2017,12,25,1,1694,1656,1869,213
2017,12,25,2,1713,1673,1941,268
2017,12,25,3,1688,1654,1928,274
2017,12,25,4,1685,1643,1897,254
2017,12,25,5,1645,1631,1906,275
2017,12,25,6,1598,1587,1859,272
2017,12,25,7,1552,1522,1783,261
2017,12,25,8,1483,1465,1682,217
2017,12,25,9,1447,1433,1664,231
2017,12,25,10,1419,1409,1663,254
2017,12,25,11,1421,1402,1659,257
2017,12,25,12,1436,1405,1652,247
2017,12,25,13,1463,1433,1623,190
2017,12,25,14,1510,1477,1555,78
2017,12,25,15,1541,1506,1604,98
2017,12,25,16,1533,1505,1677,172
2017,12,25,17,1532,1515,1647,132
2017,12,25,18,1529,1514,1737,223
2017,12,25,19,1486,1467,1717,250
2017,12,25,20,1424,1404,1647,243
2017,12,25,21,1391,1365,1644,279
2017,12,25,22,1373,1343,1663,320
2017,12,25,23,1389,1351,1629,278
2017,12,26,0,1465,1397,1588,191
2017,12,26,1,1602,1548,1582,34
2017,12,26,2,1636,1597,1642,45
2017,12,26,3,1638,1588,1603,15
2017,12,26,4,1653,1611,1617,6
2017,12,26,5,1619,1585,1615,30
2017,12,26,6,1549,1520,1570,50
2017,12,26,7,1483,1449,1551,102
2017,12,26,8,1424,1398,1564,166
2017,12,26,9,1397,1373,1533,160
2017,12,26,10,1388,1360,1527,167
2017,12,26,11,1391,1371,1565,194
2017,12,26,12,1425,1394,1567,173
2017,12,26,13,1493,1460,1549,89
2017,12,26,14,1623,1546,1524,-22
2017,12,26,15,1647,1585,1558,-27
2017,12,26,16,1617,1581,1635,54
2017,12,26,17,1595,1555,1636,81
2017,12,26,18,1555,1528,1661,133
2017,12,26,19,1525,1502,1670,168
2017,12,26,20,1498,1469,1615,146
2017,12,26,21,1476,1451,1641,190
2017,12,26,22,1476,1450,1679,229
2017,12,26,23,1488,1472,1641,169
2017,12,27,0,1548,1528,1639,111
2017,12,27,1,1681,1697,1891,194
2017,12,27,2,1752,1736,1936,200
2017,12,27,3,1775,1730,1827,97
2017,12,27,4,1777,1719,1839,120
2017,12,27,5,1709,1666,1768,102
2017,12,27,6,1599,1574,1634,60
2017,12,27,7,1492,1486,1627,141
2017,12,27,8,1437,1426,1604,178
2017,12,27,9,1408,1398,1597,199
2017,12,27,10,1396,1383,1569,186
2017,12,27,11,1403,1388,1617,229
2017,12,27,12,1435,1418,1593,175
2017,12,27,13,1503,1485,1615,130
2017,12,27,14,1621,1580,1657,77
2017,12,27,15,1649,1612,1661,49
2017,12,27,16,1620,1612,1766,154
2017,12,27,17,1579,1577,1737,160
2017,12,27,18,1550,1538,1696,158
2017,12,27,19,1524,1529,1690,161
2017,12,27,20,1500,1489,1683,194
2017,12,27,21,1487,1470,1628,158
2017,12,27,22,1486,1459,1650,191
2017,12,27,23,1509,1479,1660,181
2017,12,28,0,1567,1535,1717,182
2017,12,28,1,1730,1702,1871,169
2017,12,28,2,1772,1757,1927,170
2017,12,28,3,1776,1750,1903,153
2017,12,28,4,1758,1744,1885,141
2017,12,28,5,1696,1693,1886,193
2017,12,28,6,1590,1605,1820,215
2017,12,28,7,1494,1506,1796,290
2017,12,28,8,1460,1455,1687,232
2017,12,28,9,1434,1427,1669,242
2017,12,28,10,1428,1417,1659,242
2017,12,28,11,1435,1426,1671,245
2017,12,28,12,1469,1448,1695,247
2017,12,28,13,1544,1516,1689,173
2017,12,28,14,1668,1608,1710,102
2017,12,28,15,1688,1651,1911,260
2017,12,28,16,1657,1659,1839,180
2017,12,28,17,1597,1614,1758,144
2017,12,28,18,1557,1570,1708,138
2017,12,28,19,1524,1521,1663,142
2017,12,28,20,1494,1488,1651,163
2017,12,28,21,1478,1467,1609,142
2017,12,28,22,1477,1460,1599,139
2017,12,28,23,1499,1479,1634,155
2017,12,29,0,1562,1528,1689,161
2017,12,29,1,1726,1694,1889,195
2017,12,29,2,1772,1760,1960,200
2017,12,29,3,1772,1756,1874,118
2017,12,29,4,1764,1751,1885,134
2017,12,29,5,1703,1692,1823,131
2017,12,29,6,1600,1606,1705,99
2017,12,29,7,1500,1513,1611,98
2017,12,29,8,1453,1454,1594,140
2017,12,29,9,1423,1421,1595,174
2017,12,29,10,1399,1413,1636,223
2017,12,29,11,1405,1421,1682,261
2017,12,29,12,1437,1453,1684,231
2017,12,29,13,1516,1521,1693,172
2017,12,29,14,1636,1615,1806,191
2017,12,29,15,1657,1646,1900,254
2017,12,29,16,1623,1637,1943,306
2017,12,29,17,1581,1596,1858,262
2017,12,29,18,1532,1553,1785,232
2017,12,29,19,1515,1509,1754,245
2017,12,29,20,1482,1475,1677,202
2017,12,29,21,1467,1456,1324,-132
2017,12,29,22,1463,1439,1338,-101
2017,12,29,23,1483,1449,1348,-101
2017,12,30,0,1536,1497,1471,-26
2017,12,30,1,1691,1661,1643,-18
2017,12,30,2,1706,1708,1790,82
2017,12,30,3,1710,1702,1860,158
2017,12,30,4,1715,1706,1822,116
2017,12,30,5,1672,1669,1814,145
2017,12,30,6,1591,1594,1737,143
2017,12,30,7,1499,1509,1698,189
2017,12,30,8,1440,1444,1674,230
2017,12,30,9,1402,1411,1701,290
2017,12,30,10,1387,1400,1693,293
2017,12,30,11,1386,1401,1688,287
2017,12,30,12,1394,1415,1699,284
2017,12,30,13,1426,1456,1739,283
2017,12,30,14,1496,1518,1752,234
2017,12,30,15,1535,1553,1735,182
2017,12,30,16,1544,1562,1787,225
2017,12,30,17,1522,1523,1796,273
2017,12,30,18,1502,1490,1736,246
2017,12,30,19,1462,1457,1734,277
2017,12,30,20,1433,1417,1746,329
2017,12,30,21,1410,1402,1703,301
2017,12,30,22,1409,1398,1666,268
2017,12,30,23,1437,1421,1724,303
2017,12,31,0,1496,1479,1795,316
2017,12,31,1,1663,1641,1974,333
2017,12,31,2,1708,1690,2032,342
2017,12,31,3,1702,1676,2032,356
2017,12,31,4,1688,1660,2043,383
2017,12,31,5,1658,1617,2028,411
2017,12,31,6,1581,1556,1910,354
2017,12,31,7,1491,1478,1833,355
2017,12,31,8,1422,1425,1795,370
2017,12,31,9,1383,1383,1759,376
2017,12,31,10,1366,1357,1743,386
2017,12,31,11,1366,1351,1716,365
2017,12,31,12,1377,1355,1715,360
2017,12,31,13,1401,1397,1791,394
2017,12,31,14,1462,1446,1874,428
2017,12,31,15,1491,1432,1789,357
2017,12,31,16,1504,1479,1783,304
2017,12,31,17,1489,1478,1823,345
2017,12,31,18,1464,1467,1830,363
2017,12,31,19,1448,1455,1791,336
2017,12,31,20,1428,1431,1761,330
2017,12,31,21,1415,1429,1745,316
2017,12,31,22,1421,1442,1729,287
2017,12,31,23,1449,1459,1735,276
2018,1,1,0,1531,1523,1816,293
2018,1,1,1,1713,1682,1933,251
2018,1,1,2,1774,1719,1934,215
2018,1,1,3,1764,1700,1865,165
2018,1,1,4,1717,1675,1883,208
2018,1,1,5,1652,1646,1875,229
2018,1,1,6,1583,1601,1843,242
2018,1,1,7,1513,1556,1816,260
2018,1,1,8,1503,1523,1604,81
2018,1,1,9,1470,1489,1466,-23
2018,1,1,10,1450,1473,1452,-21
2018,1,1,11,1448,1473,1463,-10
2018,1,1,12,1455,1484,1459,-25
2018,1,1,13,1493,1519,1478,-41
2018,1,1,14,1550,1562,1500,-62
2018,1,1,15,1561,1566,1458,-108
2018,1,1,16,1554,1566,1459,-107
2018,1,1,17,1532,1545,1312,-233
2018,1,1,18,1512,1528,1339,-189
2018,1,1,19,1487,1505,1369,-136
2018,1,1,20,1455,1470,1350,-120
2018,1,1,21,1423,1435,1306,-129
2018,1,1,22,1415,1427,1242,-185
2018,1,1,23,1436,1440,1290,-150
2018,1,2,0,1512,1512,1409,-103
2018,1,2,1,1671,1699,1596,-103
2018,1,2,2,1740,1756,1565,-191
2018,1,2,3,1765,1754,1530,-224
2018,1,2,4,1737,1738,1540,-198
2018,1,2,5,1660,1687,1554,-133
2018,1,2,6,1579,1586,1542,-44
2018,1,2,7,1506,1500,1493,-7
2018,1,2,8,1441,1440,1474,34
2018,1,2,9,1428,1412,1414,2
2018,1,2,10,1416,1395,1397,2
2018,1,2,11,1424,1398,1447,49
2018,1,2,12,1459,1435,1459,24
2018,1,2,13,1550,1511,1475,-36
2018,1,2,14,1667,1635,1619,-16
2018,1,2,15,1703,1676,1603,-73
2018,1,2,16,1680,1664,1608,-56
2018,1,2,17,1635,1619,1435,-184
2018,1,2,18,1600,1594,1434,-160
2018,1,2,19,1562,1561,1450,-111
2018,1,2,20,1527,1525,1393,-132
2018,1,2,21,1511,1505,1368,-137
2018,1,2,22,1512,1510,1327,-183
2018,1,2,23,1520,1516,1292,-224
2018,1,3,0,1591,1578,1359,-219
2018,1,3,1,1815,1752,1433,-319
2018,1,3,2,1880,1817,1451,-366
2018,1,3,3,1878,1805,1417,-388
2018,1,3,4,1848,1792,1363,-429
2018,1,3,5,1780,1726,1359,-367
2018,1,3,6,1640,1613,1265,-348
2018,1,3,7,1528,1520,1320,-200
2018,1,3,8,1488,1461,1243,-218
2018,1,3,9,1469,1444,1255,-189
2018,1,3,10,1462,1436,1276,-160
2018,1,3,11,1466,1444,1275,-169
2018,1,3,12,1505,1474,1227,-247
2018,1,3,13,1605,1570,1290,-280
2018,1,3,14,1733,1705,1343,-362
2018,1,3,15,1793,1747,1394,-353
2018,1,3,16,1747,1718,1476,-242
2018,1,3,17,1701,1680,1366,-314
2018,1,3,18,1660,1637,1306,-331
2018,1,3,19,1612,1591,1300,-291
2018,1,3,20,1562,1538,1341,-197
2018,1,3,21,1533,1512,1408,-104
2018,1,3,22,1525,1497,1450,-47
2018,1,3,23,1542,1513,1512,-1
2018,1,4,0,1606,1583,1563,-20
2018,1,4,1,1775,1756,1648,-108
2018,1,4,2,1831,1821,1645,-176
2018,1,4,3,1832,1814,1594,-220
2018,1,4,4,1821,1809,1554,-255
2018,1,4,5,1758,1738,1520,-218
2018,1,4,6,1657,1618,1469,-149
2018,1,4,7,1559,1517,1436,-81
2018,1,4,8,1478,1471,1417,-54
2018,1,4,9,1436,1442,1370,-72
2018,1,4,10,1419,1441,1443,2
2018,1,4,11,1425,1440,1435,-5
2018,1,4,12,1466,1471,1450,-21
2018,1,4,13,1564,1557,1424,-133
2018,1,4,14,1692,1679,1445,-234
2018,1,4,15,1708,1752,1486,-266
2018,1,4,16,1669,1734,1530,-204
2018,1,4,17,1624,1720,1426,-294
2018,1,4,18,1614,1690,1378,-312
2018,1,4,19,1587,1628,1343,-285
2018,1,4,20,1542,1594,1331,-263
2018,1,4,21,1532,1563,1353,-210
2018,1,4,22,1521,1552,1364,-188
2018,1,4,23,1532,1536,1353,-183
2018,1,5,0,1598,1594,1331,-263
2018,1,5,1,1758,1754,1416,-338
2018,1,5,2,1808,1824,1456,-368
2018,1,5,3,1802,1819,1477,-342
2018,1,5,4,1787,1810,1431,-379
2018,1,5,5,1715,1748,1379,-369
2018,1,5,6,1605,1653,1323,-330
2018,1,5,7,1508,1561,1316,-245
2018,1,5,8,1473,1509,1275,-234
2018,1,5,9,1447,1483,1194,-289
2018,1,5,10,1436,1473,1230,-243
2018,1,5,11,1439,1473,1247,-226
2018,1,5,12,1478,1513,1270,-243
2018,1,5,13,1561,1585,1431,-154
2018,1,5,14,1687,1711,1454,-257
2018,1,5,15,1729,1752,1545,-207
2018,1,5,16,1715,1743,1526,-217
2018,1,5,17,1680,1708,1460,-248
2018,1,5,18,1620,1651,1398,-253
2018,1,5,19,1575,1598,1369,-229
2018,1,5,20,1539,1558,1384,-174
2018,1,5,21,1496,1542,1399,-143
2018,1,5,22,1471,1525,1360,-165
2018,1,5,23,1478,1524,1341,-183
2018,1,6,0,1536,1572,1381,-191
2018,1,6,1,1675,1698,1407,-291
2018,1,6,2,1737,1743,1427,-316
2018,1,6,3,1730,1726,1418,-308
2018,1,6,4,1727,1737,1423,-314
2018,1,6,5,1681,1699,1421,-278
2018,1,6,6,1597,1624,1404,-220
2018,1,6,7,1509,1531,1377,-154
2018,1,6,8,1462,1479,1373,-106
2018,1,6,9,1429,1443,1393,-50
2018,1,6,10,1411,1425,1328,-97
2018,1,6,11,1408,1419,1290,-129
2018,1,6,12,1425,1437,1307,-130
2018,1,6,13,1475,1479,1314,-165
2018,1,6,14,1545,1542,1346,-196
2018,1,6,15,1591,1580,1374,-206
2018,1,6,16,1587,1589,1452,-137
2018,1,6,17,1582,1591,1472,-119
2018,1,6,18,1541,1542,1482,-60
2018,1,6,19,1518,1524,1456,-68
2018,1,6,20,1474,1478,1455,-23
2018,1,6,21,1483,1452,1433,-19
2018,1,6,22,1464,1441,1470,29
2018,1,6,23,1464,1444,1417,-27
2018,1,7,0,1552,1512,1548,36
2018,1,7,1,1707,1659,1603,-56
2018,1,7,2,1754,1703,1594,-109
2018,1,7,3,1740,1686,1583,-103
2018,1,7,4,1722,1662,1563,-99
2018,1,7,5,1677,1612,1518,-94
2018,1,7,6,1602,1531,1489,-42
2018,1,7,7,1516,1445,1507,62
2018,1,7,8,1416,1370,1456,86
2018,1,7,9,1406,1363,1494,131
2018,1,7,10,1387,1341,1509,168
2018,1,7,11,1387,1337,1483,146
2018,1,7,12,1392,1345,1506,161
2018,1,7,13,1418,1372,1553,181
2018,1,7,14,1481,1424,1606,182
2018,1,7,15,1517,1451,1679,228
2018,1,7,16,1526,1467,1728,261
2018,1,7,17,1532,1475,1719,244
2018,1,7,18,1516,1462,1723,261
2018,1,7,19,1489,1443,1623,180
2018,1,7,20,1464,1422,1582,160
2018,1,7,21,1456,1417,1565,148
2018,1,7,22,1460,1425,1506,81
2018,1,7,23,1483,1445,1518,73
2018,1,8,0,1544,1497,1493,-4
2018,1,8,1,1711,1666,1452,-214
2018,1,8,2,1774,1736,1580,-156
2018,1,8,3,1759,1718,1607,-111
2018,1,8,4,1740,1700,1568,-132
2018,1,8,5,1682,1638,1563,-75
2018,1,8,6,1580,1546,1523,-23
2018,1,8,7,1494,1458,1463,5
2018,1,8,8,1454,1404,1451,47
2018,1,8,9,1423,1380,1453,73
2018,1,8,10,1418,1373,1405,32
2018,1,8,11,1426,1380,1406,26
2018,1,8,12,1464,1418,1463,45
2018,1,8,13,1554,1528,1483,-45
2018,1,8,14,1669,1665,1496,-169
2018,1,8,15,1730,1698,1527,-171
2018,1,8,16,1715,1677,1585,-92
2018,1,8,17,1640,1654,1540,-114
2018,1,8,18,1600,1621,1558,-63
2018,1,8,19,1591,1600,1540,-60
2018,1,8,20,1552,1577,1538,-39
2018,1,8,21,1537,1547,1678,131
2018,1,8,22,1532,1530,1616,86
2018,1,8,23,1558,1537,1559,22
2018,1,9,0,1616,1591,1554,-37
2018,1,9,1,1778,1724,1612,-112
2018,1,9,2,1836,1769,1632,-137
2018,1,9,3,1816,1746,1652,-94
2018,1,9,4,1785,1731,1649,-82
2018,1,9,5,1705,1667,1643,-24
2018,1,9,6,1600,1555,1598,43
2018,1,9,7,1502,1454,1563,109
2018,1,9,8,1440,1389,1526,137
2018,1,9,9,1407,1364,1487,123
2018,1,9,10,1395,1348,1501,153
2018,1,9,11,1402,1343,1468,125
2018,1,9,12,1442,1384,1444,60
2018,1,9,13,1539,1474,1481,7
2018,1,9,14,1666,1626,1561,-65
2018,1,9,15,1733,1677,1641,-36
2018,1,9,16,1711,1658,1634,-24
2018,1,9,17,1685,1616,1588,-28
2018,1,9,18,1651,1571,1513,-58
2018,1,9,19,1597,1543,1553,10
2018,1,9,20,1565,1518,1531,13
2018,1,9,21,1548,1502,1512,10
2018,1,9,22,1542,1485,1554,69
2018,1,9,23,1554,1493,1477,-16
2018,1,10,0,1604,1542,1471,-71
2018,1,10,1,1745,1662,1518,-144
2018,1,10,2,1784,1727,1589,-138
2018,1,10,3,1770,1705,1573,-132
2018,1,10,4,1750,1682,1585,-97
2018,1,10,5,1674,1613,1568,-45
2018,1,10,6,1567,1505,1486,-19
2018,1,10,7,1472,1411,1468,57
2018,1,10,8,1398,1369,1458,89
2018,1,10,9,1364,1338,1496,158
2018,1,10,10,1353,1327,1452,125
2018,1,10,11,1369,1330,1446,116
2018,1,10,12,1412,1366,1397,31
2018,1,10,13,1502,1454,1449,-5
2018,1,10,14,1627,1594,1579,-15
2018,1,10,15,1662,1649,1676,27
2018,1,10,16,1662,1650,1620,-30
2018,1,10,17,1662,1659,1674,15
2018,1,10,18,1633,1671,1702,31
2018,1,10,19,1612,1640,1700,60
2018,1,10,20,1593,1616,1733,117
2018,1,10,21,1585,1583,1715,132
2018,1,10,22,1585,1606,1643,37
2018,1,10,23,1651,1628,1618,-10
2018,1,11,0,1711,1661,1554,-107
2018,1,11,1,1852,1804,1734,-70
2018,1,11,2,1885,1839,1813,-26
2018,1,11,3,1820,1824,1790,-34
2018,1,11,4,1799,1775,1788,13
2018,1,11,5,1728,1698,1702,4
2018,1,11,6,1619,1545,1601,56
2018,1,11,7,1523,1444,1589,145
2018,1,11,8,1446,1401,1584,183
2018,1,11,9,1429,1393,1588,195
2018,1,11,10,1421,1387,1465,78
2018,1,11,11,1421,1388,1480,92
2018,1,11,12,1459,1418,1430,12
2018,1,11,13,1555,1506,1509,3
2018,1,11,14,1686,1642,1512,-130
2018,1,11,15,1729,1682,1535,-147
2018,1,11,16,1684,1637,1462,-175
2018,1,11,17,1654,1599,1435,-164
2018,1,11,18,1618,1576,1461,-115
2018,1,11,19,1582,1543,1481,-62
2018,1,11,20,1551,1510,1440,-70
2018,1,11,21,1526,1488,1467,-21
2018,1,11,22,1525,1474,1462,-12
2018,1,11,23,1538,1504,1546,42
2018,1,12,0,1600,1557,1545,-12
2018,1,12,1,1771,1708,1597,-111
2018,1,12,2,1821,1795,1683,-112
2018,1,12,3,1806,1794,1643,-151
2018,1,12,4,1796,1778,1616,-162
2018,1,12,5,1731,1720,1636,-84
2018,1,12,6,1627,1601,1559,-42
2018,1,12,7,1531,1509,1509,0
2018,1,12,8,1491,1461,1464,3
2018,1,12,9,1465,1437,1465,28
2018,1,12,10,1464,1435,1477,42
2018,1,12,11,1478,1450,1508,58
2018,1,12,12,1505,1474,1519,45
2018,1,12,13,1593,1557,1608,51
2018,1,12,14,1739,1707,1630,-77
2018,1,12,15,1770,1732,1685,-47
2018,1,12,16,1695,1689,1657,-32
2018,1,12,17,1645,1636,1642,6
2018,1,12,18,1601,1584,1666,82
2018,1,12,19,1543,1527,1723,196
2018,1,12,20,1498,1496,1744,248
2018,1,12,21,1470,1484,1731,247
2018,1,12,22,1467,1474,1636,162
2018,1,12,23,1491,1476,1603,127
2018,1,13,0,1563,1517,1603,86
2018,1,13,1,1707,1648,1641,-7
2018,1,13,2,1761,1707,1649,-58
2018,1,13,3,1757,1695,1681,-14
2018,1,13,4,1746,1689,1696,7
2018,1,13,5,1712,1645,1642,-3
2018,1,13,6,1626,1566,1618,52
2018,1,13,7,1541,1499,1530,31
2018,1,13,8,1482,1449,1484,35
2018,1,13,9,1459,1430,1491,61
2018,1,13,10,1451,1423,1474,51
2018,1,13,11,1448,1418,1426,8
2018,1,13,12,1467,1442,1422,-20
2018,1,13,13,1506,1483,1402,-81
2018,1,13,14,1578,1543,1399,-144
2018,1,13,15,1625,1583,1389,-194
2018,1,13,16,1625,1582,1446,-136
2018,1,13,17,1605,1554,1443,-111
2018,1,13,18,1564,1515,1479,-36
2018,1,13,19,1532,1476,1528,52
2018,1,13,20,1494,1449,1525,76
2018,1,13,21,1470,1420,1562,142
2018,1,13,22,1461,1414,1537,123
2018,1,13,23,1495,1430,1581,151
2018,1,14,0,1562,1476,1610,134
2018,1,14,1,1702,1614,1636,22
2018,1,14,2,1757,1693,1709,16
2018,1,14,3,1750,1685,1660,-25
2018,1,14,4,1733,1672,1709,37
2018,1,14,5,1692,1630,1637,7
2018,1,14,6,1613,1549,1573,24
2018,1,14,7,1536,1478,1557,79
2018,1,14,8,1466,1429,1499,70
2018,1,14,9,1446,1405,1453,48
2018,1,14,10,1431,1396,1449,53
2018,1,14,11,1439,1404,1437,33
2018,1,14,12,1449,1412,1421,9
2018,1,14,13,1483,1450,1458,8
2018,1,14,14,1550,1506,1499,-7
2018,1,14,15,1581,1527,1480,-47
2018,1,14,16,1579,1539,1500,-39
2018,1,14,17,1553,1512,1514,2
2018,1,14,18,1523,1481,1511,30
2018,1,14,19,1497,1453,1454,1
2018,1,14,20,1468,1426,1392,-34
2018,1,14,21,1450,1406,1371,-35
2018,1,14,22,1441,1397,1337,-60
2018,1,14,23,1455,1408,1354,-54
2018,1,15,0,1503,1455,1319,-136
2018,1,15,1,1688,1602,1351,-251
2018,1,15,2,1759,1683,1385,-298
2018,1,15,3,1760,1683,1409,-274
2018,1,15,4,1742,1665,1500,-165
2018,1,15,5,1683,1609,1531,-78
2018,1,15,6,1602,1478,1433,-45
2018,1,15,7,1517,1472,1467,-5
2018,1,15,8,1470,1434,1332,-102
2018,1,15,9,1447,1394,1185,-209
2018,1,15,10,1433,1386,1196,-190
2018,1,15,11,1442,1394,1235,-159
2018,1,15,12,1472,1420,1264,-156
2018,1,15,13,1543,1496,1302,-194
2018,1,15,14,1642,1597,1278,-319
2018,1,15,15,1686,1650,1295,-355
2018,1,15,16,1694,1668,1310,-358
2018,1,15,17,1666,1642,1329,-313
2018,1,15,18,1631,1609,1368,-241
2018,1,15,19,1603,1571,1420,-151
2018,1,15,20,1572,1543,1429,-114
2018,1,15,21,1547,1503,1369,-134
2018,1,15,22,1548,1511,1370,-141
2018,1,15,23,1576,1543,1447,-96
2018,1,16,0,1628,1600,1439,-161
2018,1,16,1,1790,1751,1585,-166
2018,1,16,2,1864,1810,1513,-297
2018,1,16,3,1863,1809,1468,-341
2018,1,16,4,1835,1789,1479,-310
2018,1,16,5,1763,1729,1442,-287
2018,1,16,6,1642,1619,1399,-220
2018,1,16,7,1563,1534,1336,-198
2018,1,16,8,1528,1491,1240,-251
2018,1,16,9,1502,1471,1201,-270
2018,1,16,10,1499,1467,1179,-288
2018,1,16,11,1515,1483,1170,-313
2018,1,16,12,1547,1511,1158,-353
2018,1,16,13,1645,1601,1169,-432
2018,1,16,14,1772,1744,1264,-480
2018,1,16,15,1816,1794,1346,-448
2018,1,16,16,1830,1797,1340,-457
2018,1,16,17,1796,1782,1255,-527
2018,1,16,18,1772,1758,1277,-481
2018,1,16,19,1735,1741,1257,-484
2018,1,16,20,1689,1695,1250,-445
2018,1,16,21,1648,1641,1226,-415
2018,1,16,22,1612,1595,1168,-427
2018,1,16,23,1613,1591,1171,-420
2018,1,17,0,1679,1634,1204,-430
2018,1,17,1,1820,1784,1337,-447
2018,1,17,2,1874,1872,1440,-432
2018,1,17,3,1888,1864,1378,-486
2018,1,17,4,1879,1852,1383,-469
2018,1,17,5,1807,1781,1317,-464
2018,1,17,6,1693,1675,1205,-470
2018,1,17,7,1604,1587,1013,-574
2018,1,17,8,1583,1545,900,-645
2018,1,17,9,1551,1522,916,-606
2018,1,17,10,1547,1519,937,-582
2018,1,17,11,1554,1527,949,-578
2018,1,17,12,1592,1564,1018,-546
2018,1,17,13,1671,1658,1092,-566
2018,1,17,14,1828,1794,1166,-628
2018,1,17,15,1856,1812,1390,-422
2018,1,17,16,1809,1774,1372,-402
2018,1,17,17,1756,1711,1301,-410
2018,1,17,18,1709,1670,1264,-406
2018,1,17,19,1663,1625,1280,-345
2018,1,17,20,1621,1584,1179,-405
2018,1,17,21,1585,1555,1151,-404
2018,1,17,22,1571,1541,1155,-386
2018,1,17,23,1608,1567,1163,-404
2018,1,18,0,1669,1632,1232,-400
2018,1,18,1,1818,1773,1267,-506
2018,1,18,2,1895,1858,1372,-486
2018,1,18,3,1898,1857,1251,-606
2018,1,18,4,1873,1849,1226,-623
2018,1,18,5,1800,1780,1234,-546
2018,1,18,6,1694,1666,1178,-488
2018,1,18,7,1608,1583,1047,-536
2018,1,18,8,1561,1544,1039,-505
2018,1,18,9,1540,1524,1041,-483
2018,1,18,10,1533,1515,1033,-482
2018,1,18,11,1544,1529,1034,-495
2018,1,18,12,1592,1558,1082,-476
2018,1,18,13,1691,1658,1126,-532
2018,1,18,14,1821,1809,1208,-601
2018,1,18,15,1842,1836,1296,-540
2018,1,18,16,1788,1777,1378,-399
2018,1,18,17,1729,1692,1329,-363
2018,1,18,18,1680,1634,1266,-368
2018,1,18,19,1630,1571,1259,-312
2018,1,18,20,1584,1529,1278,-251
2018,1,18,21,1555,1493,1203,-290
2018,1,18,22,1542,1472,1153,-319
2018,1,18,23,1551,1476,1129,-347
2018,1,19,0,1600,1516,1184,-332
2018,1,19,1,1750,1649,1250,-399
2018,1,19,2,1815,1754,1348,-406
2018,1,19,3,1818,1755,1303,-452
2018,1,19,4,1803,1742,1318,-424
2018,1,19,5,1740,1683,1286,-397
2018,1,19,6,1634,1586,1308,-278
2018,1,19,7,1551,1496,1214,-282
2018,1,19,8,1501,1449,1206,-243
2018,1,19,9,1481,1431,1280,-151
2018,1,19,10,1474,1423,1181,-242
2018,1,19,11,1490,1433,1214,-219
2018,1,19,12,1527,1465,1271,-194
2018,1,19,13,1620,1554,1268,-286
2018,1,19,14,1748,1691,1337,-354
2018,1,19,15,1785,1727,1406,-321
2018,1,19,16,1753,1703,1381,-322
2018,1,19,17,1691,1643,1311,-332
2018,1,19,18,1637,1575,1293,-282
2018,1,19,19,1581,1517,1276,-241
2018,1,19,20,1543,1487,1287,-200
2018,1,19,21,1517,1463,1319,-144
2018,1,19,22,1502,1449,1280,-169
2018,1,19,23,1509,1443,1241,-202
2018,1,20,0,1540,1470,1260,-210
2018,1,20,1,1649,1572,1410,-162
2018,1,20,2,1733,1661,1423,-238
2018,1,20,3,1737,1648,1351,-297
2018,1,20,4,1732,1647,1408,-239
2018,1,20,5,1686,1601,1474,-127
2018,1,20,6,1603,1537,1457,-80
2018,1,20,7,1526,1466,1289,-177
2018,1,20,8,1464,1414,1222,-192
2018,1,20,9,1441,1389,1226,-163
2018,1,20,10,1431,1386,1248,-138
2018,1,20,11,1438,1385,1262,-123
2018,1,20,12,1456,1419,1280,-139
2018,1,20,13,1496,1451,1282,-169
2018,1,20,14,1562,1514,1301,-213
2018,1,20,15,1609,1549,1352,-197
2018,1,20,16,1606,1549,1443,-106
2018,1,20,17,1586,1511,1440,-71
2018,1,20,18,1556,1468,1466,-2
2018,1,20,19,1527,1440,1463,23
2018,1,20,20,1489,1412,1524,112
2018,1,20,21,1456,1402,1542,140
2018,1,20,22,1451,1400,1526,126
2018,1,20,23,1468,1405,1544,139
2018,1,21,0,1517,1460,1587,127
2018,1,21,1,1642,1582,1690,108
2018,1,21,2,1698,1648,1664,16
2018,1,21,3,1698,1631,1636,5
2018,1,21,4,1680,1614,1609,-5
2018,1,21,5,1635,1558,1601,43
2018,1,21,6,1558,1477,1506,29
2018,1,21,7,1479,1421,1575,154
2018,1,21,8,1461,1385,1591,206
2018,1,21,9,1424,1354,1607,253
2018,1,21,10,1411,1348,1588,240
2018,1,21,11,1414,1359,1588,229
2018,1,21,12,1428,1378,1594,216
2018,1,21,13,1466,1419,1636,217
2018,1,21,14,1543,1488,1673,185
2018,1,21,15,1591,1526,1710,184
2018,1,21,16,1633,1585,1760,175
2018,1,21,17,1639,1628,1798,170
2018,1,21,18,1620,1637,1813,176
2018,1,21,19,1640,1620,1777,157
2018,1,21,20,1640,1607,1785,178
2018,1,21,21,1642,1616,1786,170
2018,1,21,22,1635,1616,1780,164
2018,1,21,23,1645,1622,1750,128
2018,1,22,0,1702,1673,1782,109
2018,1,22,1,1823,1789,1917,128
2018,1,22,2,1897,1865,1925,60
2018,1,22,3,1874,1844,1899,55
2018,1,22,4,1849,1813,1837,24
2018,1,22,5,1774,1737,1712,-25
2018,1,22,6,1666,1643,1514,-129
2018,1,22,7,1592,1550,1465,-85
2018,1,22,8,1543,1504,1519,15
2018,1,22,9,1524,1484,1509,25
2018,1,22,10,1518,1473,1541,68
2018,1,22,11,1533,1488,1454,-34
2018,1,22,12,1559,1518,1467,-51
2018,1,22,13,1657,1614,1585,-29
2018,1,22,14,1798,1765,1656,-109
2018,1,22,15,1833,1803,1642,-161
2018,1,22,16,1784,1762,1507,-255
2018,1,22,17,1732,1723,1494,-229
2018,1,22,18,1686,1678,1448,-230
2018,1,22,19,1650,1636,1397,-239
2018,1,22,20,1608,1587,1343,-244
2018,1,22,21,1582,1555,1332,-223
2018,1,22,22,1561,1541,1314,-227
2018,1,22,23,1574,1554,1249,-305
2018,1,23,0,1633,1604,1434,-170
2018,1,23,1,1777,1741,1585,-156
2018,1,23,2,1877,1841,1711,-130
2018,1,23,3,1875,1844,1708,-136
2018,1,23,4,1852,1826,1679,-147
2018,1,23,5,1780,1755,1625,-130
2018,1,23,6,1659,1649,1523,-126
2018,1,23,7,1571,1562,1483,-79
2018,1,23,8,1537,1521,1453,-68
2018,1,23,9,1528,1504,1530,26
2018,1,23,10,1525,1500,1530,30
2018,1,23,11,1543,1504,1487,-17
2018,1,23,12,1594,1549,1509,-40
2018,1,23,13,1683,1639,1559,-80
2018,1,23,14,1828,1785,1602,-183
2018,1,23,15,1857,1812,1701,-111
2018,1,23,16,1803,1757,1647,-110
2018,1,23,17,1751,1699,1559,-140
2018,1,23,18,1699,1650,1479,-171
2018,1,23,19,1642,1589,1481,-108
2018,1,23,20,1608,1550,1481,-69
2018,1,23,21,1575,1521,1356,-165
2018,1,23,22,1567,1507,1319,-188
2018,1,23,23,1577,1513,1381,-132
2018,1,24,0,1626,1555,1321,-234
2018,1,24,1,1768,1692,1414,-278
2018,1,24,2,864,1794,1507,-287
2018,1,24,3,1864,1794,1501,-293
2018,1,24,4,1861,1787,1525,-262
2018,1,24,5,1788,1723,1445,-278
2018,1,24,6,1688,1628,1367,-261
2018,1,24,7,1600,1540,1358,-182
2018,1,24,8,1561,1491,1379,-112
2018,1,24,9,1538,1483,1285,-198
2018,1,24,10,1534,1475,1300,-175
2018,1,24,11,1546,1489,1300,-189
2018,1,24,12,1590,1526,1384,-142
2018,1,24,13,1689,1620,1465,-155
2018,1,24,14,1823,1767,1520,-247
2018,1,24,15,1852,1785,1575,-210
2018,1,24,16,1812,1739,1545,-194
2018,1,24,17,1754,1670,1437,-233
2018,1,24,18,1703,1623,1416,-207
2018,1,24,19,1653,1575,1430,-145
2018,1,24,20,1612,1526,1412,-114
2018,1,24,21,1576,1493,1434,-59
2018,1,24,22,1562,1460,1429,-31
2018,1,24,23,1574,1474,1443,-31
2018,1,25,0,1624,1524,1436,-88
2018,1,25,1,1767,1637,1540,-97
2018,1,25,2,1861,1753,1658,-95
2018,1,25,3,1872,1769,1685,-84
2018,1,25,4,1857,1756,1676,-80
2018,1,25,5,1790,1701,1594,-107
2018,1,25,6,1679,1594,1356,-238
2018,1,25,7,1595,1516,1084,-432
2018,1,25,8,1531,1477,1029,-448
2018,1,25,9,1513,1455,1065,-390
2018,1,25,10,1511,1452,1043,-409
2018,1,25,11,1518,1462,1020,-442
2018,1,25,12,1562,1500,1085,-415
2018,1,25,13,1666,1593,1152,-441
2018,1,25,14,1789,1741,1216,-525
2018,1,25,15,1813,1768,1230,-538
2018,1,25,16,1761,1704,1141,-563
2018,1,25,17,1710,1630,1012,-618
2018,1,25,18,1662,1586,1039,-547
2018,1,25,19,1606,1539,1082,-457
2018,1,25,20,1573,1480,1107,-373
2018,1,25,21,1552,1451,1168,-283
2018,1,25,22,1538,1465,1223,-242
2018,1,25,23,1542,1461,1214,-247
2018,1,26,0,1588,1527,1182,-345
2018,1,26,1,1716,1634,1332,-302
2018,1,26,2,1798,1745,1494,-251
2018,1,26,3,1803,1749,1486,-263
2018,1,26,4,1793,1745,1420,-325
2018,1,26,5,1727,1668,1500,-168
2018,1,26,6,1620,1574,1517,-57
2018,1,26,7,1538,1485,1447,-38
2018,1,26,8,1482,1434,1411,-23
2018,1,26,9,1471,1405,1510,105
2018,1,26,10,1468,1396,1478,82
2018,1,26,11,1476,1397,1430,33
2018,1,26,12,1511,1434,1411,-23
2018,1,26,13,1598,1520,1394,-126
2018,1,26,14,1734,1653,1397,-256
2018,1,26,15,1773,1684,1544,-140
2018,1,26,16,1749,1629,1420,-209
2018,1,26,17,1699,1575,1324,-251
2018,1,26,18,1662,1539,1455,-84
2018,1,26,19,1618,1516,1420,-96
2018,1,26,20,1585,1483,1400,-83
2018,1,26,21,1557,1454,1408,-46
2018,1,26,22,1535,1453,1436,-17
2018,1,26,23,1550,1464,1495,31
2018,1,27,0,1596,1510,1495,-15
2018,1,27,1,1727,1622,1460,-162
2018,1,27,2,1804,1714,1526,-188
2018,1,27,3,1798,1711,1483,-228
2018,1,27,4,1797,1709,1428,-281
2018,1,27,5,1753,1682,1397,-285
2018,1,27,6,1666,1618,1365,-253
2018,1,27,7,1584,1542,1335,-207
2018,1,27,8,1543,1499,1301,-198
2018,1,27,9,1508,1467,1233,-234
2018,1,27,10,1511,1466,1215,-251
2018,1,27,11,1511,1469,1165,-304
2018,1,27,12,1531,1494,1172,-322
2018,1,27,13,1583,1545,1116,-429
2018,1,27,14,1662,1610,1106,-504
2018,1,27,15,1700,1641,1069,-572
2018,1,27,16,1693,1643,1106,-537
2018,1,27,17,1657,1609,1128,-481
2018,1,27,18,1623,1568,1152,-416
2018,1,27,19,1575,1518,1152,-366
2018,1,27,20,1528,1473,1114,-359
2018,1,27,21,1484,1435,1072,-363
2018,1,27,22,1468,1411,1033,-378
2018,1,27,23,1486,1421,1065,-356
2018,1,28,0,1532,1472,1159,-313
2018,1,28,1,1656,1596,1196,-400
2018,1,28,2,1747,1705,1257,-448
2018,1,28,3,1757,1710,1269,-441
2018,1,28,4,1741,1699,1242,-457
2018,1,28,5,1703,1657,1196,-461
2018,1,28,6,1652,1586,1211,-375
2018,1,28,7,1579,1515,1325,-190
2018,1,28,8,1524,1466,1423,-43
2018,1,28,9,1502,1445,1435,-10
2018,1,28,10,1490,1437,1347,-90
2018,1,28,11,1486,1433,1290,-143
2018,1,28,12,1499,1449,1225,-224
2018,1,28,13,1533,1487,1252,-235
2018,1,28,14,1591,1535,1304,-231
2018,1,28,15,1624,1552,1302,-250
2018,1,28,16,1607,1565,1416,-149
2018,1,28,17,1572,1529,1383,-146
2018,1,28,18,1546,1500,1351,-149
2018,1,28,19,1505,1453,1257,-196
2018,1,28,20,1496,1436,1195,-241
2018,1,28,21,1456,1405,1137,-268
2018,1,28,22,1447,1394,1109,-285
2018,1,28,23,1455,1409,1117,-292
2018,1,29,0,1507,1453,1107,-346
2018,1,29,1,1643,1586,1153,-433
2018,1,29,2,1748,1711,1221,-490
2018,1,29,3,1752,1713,1196,-517
2018,1,29,4,1739,1703,1247,-456
2018,1,29,5,1677,1639,1265,-374
2018,1,29,6,1581,1533,1265,-268
2018,1,29,7,1507,1452,1271,-181
2018,1,29,8,1460,1408,1292,-116
2018,1,29,9,1437,1393,1235,-158
2018,1,29,10,1437,1384,1179,-205
2018,1,29,11,1455,1431,1182,-249
2018,1,29,12,1467,1467,1150,-317
2018,1,29,13,1521,1572,1107,-465
2018,1,29,14,1710,1720,1174,-546
2018,1,29,15,1753,1747,1222,-525
2018,1,29,16,1713,1693,1168,-525
2018,1,29,17,1670,1622,1147,-475
2018,1,29,18,1629,1576,1228,-348
2018,1,29,19,1584,1528,1213,-315
2018,1,29,20,1555,1485,1277,-208
2018,1,29,21,1533,1466,1404,-62
2018,1,29,22,1482,1460,1467,7
2018,1,29,23,1488,1469,1484,15
2018,1,30,0,1542,1501,1504,3
2018,1,30,1,1660,1617,1594,-23
2018,1,30,2,1770,1737,1719,-18
2018,1,30,3,1783,1742,1620,-122
2018,1,30,4,1767,1719,1600,-119
2018,1,30,5,1690,1662,1528,-134
2018,1,30,6,1583,1573,1619,46
2018,1,30,7,1496,1479,1733,254
2018,1,30,8,1450,1445,1779,334
2018,1,30,9,1431,1428,1777,349
2018,1,30,10,1428,1406,1726,320
2018,1,30,11,1462,1422,1698,276
2018,1,30,12,1506,1464,1678,214
2018,1,30,13,1611,1574,1720,146
2018,1,30,14,1739,1723,1799,76
2018,1,30,15,1755,1735,1778,43
2018,1,30,16,1710,1704,1747,43
2018,1,30,17,1657,1656,1672,16
2018,1,30,18,1611,1593,1660,67
2018,1,30,19,1565,1556,1662,106
2018,1,30,20,1526,1515,1682,167
2018,1,30,21,1514,1501,1662,161
2018,1,30,22,1500,1495,1668,173
2018,1,30,23,1505,1500,1710,210
2018,1,31,0,1572,1533,1732,199
2018,1,31,1,1680,1628,1811,183
2018,1,31,2,1771,1739,1842,103
2018,1,31,3,1790,1731,1746,15
2018,1,31,4,1773,1718,1663,-55
2018,1,31,5,1699,1649,1654,5
2018,1,31,6,1595,1548,1654,106
2018,1,31,7,1503,1461,1672,211
2018,1,31,8,1444,1436,1485,49
2018,1,31,9,1415,1395,1422,27
2018,1,31,10,1410,1393,1367,-26
2018,1,31,11,1435,1403,1488,85
2018,1,31,12,1480,1447,1552,105
2018,1,31,13,1582,1547,1597,50
2018,1,31,14,1711,1682,1640,-42
2018,1,31,15,1727,1703,1667,-36
2018,1,31,16,1680,1623,1503,-120
2018,1,31,17,1633,1587,1441,-146
2018,1,31,18,1586,1539,1458,-81
2018,1,31,19,1547,1509,1513,4
2018,1,31,20,1514,1469,1513,44
2018,1,31,21,1498,1449,1475,26
2018,1,31,22,1498,1456,1486,30
2018,1,31,23,1499,1463,1526,63
2018,2,1,0,1538,1495,1528,33
2018,2,1,1,1656,1581,1520,-61
2018,2,1,2,1741,1673,1635,-38
2018,2,1,3,1742,1666,1632,-34
2018,2,1,4,1719,1656,1622,-34
2018,2,1,5,1652,1589,1638,49
2018,2,1,6,1551,1491,1537,46
2018,2,1,7,1467,1415,1436,21
2018,2,1,8,1405,1379,1427,48
2018,2,1,9,1354,1354,1388,34
2018,2,1,10,1346,1353,1389,36
2018,2,1,11,1372,1336,1323,-13
2018,2,1,12,1427,1384,1387,3
2018,2,1,13,1531,1482,1397,-85
2018,2,1,14,1656,1617,1401,-216
2018,2,1,15,1678,1642,1316,-326
2018,2,1,16,1638,1599,1252,-347
2018,2,1,17,1604,1543,1175,-368
2018,2,1,18,1569,1500,1181,-319
2018,2,1,19,1534,1462,1144,-318
2018,2,1,20,1506,1428,1194,-234
2018,2,1,21,1494,1424,1240,-184
2018,2,1,22,1480,1421,1255,-166
2018,2,1,23,1487,1434,1296,-138
2018,2,2,0,1527,1448,1228,-220
2018,2,2,1,1623,1529,1256,-273
2018,2,2,2,1676,1622,1399,-223
2018,2,2,3,1678,1613,1393,-220
2018,2,2,4,1671,1609,1373,-236
2018,2,2,5,1598,1558,1350,-208
2018,2,2,6,1501,1471,1343,-128
2018,2,2,7,1421,1392,1216,-176
2018,2,2,8,1383,1347,1183,-164
2018,2,2,9,1355,1329,1145,-184
2018,2,2,10,1355,1326,1064,-262
2018,2,2,11,1362,1334,1035,-299
2018,2,2,12,1401,1378,1027,-351
2018,2,2,13,1495,1464,1069,-395
2018,2,2,14,1625,1600,1116,-484
2018,2,2,15,1649,1629,1216,-413
2018,2,2,16,1618,1595,1311,-284
2018,2,2,17,1590,1554,1236,-318
2018,2,2,18,1551,1516,1291,-225
2018,2,2,19,1517,1486,1296,-190
2018,2,2,20,1482,1450,1326,-124
2018,2,2,21,1462,1429,1383,-46
2018,2,2,22,1467,1426,1371,-55
2018,2,2,23,1471,1429,1479,50
2018,2,3,0,1501,1452,1458,6
2018,2,3,1,1595,1522,1382,-140
2018,2,3,2,1659,1615,1429,-186
2018,2,3,3,1660,1609,1420,-189
2018,2,3,4,1655,1612,1411,-201
2018,2,3,5,1606,1573,1452,-121
2018,2,3,6,1521,1493,1440,-53
2018,2,3,7,1441,1415,1396,-19
2018,2,3,8,1389,1363,1415,52
2018,2,3,9,1358,1337,1424,87
2018,2,3,10,1345,1330,1410,80
2018,2,3,11,1348,1331,1447,116
2018,2,3,12,1366,1346,1454,108
2018,2,3,13,1404,1386,1453,67
2018,2,3,14,1492,1455,1428,-27
2018,2,3,15,1524,1479,1413,-66
2018,2,3,16,1516,1476,1499,23
2018,2,3,17,1483,1446,1476,30
2018,2,3,18,1453,1426,1519,93
2018,2,3,19,1425,1407,1454,47
2018,2,3,20,1391,1376,1431,55
2018,2,3,21,1375,1358,1416,58
2018,2,3,22,1371,1359,1424,65
2018,2,3,23,1384,1367,1455,88
2018,2,4,0,1432,1406,1507,101
2018,2,4,1,1536,1496,1469,-27
2018,2,4,2,1609,1614,1490,-124
2018,2,4,3,1610,1599,1509,-90
2018,2,4,4,1599,1581,1459,-122
2018,2,4,5,1553,1538,1463,-75
2018,2,4,6,1481,1471,1397,-74
2018,2,4,7,1414,1398,1360,-38
2018,2,4,8,1375,1351,1350,-1
2018,2,4,9,1346,1328,1220,-108
2018,2,4,10,1336,1311,1200,-111
2018,2,4,11,1342,1312,1205,-107
2018,2,4,12,1353,1324,1224,-100
2018,2,4,13,1388,1365,1231,-134
2018,2,4,14,1456,1417,1332,-85
2018,2,4,15,1489,1452,1370,-82
2018,2,4,16,1492,1450,1376,-74
2018,2,4,17,1472,1425,1418,-7
2018,2,4,18,1435,1405,1484,79
2018,2,4,19,1414,1397,1495,98
2018,2,4,20,1394,1392,1508,116
2018,2,4,21,1410,1387,1481,94
2018,2,4,22,1406,1391,1518,127
2018,2,4,23,1417,1402,1524,122
2018,2,5,0,1480,1422,1525,103
2018,2,5,1,1591,1494,1586,92
2018,2,5,2,1682,1575,1543,-32
2018,2,5,3,1682,1574,1483,-91
2018,2,5,4,1656,1570,1468,-102
2018,2,5,5,1593,1552,1623,71
2018,2,5,6,1492,1461,1558,97
2018,2,5,7,1406,1380,1479,99
2018,2,5,8,1371,1327,1442,115
2018,2,5,9,1359,1310,1521,211
2018,2,5,10,1356,1306,1608,302
2018,2,5,11,1368,1317,1648,331
2018,2,5,12,1400,1346,1677,331
2018,2,5,13,1492,1435,1673,238
2018,2,5,14,1628,1572,1648,76
2018,2,5,15,1647,1595,1676,81
2018,2,5,16,1601,1552,1652,100
2018,2,5,17,1556,1511,1625,114
2018,2,5,18,1523,1474,1732,258
2018,2,5,19,1488,1446,1755,309
2018,2,5,20,1475,1435,1697,262
2018,2,5,21,1459,1425,1651,226
2018,2,5,22,1446,1420,1639,219
2018,2,5,23,1453,1428,1604,176
2018,2,6,0,1491,1449,1616,167
2018,2,6,1,1588,1530,1612,82
2018,2,6,2,1696,1642,1654,12
2018,2,6,3,1686,1636,1582,-54
2018,2,6,4,1669,1621,1618,-3
2018,2,6,5,1598,1552,1656,104
2018,2,6,6,1501,1456,1599,143
2018,2,6,7,1410,1376,1474,98
2018,2,6,8,1369,1331,1382,51
2018,2,6,9,1343,1304,1519,215
2018,2,6,10,1337,1295,1535,240
2018,2,6,11,1344,1304,1408,104
2018,2,6,12,1382,1338,1368,30
2018,2,6,13,1482,1439,1421,-18
2018,2,6,14,1625,1584,1505,-79
2018,2,6,15,1646,1606,1531,-75
2018,2,6,16,1607,1564,1512,-52
2018,2,6,17,1553,1512,1609,97
2018,2,6,18,1504,1445,1701,256
2018,2,6,19,1492,1428,1783,355
2018,2,6,20,1481,1430,1820,390
2018,2,6,21,1479,1441,1826,385
2018,2,6,22,1498,1465,1837,372
2018,2,6,23,1505,1466,1782,316
2018,2,7,0,1546,1513,1739,226
2018,2,7,1,1637,1608,1697,89
2018,2,7,2,1742,1714,1588,-126
2018,2,7,3,1731,1706,1599,-107
2018,2,7,4,1713,1687,1564,-123
2018,2,7,5,1640,1612,1592,-20
2018,2,7,6,1523,1499,1632,133
2018,2,7,7,1448,1414,1594,180
2018,2,7,8,1407,1366,1576,210
2018,2,7,9,1388,1350,1566,216
2018,2,7,10,1408,1370,1551,181
2018,2,7,11,1398,1360,1406,46
2018,2,7,12,1436,1396,1396,0
2018,2,7,13,1545,1499,1416,-83
2018,2,7,14,1682,1632,1528,-104
2018,2,7,15,1702,1642,1479,-163
2018,2,7,16,1639,1588,1457,-131
2018,2,7,17,1588,1541,1405,-136
2018,2,7,18,1542,1494,1375,-119
2018,2,7,19,1509,1463,1407,-56
2018,2,7,20,1475,1425,1482,57
2018,2,7,21,1457,1408,1492,84
2018,2,7,22,1447,1408,1546,138
2018,2,7,23,1467,1421,1541,120
2018,2,8,0,1506,1453,1633,180
2018,2,8,1,1596,1541,1709,168
2018,2,8,2,1734,1684,1755,71
2018,2,8,3,1737,1694,1735,41
2018,2,8,4,1730,1687,1709,22
2018,2,8,5,1673,1629,1708,79
2018,2,8,6,1569,1521,1675,154
2018,2,8,7,1479,1427,1638,211
2018,2,8,8,1431,1377,1720,343
2018,2,8,9,1406,1354,1701,347
2018,2,8,10,1399,1344,1650,306
2018,2,8,11,1406,1366,1649,283
2018,2,8,12,1449,1405,1686,281
2018,2,8,13,1543,1495,1640,145
2018,2,8,14,1689,1645,1575,-70
2018,2,8,15,1701,1665,1559,-106
2018,2,8,16,1636,1606,1544,-62
2018,2,8,17,1573,1553,1519,-34
2018,2,8,18,1525,1496,1524,28
2018,2,8,19,1495,1473,1561,88
2018,2,8,20,1478,1455,1616,161
2018,2,8,21,1467,1433,1651,218
2018,2,8,22,1470,1433,1724,291
2018,2,8,23,1480,1438,1752,314
2018,2,9,0,1514,1474,1772,298
2018,2,9,1,1597,1544,1807,263
2018,2,9,2,1708,1656,1719,63
2018,2,9,3,1706,1657,1745,88
2018,2,9,4,1701,1650,1747,97
2018,2,9,5,1635,1588,1775,187
2018,2,9,6,1536,1493,1757,264
2018,2,9,7,1447,1405,1678,273
2018,2,9,8,1402,1359,1672,313
2018,2,9,9,1379,1337,1641,304
2018,2,9,10,1376,1333,1582,249
2018,2,9,11,1381,1341,1593,252
2018,2,9,12,1419,1372,1642,270
2018,2,9,13,1512,1456,1639,183
2018,2,9,14,1630,1582,1713,131
2018,2,9,15,1644,1609,1707,98
2018,2,9,16,1609,1566,1640,74
2018,2,9,17,1561,1522,1486,-36
2018,2,9,18,1516,1480,1522,42
2018,2,9,19,1480,1452,1643,191
2018,2,9,20,1450,1430,1628,198
2018,2,9,21,1440,1418,1653,235
2018,2,9,22,1442,1412,1685,273
2018,2,9,23,1448,1407,1684,277
2018,2,10,0,1479,1435,1672,237
2018,2,10,1,1557,1497,1645,148
2018,2,10,2,1639,1597,1771,174
2018,2,10,3,1637,1578,1798,220
2018,2,10,4,1632,1578,1935,357
2018,2,10,5,1588,1546,1822,276
2018,2,10,6,1507,1476,1673,197
2018,2,10,7,1418,1404,1625,221
2018,2,10,8,1370,1360,1563,203
2018,2,10,9,1345,1336,1586,250
2018,2,10,10,1331,1322,1583,261
2018,2,10,11,1346,1321,1671,350
2018,2,10,12,1363,1331,1669,338
2018,2,10,13,1398,1362,1679,317
2018,2,10,14,1472,1422,1695,273
2018,2,10,15,1513,1441,1697,256
2018,2,10,16,1502,1457,1730,273
2018,2,10,17,1479,1438,1676,238
2018,2,10,18,1451,1418,1775,357
2018,2,10,19,1427,1397,1736,339
2018,2,10,20,1402,1385,1728,343
2018,2,10,21,1381,1387,1774,387
2018,2,10,22,1374,1375,1754,379
2018,2,10,23,1383,1380,1774,394
2018,2,11,0,1426,1422,1771,349
2018,2,11,1,1528,1510,1837,327
2018,2,11,2,1622,1624,1938,314
2018,2,11,3,1601,1626,1880,254
2018,2,11,4,1619,1601,1821,220
2018,2,11,5,1575,1547,1839,292
2018,2,11,6,1512,1470,1776,306
2018,2,11,7,1432,1407,1720,313
2018,2,11,8,1416,1361,1644,283
2018,2,11,9,1379,1332,1561,229
2018,2,11,10,1375,1320,1487,167
2018,2,11,11,1372,1325,1478,153
2018,2,11,12,1388,1342,1420,78
2018,2,11,13,1422,1387,1407,20
2018,2,11,14,1492,1443,1391,-52
2018,2,11,15,1529,1471,1407,-64
2018,2,11,16,1539,1481,1451,-30
2018,2,11,17,1533,1473,1494,21
2018,2,11,18,1506,1435,1436,1
2018,2,11,19,1492,1428,1412,-16
2018,2,11,20,1456,1410,1399,-11
2018,2,11,21,1450,1392,1327,-65
2018,2,11,22,1445,1383,1303,-80
2018,2,11,23,1459,1392,1323,-69
2018,2,12,0,1508,1445,1353,-92
2018,2,12,1,1610,1549,1447,-102
2018,2,12,2,1710,1694,1636,-58
2018,2,12,3,1717,1708,1762,54
2018,2,12,4,1713,1697,1733,36
2018,2,12,5,1658,1641,1659,18
2018,2,12,6,1564,1529,1559,30
2018,2,12,7,1490,1455,1447,-8
2018,2,12,8,1450,1406,1458,52
2018,2,12,9,1430,1383,1453,70
2018,2,12,10,1416,1373,1433,60
2018,2,12,11,1429,1378,1387,9
2018,2,12,12,1457,1407,1415,8
2018,2,12,13,1541,1491,1495,4
2018,2,12,14,1685,1631,1638,7
2018,2,12,15,1696,1643,1726,83
2018,2,12,16,1659,1605,1585,-20
2018,2,12,17,1622,1576,1623,47
2018,2,12,18,1578,1528,1602,74
2018,2,12,19,1550,1505,1593,88
2018,2,12,20,1517,1477,1665,188
2018,2,12,21,1506,1476,1739,263
2018,2,12,22,1495,1480,1739,259
2018,2,12,23,1499,1492,1790,298
2018,2,13,0,1539,1526,1770,244
2018,2,13,1,1640,1597,1775,178
2018,2,13,2,1745,1717,1700,-17
2018,2,13,3,1741,1709,1818,109
2018,2,13,4,1723,1694,1856,162
2018,2,13,5,1659,1585,1829,244
2018,2,13,6,1555,1514,1715,201
2018,2,13,7,1464,1426,1559,133
2018,2,13,8,1400,1371,1547,176
2018,2,13,9,1380,1344,1446,102
2018,2,13,10,1371,1334,1396,62
2018,2,13,11,1367,1339,1394,55
2018,2,13,12,1405,1374,1430,56
2018,2,13,13,1499,1465,1493,28
2018,2,13,14,1647,1611,1419,-192
2018,2,13,15,1656,1625,1400,-225
2018,2,13,16,1632,1599,1290,-309
2018,2,13,17,1568,1537,1252,-285
2018,2,13,18,1521,1496,1391,-105
2018,2,13,19,1482,1454,1325,-129
2018,2,13,20,1458,1428,1356,-72
2018,2,13,21,1454,1424,1386,-38
2018,2,13,22,1457,1422,1358,-64
2018,2,13,23,1462,1421,1342,-79
2018,2,14,0,1489,1453,1313,-140
2018,2,14,1,1584,1527,1357,-170
2018,2,14,2,1692,1640,1489,-151
2018,2,14,3,1693,1638,1525,-113
2018,2,14,4,1684,1635,1594,-41
2018,2,14,5,1608,1585,1556,-29
2018,2,14,6,1515,1483,1493,10
2018,2,14,7,1434,1393,1515,122
2018,2,14,8,1369,1343,1541,198
2018,2,14,9,1351,1314,1478,164
2018,2,14,10,1324,1296,1403,107
2018,2,14,11,1324,1295,1395,100
2018,2,14,12,1356,1327,1368,41
2018,2,14,13,1453,1416,1438,22
2018,2,14,14,1584,1545,1478,-67
2018,2,14,15,1601,1551,1470,-81
2018,2,14,16,1556,1537,1458,-79
2018,2,14,17,1559,1507,1447,-60
2018,2,14,18,1529,1479,1550,71
2018,2,14,19,1519,1469,1561,92
2018,2,14,20,1522,1482,1613,131
2018,2,14,21,1519,1482,1600,118
2018,2,14,22,1534,1493,1647,154
2018,2,14,23,1520,1487,1695,208
2018,2,15,0,1551,1513,1660,147
2018,2,15,1,1630,1580,1681,101
2018,2,15,2,1717,1658,1589,-69
2018,2,15,3,1717,1653,1482,-171
2018,2,15,4,1715,1652,1488,-164
2018,2,15,5,1645,1603,1561,-42
2018,2,15,6,1542,1501,1606,105
2018,2,15,7,1444,1406,1596,190
2018,2,15,8,1364,1349,1555,206
2018,2,15,9,1341,1312,1590,278
2018,2,15,10,1328,1297,1571,274
2018,2,15,11,1335,1287,1591,304
2018,2,15,12,1377,1318,1624,306
2018,2,15,13,1472,1404,1519,115
2018,2,15,14,1607,1539,1585,46
2018,2,15,15,1630,1575,1633,58
2018,2,15,16,1607,1571,1669,98
2018,2,15,17,1597,1585,1724,139
2018,2,15,18,1582,1576,1751,175
2018,2,15,19,1560,1558,1793,235
2018,2,15,20,1572,1532,1749,217
2018,2,15,21,1562,1549,1778,229
2018,2,15,22,1560,1546,1803,257
2018,2,15,23,1564,1522,1736,214
2018,2,16,0,1591,1538,1739,201
2018,2,16,1,1672,1606,1768,162
2018,2,16,2,1748,1692,1789,97
2018,2,16,3,1738,1688,1752,64
2018,2,16,4,1726,1672,1757,85
2018,2,16,5,1662,1605,1753,148
2018,2,16,6,1534,1497,1778,281
2018,2,16,7,1445,1401,1707,306
2018,2,16,8,1402,1349,1644,295
2018,2,16,9,1382,1332,1699,367
2018,2,16,10,1371,1322,1529,207
2018,2,16,11,1375,1328,1488,160
2018,2,16,12,1411,1361,1580,219
2018,2,16,13,1488,1443,1607,164
2018,2,16,14,1620,1582,1662,80
2018,2,16,15,1643,1610,1678,68
2018,2,16,16,1615,1591,1622,31
2018,2,16,17,1585,1583,1606,23
2018,2,16,18,1566,1576,1717,141
2018,2,16,19,1550,1567,1728,161
2018,2,16,20,1540,1557,1672,115
2018,2,16,21,1531,1550,1594,44
2018,2,16,22,1525,1549,1581,32
2018,2,16,23,1530,1558,1552,-6
2018,2,17,0,1548,1564,1635,71
2018,2,17,1,1618,1626,1674,48
2018,2,17,2,1685,1694,1680,-14
2018,2,17,3,1667,1668,1666,-2
2018,2,17,4,1674,1654,1792,138
2018,2,17,5,1633,1608,1871,263
2018,2,17,6,1559,1533,1886,353
2018,2,17,7,1474,1457,1891,434
2018,2,17,8,1433,1404,1902,498
2018,2,17,9,1402,1373,1863,490
2018,2,17,10,1380,1348,1878,530
2018,2,17,11,1379,1346,1848,502
2018,2,17,12,1398,1363,1879,516
2018,2,17,13,1437,1403,1907,504
2018,2,17,14,1505,1457,1860,403
2018,2,17,15,1517,1476,1871,395
2018,2,17,16,1509,1460,1841,381
2018,2,17,17,1489,1442,1864,422
2018,2,17,18,1442,1412,1788,376
2018,2,17,19,1426,1394,1707,313
2018,2,17,20,1400,1367,1676,309
2018,2,17,21,1383,1348,1572,224
2018,2,17,22,1369,1344,1590,246
2018,2,17,23,1376,1346,1613,267
2018,2,18,0,1411,1378,1626,248
2018,2,18,1,1497,1460,1649,189
2018,2,18,2,1615,1583,1841,258
2018,2,18,3,1629,1593,1841,248
2018,2,18,4,1620,1574,1858,284
2018,2,18,5,1584,1542,1827,285
2018,2,18,6,1504,1474,1848,374
2018,2,18,7,1431,1413,1799,386
2018,2,18,8,1383,1365,1801,436
2018,2,18,9,1347,1337,1763,426
2018,2,18,10,1343,1326,1740,414
2018,2,18,11,1340,1311,1731,420
2018,2,18,12,1353,1328,1789,461
2018,2,18,13,1393,1366,1822,456
2018,2,18,14,1458,1413,1851,438
2018,2,18,15,1458,1414,1928,514
2018,2,18,16,1471,1427,1966,539
2018,2,18,17,1450,1404,1952,548
2018,2,18,18,1421,1383,1945,562
2018,2,18,19,1405,1369,1913,544
2018,2,18,20,1393,1360,1856,496
2018,2,18,21,1383,1345,1848,503
2018,2,18,22,1401,1365,1760,395
2018,2,18,23,1420,1388,1715,327
2018,2,19,0,1456,1424,1783,359
2018,2,19,1,1529,1496,1736,240
2018,2,19,2,1640,1609,1774,165
2018,2,19,3,1640,1608,1737,129
2018,2,19,4,1609,1580,1700,120
2018,2,19,5,1561,1529,1659,130
2018,2,19,6,1480,1441,1650,209
2018,2,19,7,1392,1352,1585,233
2018,2,19,8,1341,1305,1554,249
2018,2,19,9,1316,1278,1577,299
2018,2,19,10,1303,1268,1562,294
2018,2,19,11,1316,1277,1539,262
2018,2,19,12,1337,1297,1504,207
2018,2,19,13,1416,1360,1453,93
2018,2,19,14,1499,1445,1471,26
2018,2,19,15,1538,1473,1308,-165
2018,2,19,16,1529,1484,1299,-185
2018,2,19,17,1515,1475,1397,-78
2018,2,19,18,1506,1476,1458,-18
2018,2,19,19,1495,1471,1453,-18
2018,2,19,20,1494,1465,1504,39
2018,2,19,21,1489,1457,1512,55
2018,2,19,22,1487,1448,1477,29
2018,2,19,23,1490,1463,1505,42
2018,2,20,0,1521,1487,1465,-22
2018,2,20,1,1607,1577,1610,33
2018,2,20,2,1713,1687,1699,12
2018,2,20,3,1712,1688,1600,-88
2018,2,20,4,1697,1674,1445,-229
2018,2,20,5,1627,1606,1354,-252
2018,2,20,6,1528,1499,1333,-166
2018,2,20,7,1428,1406,1257,-149
2018,2,20,8,1387,1363,1100,-263
2018,2,20,9,1379,1352,1149,-203
2018,2,20,10,1389,1357,1266,-91
2018,2,20,11,1391,1365,1193,-172
2018,2,20,12,1428,1399,1267,-132
2018,2,20,13,1517,1490,1273,-217
2018,2,20,14,1648,1623,1446,-177
2018,2,20,15,1678,1644,1386,-258
2018,2,20,16,1658,1636,1309,-327
2018,2,20,17,1629,1595,1235,-360
2018,2,20,18,1593,1582,1139,-443
2018,2,20,19,1567,1569,1125,-444
2018,2,20,20,1570,1558,1136,-422
2018,2,20,21,1563,1550,1120,-430
2018,2,20,22,1549,1550,1109,-441
2018,2,20,23,1586,1565,1046,-519
2018,2,21,0,1618,1586,1011,-575
2018,2,21,1,1724,1663,1065,-598
2018,2,21,2,1831,1774,1196,-578
2018,2,21,3,1830,1777,1195,-582
2018,2,21,4,1772,1762,1220,-542
2018,2,21,5,1699,1684,1206,-478
2018,2,21,6,1600,1576,1202,-374
2018,2,21,7,1504,1493,1206,-287
2018,2,21,8,1478,1458,1123,-335
2018,2,21,9,1454,1427,1166,-261
2018,2,21,10,1444,1419,1149,-270
2018,2,21,11,1452,1420,1184,-236
2018,2,21,12,1480,1450,1183,-267
2018,2,21,13,1574,1539,1266,-273
2018,2,21,14,1706,1655,1309,-346
2018,2,21,15,1726,1669,1295,-374
2018,2,21,16,1689,1649,1242,-407
2018,2,21,17,1671,1600,1235,-365
2018,2,21,18,1613,1547,1226,-321
2018,2,21,19,1554,1497,1228,-269
2018,2,21,20,1520,1479,1233,-246
2018,2,21,21,1507,1465,1218,-247
2018,2,21,22,1496,1468,1231,-237
2018,2,21,23,1548,1497,1216,-281
2018,2,22,0,1578,1545,1246,-299
2018,2,22,1,1662,1634,1320,-314
2018,2,22,2,1775,1741,1435,-306
2018,2,22,3,1783,1743,1430,-313
2018,2,22,4,1758,1722,1454,-268
2018,2,22,5,1690,1650,1327,-323
2018,2,22,6,1601,1547,1302,-245
2018,2,22,7,1502,1470,1237,-233
2018,2,22,8,1453,1423,1126,-297
2018,2,22,9,1443,1412,1039,-373
2018,2,22,10,1423,1395,1049,-346
2018,2,22,11,1428,1401,1019,-382
2018,2,22,12,1458,1440,1041,-399
2018,2,22,13,1556,1524,1052,-472
2018,2,22,14,1686,1655,1237,-418
2018,2,22,15,1696,1666,1386,-280
2018,2,22,16,1675,1639,1249,-390
2018,2,22,17,1698,1653,1299,-354
2018,2,22,18,1680,1643,1365,-278
2018,2,22,19,1643,1611,1430,-181
2018,2,22,20,1578,1549,1383,-166
2018,2,22,21,1545,1510,1369,-141
2018,2,22,22,1513,1486,1329,-157
2018,2,22,23,1510,1476,1340,-136
2018,2,23,0,1544,1493,1381,-112
2018,2,23,1,1635,1568,1424,-144
2018,2,23,2,1752,1713,1533,-180
2018,2,23,3,1762,1739,1568,-171
2018,2,23,4,1759,1739,1627,-112
2018,2,23,5,1740,1686,1645,-41
2018,2,23,6,1641,1587,1634,47
2018,2,23,7,1551,1501,1626,125
2018,2,23,8,1490,1457,1476,19
2018,2,23,9,1467,1435,1326,-109
2018,2,23,10,1461,1432,1338,-94
2018,2,23,11,1471,1443,1358,-85
2018,2,23,12,1511,1485,1384,-101
2018,2,23,13,1597,1578,1381,-197
2018,2,23,14,1713,1701,1463,-238
2018,2,23,15,1719,1706,1512,-194
2018,2,23,16,1695,1640,1493,-147
2018,2,23,17,1643,1607,1481,-126
2018,2,23,18,1569,1562,1466,-96
2018,2,23,19,1524,1516,1486,-30
2018,2,23,20,1483,1481,1470,-11
2018,2,23,21,1461,1441,1370,-71
2018,2,23,22,1456,1433,1421,-12
2018,2,23,23,1462,1432,1420,-12
2018,2,24,0,1490,1445,1634,189
2018,2,24,1,1571,1517,1694,177
2018,2,24,2,1694,1635,1813,178
2018,2,24,3,1707,1651,1799,148
2018,2,24,4,1710,1655,1828,173
2018,2,24,5,1675,1629,1807,178
2018,2,24,6,1601,1551,1785,234
2018,2,24,7,1520,1483,1734,251
2018,2,24,8,1517,1440,1601,161
2018,2,24,9,1494,1406,1512,106
2018,2,24,10,1482,1399,1516,117
2018,2,24,11,1478,1399,1549,150
2018,2,24,12,1495,1418,1606,188
2018,2,24,13,1529,1477,1649,172
2018,2,24,14,1596,1538,1704,166
2018,2,24,15,1598,1560,1736,176
2018,2,24,16,1611,1575,1745,170
2018,2,24,17,1605,1570,1784,214
2018,2,24,18,1583,1554,1776,222
2018,2,24,19,1556,1512,1747,235
2018,2,24,20,1525,1478,1737,259
2018,2,24,21,1498,1443,1676,233
2018,2,24,22,1494,1418,1617,199
2018,2,24,23,1508,1417,1591,174
2018,2,25,0,1549,1455,1683,228
2018,2,25,1,1608,1534,1795,261
2018,2,25,2,1732,1683,1885,202
2018,2,25,3,1769,1704,1778,74
2018,2,25,4,1748,1696,1750,54
2018,2,25,5,1711,1650,1755,105
2018,2,25,6,1642,1585,1677,92
2018,2,25,7,1569,1522,1579,57
2018,2,25,8,1534,1476,1487,11
2018,2,25,9,1510,1452,1544,92
2018,2,25,10,1489,1436,1551,115
2018,2,25,11,1487,1432,1532,100
2018,2,25,12,1494,1452,1535,83
2018,2,25,13,1534,1487,1549,62
2018,2,25,14,1586,1529,1570,41
2018,2,25,15,1607,1546,1635,89
2018,2,25,16,1621,1539,1677,138
2018,2,25,17,1610,1564,1759,195
2018,2,25,18,1578,1539,1808,269
2018,2,25,19,1557,1503,1705,202
2018,2,25,20,1525,1475,1651,176
2018,2,25,21,1504,1444,1600,156
2018,2,25,22,1476,1426,1564,138
2018,2,25,23,1481,1428,1539,111
2018,2,26,0,1530,1470,1582,112
2018,2,26,1,1635,1566,1733,167
2018,2,26,2,1778,1722,1946,224
2018,2,26,3,1791,1746,1934,188
2018,2,26,4,1776,1738,1915,177
2018,2,26,5,1720,1679,1899,220
2018,2,26,6,1630,1587,1785,198
2018,2,26,7,1546,1515,1668,153
2018,2,26,8,1499,1461,1508,47
2018,2,26,9,1481,1446,1600,154
2018,2,26,10,1472,1445,1618,173
2018,2,26,11,1488,1458,1628,170
2018,2,26,12,1531,1497,1605,108
2018,2,26,13,1623,1587,1730,143
2018,2,26,14,1752,1714,1853,139
2018,2,26,15,1764,1722,1932,210
2018,2,26,16,1706,1666,1807,141
2018,2,26,17,1672,1618,1780,162
2018,2,26,18,1615,1570,1808,238
2018,2,26,19,1573,1530,1809,279
2018,2,26,20,1540,1485,1832,347
2018,2,26,21,1516,1472,1846,374
2018,2,26,22,1501,1464,1814,350
2018,2,26,23,1514,1463,1825,362
2018,2,27,0,1538,1481,1877,396
2018,2,27,1,1609,1544,1910,366
2018,2,27,2,1743,1686,2036,350
2018,2,27,3,1760,1712,1966,254
2018,2,27,4,1741,1705,1925,220
2018,2,27,5,1671,1638,1827,189
2018,2,27,6,1575,1534,1626,92
2018,2,27,7,1488,1447,1550,103
2018,2,27,8,1423,1395,1549,154
2018,2,27,9,1398,1372,1563,191
2018,2,27,10,1393,1366,1570,204
2018,2,27,11,1404,1376,1538,162
2018,2,27,12,1444,1416,1585,169
2018,2,27,13,1535,1507,1646,139
2018,2,27,14,1669,1637,1764,127
2018,2,27,15,1676,1640,1814,174
2018,2,27,16,1623,1576,1645,69
2018,2,27,17,1578,1533,1715,182
2018,2,27,18,1533,1483,1806,323
2018,2,27,19,1506,1458,1811,353
2018,2,27,20,1477,1436,1884,448
2018,2,27,21,1477,1439,1965,526
2018,2,27,22,1484,1453,1983,530
2018,2,27,23,1484,1458,1990,532
2018,2,28,0,1504,1477,1929,452
2018,2,28,1,1572,1526,1867,341
2018,2,28,2,1696,1662,1911,249
2018,2,28,3,1724,1679,1874,195
2018,2,28,4,1713,1663,1915,252
2018,2,28,5,1638,1599,1879,280
2018,2,28,6,1539,1499,1807,308
2018,2,28,7,1452,1410,1610,200
2018,2,28,8,1398,1364,1632,268
2018,2,28,9,1380,1341,1639,298
2018,2,28,10,1376,1341,1667,326
2018,2,28,11,1385,1347,1636,289
2018,2,28,12,1430,1392,1580,188
2018,2,28,13,1514,1479,1602,123
2018,2,28,14,1646,1611,1607,-4
2018,2,28,15,1670,1624,1571,-53
2018,2,28,16,1623,1581,1546,-35
2018,2,28,17,1609,1561,1494,-67
2018,2,28,18,1563,1518,1489,-29
2018,2,28,19,1515,1498,1510,12
2018,2,28,20,1481,1482,1431,-51
2018,2,28,21,1504,1494,1078,-416
2018,2,28,22,1505,1490,1188,-302
2018,2,28,23,1556,1496,1170,-326
2018,3,1,0,1587,1522,1113,-409
2018,3,1,1,1661,1570,1162,-408
2018,3,1,2,1775,1691,1404,-287
2018,3,1,3,1796,1736,1589,-147
2018,3,1,4,1791,1716,1585,-131
2018,3,1,5,1721,1683,1551,-132
2018,3,1,6,1598,1569,1431,-138
2018,3,1,7,1501,1473,1200,-273
2018,3,1,8,1475,1421,1168,-253
2018,3,1,9,1447,1396,1097,-299
2018,3,1,10,1442,1399,1159,-240
2018,3,1,11,1453,1407,1133,-274
2018,3,1,12,1488,1448,1277,-171
2018,3,1,13,1577,1534,1393,-141
2018,3,1,14,1707,1650,1581,-69
2018,3,1,15,1711,1651,1686,35
2018,3,1,16,1665,1594,1583,-11
2018,3,1,17,1624,1543,1564,21
2018,3,1,18,1573,1501,1533,32
2018,3,1,19,1538,1459,1529,70
2018,3,1,20,1504,1417,1503,86
2018,3,1,21,1490,1404,1553,149
2018,3,1,22,1479,1396,1629,233
2018,3,1,23,1480,1398,1663,265
2018,3,2,0,1502,1429,1747,318
2018,3,2,1,1583,1480,1787,307
2018,3,2,2,1701,1618,2003,385
2018,3,2,3,1720,1655,1913,258
2018,3,2,4,1715,1667,1908,241
2018,3,2,5,1657,1606,1885,279
2018,3,2,6,1565,1517,1869,352
2018,3,2,7,1477,1429,1838,409
2018,3,2,8,1425,1384,1820,436
2018,3,2,9,1395,1364,1744,380
2018,3,2,10,1389,1359,1833,474
2018,3,2,11,1397,1369,1829,460
2018,3,2,12,1431,1405,1879,474
2018,3,2,13,1518,1504,2023,519
2018,3,2,14,1637,1611,2078,467
2018,3,2,15,1650,1619,1996,377
2018,3,2,16,1615,1546,1843,297
2018,3,2,17,1578,1510,1911,401
2018,3,2,18,1540,1478,1947,469
2018,3,2,19,1509,1449,1946,497
2018,3,2,20,1475,1402,1811,409
2018,3,2,21,1463,1377,1763,386
2018,3,2,22,1449,1381,1759,378
2018,3,2,23,1447,1403,1774,371
2018,3,3,0,1468,1432,1803,371
2018,3,3,1,1537,1454,1786,332
2018,3,3,2,1642,1567,1883,316
2018,3,3,3,1657,1592,1936,344
2018,3,3,4,1653,1593,2042,449
2018,3,3,5,1610,1555,1961,406
2018,3,3,6,1524,1484,1879,395
2018,3,3,7,1442,1411,1923,512
2018,3,3,8,1390,1362,1870,508
2018,3,3,9,1357,1335,1822,487
2018,3,3,10,1340,1315,1760,445
2018,3,3,11,1331,1313,1693,380
2018,3,3,12,1363,1345,1677,332
2018,3,3,13,1404,1387,1610,223
2018,3,3,14,1465,1440,1651,211
2018,3,3,15,1472,1451,1602,151
2018,3,3,16,1467,1434,1613,179
2018,3,3,17,1445,1415,1704,289
2018,3,3,18,1413,1381,1787,406
2018,3,3,19,1399,1361,1813,452
2018,3,3,20,1391,1351,1784,433
2018,3,3,21,1371,1336,1824,488
2018,3,3,22,1374,1328,1837,509
2018,3,3,23,1342,1351,1819,468
2018,3,4,0,1417,1375,1805,430
2018,3,4,1,1499,1425,1847,422
2018,3,4,2,1599,1538,1903,365
2018,3,4,3,1602,1550,1928,378
2018,3,4,4,1600,1534,1958,424
2018,3,4,5,1563,1489,1935,446
2018,3,4,6,1490,1433,1880,447
2018,3,4,7,1412,1372,1850,478
2018,3,4,8,1368,1327,1760,433
2018,3,4,9,1339,1302,1622,320
2018,3,4,10,1323,1289,1553,264
2018,3,4,11,1318,1283,1547,264
2018,3,4,12,1339,1305,1610,305
2018,3,4,13,1368,1332,1686,354
2018,3,4,14,1420,1378,1689,311
2018,3,4,15,1440,1394,1741,347
2018,3,4,16,1432,1391,1793,402
2018,3,4,17,1417,1386,1884,498
2018,3,4,18,1405,1363,1829,466
2018,3,4,19,1393,1350,1813,463
2018,3,4,20,1384,1351,1823,472
2018,3,4,21,1357,1345,1816,471
2018,3,4,22,1363,1338,1789,451
2018,3,4,23,1410,1360,1794,434
2018,3,5,0,1465,1402,1949,547
2018,3,5,1,1532,1481,1959,478
2018,3,5,2,1640,1617,2055,438
2018,3,5,3,1645,1653,2074,421
2018,3,5,4,1630,1634,2066,432
2018,3,5,5,1625,1585,2019,434
2018,3,5,6,1538,1498,1947,449
2018,3,5,7,1452,1418,1898,480
2018,3,5,8,1418,1368,1836,468
2018,3,5,9,1397,1352,1801,449
2018,3,5,10,1387,1354,1747,393
2018,3,5,11,1403,1363,1766,403
2018,3,5,12,1433,1397,1760,363
2018,3,5,13,1524,1500,1802,302
2018,3,5,14,1627,1615,1941,326
2018,3,5,15,1647,1624,1824,200
2018,3,5,16,1621,1585,1671,86
2018,3,5,17,1594,1547,1689,142
2018,3,5,18,1559,1514,1705,191
2018,3,5,19,1535,1501,1731,230
2018,3,5,20,1511,1482,1728,246
2018,3,5,21,1491,1456,1718,262
2018,3,5,22,1483,1453,1664,211
2018,3,5,23,1488,1454,1639,185
2018,3,6,0,1516,1476,1649,173
2018,3,6,1,1592,1543,1636,93
2018,3,6,2,1722,1690,1797,107
2018,3,6,3,1754,1729,1817,88
2018,3,6,4,1755,1722,1839,117
2018,3,6,5,1693,1658,1810,152
2018,3,6,6,1587,1557,1802,245
2018,3,6,7,1495,1471,1802,331
2018,3,6,8,1459,1429,1878,449
2018,3,6,9,1439,1402,1913,511
2018,3,6,10,1435,1391,1917,526
2018,3,6,11,1448,1408,1936,528
2018,3,6,12,1489,1454,1962,508
2018,3,6,13,1591,1551,1982,431
2018,3,6,14,1713,1653,1993,340
2018,3,6,15,1702,1656,1922,266
2018,3,6,16,1630,1601,1916,315
2018,3,6,17,1577,1525,1792,267
2018,3,6,18,1533,1479,1748,269
2018,3,6,19,1499,1442,1793,351
2018,3,6,20,1464,1412,1679,267
2018,3,6,21,1446,1424,1701,277
2018,3,6,22,1439,1420,1697,277
2018,3,6,23,1439,1418,1667,249
2018,3,7,0,1467,1451,1670,219
2018,3,7,1,1540,1494,1618,124
2018,3,7,2,1678,1636,1832,196
2018,3,7,3,1721,1679,1901,222
2018,3,7,4,1721,1688,1780,92
2018,3,7,5,1659,1631,1704,73
2018,3,7,6,1566,1520,1631,111
2018,3,7,7,1476,1452,1707,255
2018,3,7,8,1434,1410,1654,244
2018,3,7,9,1411,1396,1701,305
2018,3,7,10,1405,1393,1664,271
2018,3,7,11,1416,1407,1673,266
2018,3,7,12,1463,1446,1669,223
2018,3,7,13,1556,1544,1633,89
2018,3,7,14,1662,1643,1784,141
2018,3,7,15,1661,1641,1768,127
2018,3,7,16,1611,1577,1721,144
2018,3,7,17,1559,1541,1740,199
2018,3,7,18,1520,1501,1777,276
2018,3,7,19,1501,1462,1823,361
2018,3,7,20,1475,1428,1818,390
2018,3,7,21,1457,1422,1823,401
2018,3,7,22,1462,1433,1850,417
2018,3,7,23,1462,1457,1815,358
2018,3,8,0,1489,1480,1776,296
2018,3,8,1,1544,1525,1795,270
2018,3,8,2,1658,1640,1848,208
2018,3,8,3,1701,1648,1834,186
2018,3,8,4,1695,1643,1813,170
2018,3,8,5,1634,1590,1763,173
2018,3,8,6,1527,1488,1780,292
2018,3,8,7,1438,1402,1686,284
2018,3,8,8,1373,1347,1589,242
2018,3,8,9,1344,1317,1495,178
2018,3,8,10,1341,1312,1457,145
2018,3,8,11,1349,1316,1462,146
2018,3,8,12,1373,1344,1543,199
2018,3,8,13,1472,1434,1614,180
2018,3,8,14,1579,1543,1706,163
2018,3,8,15,1586,1552,1569,17
2018,3,8,16,1546,1507,1562,55
2018,3,8,17,1477,1476,1575,99
2018,3,8,18,1440,1439,1689,250
2018,3,8,19,1420,1424,1746,322
2018,3,8,20,1401,1407,1807,400
2018,3,8,21,1443,1406,1842,436
2018,3,8,22,1442,1407,1861,454
2018,3,8,23,1452,1416,1842,426
2018,3,9,0,1476,1435,1723,288
2018,3,9,1,1539,1471,1758,287
2018,3,9,2,1636,1585,1726,141
2018,3,9,3,1648,1596,1752,156
2018,3,9,4,1658,1605,1725,120
2018,3,9,5,1596,1538,1612,74
2018,3,9,6,1490,1442,1518,76
2018,3,9,7,1403,1376,1382,6
2018,3,9,8,1338,1312,1106,-206
2018,3,9,9,1325,1290,1101,-189
2018,3,9,10,1310,1278,1107,-171
2018,3,9,11,1315,1288,1152,-136
2018,3,9,12,1361,1330,1171,-159
2018,3,9,13,1437,1409,1184,-225
2018,3,9,14,1539,1522,1204,-318
2018,3,9,15,1551,1536,1090,-446
2018,3,9,16,1513,1508,986,-522
2018,3,9,17,1481,1456,1001,-455
2018,3,9,18,1454,1427,1067,-360
2018,3,9,19,1439,1419,1149,-270
2018,3,9,20,1418,1409,1158,-251
2018,3,9,21,1415,1407,1232,-175
2018,3,9,22,1409,1389,1220,-169
2018,3,9,23,1417,1397,1214,-183
2018,3,10,0,1426,1411,1155,-256
2018,3,10,1,1465,1442,1106,-336
2018,3,10,2,1544,1535,1108,-427
2018,3,10,3,1570,1557,1164,-393
2018,3,10,4,1580,1551,1202,-349
2018,3,10,5,1537,1513,1108,-405
2018,3,10,6,1454,1431,1083,-348
2018,3,10,7,1376,1392,1144,-248
2018,3,10,8,1336,1314,1186,-128
2018,3,10,9,1323,1296,1189,-107
2018,3,10,10,1305,1276,1160,-116
2018,3,10,11,1294,1272,1103,-169
2018,3,10,12,1308,1279,1112,-167
2018,3,10,13,1342,1319,964,-355
2018,3,10,14,1390,1363,1013,-350
2018,3,10,15,1401,1372,1170,-202
2018,3,10,16,1404,1369,1271,-98
2018,3,10,17,1387,1363,1309,-54
2018,3,10,18,1372,1357,1292,-65
2018,3,10,19,1366,1349,1341,-8
2018,3,10,20,1339,1337,1322,-15
2018,3,10,21,1344,1336,1310,-26
2018,3,10,22,1364,1359,1304,-55
2018,3,10,23,1385,1379,1261,-118
2018,3,11,0,1422,1400,1218,-182
2018,3,11,1,1487,1452,1212,-240
2018,3,11,2,1572,1544,1265,-279
2018,3,11,3,1574,1548,1190,-358
2018,3,11,4,1564,1531,1205,-326
2018,3,11,5,1509,1483,1125,-358
2018,3,11,6,1433,1420,1054,-366
2018,3,11,7,1353,1359,1121,-238
2018,3,11,8,1328,1309,1083,-226
2018,3,11,9,1263,1275,1052,-223
2018,3,11,10,1299,1269,1007,-262
2018,3,11,11,1286,1252,1020,-232
2018,3,11,12,1298,1265,1055,-210
2018,3,11,13,1342,1299,1089,-210
2018,3,11,14,1389,1351,1066,-285
2018,3,11,15,1406,1381,1061,-320
2018,3,11,16,1442,1426,1122,-304
2018,3,11,17,1438,1444,1130,-314
2018,3,11,18,1451,1474,1070,-404
2018,3,11,19,1461,1470,1024,-446
2018,3,11,20,1470,1475,982,-493
2018,3,11,21,1455,1507,935,-572
2018,3,11,22,1453,1533,890,-643
2018,3,11,23,1453,1564,876,-688
2018,3,12,0,1478,1610,968,-642
2018,3,12,1,1530,1660,1062,-598
2018,3,12,2,1684,1739,1092,-647
2018,3,12,3,1767,1731,1089,-642
2018,3,12,4,1721,1671,1001,-670
2018,3,12,5,1614,1557,947,-610
2018,3,12,6,1480,1471,882,-589
2018,3,12,7,1620,1395,902,-493
2018,3,12,8,1359,1357,926,-431
2018,3,12,9,1336,1312,879,-433
2018,3,12,10,1330,1325,907,-418
2018,3,12,11,1341,1352,916,-436
2018,3,12,12,1388,1417,943,-474
2018,3,12,13,1492,1545,990,-555
2018,3,12,14,1603,1604,1070,-534
2018,3,12,15,1623,1585,1054,-531
2018,3,12,16,1619,1588,1064,-524
2018,3,12,17,1591,1560,1096,-464
2018,3,12,18,1560,1523,1087,-436
2018,3,12,19,1530,1487,1120,-367
2018,3,12,20,1507,1445,1201,-244
2018,3,12,21,1499,1426,1227,-199
2018,3,12,22,1500,1400,1191,-209
2018,3,12,23,1511,1381,1217,-164
2018,3,13,0,1531,1406,1359,-47
2018,3,13,1,1547,1440,1388,-52
2018,3,13,2,1625,1543,1466,-77
2018,3,13,3,1637,1600,1560,-40
2018,3,13,4,1598,1552,1473,-79
2018,3,13,5,1484,1450,1468,18
2018,3,13,6,1397,1354,1373,19
2018,3,13,7,1323,1300,1333,33
2018,3,13,8,1353,1266,1290,24
2018,3,13,9,1329,1258,1243,-15
2018,3,13,10,1325,1257,1191,-66
2018,3,13,11,1341,1272,1165,-107
2018,3,13,12,1403,1373,1172,-201
2018,3,13,13,1526,1516,1217,-299
2018,3,13,14,1618,1574,1288,-286
2018,3,13,15,1611,1538,1297,-241
2018,3,13,16,1573,1481,1396,-85
2018,3,13,17,1536,1442,1428,-14
2018,3,13,18,1508,1409,1372,-37
2018,3,13,19,1455,1382,1277,-105
2018,3,13,20,1436,1365,1206,-159
2018,3,13,21,1429,1370,1163,-207
2018,3,13,22,1431,1360,1135,-225
2018,3,13,23,1440,1361,1164,-197
2018,3,14,0,1467,1380,1242,-138
2018,3,14,1,1520,1412,1379,-33
2018,3,14,2,1590,1519,1581,62
2018,3,14,3,1642,1560,1620,60
2018,3,14,4,1603,1509,1611,102
2018,3,14,5,1512,1418,1461,43
2018,3,14,6,1415,1313,1531,218
2018,3,14,7,1353,1260,1562,302
2018,3,14,8,1309,1213,1342,129
2018,3,14,9,1288,1198,1254,56
2018,3,14,10,1287,1196,1216,20
2018,3,14,11,1302,1224,1245,21
2018,3,14,12,1375,1298,1199,-99
2018,3,14,13,1509,1424,1228,-196
2018,3,14,14,1556,1480,1271,-209
2018,3,14,15,1524,1441,1293,-148
2018,3,14,16,1503,1410,1333,-77
2018,3,14,17,1479,1372,1391,19
2018,3,14,18,1456,1345,1457,112
2018,3,14,19,1445,1324,1440,116
2018,3,14,20,1428,1320,1467,147
2018,3,14,21,1390,1328,1525,197
2018,3,14,22,1402,1329,1534,205
2018,3,14,23,1417,1342,1508,166
2018,3,15,0,1438,1369,1563,194
2018,3,15,1,1478,1386,1554,168
2018,3,15,2,1526,1514,1612,98
2018,3,15,3,1579,1540,1691,151
2018,3,15,4,1542,1490,1660,170
2018,3,15,5,1449,1388,1605,217
2018,3,15,6,1356,1287,1598,311
2018,3,15,7,1290,1227,1617,390
2018,3,15,8,1253,1194,1475,281
2018,3,15,9,1236,1169,1412,243
2018,3,15,10,1229,1165,1393,228
2018,3,15,11,1240,1194,1418,224
2018,3,15,12,1303,1271,1446,175
2018,3,15,13,1416,1402,1530,128
2018,3,15,14,1504,1452,1571,119
2018,3,15,15,1508,1420,1535,115
2018,3,15,16,1481,1415,1586,171
2018,3,15,17,1465,1410,1643,233
2018,3,15,18,1439,1412,1688,276
2018,3,15,19,1417,1394,1644,250
2018,3,15,20,1406,1397,1669,272
2018,3,15,21,1405,1415,1684,269
2018,3,15,22,1414,1371,1716,345
2018,3,15,23,1424,1429,1703,274
2018,3,16,0,1447,1419,1707,288
2018,3,16,1,1488,1450,1640,190
2018,3,16,2,1552,1550,1650,100
2018,3,16,3,1618,1638,1751,113
2018,3,16,4,1587,1604,1701,97
2018,3,16,5,1502,1510,1671,161
2018,3,16,6,1384,1419,1637,218
2018,3,16,7,1316,1369,1620,251
2018,3,16,8,1269,1336,1538,202
2018,3,16,9,1246,1320,1516,196
2018,3,16,10,1246,1323,1508,185
2018,3,16,11,1265,1342,1495,153
2018,3,16,12,1327,1418,1584,166
2018,3,16,13,1482,1553,1621,68
2018,3,16,14,1557,1605,1587,-18
2018,3,16,15,1553,1586,1510,-76
2018,3,16,16,1523,1536,1510,-26
2018,3,16,17,1466,1494,1534,40
2018,3,16,18,1428,1460,1615,155
2018,3,16,19,1405,1421,1593,172
2018,3,16,20,1393,1397,1512,115
2018,3,16,21,1396,1388,1454,66
2018,3,16,22,1363,1379,1399,20
2018,3,16,23,1365,1382,1389,7
2018,3,17,0,1377,1404,1377,-27
2018,3,17,1,1410,1422,1351,-71
2018,3,17,2,1496,1511,1276,-235
2018,3,17,3,1551,1567,1296,-271
2018,3,17,4,1531,1541,1301,-240
2018,3,17,5,1468,1473,1296,-177
2018,3,17,6,1393,1396,1245,-151
2018,3,17,7,1328,1340,1281,-59
2018,3,17,8,1294,1311,1263,-48
2018,3,17,9,1271,1279,1194,-85
2018,3,17,10,1261,1275,1179,-96
2018,3,17,11,1273,1285,1165,-120
2018,3,17,12,1303,1322,1159,-163
2018,3,17,13,1364,1385,1189,-196
2018,3,17,14,1401,1426,1157,-269
2018,3,17,15,1416,1444,1101,-343
2018,3,17,16,1405,1427,1084,-343
2018,3,17,17,1384,1401,1075,-326
2018,3,17,18,1362,1370,1093,-277
2018,3,17,19,1338,1340,1134,-206
2018,3,17,20,1320,1325,1247,-78
2018,3,17,21,1328,1343,1328,-15
2018,3,17,22,1324,1313,1322,9
2018,3,17,23,1324,1331,1337,6
2018,3,18,0,1360,1370,1276,-94
2018,3,18,1,1410,1399,1101,-298
2018,3,18,2,1494,1489,1057,-432
2018,3,18,3,1572,1525,1144,-381
2018,3,18,4,1538,1501,1068,-433
2018,3,18,5,1479,1419,937,-482
2018,3,18,6,1403,1354,942,-412
2018,3,18,7,1346,1297,906,-391
2018,3,18,8,1310,1272,800,-472
2018,3,18,9,1293,1253,830,-423
2018,3,18,10,1275,1235,778,-457
2018,3,18,11,1282,1249,780,-469
2018,3,18,12,1307,1283,838,-445
2018,3,18,13,1353,1323,985,-338
2018,3,18,14,1396,1353,1015,-338
2018,3,18,15,1413,1367,950,-417
2018,3,18,16,1419,1374,1104,-270
2018,3,18,17,1432,1385,1374,-11
2018,3,18,18,1442,1408,1513,105
2018,3,18,19,1466,1433,1560,127
2018,3,18,20,1492,1464,1538,74
2018,3,18,21,1476,1448,1391,-57
2018,3,18,22,1439,1411,1313,-98
2018,3,18,23,1459,1429,1202,-227
2018,3,19,0,1508,1481,1240,-241
2018,3,19,1,1561,1525,1290,-235
2018,3,19,2,1673,1647,1482,-165
2018,3,19,3,1726,1693,1508,-185
2018,3,19,4,1687,1636,1457,-179
2018,3,19,5,1603,1546,1327,-219
2018,3,19,6,1501,1452,1324,-128
2018,3,19,7,1432,1394,1333,-61
2018,3,19,8,1411,1374,1300,-74
2018,3,19,9,1393,1359,1295,-64
2018,3,19,10,1398,1366,1296,-70
2018,3,19,11,1418,1390,1352,-38
2018,3,19,12,1471,1452,1434,-18
2018,3,19,13,1606,1587,1568,-19
2018,3,19,14,1682,1642,1583,-59
2018,3,19,15,1664,1609,1507,-102
2018,3,19,16,1622,1574,1505,-69
2018,3,19,17,1576,1522,1490,-32
2018,3,19,18,1541,1485,1489,4
2018,3,19,19,1498,1453,1429,-24
2018,3,19,20,1463,1423,1378,-45
2018,3,19,21,1442,1406,1454,48
2018,3,19,22,1433,1394,1577,183
2018,3,19,23,1448,1422,1611,189
2018,3,20,0,1473,1436,1634,198
2018,3,20,1,1522,1482,1650,168
2018,3,20,2,1618,1603,1832,229
2018,3,20,3,1734,1651,1891,240
2018,3,20,4,1671,1605,1749,144
2018,3,20,5,1669,1510,1665,155
2018,3,20,6,1467,1419,1515,96
2018,3,20,7,1406,1367,1438,71
2018,3,20,8,1381,1347,1317,-30
2018,3,20,9,1371,1341,1274,-67
2018,3,20,10,1374,1353,1256,-97
2018,3,20,11,1411,1392,1243,-149
2018,3,20,12,1490,1471,1319,-152
2018,3,20,13,1629,1619,1458,-161
2018,3,20,14,1691,1663,1537,-126
2018,3,20,15,1657,1614,1511,-103
2018,3,20,16,1610,1556,1510,-46
2018,3,20,17,1558,1510,1491,-19
2018,3,20,18,1511,1473,1474,1
2018,3,20,19,1475,1433,1548,115
2018,3,20,20,1446,1408,1630,222
2018,3,20,21,1437,1403,1672,269
2018,3,20,22,1431,1400,1708,308
2018,3,20,23,1432,1397,1708,311
2018,3,21,0,1449,1434,1687,253
2018,3,21,1,1479,1454,1584,130
2018,3,21,2,1584,1558,1485,-73
2018,3,21,3,1722,1608,1479,-129
2018,3,21,4,1613,1554,1424,-130
2018,3,21,5,1526,1469,1419,-50
2018,3,21,6,1434,1374,1353,-21
2018,3,21,7,1376,1319,1282,-37
2018,3,21,8,1342,1303,1217,-86
2018,3,21,9,1328,1292,1193,-99
2018,3,21,10,1330,1297,1198,-99
2018,3,21,11,1347,1335,1240,-95
2018,3,21,12,1431,1402,1249,-153
2018,3,21,13,1560,1576,1358,-218
2018,3,21,14,1626,1595,1304,-291
2018,3,21,15,1605,1567,1262,-305
2018,3,21,16,1563,1512,1239,-273
2018,3,21,17,1510,1486,1223,-263
2018,3,21,18,1475,1447,1223,-224
2018,3,21,19,1450,1416,1256,-160
2018,3,21,20,1433,1396,1351,-45
2018,3,21,21,1434,1394,1413,19
2018,3,21,22,1430,1394,1493,99
2018,3,21,23,1444,1406,1605,199
2018,3,22,0,1455,1413,1576,163
2018,3,22,1,1480,1448,1413,-35
2018,3,22,2,1565,1524,1357,-167
2018,3,22,3,1644,1589,1357,-232
2018,3,22,4,1581,1526,1326,-200
2018,3,22,5,1491,1425,1287,-138
2018,3,22,6,1405,1324,1235,-89
2018,3,22,7,1345,1269,1229,-40
2018,3,22,8,1272,1239,1189,-50
2018,3,22,9,1258,1220,1149,-71
2018,3,22,10,1261,1220,1150,-70
2018,3,22,11,1282,1250,1203,-47
2018,3,22,12,1354,1322,1285,-37
2018,3,22,13,1481,1452,1346,-106
2018,3,22,14,1554,1519,1344,-175
2018,3,22,15,1542,1487,1379,-108
2018,3,22,16,1503,1451,1402,-49
2018,3,22,17,1480,1435,1466,31
2018,3,22,18,1460,1410,1605,195
2018,3,22,19,1443,1399,1658,259
2018,3,22,20,1455,1417,1649,232
2018,3,22,21,1446,1429,1681,252
2018,3,22,22,1468,1438,1674,236
2018,3,22,23,1488,1460,1628,168
2018,3,23,0,1496,1468,1508,40
2018,3,23,1,1522,1489,1314,-175
2018,3,23,2,1580,1570,1380,-190
2018,3,23,3,1637,1599,1349,-250
2018,3,23,4,1596,1523,1491,-32
2018,3,23,5,1496,1418,1524,106
2018,3,23,6,1394,1324,1529,205
2018,3,23,7,1325,1278,1468,190
2018,3,23,8,1273,1216,1441,225
2018,3,23,9,1246,1198,1427,229
2018,3,23,10,1234,1191,1407,216
2018,3,23,11,1238,1206,1401,195
2018,3,23,12,1304,1275,1363,88
2018,3,23,13,1418,1385,1415,30
2018,3,23,14,1485,1446,1397,-49
2018,3,23,15,1507,1455,1521,66
2018,3,23,16,1507,1453,1656,203
2018,3,23,17,1480,1441,1759,318
2018,3,23,18,1479,1445,1770,325
2018,3,23,19,1486,1452,1834,382
2018,3,23,20,1453,1419,1840,421
2018,3,23,21,1461,1431,1777,346
2018,3,23,22,1471,1432,1809,377
2018,3,23,23,1477,1434,1731,297
2018,3,24,0,1479,1442,1673,231
2018,3,24,1,1497,1435,1596,161
2018,3,24,2,1536,1483,1534,51
2018,3,24,3,1574,1548,1614,66
2018,3,24,4,1540,1513,1567,54
2018,3,24,5,1459,1424,1520,96
2018,3,24,6,1430,1326,1460,134
2018,3,24,7,1359,1284,1381,97
2018,3,24,8,1305,1241,1283,42
2018,3,24,9,1254,1220,1286,66
2018,3,24,10,1247,1205,1270,65
2018,3,24,11,1253,1217,1251,34
2018,3,24,12,1280,1257,1154,-103
2018,3,24,13,1330,1319,1091,-228
2018,3,24,14,1374,1367,1114,-253
2018,3,24,15,1387,1387,1148,-239
2018,3,24,16,1383,1356,1146,-210
2018,3,24,17,1376,1344,1200,-144
2018,3,24,18,1362,1344,1316,-28
2018,3,24,19,1349,1335,1389,54
2018,3,24,20,1337,1317,1425,108
2018,3,24,21,1341,1316,1465,149
2018,3,24,22,1357,1338,1565,227
2018,3,24,23,1373,1370,1509,139
2018,3,25,0,1406,1405,1437,32
2018,3,25,1,1449,1438,1332,-106
2018,3,25,2,1499,1489,1519,30
2018,3,25,3,1565,1516,1551,35
2018,3,25,4,1529,1469,1366,-103
2018,3,25,5,1436,1395,1194,-201
2018,3,25,6,1357,1317,1122,-195
2018,3,25,7,1303,1254,1288,34
2018,3,25,8,1266,1222,1222,0
2018,3,25,9,1249,1209,1298,89
2018,3,25,10,1238,1198,1222,24
2018,3,25,11,1245,1197,1326,129
2018,3,25,12,1267,1219,1352,133
2018,3,25,13,1310,1276,1416,140
2018,3,25,14,1347,1291,1415,124
2018,3,25,15,1362,1305,1438,133
2018,3,25,16,1353,1317,1544,227
2018,3,25,17,1349,1306,1399,93
2018,3,25,18,1340,1305,1409,104
2018,3,25,19,1340,1305,1410,105
2018,3,25,20,1338,1301,1385,84
2018,3,25,21,1336,1309,1430,121
2018,3,25,22,1337,1342,1560,218
2018,3,25,23,1365,1378,1646,268
2018,3,26,0,1414,1401,1585,184
2018,3,26,1,1473,1413,1503,90
2018,3,26,2,1536,1505,1575,70
2018,3,26,3,1602,1537,1593,56
2018,3,26,4,1564,1487,1547,60
2018,3,26,5,1469,1392,1487,95
2018,3,26,6,1371,1297,1429,132
2018,3,26,7,1296,1229,1402,173
2018,3,26,8,1241,1195,1321,126
2018,3,26,9,1220,1188,1302,114
2018,3,26,10,1210,1185,1289,104
2018,3,26,11,1252,1209,1293,84
2018,3,26,12,1315,1268,1318,50
2018,3,26,13,1450,1392,1435,43
2018,3,26,14,1502,1442,1483,41
2018,3,26,15,1510,1463,1530,67
2018,3,26,16,1494,1447,1598,151
2018,3,26,17,1487,1445,1578,133
2018,3,26,18,1461,1422,1560,138
2018,3,26,19,1449,1416,1537,121
2018,3,26,20,1456,1417,1477,60
2018,3,26,21,1452,1417,1446,29
2018,3,26,22,1432,1398,1430,32
2018,3,26,23,1446,1405,1401,-4
2018,3,27,0,1464,1402,1469,67
2018,3,27,1,1502,1426,1434,8
2018,3,27,2,1559,1511,1511,0
2018,3,27,3,1608,1572,1571,-1
2018,3,27,4,1568,1506,1536,30
2018,3,27,5,1470,1419,1421,2
2018,3,27,6,1371,1312,1273,-39
2018,3,27,7,1308,1263,1303,40
2018,3,27,8,1261,1229,1165,-64
2018,3,27,9,1252,1213,1072,-141
2018,3,27,10,1250,1216,1075,-141
2018,3,27,11,1278,1246,1039,-207
2018,3,27,12,1333,1319,1105,-214
2018,3,27,13,1463,1449,1230,-219
2018,3,27,14,1541,1501,1449,-52
2018,3,27,15,1549,1503,1522,19
2018,3,27,16,1535,1485,1483,-2
2018,3,27,17,1504,1459,1486,27
2018,3,27,18,1528,1495,1520,25
2018,3,27,19,1512,1487,1496,9
2018,3,27,20,1476,1452,1458,6
2018,3,27,21,1488,1466,1469,3
2018,3,27,22,1469,1449,1421,-28
2018,3,27,23,1472,1457,1454,-3
2018,3,28,0,1496,1494,1461,-33
2018,3,28,1,1539,1518,1521,3
2018,3,28,2,1614,1591,1522,-69
2018,3,28,3,1667,1634,1465,-169
2018,3,28,4,1623,1598,1342,-256
2018,3,28,5,1523,1487,1291,-196
2018,3,28,6,1429,1393,1226,-167
2018,3,28,7,1367,1338,1148,-190
2018,3,28,8,1339,1315,1161,-154
2018,3,28,9,1334,1301,1140,-161
2018,3,28,10,1334,1306,1092,-214
2018,3,28,11,1345,1333,1240,-93
2018,3,28,12,1422,1393,1386,-7
2018,3,28,13,1547,1521,1456,-65
2018,3,28,14,1598,1554,1485,-69
2018,3,28,15,1585,1517,1489,-28
2018,3,28,16,1544,1488,1559,71
2018,3,28,17,1506,1463,1600,137
2018,3,28,18,1469,1418,1528,110
2018,3,28,19,1429,1384,1315,-69
2018,3,28,20,1406,1368,1218,-150
2018,3,28,21,1388,1354,1405,51
2018,3,28,22,1390,1352,1445,93
2018,3,28,23,1403,1361,1450,89
2018,3,29,0,1425,1373,1440,67
2018,3,29,1,1456,1404,1421,17
2018,3,29,2,1531,1491,1428,-63
2018,3,29,3,1595,1574,1499,-75
2018,3,29,4,1566,1529,1430,-99
2018,3,29,5,1502,1438,1418,-20
2018,3,29,6,1408,1341,1419,78
2018,3,29,7,1347,1288,1472,184
2018,3,29,8,1322,1296,1427,131
2018,3,29,9,1302,1257,1396,139
2018,3,29,10,1301,1250,1262,12
2018,3,29,11,1318,1266,1151,-115
2018,3,29,12,1394,1366,1166,-200
2018,3,29,13,1515,1476,1195,-281
2018,3,29,14,1581,1517,1181,-336
2018,3,29,15,1538,1486,1176,-310
2018,3,29,16,1502,1449,1256,-193
2018,3,29,17,1462,1433,1275,-158
2018,3,29,18,1439,1395,1324,-71
2018,3,29,19,1411,1368,1358,-10
2018,3,29,20,1400,1353,1369,16
2018,3,29,21,1396,1345,1482,137
2018,3,29,22,1365,1334,1611,277
2018,3,29,23,1390,1345,1664,319
2018,3,30,0,1398,1376,1547,171
2018,3,30,1,1408,1377,1552,175
2018,3,30,2,1493,1451,1425,-26
2018,3,30,3,1587,1528,1457,-71
2018,3,30,4,1570,1493,1435,-58
2018,3,30,5,1493,1420,1328,-92
2018,3,30,6,1406,1330,1204,-126
2018,3,30,7,1399,1281,1049,-232
2018,3,30,8,1276,1254,985,-269
2018,3,30,9,1251,1235,1041,-194
2018,3,30,10,1250,1226,1223,-3
2018,3,30,11,1272,1259,1316,57
2018,3,30,12,1323,1319,1393,74
2018,3,30,13,1417,1419,1469,50
2018,3,30,14,1434,1407,1317,-90
2018,3,30,15,1441,1431,1283,-148
2018,3,30,16,1432,1403,1196,-207
2018,3,30,17,1405,1381,1190,-191
2018,3,30,18,1377,1351,1199,-152
2018,3,30,19,1366,1339,1177,-162
2018,3,30,20,1351,1325,1247,-78
2018,3,30,21,1356,1331,1342,11
2018,3,30,22,1359,1319,1378,59
2018,3,30,23,1374,1337,1424,87
2018,3,31,0,1401,1375,1424,49
2018,3,31,1,1414,1378,1383,5
2018,3,31,2,1473,1440,1480,40
2018,3,31,3,1555,1518,1494,-24
2018,3,31,4,1543,1475,1398,-77
2018,3,31,5,1478,1412,1360,-52
2018,3,31,6,1390,1330,1295,-35
2018,3,31,7,1331,1276,1240,-36
2018,3,31,8,1282,1239,1194,-45
2018,3,31,9,1250,1215,1150,-65
2018,3,31,10,1235,1207,1188,-19
2018,3,31,11,1229,1214,1213,-1
2018,3,31,12,1269,1248,1166,-82
2018,3,31,13,1313,1301,1236,-65
2018,3,31,14,1347,1317,1235,-82
2018,3,31,15,1372,1346,1241,-105
2018,3,31,16,1375,1341,1242,-99
2018,3,31,17,1364,1345,1297,-48
2018,3,31,18,1354,1314,1343,29
2018,3,31,19,1333,1300,1331,31
2018,3,31,20,1329,1294,1301,7
2018,3,31,21,1333,1306,1342,36
2018,3,31,22,1350,1320,1347,27
2018,3,31,23,1357,1332,1354,22
2018,4,1,0,1422,1380,1312,-68
2018,4,1,1,1420,1395,1306,-89
2018,4,1,2,1486,1455,1257,-198
2018,4,1,3,1538,1505,1264,-241
2018,4,1,4,1522,1469,1227,-242
2018,4,1,5,1476,1393,1226,-167
2018,4,1,6,1385,1316,1305,-11
2018,4,1,7,1321,1256,1268,12
2018,4,1,8,1246,1204,1265,61
2018,4,1,9,1213,1181,1251,70
2018,4,1,10,1200,1173,1227,54
2018,4,1,11,1207,1179,1317,138
2018,4,1,12,1226,1202,1356,154
2018,4,1,13,1269,1246,1253,7
2018,4,1,14,1295,1257,1147,-110
2018,4,1,15,1332,1298,1145,-153
2018,4,1,16,1348,1313,1315,2
2018,4,1,17,1338,1308,1332,24
2018,4,1,18,1345,1315,1375,60
2018,4,1,19,1335,1298,1342,44
2018,4,1,20,1331,1287,1326,39
2018,4,1,21,1326,1282,1327,45
2018,4,1,22,1326,1284,1314,30
2018,4,1,23,1334,1294,1244,-50
2018,4,2,0,1352,1310,1181,-129
2018,4,2,1,1393,1335,1153,-182
2018,4,2,2,1447,1421,1251,-170
2018,4,2,3,1514,1485,1275,-210
2018,4,2,4,1490,1451,1248,-203
2018,4,2,5,1411,1375,1193,-182
2018,4,2,6,1332,1283,1195,-88
2018,4,2,7,1253,1232,1242,10
2018,4,2,8,1236,1202,1298,96
2018,4,2,9,1225,1197,1348,151
2018,4,2,10,1217,1188,1338,150
2018,4,2,11,1247,1220,1341,121
2018,4,2,12,1302,1313,1439,126
2018,4,2,13,1413,1405,1473,68
2018,4,2,14,1470,1436,1508,72
2018,4,2,15,1475,1413,1495,82
2018,4,2,16,1461,1410,1611,201
2018,4,2,17,1456,1407,1655,248
2018,4,2,18,1461,1401,1678,277
2018,4,2,19,1490,1410,1754,344
2018,4,2,20,1495,1412,1779,367
2018,4,2,21,1502,1408,1792,384
2018,4,2,22,1513,1419,1822,403
2018,4,2,23,1528,1427,1893,466
2018,4,3,0,1538,1448,1915,467
2018,4,3,1,1542,1463,1903,440
2018,4,3,2,1572,1529,1866,337
2018,4,3,3,1616,1594,1984,390
2018,4,3,4,1571,1542,1873,331
2018,4,3,5,1477,1425,1733,308
2018,4,3,6,1370,1322,1767,445
2018,4,3,7,1304,1267,1783,516
2018,4,3,8,1258,1237,1741,504
2018,4,3,9,1242,1217,1703,486
2018,4,3,10,1244,1205,1697,492
2018,4,3,11,1267,1231,1701,470
2018,4,3,12,1338,1297,1714,417
2018,4,3,13,1467,1415,1758,343
2018,4,3,14,1536,1440,1626,186
2018,4,3,15,1528,1431,1648,217
2018,4,3,16,1491,1416,1662,246
2018,4,3,17,1476,1402,1703,301
2018,4,3,18,1453,1399,1680,281
2018,4,3,19,1439,1390,1667,277
2018,4,3,20,1452,1393,1683,290
2018,4,3,21,1446,1393,1666,273
2018,4,3,22,1461,1401,1675,274
2018,4,3,23,1484,1413,1632,219
2018,4,4,0,1493,1426,1677,251
2018,4,4,1,1507,1440,1630,190
2018,4,4,2,1573,1489,1696,207
2018,4,4,3,1617,1570,1849,279
2018,4,4,4,1579,1507,1823,316
2018,4,4,5,1476,1402,1680,278
2018,4,4,6,1388,1307,1596,289
2018,4,4,7,1310,1248,1456,208
2018,4,4,8,1265,1228,1256,28
2018,4,4,9,1251,1212,1184,-28
2018,4,4,10,1253,1208,1154,-54
2018,4,4,11,1276,1241,1155,-86
2018,4,4,12,1353,1327,1170,-157
2018,4,4,13,1480,1443,1290,-153
2018,4,4,14,1545,1481,1386,-95
2018,4,4,15,1534,1456,1303,-153
2018,4,4,16,1494,1417,1302,-115
2018,4,4,17,1473,1406,1375,-31
2018,4,4,18,1450,1386,1414,28
2018,4,4,19,1434,1367,1444,77
2018,4,4,20,1443,1373,1484,111
2018,4,4,21,1437,1389,1568,179
2018,4,4,22,1451,1402,1577,175
2018,4,4,23,1472,1419,1612,193
2018,4,5,0,1485,1441,1655,214
2018,4,5,1,1497,1455,1653,198
2018,4,5,2,1564,1524,1731,207
2018,4,5,3,1613,1568,1748,180
2018,4,5,4,1570,1509,1686,177
2018,4,5,5,1463,1398,1586,188
2018,4,5,6,1375,1294,1462,168
2018,4,5,7,1294,1232,1422,190
2018,4,5,8,1252,1227,1411,184
2018,4,5,9,1236,1194,1315,121
2018,4,5,10,1238,1187,1215,28
2018,4,5,11,1262,1212,1234,22
2018,4,5,12,1339,1294,1247,-47
2018,4,5,13,1468,1417,1296,-121
2018,4,5,14,1529,1436,1284,-152
2018,4,5,15,1501,1433,1250,-183
2018,4,5,16,1463,1437,1338,-99
2018,4,5,17,1442,1425,1397,-28
2018,4,5,18,1425,1435,1417,-18
2018,4,5,19,1411,1427,1440,13
2018,4,5,20,1428,1448,1513,65
2018,4,5,21,1423,1445,1544,99
2018,4,5,22,1446,1450,1539,89
2018,4,5,23,1488,1447,1473,26
2018,4,6,0,1494,1445,1580,135
2018,4,6,1,1504,1449,1663,214
2018,4,6,2,1563,1517,1591,74
2018,4,6,3,1608,1575,1538,-37
2018,4,6,4,1562,1522,1413,-109
2018,4,6,5,1451,1418,1243,-175
2018,4,6,6,1364,1319,1114,-205
2018,4,6,7,1287,1264,1111,-153
2018,4,6,8,1261,1236,1093,-143
2018,4,6,9,1231,1209,1061,-148
2018,4,6,10,1212,1197,1036,-161
2018,4,6,11,1235,1214,1068,-146
2018,4,6,12,1287,1273,1124,-149
2018,4,6,13,1389,1394,1264,-130
2018,4,6,14,1430,1422,1274,-148
2018,4,6,15,1451,1428,1302,-126
2018,4,6,16,1463,1454,1255,-199
2018,4,6,17,1443,1438,1201,-237
2018,4,6,18,1420,1416,1201,-215
2018,4,6,19,1418,1414,1308,-106
2018,4,6,20,1428,1421,1433,12
2018,4,6,21,1449,1441,1537,96
2018,4,6,22,1464,1462,1530,68
2018,4,6,23,1457,1463,1444,-19
2018,4,7,0,1461,1462,1425,-37
2018,4,7,1,1458,1467,1414,-53
2018,4,7,2,1490,1508,1449,-59
2018,4,7,3,1541,1584,1717,133
2018,4,7,4,1526,1534,1681,147
2018,4,7,5,1445,1452,1581,129
2018,4,7,6,1349,1362,1423,61
2018,4,7,7,1283,1293,1299,6
2018,4,7,8,1261,1255,1299,44
2018,4,7,9,1219,1219,1191,-28
2018,4,7,10,1201,1212,1128,-84
2018,4,7,11,1200,1215,1026,-189
2018,4,7,12,1224,1237,1066,-171
2018,4,7,13,1277,1297,1090,-207
2018,4,7,14,1299,1311,1077,-234
2018,4,7,15,1317,1311,1052,-259
2018,4,7,16,1362,1356,1103,-253
2018,4,7,17,1348,1345,1145,-200
2018,4,7,18,1348,1349,1179,-170
2018,4,7,19,1365,1361,1240,-121
2018,4,7,20,1380,1367,1391,24
2018,4,7,21,1399,1383,1511,128
2018,4,7,22,1439,1414,1261,-153
2018,4,7,23,1459,1450,1149,-301
2018,4,8,0,1496,1472,1192,-280
2018,4,8,1,1516,1495,1251,-244
2018,4,8,2,1564,1536,1237,-299
2018,4,8,3,1591,1589,1250,-339
2018,4,8,4,1557,1542,1268,-274
2018,4,8,5,1479,1466,1229,-237
2018,4,8,6,1391,1383,1238,-145
2018,4,8,7,1320,1315,1260,-55
2018,4,8,8,1243,1263,1232,-31
2018,4,8,9,1224,1227,1212,-15
2018,4,8,10,1219,1205,1200,-5
2018,4,8,11,1238,1209,1182,-27
2018,4,8,12,1298,1222,1146,-76
2018,4,8,13,1410,1244,1144,-100
2018,4,8,14,1467,1255,1160,-95
2018,4,8,15,1461,1298,1218,-80
2018,4,8,16,1437,1334,1295,-39
2018,4,8,17,1436,1366,1372,6
2018,4,8,18,1421,1384,1413,29
2018,4,8,19,1412,1393,1417,24
2018,4,8,20,1430,1393,1450,57
2018,4,8,21,1423,1421,1505,84
2018,4,8,22,1439,1440,1526,86
2018,4,8,23,1463,1453,1578,125
2018,4,9,0,1480,1484,1544,60
2018,4,9,1,1498,1501,1497,-4
2018,4,9,2,1560,1543,1488,-55
2018,4,9,3,1604,1595,1566,-29
2018,4,9,4,1560,1524,1418,-106
2018,4,9,5,1456,1415,1242,-173
2018,4,9,6,1369,1299,1053,-246
2018,4,9,7,1289,1238,1085,-153
2018,4,9,8,1245,1203,1090,-113
2018,4,9,9,1230,1185,1089,-96
2018,4,9,10,1231,1183,1074,-109
2018,4,9,11,1250,1190,931,-259
2018,4,9,12,1324,1292,1030,-262
2018,4,9,13,1448,1401,1096,-305
2018,4,9,14,1515,1428,1109,-319
2018,4,9,15,1511,1414,1038,-376
2018,4,9,16,1480,1396,1084,-312
2018,4,9,17,1470,1397,1243,-154
2018,4,9,18,1447,1392,1255,-137
2018,4,9,19,1435,1390,1279,-111
2018,4,9,20,1447,1402,1318,-84
2018,4,9,21,1446,1414,1276,-138
2018,4,9,22,1460,1430,1266,-164
2018,4,9,23,1487,1449,1231,-218
2018,4,10,0,1496,1469,1333,-136
2018,4,10,1,1508,1469,1529,60
2018,4,10,2,1570,1515,1585,70
2018,4,10,3,1614,1598,1754,156
2018,4,10,4,1571,1539,1757,218
2018,4,10,5,1467,1434,1619,185
2018,4,10,6,1375,1318,1502,184
2018,4,10,7,1294,1264,1358,94
2018,4,10,8,1260,1231,1176,-55
2018,4,10,9,1244,1220,1058,-162
2018,4,10,10,1245,1215,993,-222
2018,4,10,11,1266,1234,994,-240
2018,4,10,12,1338,1308,1033,-275
2018,4,10,13,1464,1430,1080,-350
2018,4,10,14,1534,1456,1079,-377
2018,4,10,15,1527,1453,1054,-399
2018,4,10,16,1492,1430,1085,-345
2018,4,10,17,1474,1417,1087,-330
2018,4,10,18,1450,1407,1107,-300
2018,4,10,19,1432,1410,1233,-177
2018,4,10,20,1451,1419,1304,-115
2018,4,10,21,1448,1439,1315,-124
2018,4,10,22,1462,1447,1348,-99
2018,4,10,23,1486,1484,1374,-110
2018,4,11,0,1494,1494,1363,-131
2018,4,11,1,1503,1476,1374,-102
2018,4,11,2,1568,1535,1244,-291
2018,4,11,3,1611,1607,1434,-173
2018,4,11,4,1575,1537,1378,-159
2018,4,11,5,1468,1425,1341,-84
2018,4,11,6,1377,1321,1242,-79
2018,4,11,7,1296,1256,1129,-127
2018,4,11,8,1255,1225,1123,-102
2018,4,11,9,1226,1201,1119,-82
2018,4,11,10,1216,1194,1166,-28
2018,4,11,11,1239,1214,1236,22
2018,4,11,12,1299,1278,1299,21
2018,4,11,13,1413,1390,1407,17
2018,4,11,14,1470,1428,1453,25
2018,4,11,15,1463,1394,1314,-80
2018,4,11,16,1457,1380,1367,-13
2018,4,11,17,1464,1387,1442,55
2018,4,11,18,1472,1399,1466,67
2018,4,11,19,1486,1425,1534,109
2018,4,11,20,1512,1463,1587,124
2018,4,11,21,1544,1493,1663,170
2018,4,11,22,1578,1515,1687,172
2018,4,11,23,1604,1533,1633,100
2018,4,12,0,1620,1543,1578,35
2018,4,12,1,1581,1521,1472,-49
2018,4,12,2,1576,1538,1366,-172
2018,4,12,3,1653,1614,1447,-167
2018,4,12,4,1613,1557,1393,-164
2018,4,12,5,1494,1441,1301,-140
2018,4,12,6,1383,1321,1343,22
2018,4,12,7,1317,1247,1355,108
2018,4,12,8,1260,1213,1289,76
2018,4,12,9,1238,1196,1205,9
2018,4,12,10,1226,1195,1242,47
2018,4,12,11,1236,1216,1286,70
2018,4,12,12,1311,1273,1367,94
2018,4,12,13,1406,1376,1426,50
2018,4,12,14,1465,1406,1406,0
2018,4,12,15,1447,1409,1352,-57
2018,4,12,16,1449,1426,1456,30
2018,4,12,17,1459,1448,1472,24
2018,4,12,18,1460,1451,1556,105
2018,4,12,19,1477,1486,1621,135
2018,4,12,20,1492,1504,1587,83
2018,4,12,21,1508,1526,1570,44
2018,4,12,22,1520,1524,1504,-20
2018,4,12,23,1552,1516,1418,-98
2018,4,13,0,1552,1511,1406,-105
2018,4,13,1,1549,1516,1408,-108
2018,4,13,2,1575,1550,1436,-114
2018,4,13,3,1638,1617,1556,-61
2018,4,13,4,1591,1552,1519,-33
2018,4,13,5,1483,1437,1402,-35
2018,4,13,6,1376,1328,1390,62
2018,4,13,7,1305,1266,1335,69
2018,4,13,8,1273,1227,1207,-20
2018,4,13,9,1248,1209,1157,-52
2018,4,13,10,1240,1209,1238,29
2018,4,13,11,1253,1116,1220,104
2018,4,13,12,1302,1295,1327,32
2018,4,13,13,1409,1412,1364,-48
2018,4,13,14,1482,1471,1399,-72
2018,4,13,15,1506,1493,1476,-17
2018,4,13,16,1495,1487,1483,-4
2018,4,13,17,1474,1470,1479,9
2018,4,13,18,1442,1453,1394,-59
2018,4,13,19,1433,1444,1421,-23
2018,4,13,20,1438,1422,1495,73
2018,4,13,21,1414,1397,1387,-10
2018,4,13,22,1411,1398,1499,101
2018,4,13,23,1398,1381,1463,82
2018,4,14,0,1407,1395,1431,36
2018,4,14,1,1424,1421,1325,-96
2018,4,14,2,1478,1484,1318,-166
2018,4,14,3,1562,1589,1452,-137
2018,4,14,4,1557,1568,1449,-119
2018,4,14,5,1504,1490,1361,-129
2018,4,14,6,1415,1403,1152,-251
2018,4,14,7,1354,1361,1076,-285
2018,4,14,8,1331,1323,985,-338
2018,4,14,9,1311,1307,968,-339
2018,4,14,10,1307,1298,958,-340
2018,4,14,11,1341,1307,984,-323
2018,4,14,12,1374,1340,1079,-261
2018,4,14,13,1429,1390,1091,-299
2018,4,14,14,1449,1410,1075,-335
2018,4,14,15,1452,1400,1041,-359
2018,4,14,16,1438,1384,1043,-341
2018,4,14,17,1422,1375,1064,-311
2018,4,14,18,1390,1342,1153,-189
2018,4,14,19,1364,1319,1143,-176
2018,4,14,20,1341,1297,1115,-182
2018,4,14,21,1328,1288,1149,-139
2018,4,14,22,1322,1300,1204,-96
2018,4,14,23,1320,1309,1252,-57
2018,4,15,0,1341,1342,1287,-55
2018,4,15,1,1380,1371,1285,-86
2018,4,15,2,1453,1422,1310,-112
2018,4,15,3,1528,1505,1304,-201
2018,4,15,4,1498,1474,1195,-279
2018,4,15,5,1425,1406,1163,-243
2018,4,15,6,1342,1336,1115,-221
2018,4,15,7,1290,1279,1125,-154
2018,4,15,8,1269,1242,1090,-152
2018,4,15,9,1255,1229,1097,-132
2018,4,15,10,1251,1229,998,-231
2018,4,15,11,1266,1241,946,-295
2018,4,15,12,1294,1275,938,-337
2018,4,15,13,1327,1313,961,-352
2018,4,15,14,1356,1332,1008,-324
2018,4,15,15,1361,1327,944,-383
2018,4,15,16,1367,1320,965,-355
2018,4,15,17,1348,1314,995,-319
2018,4,15,18,1334,1303,1022,-281
2018,4,15,19,1321,1299,1014,-285
2018,4,15,20,1317,1300,1002,-298
2018,4,15,21,1326,1305,1033,-272
2018,4,15,22,1344,1322,1059,-263
2018,4,15,23,1365,1358,1086,-272
2018,4,16,0,1394,1397,1101,-296
2018,4,16,1,1418,1425,1099,-326
2018,4,16,2,1482,1475,1087,-388
2018,4,16,3,1564,1551,1244,-307
2018,4,16,4,1546,1499,1221,-278
2018,4,16,5,1463,1405,1123,-282
2018,4,16,6,1366,1302,1116,-186
2018,4,16,7,1308,1236,1119,-117
2018,4,16,8,1245,1205,1084,-121
2018,4,16,9,1226,1187,1108,-79
2018,4,16,10,1226,1186,1151,-35
2018,4,16,11,1247,1216,1117,-99
2018,4,16,12,1303,1287,1160,-127
2018,4,16,13,1407,1399,1312,-87
2018,4,16,14,1471,1446,1336,-110
2018,4,16,15,1469,1441,1313,-128
2018,4,16,16,1471,1433,1379,-54
2018,4,16,17,1482,1445,1397,-48
2018,4,16,18,1473,1449,1382,-67
2018,4,16,19,1480,1455,1403,-52
2018,4,16,20,1503,1458,1431,-27
2018,4,16,21,1513,1463,1462,-1
2018,4,16,22,1470,1489,1511,22
2018,4,16,23,1486,1507,1546,39
2018,4,17,0,1523,1515,1500,-15
2018,4,17,1,1539,1509,1434,-75
2018,4,17,2,1569,1552,1481,-71
2018,4,17,3,1634,1607,1521,-86
2018,4,17,4,1610,1575,1538,-37
2018,4,17,5,1499,1431,1286,-145
2018,4,17,6,1389,1332,1265,-67
2018,4,17,7,1317,1274,1290,16
2018,4,17,8,1251,1239,1325,86
2018,4,17,9,1229,1215,1301,86
2018,4,17,10,1220,1210,1258,48
2018,4,17,11,1248,1219,1262,43
2018,4,17,12,1307,1297,1290,-7
2018,4,17,13,1414,1404,1413,9
2018,4,17,14,1465,1450,1454,4
2018,4,17,15,1470,1442,1483,41
2018,4,17,16,1468,1427,1443,16
2018,4,17,17,1455,1439,1529,90
2018,4,17,18,1456,1451,1625,174
2018,4,17,19,1461,1449,1621,172
2018,4,17,20,1459,1455,1581,126
2018,4,17,21,1463,1436,1341,-95
2018,4,17,22,1469,1435,1282,-153
2018,4,17,23,1468,1472,1519,47
2018,4,18,0,1480,1484,1490,6
2018,4,18,1,1495,1467,1448,-19
2018,4,18,2,1520,1502,1555,53
2018,4,18,3,1592,1592,1676,84
2018,4,18,4,1562,1533,1539,6
2018,4,18,5,1469,1435,1455,20
2018,4,18,6,1368,1313,1435,122
2018,4,18,7,1305,1281,1475,194
2018,4,18,8,1258,1232,1444,212
2018,4,18,9,1243,1216,1343,127
2018,4,18,10,1236,1217,1163,-54
2018,4,18,11,1277,1245,1092,-153
2018,4,18,12,1340,1338,1078,-260
2018,4,18,13,1445,1454,1193,-261
2018,4,18,14,1497,1499,1169,-330
2018,4,18,15,1495,1467,1136,-331
2018,4,18,16,1481,1428,1071,-357
2018,4,18,17,1470,1406,1064,-342
2018,4,18,18,1457,1380,1069,-311
2018,4,18,19,1452,1369,1070,-299
2018,4,18,20,1455,1374,1130,-244
2018,4,18,21,1458,1376,1181,-195
2018,4,18,22,1471,1400,1168,-232
2018,4,18,23,1485,1437,1212,-225
2018,4,19,0,1501,1445,1312,-133
2018,4,19,1,1498,1450,1379,-71
2018,4,19,2,1518,1488,1457,-31
2018,4,19,3,1587,1582,1589,7
2018,4,19,4,1569,1539,1572,33
2018,4,19,5,1476,1442,1418,-24
2018,4,19,6,1374,1335,1359,24
2018,4,19,7,1306,1287,1323,36
2018,4,19,8,1263,1245,1245,0
2018,4,19,9,1246,1222,1154,-68
2018,4,19,10,1247,1223,1115,-108
2018,4,19,11,1271,1248,1113,-135
2018,4,19,12,1339,1319,1203,-116
2018,4,19,13,1468,1425,1298,-127
2018,4,19,14,1535,1451,1266,-185
2018,4,19,15,1526,1435,1291,-144
2018,4,19,16,1489,1427,1401,-26
2018,4,19,17,1474,1426,1402,-24
2018,4,19,18,1453,1435,1513,78
2018,4,19,19,1437,1439,1585,146
2018,4,19,20,1453,1452,1640,188
2018,4,19,21,1449,1460,1644,184
2018,4,19,22,1463,1479,1578,99
2018,4,19,23,1483,1488,1574,86
2018,4,20,0,1495,1491,1539,48
2018,4,20,1,1506,1495,1501,6
2018,4,20,2,1566,1537,1527,-10
2018,4,20,3,1615,1616,1627,11
2018,4,20,4,1577,1562,1572,10
2018,4,20,5,1474,1455,1494,39
2018,4,20,6,1384,1358,1423,65
2018,4,20,7,1303,1301,1307,6
2018,4,20,8,1258,1264,1311,47
2018,4,20,9,1243,1233,1318,85
2018,4,20,10,1247,1223,1296,73
2018,4,20,11,1270,1246,1349,103
2018,4,20,12,1340,1316,1377,61
2018,4,20,13,1466,1411,1384,-27
2018,4,20,14,1533,1464,1460,-4
2018,4,20,15,1526,1464,1502,38
2018,4,20,16,1485,1445,1385,-60
2018,4,20,17,1468,1448,1399,-49
2018,4,20,18,1447,1442,1570,128
2018,4,20,19,1432,1412,1574,162
2018,4,20,20,1443,1409,1548,139
2018,4,20,21,1437,1406,1547,141
2018,4,20,22,1454,1413,1548,135
2018,4,20,23,1478,1413,1526,113
2018,4,21,0,1486,1414,1493,79
2018,4,21,1,1500,1408,1415,7
2018,4,21,2,1566,1439,1360,-79
2018,4,21,3,1614,1542,1463,-79
2018,4,21,4,1578,1504,1487,-17
2018,4,21,5,1479,1437,1421,-16
2018,4,21,6,1392,1361,1301,-60
2018,4,21,7,1312,1299,1261,-38
2018,4,21,8,1266,1270,1166,-104
2018,4,21,9,1252,1245,1169,-76
2018,4,21,10,1252,1236,1018,-218
2018,4,21,11,1274,1254,1040,-214
2018,4,21,12,1336,1283,1193,-90
2018,4,21,13,1451,1320,1240,-80
2018,4,21,14,1508,1360,1144,-216
2018,4,21,15,1500,1400,1217,-183
2018,4,21,16,1467,1427,1371,-56
2018,4,21,17,1453,1413,1419,6
2018,4,21,18,1431,1363,1319,-44
2018,4,21,19,1414,1338,1188,-150
2018,4,21,20,1428,1326,1103,-223
2018,4,21,21,1421,1317,1112,-205
2018,4,21,22,1436,1319,1131,-188
2018,4,21,23,1459,1351,1220,-131
2018,4,22,0,1472,1376,1239,-137
2018,4,22,1,1494,1393,1244,-149
2018,4,22,2,1559,1439,1255,-184
2018,4,22,3,1606,1518,1226,-292
2018,4,22,4,1564,1485,1315,-170
2018,4,22,5,1464,1410,1328,-82
2018,4,22,6,1385,1326,1286,-40
2018,4,22,7,1302,1267,1190,-77
2018,4,22,8,1265,1227,1018,-209
2018,4,22,9,1247,1216,1045,-171
2018,4,22,10,1248,1216,1014,-202
2018,4,22,11,1270,1225,959,-266
2018,4,22,12,1332,1256,953,-303
2018,4,22,13,1442,1289,964,-325
2018,4,22,14,1501,1309,945,-364
2018,4,22,15,1488,1321,922,-399
2018,4,22,16,1451,1318,979,-339
2018,4,22,17,1444,1320,984,-336
2018,4,22,18,1426,1320,1027,-293
2018,4,22,19,1411,1336,1060,-276
2018,4,22,20,1429,1351,1092,-259
2018,4,22,21,1423,1351,1051,-300
2018,4,22,22,1440,1370,1034,-336
2018,4,22,23,1464,1415,1056,-359
2018,4,23,0,1475,1448,1159,-289
2018,4,23,1,1494,1466,1190,-276
2018,4,23,2,1559,1499,1303,-196
2018,4,23,3,1604,1576,1374,-202
2018,4,23,4,1568,1522,1328,-194
2018,4,23,5,1470,1415,1143,-272
2018,4,23,6,1381,1310,1038,-272
2018,4,23,7,1298,1240,1036,-204
2018,4,23,8,1250,1209,1048,-161
2018,4,23,9,1234,1193,974,-219
2018,4,23,10,1232,1197,932,-265
2018,4,23,11,1258,1207,910,-297
2018,4,23,12,1327,1281,905,-376
2018,4,23,13,1455,1397,946,-451
2018,4,23,14,1523,1423,977,-446
2018,4,23,15,1518,1418,996,-422
2018,4,23,16,1488,1411,1048,-363
2018,4,23,17,1474,1416,1126,-290
2018,4,23,18,1457,1425,1152,-273
2018,4,23,19,1443,1447,1257,-190
2018,4,23,20,1461,1468,1285,-183
2018,4,23,21,1458,1495,1373,-122
2018,4,23,22,1478,1540,1463,-77
2018,4,23,23,1498,1568,1462,-106
2018,4,24,0,1506,1573,1391,-182
2018,4,24,1,1519,1582,1331,-251
2018,4,24,2,1576,1573,1337,-236
2018,4,24,3,1619,1653,1427,-226
2018,4,24,4,1576,1576,1387,-189
2018,4,24,5,1470,1465,1477,12
2018,4,24,6,1375,1342,1345,3
2018,4,24,7,1296,1278,1254,-24
2018,4,24,8,1255,1238,1206,-32
2018,4,24,9,1238,1218,1253,35
2018,4,24,10,1239,1205,1243,38
2018,4,24,11,1263,1221,1271,50
2018,4,24,12,1331,1267,1236,-31
2018,4,24,13,1455,1348,1229,-119
2018,4,24,14,1524,1400,1201,-199
2018,4,24,15,1516,1381,1164,-217
2018,4,24,16,1480,1382,1170,-212
2018,4,24,17,1468,1395,1300,-95
2018,4,24,18,1451,1417,1442,25
2018,4,24,19,1443,1438,1426,-12
2018,4,24,20,1461,1474,1548,74
2018,4,24,21,1462,1513,1686,173
2018,4,24,22,1475,1554,1682,128
2018,4,24,23,1501,1596,1707,111
2018,4,25,0,1510,1631,1727,96
2018,4,25,1,1520,1634,1740,106
2018,4,25,2,1580,1612,1763,151
2018,4,25,3,1619,1680,1919,239
2018,4,25,4,1577,1601,1821,220
2018,4,25,5,1472,1477,1744,267
2018,4,25,6,1384,1363,1635,272
2018,4,25,7,1299,1300,1527,227
2018,4,25,8,1255,1253,1489,236
2018,4,25,9,1239,1226,1478,252
2018,4,25,10,1240,1214,1419,205
2018,4,25,11,1263,1230,1391,161
2018,4,25,12,1335,1277,1393,116
2018,4,25,13,1463,1356,1439,83
2018,4,25,14,1533,1400,1452,52
2018,4,25,15,1526,1400,1432,32
2018,4,25,16,1489,1379,1376,-3
2018,4,25,17,1464,1380,1385,5
2018,4,25,18,1444,1375,1310,-65
2018,4,25,19,1435,1381,1303,-78
2018,4,25,20,1453,1394,1260,-134
2018,4,25,21,1443,1404,1281,-123
2018,4,25,22,1463,1467,1301,-166
2018,4,25,23,1482,1503,1338,-165
2018,4,26,0,1489,1531,1364,-167
2018,4,26,1,1513,1528,1387,-141
2018,4,26,2,1566,1533,1553,20
2018,4,26,3,1604,1633,1784,151
2018,4,26,4,1561,1579,1664,85
2018,4,26,5,1469,1452,1485,33
2018,4,26,6,1376,1336,1379,43
2018,4,26,7,1301,1267,1345,78
2018,4,26,8,1253,1230,1283,53
2018,4,26,9,1239,1213,1275,62
2018,4,26,10,1236,1204,1243,39
2018,4,26,11,1258,1218,1315,97
2018,4,26,12,1319,1284,1315,31
2018,4,26,13,1445,1372,1403,31
2018,4,26,14,1501,1409,1397,-12
2018,4,26,15,1483,1410,1389,-21
2018,4,26,16,1436,1417,1452,35
2018,4,26,17,1418,1428,1576,148
2018,4,26,18,1401,1446,1626,180
2018,4,26,19,1393,1460,1634,174
2018,4,26,20,1411,1489,1651,162
2018,4,26,21,1410,1518,1655,137
2018,4,26,22,1437,1546,1741,195
2018,4,26,23,1469,1577,1902,325
2018,4,27,0,1478,1589,1884,295
2018,4,27,1,1496,1581,1799,218
2018,4,27,2,1560,1570,1780,210
2018,4,27,3,1602,1636,1827,191
2018,4,27,4,1566,1561,1841,280
2018,4,27,5,1462,1448,1674,226
2018,4,27,6,1370,1340,1552,212
2018,4,27,7,1285,1272,1466,194
2018,4,27,8,1248,1223,1394,171
2018,4,27,9,1228,1201,1321,120
2018,4,27,10,1229,1196,1269,73
2018,4,27,11,1250,1217,1165,-52
2018,4,27,12,1308,1281,1152,-129
2018,4,27,13,1426,1364,1268,-96
2018,4,27,14,1495,1402,1252,-150
2018,4,27,15,1492,1405,1235,-170
2018,4,27,16,1455,1413,1252,-161
2018,4,27,17,1441,1412,1279,-133
2018,4,27,18,1423,1403,1318,-85
2018,4,27,19,1406,1411,1338,-73
2018,4,27,20,1423,1419,1400,-19
2018,4,27,21,1423,1439,1478,39
2018,4,27,22,1443,1457,1511,54
2018,4,27,23,1463,1490,1565,75
2018,4,28,0,1475,1499,1478,-21
2018,4,28,1,1488,1482,1475,-7
2018,4,28,2,1550,1485,1614,129
2018,4,28,3,1598,1580,1776,196
2018,4,28,4,1562,1559,1742,183
2018,4,28,5,1465,1462,1594,132
2018,4,28,6,1375,1367,1537,170
2018,4,28,7,1292,1298,1458,160
2018,4,28,8,1245,1252,1340,88
2018,4,28,9,1231,1221,1395,174
2018,4,28,10,1230,1209,1421,212
2018,4,28,11,1250,1208,1417,209
2018,4,28,12,1312,1234,1395,161
2018,4,28,13,1422,1242,1348,106
2018,4,28,14,1476,1273,1304,31
2018,4,28,15,1476,1312,1226,-86
2018,4,28,16,1449,1345,1209,-136
2018,4,28,17,1439,1369,1221,-148
2018,4,28,18,1421,1383,1270,-113
2018,4,28,19,1407,1407,1305,-102
2018,4,28,20,1423,1428,1332,-96
2018,4,28,21,1418,1460,1339,-121
2018,4,28,22,1436,1482,1392,-90
2018,4,28,23,1461,1507,1505,-2
2018,4,29,0,1474,1490,1518,28
2018,4,29,1,1496,1480,1546,66
2018,4,29,2,1554,1492,1592,100
2018,4,29,3,1595,1541,1553,12
2018,4,29,4,1558,1499,1400,-99
2018,4,29,5,1457,1413,1299,-114
2018,4,29,6,1372,1325,1259,-66
2018,4,29,7,1290,1259,1171,-88
2018,4,29,8,1250,1226,1115,-111
2018,4,29,9,1231,1195,1117,-78
2018,4,29,10,1229,1182,1139,-43
2018,4,29,11,1249,1177,1031,-146
2018,4,29,12,1308,1193,1024,-169
2018,4,29,13,1417,1201,1045,-156
2018,4,29,14,1467,1227,1081,-146
2018,4,29,15,1464,1262,1174,-88
2018,4,29,16,1437,1301,1441,140
2018,4,29,17,1426,1333,1457,124
2018,4,29,18,1411,1362,1438,76
2018,4,29,19,1404,1391,1526,135
2018,4,29,20,1423,1431,1655,224
2018,4,29,21,1424,1457,1699,242
2018,4,29,22,1447,1484,1706,222
2018,4,29,23,1472,1525,1791,266
2018,4,30,0,1487,1575,1783,208
2018,4,30,1,1505,1581,1822,241
2018,4,30,2,1555,1581,1778,197
2018,4,30,3,1596,1635,1859,224
2018,4,30,4,1568,1584,1829,245
2018,4,30,5,1467,1451,1735,284
2018,4,30,6,1375,1335,1628,293
2018,4,30,7,1289,1264,1548,284
2018,4,30,8,1247,1222,1433,211
2018,4,30,9,1231,1202,1380,178
2018,4,30,10,1229,1190,1325,135
2018,4,30,11,1250,1212,1326,114
2018,4,30,12,1317,1274,1321,47
2018,4,30,13,1439,1372,1286,-86
2018,4,30,14,1505,1420,1264,-156
2018,4,30,15,1498,1439,1248,-191
2018,4,30,16,1465,1446,1250,-196
2018,4,30,17,1453,1453,1432,-21
2018,4,30,18,1444,1456,1531,75
2018,4,30,19,1433,1455,1591,136
2018,4,30,20,1449,1480,1708,228
2018,4,30,21,1446,1495,1793,298
2018,4,30,22,1465,1529,1829,300
2018,4,30,23,1491,1557,1866,309
2018,5,1,0,1503,1548,1819,271
2018,5,1,1,1520,1512,1781,269
2018,5,1,2,1578,1559,1805,246
2018,5,1,3,1616,1624,1464,-160
2018,5,1,4,1574,1560,1479,-81
2018,5,1,5,1467,1441,1403,-38
2018,5,1,6,1375,1324,1276,-48
2018,5,1,7,1292,1260,1231,-29
2018,5,1,8,1265,1216,1134,-82
2018,5,1,9,1241,1205,1031,-174
2018,5,1,10,1229,1189,943,-246
2018,5,1,11,1242,1200,1000,-200
2018,5,1,12,1297,1279,1190,-89
2018,5,1,13,1393,1352,1404,52
2018,5,1,14,1457,1398,1422,24
2018,5,1,15,1475,1410,1509,99
2018,5,1,16,1478,1436,1561,125
2018,5,1,17,1478,1443,1539,96
2018,5,1,18,1489,1433,1547,114
2018,5,1,19,1493,1438,1582,144
2018,5,1,20,1512,1497,1624,127
2018,5,1,21,1531,1480,1594,114
2018,5,1,22,1548,1508,1615,107
2018,5,1,23,1568,1532,1627,95
2018,5,2,0,1579,1541,1646,105
2018,5,2,1,1584,1521,1557,36
2018,5,2,2,1596,1535,1533,-2
2018,5,2,3,1649,1606,1513,-93
2018,5,2,4,1611,1551,1480,-71
2018,5,2,5,1499,1470,1428,-42
2018,5,2,6,1378,1356,1307,-49
2018,5,2,7,1303,1282,1286,4
2018,5,2,8,1257,1260,1128,-132
2018,5,2,9,1236,1179,1046,-133
2018,5,2,10,1229,1221,1066,-155
2018,5,2,11,1244,1210,1100,-110
2018,5,2,12,1301,1268,1143,-125
2018,5,2,13,1405,1359,1244,-115
2018,5,2,14,1461,1398,1268,-130
2018,5,2,15,1473,1398,1176,-222
2018,5,2,16,1475,1417,1327,-90
2018,5,2,17,1476,1434,1415,-19
2018,5,2,18,1468,1429,1416,-13
2018,5,2,19,1456,1442,1517,75
2018,5,2,20,1469,1462,1559,97
2018,5,2,21,1460,1467,1652,185
2018,5,2,22,1472,1464,1638,174
2018,5,2,23,1498,1493,1730,237
2018,5,3,0,1504,1499,1691,192
2018,5,3,1,1514,1475,1632,157
2018,5,3,2,1549,1483,1580,97
2018,5,3,3,1608,1549,1702,153
2018,5,3,4,1573,1501,1630,129
2018,5,3,5,1479,1392,1557,165
2018,5,3,6,1370,1293,1462,169
2018,5,3,7,1302,1248,1372,124
2018,5,3,8,1266,1227,1219,-8
2018,5,3,9,1244,1219,1175,-44
2018,5,3,10,1241,1215,1155,-60
2018,5,3,11,1257,1218,1274,56
2018,5,3,12,1323,1303,1465,162
2018,5,3,13,1423,1409,1569,160
2018,5,3,14,1482,1441,1545,104
2018,5,3,15,1480,1440,1510,70
2018,5,3,16,1466,1437,1557,120
2018,5,3,17,1450,1444,1666,222
2018,5,3,18,1424,1430,1688,258
2018,5,3,19,1427,1434,1703,269
2018,5,3,20,1432,1435,1733,298
2018,5,3,21,1447,1438,1747,309
2018,5,3,22,1464,1454,1630,176
2018,5,3,23,1472,1457,1537,80
2018,5,4,0,1496,1462,1532,70
2018,5,4,1,1489,1456,1481,25
2018,5,4,2,1517,1469,1475,6
2018,5,4,3,1585,1553,1507,-46
2018,5,4,4,1564,1529,1408,-121
2018,5,4,5,1475,1425,1275,-150
2018,5,4,6,1376,1324,1195,-129
2018,5,4,7,1304,1262,1112,-150
2018,5,4,8,1267,1226,1086,-140
2018,5,4,9,1241,1205,1103,-102
2018,5,4,10,1234,1199,1089,-110
2018,5,4,11,1243,1219,1068,-151
2018,5,4,12,1295,1295,1046,-249
2018,5,4,13,1385,1389,1060,-329
2018,5,4,14,1442,1432,1013,-419
2018,5,4,15,1447,1417,1011,-406
2018,5,4,16,1438,1406,1052,-354
2018,5,4,17,1441,1398,1075,-323
2018,5,4,18,1439,1414,1089,-325
2018,5,4,19,1427,1400,1100,-300
2018,5,4,20,1440,1418,1210,-208
2018,5,4,21,1444,1441,1241,-200
2018,5,4,22,1448,1460,1245,-215
2018,5,4,23,1464,1483,1263,-220
2018,5,5,0,1479,1508,1207,-301
2018,5,5,1,1470,1509,1187,-322
2018,5,5,2,1480,1507,1217,-290
2018,5,5,3,1556,1588,1354,-234
2018,5,5,4,1552,1556,1367,-189
2018,5,5,5,1473,1467,1261,-206
2018,5,5,6,1377,1363,1187,-176
2018,5,5,7,1314,1296,1113,-183
2018,5,5,8,1272,1257,1050,-207
2018,5,5,9,1240,1236,964,-272
2018,5,5,10,1224,1216,958,-258
2018,5,5,11,1230,1222,951,-271
2018,5,5,12,1243,1250,985,-265
2018,5,5,13,1257,1263,1011,-252
2018,5,5,14,1293,1293,1026,-267
2018,5,5,15,1330,1313,1017,-296
2018,5,5,16,1357,1329,1071,-258
2018,5,5,17,1373,1347,1121,-226
2018,5,5,18,1392,1357,1118,-239
2018,5,5,19,1400,1370,1112,-258
2018,5,5,20,1421,1393,1151,-242
2018,5,5,21,1439,1425,1149,-276
2018,5,5,22,1470,1466,1171,-295
2018,5,5,23,1512,1503,1228,-275
2018,5,6,0,1550,1545,1273,-272
2018,5,6,1,1557,1564,1251,-313
2018,5,6,2,1551,1562,1269,-293
2018,5,6,3,1587,1587,1310,-277
2018,5,6,4,1584,1552,1318,-234
2018,5,6,5,1516,1442,1268,-174
2018,5,6,6,1406,1351,1225,-126
2018,5,6,7,1334,1282,1164,-118
2018,5,6,8,1271,1242,1146,-96
2018,5,6,9,1240,1215,1164,-51
2018,5,6,10,1216,1193,1090,-103
2018,5,6,11,1218,1190,1072,-118
2018,5,6,12,1221,1205,1121,-84
2018,5,6,13,1230,1213,1195,-18
2018,5,6,14,1257,1236,1213,-23
2018,5,6,15,1298,1277,1196,-81
2018,5,6,16,1335,1297,1257,-40
2018,5,6,17,1370,1314,1301,-13
2018,5,6,18,1407,1347,1255,-92
2018,5,6,19,1440,1393,1206,-187
2018,5,6,20,1484,1430,1256,-174
2018,5,6,21,1521,1473,1296,-177
2018,5,6,22,1569,1522,1292,-230
2018,5,6,23,1622,1577,1311,-266
2018,5,7,0,1657,1605,1379,-226
2018,5,7,1,1661,1623,1362,-261
2018,5,7,2,1650,1619,1378,-241
2018,5,7,3,1677,1673,1410,-263
2018,5,7,4,1647,1608,1426,-182
2018,5,7,5,1561,1488,1433,-55
2018,5,7,6,1427,1368,1375,7
2018,5,7,7,1337,1274,1358,84
2018,5,7,8,1291,1226,1174,-52
2018,5,7,9,1273,1199,1099,-100
2018,5,7,10,1261,1188,1164,-24
2018,5,7,11,1269,1199,1217,18
2018,5,7,12,1309,1261,1213,-48
2018,5,7,13,1387,1310,1219,-91
2018,5,7,14,1455,1394,1222,-172
2018,5,7,15,1488,1379,1217,-162
2018,5,7,16,1529,1438,1396,-42
2018,5,7,17,1577,1493,1524,31
2018,5,7,18,1630,1542,1416,-126
2018,5,7,19,1687,1584,1409,-175
2018,5,7,20,1743,1656,1455,-201
2018,5,7,21,1794,1707,1486,-221
2018,5,7,22,1849,1752,1519,-233
2018,5,7,23,1876,1779,1542,-237
2018,5,8,0,1865,1754,1482,-272
2018,5,8,1,1815,1727,1395,-332
2018,5,8,2,1779,1717,1412,-305
2018,5,8,3,1787,1778,1491,-287
2018,5,8,4,1742,1722,1461,-261
2018,5,8,5,1641,1571,1248,-323
2018,5,8,6,1502,1428,1087,-341
2018,5,8,7,1400,1349,1017,-332
2018,5,8,8,1368,1297,1008,-289
2018,5,8,9,1321,1256,1002,-254
2018,5,8,10,1302,1235,1062,-173
2018,5,8,11,1299,1260,1069,-191
2018,5,8,12,1346,1311,1085,-226
2018,5,8,13,1428,1383,1114,-269
2018,5,8,14,1493,1443,1135,-308
2018,5,8,15,1537,1492,1149,-343
2018,5,8,16,1592,1542,1223,-319
2018,5,8,17,1657,1594,1258,-336
2018,5,8,18,1724,1648,1286,-362
2018,5,8,19,1772,1695,1354,-341
2018,5,8,20,1842,1767,1407,-360
2018,5,8,21,1915,1822,1475,-347
2018,5,8,22,1969,1872,1591,-281
2018,5,8,23,2014,1918,1592,-326
2018,5,9,0,2014,1933,1585,-348
2018,5,9,1,1962,1913,1532,-381
2018,5,9,2,1932,1887,1532,-355
2018,5,9,3,1913,1888,1538,-350
2018,5,9,4,1838,1795,1470,-325
2018,5,9,5,1693,1638,1371,-267
2018,5,9,6,1544,1485,1326,-159
2018,5,9,7,1429,1382,1233,-149
2018,5,9,8,1365,1322,972,-350
2018,5,9,9,1308,1282,992,-290
2018,5,9,10,1289,1260,1006,-254
2018,5,9,11,1288,1257,1001,-256
2018,5,9,12,1339,1307,966,-341
2018,5,9,13,1420,1378,933,-445
2018,5,9,14,1483,1451,937,-514
2018,5,9,15,1515,1489,914,-575
2018,5,9,16,1570,1534,853,-681
2018,5,9,17,1651,1611,1004,-607
2018,5,9,18,1737,1672,1042,-630
2018,5,9,19,1789,1748,1171,-577
2018,5,9,20,1860,1823,1195,-628
2018,5,9,21,1936,1885,1204,-681
2018,5,9,22,1995,1906,1216,-690
2018,5,9,23,2057,1943,1289,-654
2018,5,10,0,2068,1970,1372,-598
2018,5,10,1,2018,1950,1308,-642
2018,5,10,2,1976,1908,1263,-645
2018,5,10,3,1946,1910,1221,-689
2018,5,10,4,1880,1817,1181,-636
2018,5,10,5,1731,1661,937,-724
2018,5,10,6,1575,1493,925,-568
2018,5,10,7,1462,1403,1034,-369
2018,5,10,8,1382,1333,1117,-216
2018,5,10,9,1329,1283,1110,-173
2018,5,10,10,1317,1267,1123,-144
2018,5,10,11,1321,1276,1121,-155
2018,5,10,12,1357,1328,1171,-157
2018,5,10,13,1443,1381,1103,-278
2018,5,10,14,1515,1461,1132,-329
2018,5,10,15,1557,1491,1243,-248
2018,5,10,16,1614,1547,1270,-277
2018,5,10,17,1684,1613,1302,-311
2018,5,10,18,1757,1688,1395,-293
2018,5,10,19,1824,1752,1547,-205
2018,5,10,20,1898,1810,1787,-23
2018,5,10,21,1966,1882,1803,-79
2018,5,10,22,2040,1944,1807,-137
2018,5,10,23,2093,2006,1850,-156
2018,5,11,0,2093,2025,1837,-188
2018,5,11,1,2049,1979,1763,-216
2018,5,11,2,2017,1929,1638,-291
2018,5,11,3,1981,1956,1624,-332
2018,5,11,4,1904,1875,1658,-217
2018,5,11,5,1764,1707,1540,-167
2018,5,11,6,1610,1549,1537,-12
2018,5,11,7,1492,1460,1483,23
2018,5,11,8,1409,1385,1414,29
2018,5,11,9,1359,1336,1299,-37
2018,5,11,10,1333,1313,1265,-48
2018,5,11,11,1330,1315,1182,-133
2018,5,11,12,1374,1363,1113,-250
2018,5,11,13,1455,1420,1203,-217
2018,5,11,14,1524,1489,1239,-250
2018,5,11,15,1572,1530,1236,-294
2018,5,11,16,1619,1591,1384,-207
2018,5,11,17,1681,1653,1439,-214
2018,5,11,18,1741,1732,1627,-105
2018,5,11,19,1784,1746,1656,-90
2018,5,11,20,1862,1799,1779,-20
2018,5,11,21,1926,1858,1849,-9
2018,5,11,22,1985,1908,1869,-39
2018,5,11,23,2018,1938,1909,-29
2018,5,12,0,2012,1936,1894,-42
2018,5,12,1,1963,1890,1861,-29
2018,5,12,2,1940,1796,1780,-16
2018,5,12,3,1922,1834,1751,-83
2018,5,12,4,1858,1787,1669,-118
2018,5,12,5,1744,1663,1552,-111
2018,5,12,6,1590,1524,1451,-73
2018,5,12,7,1481,1424,1230,-194
2018,5,12,8,1407,1343,1109,-234
2018,5,12,9,1353,1314,1127,-187
2018,5,12,10,1322,1281,1169,-112
2018,5,12,11,1316,1271,1127,-144
2018,5,12,12,1325,1276,1068,-208
2018,5,12,13,1355,1274,1109,-165
2018,5,12,14,1386,1324,1084,-240
2018,5,12,15,1436,1393,1239,-154
2018,5,12,16,1493,1454,1273,-181
2018,5,12,17,1552,1491,1239,-252
2018,5,12,18,1606,1533,1312,-221
2018,5,12,19,1649,1573,1453,-120
2018,5,12,20,1708,1632,1480,-152
2018,5,12,21,1763,1692,1521,-171
2018,5,12,22,1818,1733,1544,-189
2018,5,12,23,1856,1784,1519,-265
2018,5,13,0,1868,1793,1526,-267
2018,5,13,1,1834,1803,1506,-297
2018,5,13,2,1833,1751,1535,-216
2018,5,13,3,1810,1758,1568,-190
2018,5,13,4,1755,1697,1497,-200
2018,5,13,5,1656,1584,1388,-196
2018,5,13,6,1537,1473,1388,-85
2018,5,13,7,1441,1379,1435,56
2018,5,13,8,1343,1322,1459,137
2018,5,13,9,1290,1288,1419,131
2018,5,13,10,1255,1249,1303,54
2018,5,13,11,1248,1232,1254,22
2018,5,13,12,1253,1245,1263,18
2018,5,13,13,1258,1230,1248,18
2018,5,13,14,1300,1289,1262,-27
2018,5,13,15,1354,1340,1372,32
2018,5,13,16,1396,1395,1430,35
2018,5,13,17,1436,1431,1394,-37
2018,5,13,18,1485,1461,1442,-19
2018,5,13,19,1531,1502,1547,45
2018,5,13,20,1586,1546,1623,77
2018,5,13,21,1628,1600,1641,41
2018,5,13,22,1673,1648,1646,-2
2018,5,13,23,1728,1711,1670,-41
2018,5,14,0,1755,1738,1692,-46
2018,5,14,1,1742,1743,1675,-68
2018,5,14,2,1738,1698,1635,-63
2018,5,14,3,1751,1715,1687,-28
2018,5,14,4,1723,1681,1707,26
2018,5,14,5,1613,1579,1526,-53
2018,5,14,6,1484,1430,1505,75
2018,5,14,7,1383,1358,1485,127
2018,5,14,8,1302,1288,1461,173
2018,5,14,9,1268,1272,1331,59
2018,5,14,10,1255,1264,1169,-95
2018,5,14,11,1265,1261,1127,-134
2018,5,14,12,1313,1302,1154,-148
2018,5,14,13,1388,1380,1128,-252
2018,5,14,14,1456,1442,1174,-268
2018,5,14,15,1491,1471,1204,-267
2018,5,14,16,1521,1503,1281,-222
2018,5,14,17,1572,1617,1425,-192
2018,5,14,18,1610,1624,1377,-247
2018,5,14,19,1645,1666,1413,-253
2018,5,14,20,1697,1712,1469,-243
2018,5,14,21,1735,1767,1497,-270
2018,5,14,22,1783,1807,1525,-282
2018,5,14,23,1826,1846,1525,-321
2018,5,15,0,1841,1859,1412,-447
2018,5,15,1,1786,1808,1382,-426
2018,5,15,2,1767,1791,1326,-465
2018,5,15,3,1774,1838,1269,-569
2018,5,15,4,1739,1781,1230,-551
2018,5,15,5,1628,1616,1196,-420
2018,5,15,6,1486,1461,1210,-251
2018,5,15,7,1380,1366,1172,-194
2018,5,15,8,1306,1313,1226,-87
2018,5,15,9,1274,1272,1170,-102
2018,5,15,10,1256,1249,1108,-141
2018,5,15,11,1262,1260,1079,-181
2018,5,15,12,1312,1313,1111,-202
2018,5,15,13,1394,1382,1127,-255
2018,5,15,14,1459,1454,1113,-341
2018,5,15,15,1487,1488,1240,-248
2018,5,15,16,1520,1483,1253,-230
2018,5,15,17,1556,1513,1356,-157
2018,5,15,18,1595,1575,1380,-195
2018,5,15,19,1631,1628,1415,-213
2018,5,15,20,1690,1673,1377,-296
2018,5,15,21,1736,1745,1471,-274
2018,5,15,22,1785,1817,1653,-164
2018,5,15,23,1818,1875,1670,-205
2018,5,16,0,1816,1898,1638,-260
2018,5,16,1,1780,1863,1575,-288
2018,5,16,2,1764,1839,1480,-359
2018,5,16,3,1773,1867,1515,-352
2018,5,16,4,1718,1772,1397,-375
2018,5,16,5,1599,1595,1301,-294
2018,5,16,6,1468,1433,1339,-94
2018,5,16,7,1373,1344,1384,40
2018,5,16,8,1295,1292,1316,24
2018,5,16,9,1260,1259,1340,81
2018,5,16,10,1252,1239,1385,146
2018,5,16,11,1254,1251,1341,90
2018,5,16,12,1303,1302,1305,3
2018,5,16,13,1376,1367,1305,-62
2018,5,16,14,1439,1432,1200,-232
2018,5,16,15,1462,1456,1115,-341
2018,5,16,16,1490,1514,1110,-404
2018,5,16,17,1547,1559,1140,-419
2018,5,16,18,1603,1619,1222,-397
2018,5,16,19,1644,1669,1347,-322
2018,5,16,20,1702,1740,1375,-365
2018,5,16,21,1752,1789,1436,-353
2018,5,16,22,1802,1850,1577,-273
2018,5,16,23,1837,1914,1696,-218
2018,5,17,0,1864,1944,1649,-295
2018,5,17,1,1827,1929,1600,-329
2018,5,17,2,1804,1899,1539,-360
2018,5,17,3,1806,1905,1554,-351
2018,5,17,4,1761,1812,1551,-261
2018,5,17,5,1641,1641,1447,-194
2018,5,17,6,1496,1492,1381,-111
2018,5,17,7,1398,1398,1405,7
2018,5,17,8,1316,1334,1469,135
2018,5,17,9,1291,1292,1347,55
2018,5,17,10,1264,1269,1178,-91
2018,5,17,11,1264,1273,1089,-184
2018,5,17,12,1308,1325,1094,-231
2018,5,17,13,1386,1376,1151,-225
2018,5,17,14,1458,1443,1126,-317
2018,5,17,15,1484,1478,1098,-380
2018,5,17,16,1479,1528,1129,-399
2018,5,17,17,1507,1587,1216,-371
2018,5,17,18,1553,1652,1332,-320
2018,5,17,19,1600,1712,1574,-138
2018,5,17,20,1658,1766,1764,-2
2018,5,17,21,1735,1835,1837,2
2018,5,17,22,1820,1893,1929,36
2018,5,17,23,1891,1953,1951,-2
2018,5,18,0,1898,1964,1898,-66
2018,5,18,1,1870,1945,1837,-108
2018,5,18,2,1836,1910,1732,-178
2018,5,18,3,1829,1895,1697,-198
2018,5,18,4,1772,1814,1750,-64
2018,5,18,5,1651,1649,1632,-17
2018,5,18,6,1493,1494,1552,58
2018,5,18,7,1387,1396,1379,-17
2018,5,18,8,1325,1335,1335,0
2018,5,18,9,1280,1281,1233,-48
2018,5,18,10,1245,1259,1172,-87
2018,5,18,11,1250,1264,1159,-105
2018,5,18,12,1293,1308,1104,-204
2018,5,18,13,1363,1373,1179,-194
2018,5,18,14,1434,1440,1184,-256
2018,5,18,15,1466,1484,1195,-289
2018,5,18,16,1496,1560,1290,-270
2018,5,18,17,1542,1562,1371,-191
2018,5,18,18,1574,1603,1498,-105
2018,5,18,19,1590,1638,1524,-114
2018,5,18,20,1624,1673,1558,-115
2018,5,18,21,1655,1744,1653,-91
2018,5,18,22,1686,1817,1760,-57
2018,5,18,23,1716,1795,1709,-86
2018,5,19,0,1728,1788,1716,-72
2018,5,19,1,1699,1750,1637,-113
2018,5,19,2,1681,1699,1507,-192
2018,5,19,3,1705,1770,1542,-228
2018,5,19,4,1674,1736,1514,-222
2018,5,19,5,1579,1569,1387,-182
2018,5,19,6,1450,1429,1287,-142
2018,5,19,7,1363,1344,1220,-124
2018,5,19,8,1304,1281,1173,-108
2018,5,19,9,1261,1249,1194,-55
2018,5,19,10,1235,1232,1242,10
2018,5,19,11,1230,1235,1183,-52
2018,5,19,12,1242,1254,1189,-65
2018,5,19,13,1248,1253,1131,-122
2018,5,19,14,1283,1295,1060,-235
2018,5,19,15,1329,1340,1222,-118
2018,5,19,16,1363,1376,1245,-131
2018,5,19,17,1397,1417,1203,-214
2018,5,19,18,1439,1466,1244,-222
2018,5,19,19,1478,1543,1348,-195
2018,5,19,20,1513,1559,1321,-238
2018,5,19,21,1549,1613,1414,-199
2018,5,19,22,1585,1677,1439,-238
2018,5,19,23,1636,1725,1513,-212
2018,5,20,0,1666,1773,1565,-208
2018,5,20,1,1645,1759,1691,-68
2018,5,20,2,1645,1720,1578,-142
2018,5,20,3,1659,1725,1499,-226
2018,5,20,4,1640,1646,1480,-166
2018,5,20,5,1552,1496,1479,-17
2018,5,20,6,1447,1370,1493,123
2018,5,20,7,1350,1292,1471,179
2018,5,20,8,1296,1246,1539,293
2018,5,20,9,1263,1214,1487,273
2018,5,20,10,1231,1201,1398,197
2018,5,20,11,1221,1197,1350,153
2018,5,20,12,1230,1206,1360,154
2018,5,20,13,1235,1235,1402,167
2018,5,20,14,1267,1240,1389,149
2018,5,20,15,1312,1282,1410,128
2018,5,20,16,1342,1364,1453,89
2018,5,20,17,1380,1370,1410,40
2018,5,20,18,1428,1430,1379,-51
2018,5,20,19,1461,1478,1408,-70
2018,5,20,20,1499,1518,1412,-106
2018,5,20,21,1543,1578,1529,-49
2018,5,20,22,1582,1637,1471,-166
2018,5,20,23,1626,1711,1605,-106
2018,5,21,0,1659,1760,1728,-32
2018,5,21,1,1655,1750,1760,10
2018,5,21,2,1648,1722,1708,-14
2018,5,21,3,1670,1754,1762,8
2018,5,21,4,1646,1753,1720,-33
2018,5,21,5,1560,1575,1528,-47
2018,5,21,6,1421,1434,1362,-72
2018,5,21,7,1336,1350,1320,-30
2018,5,21,8,1285,1291,1159,-132
2018,5,21,9,1247,1248,1109,-139
2018,5,21,10,1234,1250,1117,-133
2018,5,21,11,1241,1267,1043,-224
2018,5,21,12,1290,1325,1048,-277
2018,5,21,13,1361,1388,1107,-281
2018,5,21,14,1427,1424,1251,-173
2018,5,21,15,1473,1506,1337,-169
2018,5,21,16,1505,1540,1378,-162
2018,5,21,17,1541,1584,1506,-78
2018,5,21,18,1586,1638,1616,-22
2018,5,21,19,1631,1712,1687,-25
2018,5,21,20,1671,1736,1751,15
2018,5,21,21,1710,1722,1720,-2
2018,5,21,22,1750,1653,1700,47
2018,5,21,23,1766,1639,1588,-51
2018,5,22,0,1771,1633,1554,-79
2018,5,22,1,1750,1615,1510,-105
2018,5,22,2,1729,1596,1580,-16
2018,5,22,3,1758,1639,1575,-64
2018,5,22,4,1695,1584,1641,57
2018,5,22,5,1544,1473,1451,-22
2018,5,22,6,1395,1351,1350,-1
2018,5,22,7,1308,1282,1356,74
2018,5,22,8,1248,1246,1348,102
2018,5,22,9,1215,1224,1340,116
2018,5,22,10,1203,1219,1347,128
2018,5,22,11,1218,1224,1367,143
2018,5,22,12,1267,1280,1391,111
2018,5,22,13,1352,1357,1330,-27
2018,5,22,14,1419,1418,1390,-28
2018,5,22,15,1458,1457,1344,-113
2018,5,22,16,1486,1473,1338,-135
2018,5,22,17,1532,1509,1422,-87
2018,5,22,18,1581,1546,1501,-45
2018,5,22,19,1613,1586,1584,-2
2018,5,22,20,1663,1621,1663,42
2018,5,22,21,1713,1692,1832,140
2018,5,22,22,1763,1719,1765,46
2018,5,22,23,1814,1763,1697,-66
2018,5,23,0,1819,1766,1767,1
2018,5,23,1,1790,1739,1772,33
2018,5,23,2,1769,1713,1702,-11
2018,5,23,3,1789,1727,1677,-50
2018,5,23,4,1746,1677,1644,-33
2018,5,23,5,1613,1548,1377,-171
2018,5,23,6,1469,1408,1383,-25
2018,5,23,7,1372,1334,1329,-5
2018,5,23,8,1296,1286,1392,106
2018,5,23,9,1267,1244,1351,107
2018,5,23,10,1240,1225,1278,53
2018,5,23,11,1261,1221,1244,23
2018,5,23,12,1314,1294,1230,-64
2018,5,23,13,1382,1361,1179,-182
2018,5,23,14,1446,1403,1282,-121
2018,5,23,15,1479,1453,1314,-139
2018,5,23,16,1512,1479,1317,-162
2018,5,23,17,1543,1536,1444,-92
2018,5,23,18,1597,1568,1536,-32
2018,5,23,19,1644,1601,1614,13
2018,5,23,20,1700,1658,1772,114
2018,5,23,21,1764,1711,1839,128
2018,5,23,22,1809,1779,1899,120
2018,5,23,23,1843,1811,1926,115
2018,5,24,0,1856,1895,1925,30
2018,5,24,1,1829,1816,1812,-4
2018,5,24,2,1800,1792,1850,58
2018,5,24,3,1813,1798,1887,89
2018,5,24,4,1764,1734,1921,187
2018,5,24,5,1625,1589,1747,158
2018,5,24,6,1476,1457,1575,118
2018,5,24,7,1380,1354,1583,229
2018,5,24,8,1323,1297,1462,165
2018,5,24,9,1275,1256,1409,153
2018,5,24,10,1259,1231,1454,223
2018,5,24,11,1256,1235,1428,193
2018,5,24,12,1318,1281,1367,86
2018,5,24,13,1388,1328,1380,52
2018,5,24,14,1453,1382,1359,-23
2018,5,24,15,1499,1427,1358,-69
2018,5,24,16,1531,1474,1383,-91
2018,5,24,17,1572,1520,1438,-82
2018,5,24,18,1634,1584,1481,-103
2018,5,24,19,1674,1645,1629,-16
2018,5,24,20,1736,1722,1684,-38
2018,5,24,21,1795,1805,1720,-85
2018,5,24,22,1843,1868,1733,-135
2018,5,24,23,1880,1933,1703,-230
2018,5,25,0,1905,1947,1723,-224
2018,5,25,1,1881,1927,1722,-205
2018,5,25,2,1837,1890,1677,-213
2018,5,25,3,1848,1885,1605,-280
2018,5,25,4,1784,1801,1638,-163
2018,5,25,5,1648,1663,1643,-20
2018,5,25,6,1506,1496,1588,92
2018,5,25,7,1418,1394,1457,63
2018,5,25,8,1353,1329,1454,125
2018,5,25,9,1310,1283,1547,264
2018,5,25,10,1293,1256,1557,301
2018,5,25,11,1282,1256,1604,348
2018,5,25,12,1326,1287,1578,291
2018,5,25,13,1386,1321,1583,262
2018,5,25,14,1454,1394,1452,58
2018,5,25,15,1504,1448,1388,-60
2018,5,25,16,1558,1505,1575,70
2018,5,25,17,1635,1576,1602,26
2018,5,25,18,1699,1655,1599,-56
2018,5,25,19,1757,1724,1643,-81
2018,5,25,20,1824,1799,1642,-157
2018,5,25,21,1894,1868,1671,-197
2018,5,25,22,1962,1930,1696,-234
2018,5,25,23,2010,1993,1711,-282
2018,5,26,0,2028,1991,1753,-238
2018,5,26,1,1983,1978,1713,-265
2018,5,26,2,1929,1930,1604,-326
2018,5,26,3,1928,1908,1590,-318
2018,5,26,4,1860,1835,1564,-271
2018,5,26,5,1735,1659,1547,-112
2018,5,26,6,1583,1515,1673,158
2018,5,26,7,1471,1414,1664,250
2018,5,26,8,1399,1328,1501,173
2018,5,26,9,1342,1285,1472,187
2018,5,26,10,1314,1251,1413,162
2018,5,26,11,1295,1243,1305,62
2018,5,26,12,1304,1250,1277,27
2018,5,26,13,1307,1251,1253,2
2018,5,26,14,1343,1297,1156,-141
2018,5,26,15,1414,1342,1172,-170
2018,5,26,16,1494,1399,1256,-143
2018,5,26,17,1572,1437,1294,-143
2018,5,26,18,1661,1501,1321,-180
2018,5,26,19,1738,1561,1389,-172
2018,5,26,20,1811,1619,1476,-143
2018,5,26,21,1887,1646,1623,-23
2018,5,26,22,1959,1676,1608,-68
2018,5,26,23,2010,1684,1591,-93
2018,5,27,0,2042,1707,1594,-113
2018,5,27,1,2025,1680,1500,-180
2018,5,27,2,1985,1648,1486,-162
2018,5,27,3,1943,1685,1501,-184
2018,5,27,4,1881,1655,1451,-204
2018,5,27,5,1763,1546,1431,-115
2018,5,27,6,1617,1427,1470,43
2018,5,27,7,1503,1349,1441,92
2018,5,27,8,1423,1303,1399,96
2018,5,27,9,1364,1263,1316,53
2018,5,27,10,1330,1246,1276,30
2018,5,27,11,1310,1232,1238,6
2018,5,27,12,1305,1226,1241,15
2018,5,27,13,1297,1212,1235,23
2018,5,27,14,1325,1305,1263,-42
2018,5,27,15,1385,1321,1193,-128
2018,5,27,16,1453,1382,1248,-134
2018,5,27,17,1531,1437,1264,-173
2018,5,27,18,1626,1499,1344,-155
2018,5,27,19,1701,1553,1348,-205
2018,5,27,20,1777,1619,1369,-250
2018,5,27,21,1846,1685,1478,-207
2018,5,27,22,1909,1744,1671,-73
2018,5,27,23,1971,1797,1717,-80
2018,5,28,0,2014,1848,1741,-107
2018,5,28,1,1992,1852,1691,-161
2018,5,28,2,1967,1814,1593,-221
2018,5,28,3,1936,1784,1607,-177
2018,5,28,4,1868,1734,1677,-57
2018,5,28,5,1737,1594,1640,46
2018,5,28,6,1592,1453,1589,136
2018,5,28,7,1480,1364,1512,148
2018,5,28,8,1350,1291,1435,144
2018,5,28,9,1305,1255,1321,66
2018,5,28,10,1274,1223,1228,5
2018,5,28,11,1260,1215,1213,-2
2018,5,28,12,1252,1237,1213,-24
2018,5,28,13,1242,1234,1208,-26
2018,5,28,14,1330,1271,1190,-81
2018,5,28,15,1382,1303,1180,-123
2018,5,28,16,1454,1390,1248,-142
2018,5,28,17,1522,1446,1319,-127
2018,5,28,18,1604,1509,1380,-129
2018,5,28,19,1679,1555,1432,-123
2018,5,28,20,1744,1620,1481,-139
2018,5,28,21,1819,1676,1533,-143
2018,5,28,22,1893,1746,1604,-142
2018,5,28,23,1947,1814,1614,-200
2018,5,29,0,1988,1868,1629,-239
2018,5,29,1,1939,1877,1543,-334
2018,5,29,2,1916,1838,1454,-384
2018,5,29,3,1876,1838,1403,-435
2018,5,29,4,1808,1767,1431,-336
2018,5,29,5,1673,1619,1305,-314
2018,5,29,6,1553,1474,1326,-148
2018,5,29,7,1447,1372,1294,-78
2018,5,29,8,1334,1307,1211,-96
2018,5,29,9,1298,1262,1149,-113
2018,5,29,10,1298,1235,1156,-79
2018,5,29,11,1293,1249,1156,-93
2018,5,29,12,1333,1284,1169,-115
2018,5,29,13,1405,1337,1099,-238
2018,5,29,14,1475,1411,1138,-273
2018,5,29,15,1529,1458,1170,-288
2018,5,29,16,1581,1514,1211,-303
2018,5,29,17,1650,1592,1399,-193
2018,5,29,18,1723,1656,1514,-142
2018,5,29,19,1792,1726,1557,-169
2018,5,29,20,1867,1796,1611,-185
2018,5,29,21,1945,1865,1658,-207
2018,5,29,22,2019,1948,1685,-263
2018,5,29,23,2084,2000,1729,-271
2018,5,30,0,2096,2030,1755,-275
2018,5,30,1,2047,2010,1709,-301
2018,5,30,2,2003,1958,1634,-324
2018,5,30,3,1994,1955,1520,-435
2018,5,30,4,1907,1873,1474,-399
2018,5,30,5,1755,1699,1266,-433
2018,5,30,6,1582,1527,1191,-336
2018,5,30,7,1477,1427,1157,-270
2018,5,30,8,1370,1353,1160,-193
2018,5,30,9,1324,1313,1146,-167
2018,5,30,10,1297,1296,1118,-178
2018,5,30,11,1300,1295,1097,-198
2018,5,30,12,1338,1322,1128,-194
2018,5,30,13,1394,1359,1135,-224
2018,5,30,14,1468,1420,1194,-226
2018,5,30,15,1528,1479,1237,-242
2018,5,30,16,1579,1560,1297,-263
2018,5,30,17,1652,1640,1262,-378
2018,5,30,18,1719,1736,1307,-429
2018,5,30,19,1779,1810,1436,-374
2018,5,30,20,1860,1872,1564,-308
2018,5,30,21,1917,1940,1663,-277
2018,5,30,22,1981,1992,1638,-354
2018,5,30,23,2012,2027,1625,-402
2018,5,31,0,2032,2019,1658,-361
2018,5,31,1,1999,2003,1594,-409
2018,5,31,2,1939,1951,1703,-248
2018,5,31,3,1947,1937,1665,-272
2018,5,31,4,1880,1857,1635,-222
2018,5,31,5,1738,1685,1524,-161
2018,5,31,6,1582,1529,1377,-152
2018,5,31,7,1457,1414,1308,-106
2018,5,31,8,1392,1356,1229,-127
2018,5,31,9,1335,1314,1233,-81
2018,5,31,10,1307,1290,1211,-79
2018,5,31,11,1312,1287,1227,-60
2018,5,31,12,1352,1330,1190,-140
2018,5,31,13,1419,1366,1178,-188
2018,5,31,14,1491,1444,1161,-283
2018,5,31,15,1532,1505,1267,-238
2018,5,31,16,1591,1574,1226,-348
2018,5,31,17,1673,1663,1315,-348
2018,5,31,18,1759,1757,1420,-337
2018,5,31,19,1823,1813,1523,-290
2018,5,31,20,1910,1895,1632,-263
2018,5,31,21,1988,1957,1769,-188
2018,5,31,22,2056,2042,1857,-185
2018,5,31,23,2104,2078,1910,-168
2018,6,1,0,2125,2111,1978,-133
2018,6,1,1,2094,2083,1874,-209
2018,6,1,2,2047,2026,1759,-267
2018,6,1,3,2026,2037,1825,-212
2018,6,1,4,1939,1908,1715,-193
2018,6,1,5,1783,1734,1616,-118
2018,6,1,6,1614,1583,1523,-60
2018,6,1,7,1496,1474,1447,-27
2018,6,1,8,1413,1407,1275,-132
2018,6,1,9,1351,1343,1167,-176
2018,6,1,10,1323,1308,1169,-139
2018,6,1,11,1319,1307,1217,-90
2018,6,1,12,1349,1336,1174,-162
2018,6,1,13,1403,1368,1172,-196
2018,6,1,14,1472,1448,1127,-321
2018,6,1,15,1534,1523,1256,-267
2018,6,1,16,1602,1599,1426,-173
2018,6,1,17,1680,1680,1467,-213
2018,6,1,18,1764,1747,1547,-200
2018,6,1,19,1824,1809,1655,-154
2018,6,1,20,1900,1878,1771,-107
2018,6,1,21,1974,1951,1782,-169
2018,6,1,22,2029,2017,1891,-126
2018,6,1,23,2079,2086,1970,-116
2018,6,2,0,2091,2096,1989,-107
2018,6,2,1,2046,2080,1936,-144
2018,6,2,2,2001,2001,1785,-216
2018,6,2,3,1976,1975,1685,-290
2018,6,2,4,1916,1889,1584,-305
2018,6,2,5,1778,1752,1492,-260
2018,6,2,6,1630,1601,1493,-108
2018,6,2,7,1506,1469,1348,-121
2018,6,2,8,1424,1391,1226,-165
2018,6,2,9,1366,1340,1092,-248
2018,6,2,10,1340,1305,989,-316
2018,6,2,11,1311,1288,1010,-278
2018,6,2,12,1315,1300,1024,-276
2018,6,2,13,1311,1289,1118,-171
2018,6,2,14,1355,1324,1196,-128
2018,6,2,15,1436,1380,1304,-76
2018,6,2,16,1533,1453,1457,4
2018,6,2,17,1623,1540,1496,-44
2018,6,2,18,1712,1640,1539,-101
2018,6,2,19,1787,1731,1601,-130
2018,6,2,20,1863,1812,1626,-186
2018,6,2,21,1925,1890,1701,-189
2018,6,2,22,2018,1961,1748,-213
2018,6,2,23,2054,2019,1753,-266
2018,6,3,0,2082,2055,1810,-245
2018,6,3,1,2057,2024,1830,-194
2018,6,3,2,2011,1958,1804,-154
2018,6,3,3,1966,1916,1780,-136
2018,6,3,4,1905,1862,1737,-125
2018,6,3,5,1783,1726,1643,-83
2018,6,3,6,1651,1605,1591,-14
2018,6,3,7,1519,1502,1476,-26
2018,6,3,8,1457,1427,1486,59
2018,6,3,9,1398,1377,1422,45
2018,6,3,10,1360,1337,1375,38
2018,6,3,11,1341,1321,1354,33
2018,6,3,12,1342,1318,1356,38
2018,6,3,13,1342,1307,1340,33
2018,6,3,14,1365,1341,1368,27
2018,6,3,15,1427,1426,1425,-1
2018,6,3,16,1501,1488,1505,17
2018,6,3,17,1568,1524,1636,112
2018,6,3,18,1635,1589,1648,59
2018,6,3,19,1699,1643,1680,37
2018,6,3,20,1751,1712,1746,34
2018,6,3,21,1792,1737,1696,-41
2018,6,3,22,1833,1681,1678,-3
2018,6,3,23,1832,1668,1624,-44
2018,6,4,0,1841,1649,1515,-134
2018,6,4,1,1823,1602,1565,-37
2018,6,4,2,1821,1582,1563,-19
2018,6,4,3,1818,1616,1615,-1
2018,6,4,4,1769,1597,1582,-15
2018,6,4,5,1657,1504,1495,-9
2018,6,4,6,1530,1389,1352,-37
2018,6,4,7,1427,1316,1193,-123
2018,6,4,8,1384,1276,1157,-119
2018,6,4,9,1336,1249,1141,-108
2018,6,4,10,1322,1235,1113,-122
2018,6,4,11,1320,1233,1081,-152
2018,6,4,12,1366,1283,1098,-185
2018,6,4,13,1427,1326,1171,-155
2018,6,4,14,1486,1397,1162,-235
2018,6,4,15,1543,1440,1212,-228
2018,6,4,16,1611,1499,1320,-179
2018,6,4,17,1690,1573,1449,-124
2018,6,4,18,1777,1646,1456,-190
2018,6,4,19,1843,1727,1448,-279
2018,6,4,20,1931,1784,1469,-315
2018,6,4,21,2004,1884,1570,-314
2018,6,4,22,2077,1960,1626,-334
2018,6,4,23,2122,2035,1702,-333
2018,6,5,0,2144,2057,1718,-339
2018,6,5,1,2093,2054,1684,-370
2018,6,5,2,2045,2014,1625,-389
2018,6,5,3,2006,1980,1598,-382
2018,6,5,4,1928,1890,1543,-347
2018,6,5,5,1767,1719,1460,-259
2018,6,5,6,1608,1553,1433,-120
2018,6,5,7,1492,1469,1427,-42
2018,6,5,8,1413,1360,1282,-78
2018,6,5,9,1365,1309,1201,-108
2018,6,5,10,1342,1287,1203,-84
2018,6,5,11,1336,1288,1192,-96
2018,6,5,12,1377,1324,1166,-158
2018,6,5,13,1443,1348,1137,-211
2018,6,5,14,1501,1436,1155,-281
2018,6,5,15,1571,1511,1143,-368
2018,6,5,16,1647,1589,1215,-374
2018,6,5,17,1734,1690,1329,-361
2018,6,5,18,1834,1786,1406,-380
2018,6,5,19,1912,1880,1477,-403
2018,6,5,20,1992,1976,1475,-501
2018,6,5,21,2055,2061,1639,-422
2018,6,5,22,2108,2139,1736,-403
2018,6,5,23,2146,2173,1809,-364
2018,6,6,0,2161,2176,1796,-380
2018,6,6,1,2121,2168,1702,-466
2018,6,6,2,2064,2115,1640,-475
2018,6,6,3,2033,2079,1546,-533
2018,6,6,4,1958,1990,1464,-526
2018,6,6,5,1797,1864,1419,-445
2018,6,6,6,1640,1637,1495,-142
2018,6,6,7,1512,1496,1539,43
2018,6,6,8,1458,1425,1523,98
2018,6,6,9,1392,1372,1519,147
2018,6,6,10,1364,1336,1477,141
2018,6,6,11,1364,1335,1450,115
2018,6,6,12,1398,1366,1423,57
2018,6,6,13,1448,1410,1345,-65
2018,6,6,14,1530,1490,1236,-254
2018,6,6,15,1603,1563,1249,-314
2018,6,6,16,1682,1663,1390,-273
2018,6,6,17,1789,1766,1461,-305
2018,6,6,18,1895,1864,1474,-390
2018,6,6,19,1958,1955,1536,-419
2018,6,6,20,2037,2057,1585,-472
2018,6,6,21,2105,2129,1669,-460
2018,6,6,22,2181,2213,1648,-565
2018,6,6,23,2230,2242,1546,-696
2018,6,7,0,2231,2197,1359,-838
2018,6,7,1,2189,2100,1266,-834
2018,6,7,2,2132,2006,1290,-716
2018,6,7,3,2105,1988,1425,-563
2018,6,7,4,2023,1923,1530,-393
2018,6,7,5,1863,1742,1447,-295
2018,6,7,6,1693,1599,1444,-155
2018,6,7,7,1556,1486,1289,-197
2018,6,7,8,1481,1415,1326,-89
2018,6,7,9,1423,1371,1307,-64
2018,6,7,10,1383,1338,1296,-42
2018,6,7,11,1382,1331,1287,-44
2018,6,7,12,1409,1369,1290,-79
2018,6,7,13,1450,1403,1281,-122
2018,6,7,14,1525,1508,1241,-267
2018,6,7,15,1604,1591,1180,-411
2018,6,7,16,1687,1676,1138,-538
2018,6,7,17,1793,1806,1086,-720
2018,6,7,18,1895,1896,1097,-799
2018,6,7,19,1971,1992,1133,-859
2018,6,7,20,2064,2086,1220,-866
2018,6,7,21,2148,2143,1378,-765
2018,6,7,22,2219,2212,1487,-725
2018,6,7,23,2263,2244,1518,-726
2018,6,8,0,2270,2223,1463,-760
2018,6,8,1,2219,2154,1415,-739
2018,6,8,2,2156,2102,1392,-710
2018,6,8,3,2144,2073,1454,-619
2018,6,8,4,2053,2004,1483,-521
2018,6,8,5,1883,1823,1310,-513
2018,6,8,6,1716,1660,1215,-445
2018,6,8,7,1582,1545,1200,-345
2018,6,8,8,1498,1463,1295,-168
2018,6,8,9,1434,1408,1271,-137
2018,6,8,10,1396,1375,1260,-115
2018,6,8,11,1391,1373,1241,-132
2018,6,8,12,1418,1391,1217,-174
2018,6,8,13,1463,1418,1169,-249
2018,6,8,14,1538,1506,1128,-378
2018,6,8,15,1615,1597,1162,-435
2018,6,8,16,1701,1700,1257,-443
2018,6,8,17,1815,1795,1324,-471
2018,6,8,18,1924,1909,1388,-521
2018,6,8,19,1995,1996,1477,-519
2018,6,8,20,2090,2076,1516,-560
2018,6,8,21,2169,2149,1581,-568
2018,6,8,22,2236,2203,1683,-520
2018,6,8,23,2269,2245,1742,-503
2018,6,9,0,2246,2255,1820,-435
2018,6,9,1,2194,2169,1858,-311
2018,6,9,2,2106,2087,1836,-251
2018,6,9,3,2078,2073,1752,-321
2018,6,9,4,2008,2014,1669,-345
2018,6,9,5,1865,1879,1548,-331
2018,6,9,6,1718,1695,1508,-187
2018,6,9,7,1584,1569,1515,-54
2018,6,9,8,1520,1482,1606,124
2018,6,9,9,1441,1414,1594,180
2018,6,9,10,1394,1380,1619,239
2018,6,9,11,1369,1364,1621,257
2018,6,9,12,1373,1368,1551,183
2018,6,9,13,1363,1369,1559,190
2018,6,9,14,1444,1432,1501,69
2018,6,9,15,1540,1523,1549,26
2018,6,9,16,1623,1628,1434,-194
2018,6,9,17,1730,1734,1497,-237
2018,6,9,18,1834,1815,1539,-276
2018,6,9,19,1920,1901,1550,-351
2018,6,9,20,1994,1976,1651,-325
2018,6,9,21,2076,2031,1691,-340
2018,6,9,22,2123,2079,1716,-363
2018,6,9,23,2147,2123,1778,-345
2018,6,10,0,2137,2127,1794,-333
2018,6,10,1,2087,2061,1805,-256
2018,6,10,2,2059,1995,1770,-225
2018,6,10,3,2014,1989,1692,-297
2018,6,10,4,1960,1937,1567,-370
2018,6,10,5,1835,1819,1541,-278
2018,6,10,6,1691,1693,1320,-373
2018,6,10,7,1580,1595,1221,-374
2018,6,10,8,1501,1526,1200,-326
2018,6,10,9,1444,1470,1149,-321
2018,6,10,10,1403,1436,1110,-326
2018,6,10,11,1378,1417,1095,-322
2018,6,10,12,1375,1412,1137,-275
2018,6,10,13,1355,1396,1133,-263
2018,6,10,14,1392,1445,1200,-245
2018,6,10,15,1478,1548,1176,-372
2018,6,10,16,1571,1633,1226,-407
2018,6,10,17,1669,1726,1345,-381
2018,6,10,18,1769,1819,1413,-406
2018,6,10,19,1863,1909,1519,-390
2018,6,10,20,1941,1971,1593,-378
2018,6,10,21,2010,2022,1675,-347
2018,6,10,22,2080,2086,1756,-330
2018,6,10,23,2134,2153,1802,-351
2018,6,11,0,2163,2192,1830,-362
2018,6,11,1,2140,2182,1793,-389
2018,6,11,2,2120,2127,1717,-410
2018,6,11,3,2091,2064,1638,-426
2018,6,11,4,2010,1993,1611,-382
2018,6,11,5,1867,1814,1409,-405
2018,6,11,6,1708,1643,1299,-344
2018,6,11,7,1587,1509,1178,-331
2018,6,11,8,1473,1442,1171,-271
2018,6,11,9,1418,1396,1210,-186
2018,6,11,10,1387,1361,1238,-123
2018,6,11,11,1378,1353,1179,-174
2018,6,11,12,1416,1374,1171,-203
2018,6,11,13,1462,1419,1232,-187
2018,6,11,14,1547,1506,1296,-210
2018,6,11,15,1622,1594,1366,-228
2018,6,11,16,1704,1682,1459,-223
2018,6,11,17,1806,1785,1349,-436
2018,6,11,18,1892,1891,1345,-546
2018,6,11,19,1978,1975,1480,-495
2018,6,11,20,2076,2015,1499,-516
2018,6,11,21,2153,2166,1556,-610
2018,6,11,22,2206,2243,1637,-606
2018,6,11,23,2249,2305,1692,-613
2018,6,12,0,2262,2331,1664,-667
2018,6,12,1,2208,2319,1610,-709
2018,6,12,2,2150,2255,1652,-603
2018,6,12,3,2123,2189,1627,-562
2018,6,12,4,2037,2086,1550,-536
2018,6,12,5,1881,1871,1408,-463
2018,6,12,6,1710,1705,1247,-458
2018,6,12,7,1584,1558,1060,-498
2018,6,12,8,1511,1457,990,-467
2018,6,12,9,1460,1395,1004,-391
2018,6,12,10,1419,1359,995,-364
2018,6,12,11,1409,1356,995,-361
2018,6,12,12,1434,1389,1018,-371
2018,6,12,13,1482,1433,1030,-403
2018,6,12,14,1566,1517,1060,-457
2018,6,12,15,1647,1603,1124,-479
2018,6,12,16,1744,1708,1165,-543
2018,6,12,17,1850,1822,1244,-578
2018,6,12,18,1964,1943,1329,-614
2018,6,12,19,2074,2049,1456,-593
2018,6,12,20,2176,2170,1616,-554
2018,6,12,21,2263,2273,1677,-596
2018,6,12,22,2327,2312,1728,-584
2018,6,12,23,2370,2364,1779,-585
2018,6,13,0,2370,2366,1873,-493
2018,6,13,1,2312,2328,1840,-488
2018,6,13,2,2256,2297,1815,-482
2018,6,13,3,2213,2233,1846,-387
2018,6,13,4,2126,2105,1789,-316
2018,6,13,5,1943,1898,1563,-335
2018,6,13,6,1761,1693,1463,-230
2018,6,13,7,1624,1566,1381,-185
2018,6,13,8,1552,1478,1343,-135
2018,6,13,9,1489,1422,1274,-148
2018,6,13,10,1451,1379,1316,-63
2018,6,13,11,1441,1378,1358,-20
2018,6,13,12,1471,1417,1318,-99
2018,6,13,13,1515,1455,1366,-89
2018,6,13,14,1603,1542,1430,-112
2018,6,13,15,1688,1638,1653,15
2018,6,13,16,1790,1750,1833,83
2018,6,13,17,1899,1873,1803,-70
2018,6,13,18,2014,1973,1800,-173
2018,6,13,19,2118,2053,1918,-135
2018,6,13,20,2214,2131,1956,-175
2018,6,13,21,2309,2196,1898,-298
2018,6,13,22,2366,2266,1811,-455
2018,6,13,23,2393,2303,1828,-475
2018,6,14,0,2364,2276,1828,-448
2018,6,14,1,2298,2214,1822,-392
2018,6,14,2,2239,2106,1750,-356
2018,6,14,3,2204,2064,1731,-333
2018,6,14,4,2125,1997,1616,-381
2018,6,14,5,1944,1849,1474,-375
2018,6,14,6,1762,1696,1328,-368
2018,6,14,7,1629,1576,1220,-356
2018,6,14,8,1550,1490,1132,-358
2018,6,14,9,1492,1438,1146,-292
2018,6,14,10,1450,1406,1141,-265
2018,6,14,11,1443,1411,1182,-229
2018,6,14,12,1475,1441,1228,-213
2018,6,14,13,1529,1481,1283,-198
2018,6,14,14,1598,1580,1259,-321
2018,6,14,15,1681,1669,1296,-373
2018,6,14,16,1776,1770,1413,-357
2018,6,14,17,1880,1868,1524,-344
2018,6,14,18,1988,1970,1503,-467
2018,6,14,19,2086,2079,1615,-464
2018,6,14,20,2176,2172,1679,-493
2018,6,14,21,2254,2276,1717,-559
2018,6,14,22,2307,2316,1816,-500
2018,6,14,23,2302,2219,1910,-309
2018,6,15,0,2264,2183,1987,-196
2018,6,15,1,2174,2111,1871,-240
2018,6,15,2,2121,2029,1837,-192
2018,6,15,3,2097,2049,1641,-408
2018,6,15,4,2006,1986,1485,-501
2018,6,15,5,1849,1835,1338,-497
2018,6,15,6,1685,1677,1321,-356
2018,6,15,7,1563,1560,1293,-267
2018,6,15,8,1479,1492,1355,-137
2018,6,15,9,1422,1434,1336,-98
2018,6,15,10,1385,1391,1238,-153
2018,6,15,11,1380,1380,1197,-183
2018,6,15,12,1410,1416,1210,-206
2018,6,15,13,1462,1454,1254,-200
2018,6,15,14,1535,1552,1257,-295
2018,6,15,15,1607,1658,1349,-309
2018,6,15,16,1710,1768,1324,-444
2018,6,15,17,1804,1880,1360,-520
2018,6,15,18,1910,1980,1399,-581
2018,6,15,19,1975,2072,1531,-541
2018,6,15,20,2057,2146,1611,-535
2018,6,15,21,2135,2174,1681,-493
2018,6,15,22,2166,2197,1756,-441
2018,6,15,23,2187,2224,1870,-354
2018,6,16,0,2168,2193,1989,-204
2018,6,16,1,2099,2100,1857,-243
2018,6,16,2,2036,2011,1542,-469
2018,6,16,3,2001,2026,1535,-491
2018,6,16,4,1948,2000,1541,-459
2018,6,16,5,1841,1863,1495,-368
2018,6,16,6,1702,1689,1422,-267
2018,6,16,7,1583,1587,1299,-288
2018,6,16,8,1519,1484,1269,-215
2018,6,16,9,1449,1436,1320,-116
2018,6,16,10,1405,1388,1233,-155
2018,6,16,11,1393,1365,1117,-248
2018,6,16,12,1399,1382,1058,-324
2018,6,16,13,1410,1395,1079,-316
2018,6,16,14,1435,1432,1091,-341
2018,6,16,15,1497,1474,1145,-329
2018,6,16,16,1560,1532,1199,-333
2018,6,16,17,1608,1558,1142,-416
2018,6,16,18,1668,1568,1119,-449
2018,6,16,19,1711,1578,1193,-385
2018,6,16,20,1722,1582,1272,-310
2018,6,16,21,1761,1581,1355,-226
2018,6,16,22,1791,1626,1439,-187
2018,6,16,23,1779,1655,1463,-192
2018,6,17,0,1781,1705,1502,-203
2018,6,17,1,1774,1660,1390,-270
2018,6,17,2,1764,1638,1389,-249
2018,6,17,3,1758,1658,1338,-320
2018,6,17,4,1722,1657,1258,-399
2018,6,17,5,1642,1574,1195,-379
2018,6,17,6,1539,1469,1182,-287
2018,6,17,7,1449,1394,1154,-240
2018,6,17,8,1379,1339,1039,-300
2018,6,17,9,1340,1303,998,-305
2018,6,17,10,1294,1279,983,-296
2018,6,17,11,1270,1275,956,-319
2018,6,17,12,1284,1284,964,-320
2018,6,17,13,1280,1274,933,-341
2018,6,17,14,1312,1314,916,-398
2018,6,17,15,1373,1368,948,-420
2018,6,17,16,1443,1425,972,-453
2018,6,17,17,1495,1454,1055,-399
2018,6,17,18,1545,1489,1196,-293
2018,6,17,19,1601,1542,1312,-230
2018,6,17,20,1649,1603,1390,-213
2018,6,17,21,1696,1657,1404,-253
2018,6,17,22,1744,1711,1428,-283
2018,6,17,23,1786,1758,1411,-347
2018,6,18,0,1847,1819,1391,-428
2018,6,18,1,1861,1814,1456,-358
2018,6,18,2,1834,1789,1346,-443
2018,6,18,3,1827,1792,1412,-380
2018,6,18,4,1786,1774,1645,-129
2018,6,18,5,1667,1666,1594,-72
2018,6,18,6,1521,1513,1445,-68
2018,6,18,7,1411,1416,1356,-60
2018,6,18,8,1321,1359,1261,-98
2018,6,18,9,1279,1305,1205,-100
2018,6,18,10,1255,1290,1121,-169
2018,6,18,11,1260,1282,1104,-178
2018,6,18,12,1303,1319,1140,-179
2018,6,18,13,1361,1352,1112,-240
2018,6,18,14,1441,1441,1078,-363
2018,6,18,15,1501,1523,1094,-429
2018,6,18,16,1584,1598,1135,-463
2018,6,18,17,1662,1661,1167,-494
2018,6,18,18,1741,1734,1369,-365
2018,6,18,19,1809,1811,1507,-304
2018,6,18,20,1876,1911,1524,-387
2018,6,18,21,1942,1992,1589,-403
2018,6,18,22,2007,2054,1636,-418
2018,6,18,23,2044,2113,1712,-401
2018,6,19,0,2082,2151,1701,-450
2018,6,19,1,2051,2135,1651,-484
2018,6,19,2,2002,2092,1566,-526
2018,6,19,3,1978,2054,1514,-540
2018,6,19,4,1909,1985,1559,-426
2018,6,19,5,1770,1811,1491,-320
2018,6,19,6,1615,1650,1397,-253
2018,6,19,7,1503,1529,1360,-169
2018,6,19,8,1444,1449,1245,-204
2018,6,19,9,1394,1406,1185,-221
2018,6,19,10,1361,1381,1141,-240
2018,6,19,11,1353,1380,1110,-270
2018,6,19,12,1386,1409,1103,-306
2018,6,19,13,1439,1448,1135,-313
2018,6,19,14,1519,1549,1115,-434
2018,6,19,15,1586,1627,1112,-515
2018,6,19,16,1663,1714,1118,-596
2018,6,19,17,1744,1802,1172,-630
2018,6,19,18,1811,1898,1242,-656
2018,6,19,19,1888,1974,1361,-613
2018,6,19,20,1967,2034,1414,-620
2018,6,19,21,2037,2118,1506,-612
2018,6,19,22,2090,2187,1579,-608
2018,6,19,23,2121,2255,1660,-595
2018,6,20,0,2158,2279,1717,-562
2018,6,20,1,2129,2266,1688,-578
2018,6,20,2,2081,2200,1551,-649
2018,6,20,3,2049,2126,1455,-671
2018,6,20,4,1980,2029,1453,-576
2018,6,20,5,1825,1819,1409,-410
2018,6,20,6,1655,1649,1321,-328
2018,6,20,7,1540,1519,1184,-335
2018,6,20,8,1471,1448,1085,-363
2018,6,20,9,1410,1394,1008,-386
2018,6,20,10,1376,1366,1077,-289
2018,6,20,11,1367,1360,1269,-91
2018,6,20,12,1398,1394,1297,-97
2018,6,20,13,1436,1430,1283,-147
2018,6,20,14,1511,1516,1391,-125
2018,6,20,15,1574,1581,1404,-177
2018,6,20,16,1646,1650,1333,-317
2018,6,20,17,1720,1759,1283,-476
2018,6,20,18,1812,1853,1347,-506
2018,6,20,19,1902,1960,1391,-569
2018,6,20,20,2014,2045,1422,-623
2018,6,20,21,2102,2145,1408,-737
2018,6,20,22,2176,2222,1456,-766
2018,6,20,23,2221,2305,1532,-773
2018,6,21,0,2252,2328,1597,-731
2018,6,21,1,2219,2313,1578,-735
2018,6,21,2,2161,2256,1536,-720
2018,6,21,3,2108,2192,1550,-642
2018,6,21,4,2043,2095,1489,-606
2018,6,21,5,1885,1893,1404,-489
2018,6,21,6,1721,1719,1287,-432
2018,6,21,7,1585,1576,1154,-422
2018,6,21,8,1492,1483,1146,-337
2018,6,21,9,1428,1426,1207,-219
2018,6,21,10,1392,1394,1173,-221
2018,6,21,11,1386,1388,1190,-198
2018,6,21,12,1420,1434,1196,-238
2018,6,21,13,1469,1475,1176,-299
2018,6,21,14,1553,1574,1172,-402
2018,6,21,15,1627,1678,1151,-527
2018,6,21,16,1717,1761,1197,-564
2018,6,21,17,1811,1883,1218,-665
2018,6,21,18,1918,1984,1288,-696
2018,6,21,19,1977,2090,1389,-701
2018,6,21,20,2064,2185,1440,-745
2018,6,21,21,2158,2266,1538,-728
2018,6,21,22,2244,2293,1602,-691
2018,6,21,23,2309,2352,1572,-780
2018,6,22,0,2335,2274,1483,-791
2018,6,22,1,2326,2333,1692,-641
2018,6,22,2,2248,2324,1648,-676
2018,6,22,3,2210,2257,1735,-522
2018,6,22,4,2131,2152,1823,-329
2018,6,22,5,1940,1977,1699,-278
2018,6,22,6,1761,1757,1630,-127
2018,6,22,7,1620,1629,1495,-134
2018,6,22,8,1578,1536,1349,-187
2018,6,22,9,1517,1480,1371,-109
2018,6,22,10,1478,1446,1440,-6
2018,6,22,11,1474,1432,1469,37
2018,6,22,12,1493,1473,1499,26
2018,6,22,13,1546,1513,1557,44
2018,6,22,14,1626,1613,1571,-42
2018,6,22,15,1733,1711,1673,-38
2018,6,22,16,1847,1816,1740,-76
2018,6,22,17,1962,1930,1723,-207
2018,6,22,18,2102,2028,1772,-256
2018,6,22,19,2216,2127,1807,-320
2018,6,22,20,2314,2237,1882,-355
2018,6,22,21,2406,2313,1972,-341
2018,6,22,22,2483,2343,2127,-216
2018,6,22,23,2523,2390,2135,-255
2018,6,23,0,2544,2393,2158,-235
2018,6,23,1,2486,2341,2133,-208
2018,6,23,2,2402,2313,2078,-235
2018,6,23,3,2340,2262,2057,-205
2018,6,23,4,2268,2162,2026,-136
2018,6,23,5,2085,1980,1850,-130
2018,6,23,6,1893,1782,1702,-80
2018,6,23,7,1740,1651,1543,-108
2018,6,23,8,1607,1547,1355,-192
2018,6,23,9,1521,1477,1267,-210
2018,6,23,10,1471,1427,1213,-214
2018,6,23,11,1448,1404,1207,-197
2018,6,23,12,1437,1406,1240,-166
2018,6,23,13,1424,1398,1181,-217
2018,6,23,14,1471,1470,1150,-320
2018,6,23,15,1576,1567,1184,-383
2018,6,23,16,1696,1679,1353,-326
2018,6,23,17,1803,1793,1519,-274
2018,6,23,18,1916,1898,1613,-285
2018,6,23,19,2019,1966,1665,-301
2018,6,23,20,2105,2054,1734,-320
2018,6,23,21,2191,2102,1800,-302
2018,6,23,22,2254,2237,1955,-282
2018,6,23,23,2296,2293,1970,-323
2018,6,24,0,2315,2323,2020,-303
2018,6,24,1,2275,2303,1977,-326
2018,6,24,2,2225,2248,1838,-410
2018,6,24,3,2172,2162,1744,-418
2018,6,24,4,2123,2077,1742,-335
2018,6,24,5,1971,1938,1662,-276
2018,6,24,6,1821,1741,1557,-184
2018,6,24,7,1684,1620,1446,-174
2018,6,24,8,1571,1548,1412,-136
2018,6,24,9,1493,1479,1465,-14
2018,6,24,10,1447,1430,1458,28
2018,6,24,11,1418,1412,1433,21
2018,6,24,12,1412,1394,1385,-9
2018,6,24,13,1390,1370,1329,-41
2018,6,24,14,1453,1439,1290,-149
2018,6,24,15,1547,1533,1353,-180
2018,6,24,16,1664,1640,1572,-68
2018,6,24,17,1766,1754,1703,-51
2018,6,24,18,1868,1855,1772,-83
2018,6,24,19,1971,1961,1857,-104
2018,6,24,20,2067,2057,1888,-169
2018,6,24,21,2144,2152,1907,-245
2018,6,24,22,2194,2221,2021,-200
2018,6,24,23,2244,2265,2027,-238
2018,6,25,0,2261,2302,2108,-194
2018,6,25,1,2221,2301,2111,-190
2018,6,25,2,2192,2252,1937,-315
2018,6,25,3,2147,2219,1908,-311
2018,6,25,4,2098,2104,1788,-316
2018,6,25,5,1963,1922,1739,-183
2018,6,25,6,1798,1749,1631,-118
2018,6,25,7,1650,1604,1528,-76
2018,6,25,8,1548,1510,1533,23
2018,6,25,9,1476,1442,1593,151
2018,6,25,10,1437,1403,1514,111
2018,6,25,11,1433,1399,1499,100
2018,6,25,12,1462,1439,1465,26
2018,6,25,13,1507,1478,1479,1
2018,6,25,14,1594,1573,1519,-54
2018,6,25,15,1680,1644,1516,-128
2018,6,25,16,1771,1727,1537,-190
2018,6,25,17,1889,1828,1537,-291
2018,6,25,18,1974,1920,1568,-352
2018,6,25,19,2070,2007,1606,-401
2018,6,25,20,2168,2103,1623,-480
2018,6,25,21,2246,2194,1685,-509
2018,6,25,22,2289,2225,1758,-467
2018,6,25,23,2355,2281,1879,-402
2018,6,26,0,2374,2311,1947,-364
2018,6,26,1,2355,2305,1979,-326
2018,6,26,2,2276,2292,1895,-397
2018,6,26,3,2241,2231,1911,-320
2018,6,26,4,2164,2117,2085,-32
2018,6,26,5,2001,1912,1847,-65
2018,6,26,6,1796,1716,1693,-23
2018,6,26,7,1670,1566,1625,59
2018,6,26,8,1574,1484,1439,-45
2018,6,26,9,1516,1423,1343,-80
2018,6,26,10,1486,1390,1283,-107
2018,6,26,11,1479,1379,1287,-92
2018,6,26,12,1498,1413,1365,-48
2018,6,26,13,1545,1454,1461,7
2018,6,26,14,1633,1549,1470,-79
2018,6,26,15,1736,1639,1403,-236
2018,6,26,16,1854,1737,1569,-168
2018,6,26,17,1966,1874,1671,-203
2018,6,26,18,2075,1992,1750,-242
2018,6,26,19,2189,2066,1883,-183
2018,6,26,20,2295,2188,1856,-332
2018,6,26,21,2389,2337,1847,-490
2018,6,26,22,2451,2391,1858,-533
2018,6,26,23,2503,2461,1905,-556
2018,6,27,0,2538,2471,1916,-555
2018,6,27,1,2494,2448,1916,-532
2018,6,27,2,2425,2382,1936,-446
2018,6,27,3,2385,2304,1869,-435
2018,6,27,4,2284,2189,1928,-261
2018,6,27,5,2082,1971,1747,-224
2018,6,27,6,1878,1773,1616,-157
2018,6,27,7,1726,1626,1740,114
2018,6,27,8,1598,1540,1689,149
2018,6,27,9,1531,1481,1558,77
2018,6,27,10,1495,1444,1434,-10
2018,6,27,11,1479,1424,1422,-2
2018,6,27,12,1499,1470,1386,-84
2018,6,27,13,1550,1502,1402,-100
2018,6,27,14,1635,1602,1477,-125
2018,6,27,15,1739,1698,1483,-215
2018,6,27,16,1856,1803,1595,-208
2018,6,27,17,1967,1901,1604,-297
2018,6,27,18,2098,2043,1658,-385
2018,6,27,19,2211,2160,1702,-458
2018,6,27,20,2307,2288,1648,-640
2018,6,27,21,2407,2401,1550,-851
2018,6,27,22,2477,2454,1532,-922
2018,6,27,23,2536,2455,1480,-975
2018,6,28,0,2563,2458,1574,-884
2018,6,28,1,2517,2434,1685,-749
2018,6,28,2,2446,2409,1753,-656
2018,6,28,3,2388,2340,1629,-711
2018,6,28,4,2283,2231,1619,-612
2018,6,28,5,2077,2035,1645,-390
2018,6,28,6,1869,1823,1614,-209
2018,6,28,7,1713,1685,1517,-168
2018,6,28,8,1608,1601,1493,-108
2018,6,28,9,1548,1514,1255,-259
2018,6,28,10,1508,1471,1134,-337
2018,6,28,11,1490,1460,1085,-375
2018,6,28,12,1519,1489,1169,-320
2018,6,28,13,1566,1525,1214,-311
2018,6,28,14,1657,1633,1187,-446
2018,6,28,15,1764,1716,1197,-519
2018,6,28,16,1887,1817,1339,-478
2018,6,28,17,2010,1939,1376,-563
2018,6,28,18,2135,2061,1369,-692
2018,6,28,19,2243,2190,1502,-688
2018,6,28,20,2346,2296,1520,-776
2018,6,28,21,2432,2389,1580,-809
2018,6,28,22,2490,2453,1663,-790
2018,6,28,23,2536,2482,1817,-665
2018,6,29,0,2541,2481,1905,-576
2018,6,29,1,2483,2437,1756,-681
2018,6,29,2,2423,2350,1644,-706
2018,6,29,3,2373,2297,1684,-613
2018,6,29,4,2279,2231,1811,-420
2018,6,29,5,2088,2042,1682,-360
2018,6,29,6,1876,1846,1706,-140
2018,6,29,7,1723,1720,1660,-60
2018,6,29,8,1631,1638,1627,-11
2018,6,29,9,1561,1580,1622,42
2018,6,29,10,1514,1537,1523,-14
2018,6,29,11,1510,1517,1536,19
2018,6,29,12,1533,1547,1515,-32
2018,6,29,13,1584,1573,1523,-50
2018,6,29,14,1682,1665,1521,-144
2018,6,29,15,1787,1776,1590,-186
2018,6,29,16,1911,1868,1700,-168
2018,6,29,17,2027,1954,1716,-238
2018,6,29,18,2144,2019,1737,-282
2018,6,29,19,2247,2095,1758,-337
2018,6,29,20,2350,2147,1792,-355
2018,6,29,21,2433,2190,1786,-404
2018,6,29,22,2462,2237,1809,-428
2018,6,29,23,2496,2234,1774,-460
2018,6,30,0,2469,2189,1701,-488
2018,6,30,1,2395,2126,1668,-458
2018,6,30,2,2323,2041,1522,-519
2018,6,30,3,2281,2047,1509,-538
2018,6,30,4,2203,2011,1570,-441
2018,6,30,5,2049,1870,1632,-238
2018,6,30,6,1864,1735,1648,-87
2018,6,30,7,1726,1642,1562,-80
2018,6,30,8,1613,1560,1534,-26
2018,6,30,9,1540,1503,1571,68
2018,6,30,10,1494,1458,1530,72
2018,6,30,11,1465,1440,1520,80
2018,6,30,12,1476,1433,1487,54
2018,6,30,13,1465,1423,1415,-8
2018,6,30,14,1521,1500,1389,-111
2018,6,30,15,1617,1592,1398,-194
2018,6,30,16,1733,1701,1580,-121
2018,6,30,17,1841,1796,1637,-159
2018,6,30,18,1953,1877,1695,-182
2018,6,30,19,2042,1953,1715,-238
2018,6,30,20,2137,2012,1591,-421
2018,6,30,21,2214,2041,1494,-547
2018,6,30,22,2283,2080,1542,-538
2018,6,30,23,2329,2127,1451,-676
2018,7,1,0,2362,2139,1371,-768
2018,7,1,1,2324,2097,1397,-700
2018,7,1,2,2270,2028,1328,-700
2018,7,1,3,2222,1982,1320,-662
2018,7,1,4,2134,1943,1441,-502
2018,7,1,5,1987,1799,1468,-331
2018,7,1,6,1820,1651,1510,-141
2018,7,1,7,1699,1537,1370,-167
2018,7,1,8,1506,1461,1314,-147
2018,7,1,9,1435,1407,1245,-162
2018,7,1,10,1389,1365,1278,-87
2018,7,1,11,1363,1344,1204,-140
2018,7,1,12,1351,1351,1292,-59
2018,7,1,13,1327,1331,1182,-149
2018,7,1,14,1385,1393,1245,-148
2018,7,1,15,1479,1477,1298,-179
2018,7,1,16,1583,1578,1274,-304
2018,7,1,17,1688,1677,1255,-422
2018,7,1,18,1786,1792,1345,-447
2018,7,1,19,1883,1901,1286,-615
2018,7,1,20,1963,1997,1369,-628
2018,7,1,21,2034,2091,1378,-713
2018,7,1,22,2118,2183,1388,-795
2018,7,1,23,2184,2242,1386,-856
2018,7,2,0,2225,2274,1424,-850
2018,7,2,1,2227,2270,1453,-817
2018,7,2,2,2182,2216,1386,-830
2018,7,2,3,2124,2142,1409,-733
2018,7,2,4,2061,2066,1457,-609
2018,7,2,5,1911,1887,1453,-434
2018,7,2,6,1743,1717,1353,-364
2018,7,2,7,1596,1586,1271,-315
2018,7,2,8,1537,1502,1234,-268
2018,7,2,9,1462,1439,1176,-263
2018,7,2,10,1423,1404,1174,-230
2018,7,2,11,1417,1408,1144,-264
2018,7,2,12,1442,1435,1083,-352
2018,7,2,13,1480,1473,1106,-367
2018,7,2,14,1577,1579,1207,-372
2018,7,2,15,1682,1667,1295,-372
2018,7,2,16,1789,1775,1406,-369
2018,7,2,17,1916,1878,1365,-513
2018,7,2,18,2007,1991,1354,-637
2018,7,2,19,2123,2078,1470,-608
2018,7,2,20,2214,2179,1589,-590
2018,7,2,21,2286,2258,1645,-613
2018,7,2,22,2325,2335,1740,-595
2018,7,2,23,2377,2385,1845,-540
2018,7,3,0,2391,2382,1799,-583
2018,7,3,1,2350,2334,1666,-668
2018,7,3,2,2289,2261,1632,-629
2018,7,3,3,2253,2221,1541,-680
2018,7,3,4,2170,2141,1551,-590
2018,7,3,5,2022,1969,1537,-432
2018,7,3,6,1807,1798,1452,-346
2018,7,3,7,1675,1706,1236,-470
2018,7,3,8,1578,1612,1308,-304
2018,7,3,9,1520,1540,1244,-296
2018,7,3,10,1484,1514,1192,-322
2018,7,3,11,1471,1500,1093,-407
2018,7,3,12,1500,1527,1083,-444
2018,7,3,13,1546,1561,1153,-408
2018,7,3,14,1626,1646,1191,-455
2018,7,3,15,1706,1713,1127,-586
2018,7,3,16,1804,1801,1214,-587
2018,7,3,17,1900,1890,1341,-549
2018,7,3,18,2007,1975,1422,-553
2018,7,3,19,2096,2079,1585,-494
2018,7,3,20,2180,2142,1644,-498
2018,7,3,21,2274,2222,1730,-492
2018,7,3,22,2335,2284,1713,-571
2018,7,3,23,2371,2323,1693,-630
2018,7,4,0,2372,2309,1591,-718
2018,7,4,1,2335,2270,1532,-738
2018,7,4,2,2282,2210,1590,-620
2018,7,4,3,2251,2145,1601,-544
2018,7,4,4,2155,2067,1599,-468
2018,7,4,5,1992,1910,1581,-329
2018,7,4,6,1818,1749,1575,-174
2018,7,4,7,1680,1630,1429,-201
2018,7,4,8,1615,1557,1205,-352
2018,7,4,9,1550,1473,1166,-307
2018,7,4,10,1506,1427,1128,-299
2018,7,4,11,1471,1420,1108,-312
2018,7,4,12,1471,1424,1090,-334
2018,7,4,13,1471,1426,1088,-338
2018,7,4,14,1507,1454,1071,-383
2018,7,4,15,1603,1518,1181,-337
2018,7,4,16,1710,1630,1239,-391
2018,7,4,17,1818,1764,1310,-454
2018,7,4,18,1929,1877,1407,-470
2018,7,4,19,2038,1997,1442,-555
2018,7,4,20,2136,2024,1464,-560
2018,7,4,21,2217,2065,1412,-653
2018,7,4,22,2274,2093,1471,-622
2018,7,4,23,2312,2115,1558,-557
2018,7,5,0,2322,2084,1689,-395
2018,7,5,1,2277,2019,1684,-335
2018,7,5,2,2239,1948,1685,-263
2018,7,5,3,2202,1925,1708,-217
2018,7,5,4,2118,1877,1754,-123
2018,7,5,5,1962,1812,1718,-94
2018,7,5,6,1823,1713,1662,-51
2018,7,5,7,1699,1650,1513,-137
2018,7,5,8,1596,1546,1158,-388
2018,7,5,9,1532,1495,1147,-348
2018,7,5,10,1502,1457,1201,-256
2018,7,5,11,1492,1449,1206,-243
2018,7,5,12,1525,1477,1236,-241
2018,7,5,13,1569,1509,1305,-204
2018,7,5,14,1657,1592,1338,-254
2018,7,5,15,1741,1700,1392,-308
2018,7,5,16,1836,1807,1492,-315
2018,7,5,17,1956,1925,1628,-297
2018,7,5,18,2047,2022,1702,-320
2018,7,5,19,2154,2100,1757,-343
2018,7,5,20,2234,2142,1757,-385
2018,7,5,21,2306,2183,1855,-328
2018,7,5,22,2317,2188,1816,-372
2018,7,5,23,2315,2175,1817,-358
2018,7,6,0,2269,2130,1767,-363
2018,7,6,1,2188,2024,1787,-237
2018,7,6,2,2158,1918,1740,-178
2018,7,6,3,2146,1898,1653,-245
2018,7,6,4,2072,1870,1687,-183
2018,7,6,5,1925,1763,1461,-302
2018,7,6,6,1763,1627,1351,-276
2018,7,6,7,1635,1527,1344,-183
2018,7,6,8,1544,1449,1301,-148
2018,7,6,9,1488,1414,1294,-120
2018,7,6,10,1448,1387,1276,-111
2018,7,6,11,1449,1386,1244,-142
2018,7,6,12,1480,1430,1163,-267
2018,7,6,13,1531,1468,1170,-298
2018,7,6,14,1607,1557,1177,-380
2018,7,6,15,1672,1656,1219,-437
2018,7,6,16,1755,1745,1292,-453
2018,7,6,17,1847,1839,1317,-522
2018,7,6,18,1927,1899,1443,-456
2018,7,6,19,2006,1958,1519,-439
2018,7,6,20,2071,2019,1587,-432
2018,7,6,21,2141,2058,1594,-464
2018,7,6,22,2180,2114,1642,-472
2018,7,6,23,2210,2149,1644,-505
2018,7,7,0,2201,2141,1700,-441
2018,7,7,1,2148,2106,1782,-324
2018,7,7,2,2098,2070,1783,-287
2018,7,7,3,2071,2071,1742,-329
2018,7,7,4,2009,2006,1765,-241
2018,7,7,5,1892,1882,1658,-224
2018,7,7,6,1753,1741,1462,-279
2018,7,7,7,1640,1636,1388,-248
2018,7,7,8,1547,1557,1178,-379
2018,7,7,9,1480,1503,1216,-287
2018,7,7,10,1444,1464,1192,-272
2018,7,7,11,1427,1451,1190,-261
2018,7,7,12,1422,1446,1112,-334
2018,7,7,13,1419,1447,1085,-362
2018,7,7,14,1462,1513,1143,-370
2018,7,7,15,1544,1612,1213,-399
2018,7,7,16,1635,1722,1239,-483
2018,7,7,17,1716,1823,1313,-510
2018,7,7,18,1790,1930,1380,-550
2018,7,7,19,1865,2012,1464,-548
2018,7,7,20,1942,2082,1566,-516
2018,7,7,21,2004,2137,1705,-432
2018,7,7,22,2044,2171,1663,-508
2018,7,7,23,2086,2142,1660,-482
2018,7,8,0,2078,2127,1630,-497
2018,7,8,1,2049,2114,1620,-494
2018,7,8,2,2015,2047,1534,-513
2018,7,8,3,1979,2009,1491,-518
2018,7,8,4,1931,1974,1625,-349
2018,7,8,5,1825,1845,1443,-402
2018,7,8,6,1691,1691,1275,-416
2018,7,8,7,1583,1582,1032,-550
2018,7,8,8,1506,1520,989,-531
2018,7,8,9,1452,1455,940,-515
2018,7,8,10,1415,1424,1015,-409
2018,7,8,11,1391,1389,953,-436
2018,7,8,12,1385,1393,897,-496
2018,7,8,13,1372,1367,918,-449
2018,7,8,14,1411,1415,1097,-318
2018,7,8,15,1493,1504,1166,-338
2018,7,8,16,1583,1624,1224,-400
2018,7,8,17,1677,1715,1308,-407
2018,7,8,18,1772,1823,1333,-490
2018,7,8,19,1853,1906,1414,-492
2018,7,8,20,1931,1965,1504,-461
2018,7,8,21,1998,2004,1522,-482
2018,7,8,22,2046,2063,1583,-480
2018,7,8,23,2085,2067,1663,-404
2018,7,9,0,2095,2090,1689,-401
2018,7,9,1,2061,2092,1756,-336
2018,7,9,2,2037,2064,1772,-292
2018,7,9,3,2009,2045,1703,-342
2018,7,9,4,1955,1982,1674,-308
2018,7,9,5,1832,1854,1540,-314
2018,7,9,6,1680,1679,1507,-172
2018,7,9,7,1563,1569,1409,-160
2018,7,9,8,1495,1493,1232,-261
2018,7,9,9,1443,1442,1205,-237
2018,7,9,10,1413,1420,1166,-254
2018,7,9,11,1414,1419,1152,-267
2018,7,9,12,1444,1460,1154,-306
2018,7,9,13,1506,1509,1158,-351
2018,7,9,14,1589,1597,1196,-401
2018,7,9,15,1658,1673,1308,-365
2018,7,9,16,1738,1759,1389,-370
2018,7,9,17,1820,1852,1518,-334
2018,7,9,18,1893,1931,1598,-333
2018,7,9,19,1959,2004,1655,-349
2018,7,9,20,2022,2061,1761,-300
2018,7,9,21,2077,2097,1844,-253
2018,7,9,22,2110,2146,1894,-252
2018,7,9,23,2126,2179,1866,-313
2018,7,10,0,2137,2202,1929,-273
2018,7,10,1,2098,2155,1897,-258
2018,7,10,2,2081,2100,1873,-227
2018,7,10,3,2054,2063,1855,-208
2018,7,10,4,1989,1987,1818,-169
2018,7,10,5,1851,1843,1637,-206
2018,7,10,6,1684,1653,1477,-176
2018,7,10,7,1563,1551,1289,-262
2018,7,10,8,1545,1482,1195,-287
2018,7,10,9,1486,1435,1200,-235
2018,7,10,10,1457,1413,1171,-242
2018,7,10,11,1444,1405,1142,-263
2018,7,10,12,1480,1443,1101,-342
2018,7,10,13,1532,1499,1147,-352
2018,7,10,14,1607,1605,1216,-389
2018,7,10,15,1685,1673,1275,-398
2018,7,10,16,1787,1764,1291,-473
2018,7,10,17,1875,1863,1345,-518
2018,7,10,18,1963,1955,1379,-576
2018,7,10,19,2051,2028,1459,-569
2018,7,10,20,2125,2093,1585,-508
2018,7,10,21,2200,2180,1683,-497
2018,7,10,22,2258,2241,1758,-483
2018,7,10,23,2287,2273,1792,-481
2018,7,11,0,2288,2268,1838,-430
2018,7,11,1,2242,2205,1829,-376
2018,7,11,2,2200,2130,1805,-325
2018,7,11,3,2167,2086,1738,-348
2018,7,11,4,2087,2020,1676,-344
2018,7,11,5,1939,1854,1560,-294
2018,7,11,6,1763,1679,1566,-113
2018,7,11,7,1643,1576,1493,-83
2018,7,11,8,1559,1507,1538,31
2018,7,11,9,1500,1460,1511,51
2018,7,11,10,1468,1420,1382,-38
2018,7,11,11,1461,1416,1390,-26
2018,7,11,12,1495,1459,1397,-62
2018,7,11,13,1553,1512,1476,-36
2018,7,11,14,1630,1603,1487,-116
2018,7,11,15,1707,1676,1561,-115
2018,7,11,16,1798,1767,1536,-231
2018,7,11,17,1891,1874,1563,-311
2018,7,11,18,1983,1966,1608,-358
2018,7,11,19,2064,2042,1690,-352
2018,7,11,20,2144,2127,1744,-383
2018,7,11,21,2210,2191,1890,-301
2018,7,11,22,2256,2235,1971,-264
2018,7,11,23,2274,2243,1946,-297
2018,7,12,0,2247,2152,1806,-346
2018,7,12,1,2194,2050,1774,-276
2018,7,12,2,2139,1970,1794,-176
2018,7,12,3,2107,1979,1803,-176
2018,7,12,4,2025,1938,1869,-69
2018,7,12,5,1882,1780,1720,-60
2018,7,12,6,1717,1617,1457,-160
2018,7,12,7,1606,1518,1413,-105
2018,7,12,8,1519,1451,1529,78
2018,7,12,9,1469,1410,1538,128
2018,7,12,10,1433,1394,1513,119
2018,7,12,11,1427,1395,1405,10
2018,7,12,12,1469,1451,1472,21
2018,7,12,13,1530,1505,1510,5
2018,7,12,14,1603,1567,1512,-55
2018,7,12,15,1675,1627,1521,-106
2018,7,12,16,1763,1708,1708,0
2018,7,12,17,1850,1787,1839,52
2018,7,12,18,1944,1857,1839,-18
2018,7,12,19,2022,1914,1750,-164
2018,7,12,20,2091,1976,1552,-424
2018,7,12,21,2152,2057,1493,-564
2018,7,12,22,2204,2127,1563,-564
2018,7,12,23,2198,2148,1634,-514
2018,7,13,0,2161,2148,1653,-495
2018,7,13,1,2100,2086,1556,-530
2018,7,13,2,2054,2028,1443,-585
2018,7,13,3,2028,2026,1344,-682
2018,7,13,4,1969,1971,1318,-653
2018,7,13,5,1835,1828,1180,-648
2018,7,13,6,1685,1669,1119,-550
2018,7,13,7,1567,1552,1073,-479
2018,7,13,8,1482,1477,1040,-437
2018,7,13,9,1437,1426,935,-491
2018,7,13,10,1404,1397,878,-519
2018,7,13,11,1398,1401,892,-509
2018,7,13,12,1428,1442,880,-562
2018,7,13,13,1483,1489,875,-614
2018,7,13,14,1560,1576,877,-699
2018,7,13,15,1630,1657,920,-737
2018,7,13,16,1714,1761,1201,-560
2018,7,13,17,1798,1829,1237,-592
2018,7,13,18,1877,1931,1291,-640
2018,7,13,19,1943,2023,1334,-689
2018,7,13,20,2011,2077,1578,-499
2018,7,13,21,2064,2136,1696,-440
2018,7,13,22,2103,2165,1700,-465
2018,7,13,23,2108,2149,1544,-605
2018,7,14,0,2086,2068,1481,-587
2018,7,14,1,2031,1999,1459,-540
2018,7,14,2,1969,1938,1544,-394
2018,7,14,3,1954,1964,1593,-371
2018,7,14,4,1908,1911,1506,-405
2018,7,14,5,1800,1794,1316,-478
2018,7,14,6,1659,1653,1256,-397
2018,7,14,7,1544,1552,1083,-469
2018,7,14,8,1498,1499,935,-564
2018,7,14,9,1441,1441,960,-481
2018,7,14,10,1407,1410,951,-459
2018,7,14,11,1384,1400,948,-452
2018,7,14,12,1386,1403,939,-464
2018,7,14,13,1380,1405,946,-459
2018,7,14,14,1428,1495,1034,-461
2018,7,14,15,1510,1588,1190,-398
2018,7,14,16,1607,1671,1290,-381
2018,7,14,17,1695,1777,1339,-438
2018,7,14,18,1774,1862,1355,-507
2018,7,14,19,1841,1940,1463,-477
2018,7,14,20,1906,2021,1488,-533
2018,7,14,21,1952,2064,1594,-470
2018,7,14,22,2008,2124,1667,-457
2018,7,14,23,2019,2134,1751,-383
2018,7,15,0,2007,2025,1668,-357
2018,7,15,1,2001,1920,1504,-416
2018,7,15,2,1965,1862,1476,-386
2018,7,15,3,1944,1869,1472,-397
2018,7,15,4,1912,1828,1487,-341
2018,7,15,5,1805,1725,1420,-305
2018,7,15,6,1669,1611,1341,-270
2018,7,15,7,1566,1526,1232,-294
2018,7,15,8,1511,1478,1046,-432
2018,7,15,9,1448,1425,990,-435
2018,7,15,10,1414,1370,958,-412
2018,7,15,11,1394,1361,912,-449
2018,7,15,12,1391,1361,970,-391
2018,7,15,13,1372,1351,915,-436
2018,7,15,14,1402,1427,988,-439
2018,7,15,15,1484,1513,1026,-487
2018,7,15,16,1590,1621,1145,-476
2018,7,15,17,1682,1711,1237,-474
2018,7,15,18,1769,1827,1323,-504
2018,7,15,19,1866,1914,1356,-558
2018,7,15,20,1932,1986,1445,-541
2018,7,15,21,1989,2063,1421,-642
2018,7,15,22,2075,2093,1491,-602
2018,7,15,23,2120,2123,1720,-403
2018,7,16,0,2119,2129,1767,-362
2018,7,16,1,2101,2076,1625,-451
2018,7,16,2,2064,2021,1475,-546
2018,7,16,3,2045,2009,1480,-529
2018,7,16,4,1988,1944,1368,-576
2018,7,16,5,1863,1814,1209,-605
2018,7,16,6,1706,1663,1271,-392
2018,7,16,7,1594,1568,1223,-345
2018,7,16,8,1525,1538,1177,-361
2018,7,16,9,1468,1469,1144,-325
2018,7,16,10,1441,1428,1087,-341
2018,7,16,11,1441,1433,1126,-307
2018,7,16,12,1474,1485,1182,-303
2018,7,16,13,1523,1531,1221,-310
2018,7,16,14,1614,1615,1283,-332
2018,7,16,15,1689,1675,1419,-256
2018,7,16,16,1777,1752,1585,-167
2018,7,16,17,1865,1839,1667,-172
2018,7,16,18,1958,1945,1749,-196
2018,7,16,19,2049,2026,1857,-169
2018,7,16,20,2117,2109,2007,-102
2018,7,16,21,2189,2156,2024,-132
2018,7,16,22,2239,2166,2044,-122
2018,7,16,23,2250,2137,1987,-150
2018,7,17,0,2219,2080,1984,-96
2018,7,17,1,2171,2005,1830,-175
2018,7,17,2,2120,1925,1666,-259
2018,7,17,3,2107,1954,1655,-299
2018,7,17,4,2041,1911,1678,-233
2018,7,17,5,1898,1780,1615,-165
2018,7,17,6,1733,1623,1563,-60
2018,7,17,7,1606,1527,1529,2
2018,7,17,8,1545,1467,1363,-104
2018,7,17,9,1482,1425,1322,-103
2018,7,17,10,1465,1394,1256,-138
2018,7,17,11,1463,1418,1250,-168
2018,7,17,12,1494,1450,1240,-210
2018,7,17,13,1540,1504,1237,-267
2018,7,17,14,1625,1599,1342,-257
2018,7,17,15,1716,1699,1434,-265
2018,7,17,16,1823,1783,1510,-273
2018,7,17,17,1919,1889,1621,-268
2018,7,17,18,2019,1980,1664,-316
2018,7,17,19,2119,2068,1732,-336
2018,7,17,20,2189,2138,1751,-387
2018,7,17,21,2261,2200,1843,-357
2018,7,17,22,2312,2255,1900,-355
2018,7,17,23,2350,2273,1886,-387
2018,7,18,0,2326,2269,1931,-338
2018,7,18,1,2273,2262,1941,-321
2018,7,18,2,2222,2190,1977,-213
2018,7,18,3,2195,2172,1968,-204
2018,7,18,4,2121,2088,1894,-194
2018,7,18,5,1960,1947,1642,-305
2018,7,18,6,1788,1744,1702,-42
2018,7,18,7,1651,1635,1651,16
2018,7,18,8,1562,1560,1599,39
2018,7,18,9,1504,1503,1565,62
2018,7,18,10,1472,1459,1542,83
2018,7,18,11,1467,1460,1497,37
2018,7,18,12,1494,1489,1516,27
2018,7,18,13,1541,1535,1607,72
2018,7,18,14,1635,1620,1642,22
2018,7,18,15,1723,1711,1707,-4
2018,7,18,16,1837,1837,1740,-97
2018,7,18,17,1946,1955,1795,-160
2018,7,18,18,2071,2070,1802,-268
2018,7,18,19,2177,2167,1786,-381
2018,7,18,20,2282,2271,1814,-457
2018,7,18,21,2361,2369,1837,-532
2018,7,18,22,2449,2408,1853,-555
2018,7,18,23,2459,2441,1878,-563
2018,7,19,0,2416,2420,1880,-540
2018,7,19,1,2368,2339,1764,-575
2018,7,19,2,2277,2299,1668,-631
2018,7,19,3,2264,2283,1703,-580
2018,7,19,4,2167,2193,1683,-510
2018,7,19,5,2007,2008,1600,-408
2018,7,19,6,1830,1821,1554,-267
2018,7,19,7,1686,1694,1415,-279
2018,7,19,8,1614,1595,1410,-185
2018,7,19,9,1565,1554,1392,-162
2018,7,19,10,1529,1506,1392,-114
2018,7,19,11,1525,1502,1424,-78
2018,7,19,12,1546,1531,1410,-121
2018,7,19,13,1588,1573,1398,-175
2018,7,19,14,1693,1672,1408,-264
2018,7,19,15,1783,1774,1457,-317
2018,7,19,16,1906,1890,1544,-346
2018,7,19,17,2029,2025,1600,-425
2018,7,19,18,2160,2141,1760,-381
2018,7,19,19,2264,2254,1823,-431
2018,7,19,20,2365,2344,1876,-468
2018,7,19,21,2457,2443,1990,-453
2018,7,19,22,2504,2397,1926,-471
2018,7,19,23,2528,2385,1912,-473
2018,7,20,0,2452,2371,1914,-457
2018,7,20,1,2372,2321,1916,-405
2018,7,20,2,2279,2280,1849,-431
2018,7,20,3,2274,2273,1826,-447
2018,7,20,4,2204,2192,1769,-423
2018,7,20,5,2046,2017,1536,-481
2018,7,20,6,1856,1833,1461,-372
2018,7,20,7,1731,1705,1428,-277
2018,7,20,8,1637,1621,1450,-171
2018,7,20,9,1576,1560,1460,-100
2018,7,20,10,1534,1527,1458,-69
2018,7,20,11,1524,1517,1440,-77
2018,7,20,12,1543,1554,1430,-124
2018,7,20,13,1595,1583,1468,-115
2018,7,20,14,1691,1669,1468,-201
2018,7,20,15,1798,1757,1461,-296
2018,7,20,16,1915,1888,1560,-328
2018,7,20,17,2037,2001,1469,-532
2018,7,20,18,2171,2160,1622,-538
2018,7,20,19,2284,2260,1690,-570
2018,7,20,20,2373,2351,1781,-570
2018,7,20,21,2458,2424,1857,-567
2018,7,20,22,2531,2447,1879,-568
2018,7,20,23,2543,2457,1912,-545
2018,7,21,0,2501,2438,1891,-547
2018,7,21,1,2434,2336,1763,-573
2018,7,21,2,2354,2301,1683,-618
2018,7,21,3,2334,2305,1631,-674
2018,7,21,4,2278,2190,1643,-547
2018,7,21,5,2129,2035,1550,-485
2018,7,21,6,1939,1869,1513,-356
2018,7,21,7,1800,1750,1442,-308
2018,7,21,8,1699,1662,1367,-295
2018,7,21,9,1623,1594,1342,-252
2018,7,21,10,1583,1544,1320,-224
2018,7,21,11,1553,1522,1267,-255
2018,7,21,12,1554,1512,1258,-254
2018,7,21,13,1538,1498,1279,-219
2018,7,21,14,1601,1565,1287,-278
2018,7,21,15,1720,1696,1304,-392
2018,7,21,16,1854,1823,1331,-492
2018,7,21,17,1965,1937,1352,-585
2018,7,21,18,2099,2068,1390,-678
2018,7,21,19,2196,2175,1545,-630
2018,7,21,20,2296,2268,1617,-651
2018,7,21,21,2378,2347,1683,-664
2018,7,21,22,2429,2418,1702,-716
2018,7,21,23,2467,2455,1734,-721
2018,7,22,0,2443,2483,1769,-714
2018,7,22,1,2405,2440,1788,-652
2018,7,22,2,2332,2382,1751,-631
2018,7,22,3,2314,2307,1693,-614
2018,7,22,4,2244,2208,1720,-488
2018,7,22,5,2098,2046,1674,-372
2018,7,22,6,1939,1860,1668,-192
2018,7,22,7,1803,1729,1610,-119
2018,7,22,8,1694,1615,1411,-204
2018,7,22,9,1620,1560,1267,-293
2018,7,22,10,1578,1507,1228,-279
2018,7,22,11,1544,1479,1214,-265
2018,7,22,12,1540,1465,1185,-280
2018,7,22,13,1508,1448,1168,-280
2018,7,22,14,1566,1505,1154,-351
2018,7,22,15,1687,1628,1182,-446
2018,7,22,16,1821,1757,1287,-470
2018,7,22,17,1952,1888,1395,-493
2018,7,22,18,2102,2023,1538,-485
2018,7,22,19,2213,2157,1644,-513
2018,7,22,20,2321,2256,1720,-536
2018,7,22,21,2387,2365,1721,-644
2018,7,22,22,2434,2453,1759,-694
2018,7,22,23,2493,2527,1735,-792
2018,7,23,0,2477,2550,1739,-811
2018,7,23,1,2445,2518,1741,-777
2018,7,23,2,2377,2465,1691,-774
2018,7,23,3,2373,2373,1717,-656
2018,7,23,4,2311,2289,1747,-542
2018,7,23,5,2145,2085,1635,-450
2018,7,23,6,1961,1911,1575,-336
2018,7,23,7,1813,1765,1403,-362
2018,7,23,8,1674,1669,1274,-395
2018,7,23,9,1614,1605,1380,-225
2018,7,23,10,1581,1591,1448,-143
2018,7,23,11,1578,1591,1459,-132
2018,7,23,12,1595,1630,1415,-215
2018,7,23,13,1629,1690,1449,-241
2018,7,23,14,1735,1804,1479,-325
2018,7,23,15,1842,1915,1577,-338
2018,7,23,16,1980,1999,1678,-321
2018,7,23,17,2096,2107,1805,-302
2018,7,23,18,2232,2218,1912,-306
2018,7,23,19,2344,2301,1967,-334
2018,7,23,20,2451,2393,2015,-378
2018,7,23,21,2537,2473,2052,-421
2018,7,23,22,2566,2550,2109,-441
2018,7,23,23,2565,2565,2174,-391
2018,7,24,0,2498,2602,2271,-331
2018,7,24,1,2410,2549,2231,-318
2018,7,24,2,2323,2404,2149,-255
2018,7,24,3,2317,2270,2075,-195
2018,7,24,4,2248,2112,1979,-133
2018,7,24,5,2076,1927,1904,-23
2018,7,24,6,1889,1761,1813,52
2018,7,24,7,1746,1658,1737,79
2018,7,24,8,1639,1585,1718,133
2018,7,24,9,1583,1549,1709,160
2018,7,24,10,1556,1517,1602,85
2018,7,24,11,1552,1510,1530,20
2018,7,24,12,1586,1555,1550,-5
2018,7,24,13,1646,1608,1554,-54
2018,7,24,14,1720,1693,1568,-125
2018,7,24,15,1810,1771,1602,-169
2018,7,24,16,1907,1864,1667,-197
2018,7,24,17,2009,1954,1731,-223
2018,7,24,18,2127,2041,1774,-267
2018,7,24,19,2219,2128,1903,-225
2018,7,24,20,2306,2222,1952,-270
2018,7,24,21,2390,2296,2026,-270
2018,7,24,22,2452,2361,2111,-250
2018,7,24,23,2463,2429,2188,-241
2018,7,25,0,2409,2424,2258,-166
2018,7,25,1,2352,2347,2243,-104
2018,7,25,2,2273,2261,2119,-142
2018,7,25,3,2255,2232,2075,-157
2018,7,25,4,2192,2090,2090,0
2018,7,25,5,2034,1889,2056,167
2018,7,25,6,1866,1721,1954,233
2018,7,25,7,1738,1645,1914,269
2018,7,25,8,1621,1580,1866,286
2018,7,25,9,1553,1523,1812,289
2018,7,25,10,1525,1497,1779,282
2018,7,25,11,1516,1495,1667,172
2018,7,25,12,1539,1543,1674,131
2018,7,25,13,1605,1586,1709,123
2018,7,25,14,1683,1682,1756,74
2018,7,25,15,1773,1764,1766,2
2018,7,25,16,1860,1855,1786,-69
2018,7,25,17,1966,1928,1908,-20
2018,7,25,18,2087,2031,1989,-42
2018,7,25,19,2185,2129,2068,-61
2018,7,25,20,2282,2226,2186,-40
2018,7,25,21,2387,2298,2211,-87
2018,7,25,22,2455,2348,2179,-169
2018,7,25,23,2484,2380,2136,-244
2018,7,26,0,2460,2371,2253,-118
2018,7,26,1,2419,2311,2244,-67
2018,7,26,2,2362,2255,2188,-67
2018,7,26,3,2318,2226,2095,-131
2018,7,26,4,2218,2133,2082,-51
2018,7,26,5,2050,1974,1943,-31
2018,7,26,6,1866,1816,1896,80
2018,7,26,7,1746,1685,1839,154
2018,7,26,8,1633,1616,1729,113
2018,7,26,9,1569,1571,1815,244
2018,7,26,10,1529,1537,1848,311
2018,7,26,11,1525,1528,1783,255
2018,7,26,12,1564,1564,1763,199
2018,7,26,13,1621,1605,1792,187
2018,7,26,14,1689,1675,1914,239
2018,7,26,15,1777,1755,1981,226
2018,7,26,16,1883,1841,2026,185
2018,7,26,17,1995,1931,2097,166
2018,7,26,18,2110,2019,2171,152
2018,7,26,19,2227,2105,2270,165
2018,7,26,20,2295,2218,2341,123
2018,7,26,21,2373,2300,2362,62
2018,7,26,22,2410,2339,2213,-126
2018,7,26,23,2432,2320,2192,-128
2018,7,27,0,2383,2285,2188,-97
2018,7,27,1,2300,2180,2238,58
2018,7,27,2,2220,2093,2180,87
2018,7,27,3,2181,1943,2018,75
2018,7,27,4,2078,1869,1969,100
2018,7,27,5,1922,1718,1863,145
2018,7,27,6,1762,1596,1829,233
2018,7,27,7,1675,1530,1717,187
2018,7,27,8,1558,1452,1658,206
2018,7,27,9,1505,1411,1639,228
2018,7,27,10,1469,1392,1523,131
2018,7,27,11,1473,1395,1462,67
2018,7,27,12,1502,1457,1502,45
2018,7,27,13,1567,1508,1568,60
2018,7,27,14,1641,1589,1570,-19
2018,7,27,15,1701,1649,1554,-95
2018,7,27,16,1778,1731,1653,-78
2018,7,27,17,1882,1818,1837,19
2018,7,27,18,1978,1895,1987,92
2018,7,27,19,2074,1998,2018,20
2018,7,27,20,2137,2070,2069,-1
2018,7,27,21,2202,2092,2080,-12
2018,7,27,22,2240,2097,2062,-35
2018,7,27,23,2274,2116,2016,-100
2018,7,28,0,2229,2097,2049,-48
2018,7,28,1,2172,2001,1960,-41
2018,7,28,2,2108,1925,1876,-49
2018,7,28,3,2074,1928,1955,27
2018,7,28,4,1999,1848,1928,80
2018,7,28,5,1894,1678,1754,76
2018,7,28,6,1750,1571,1676,105
2018,7,28,7,1641,1507,1491,-16
2018,7,28,8,1519,1435,1373,-62
2018,7,28,9,1464,1387,1392,5
2018,7,28,10,1437,1372,1329,-43
2018,7,28,11,1417,1373,1286,-87
2018,7,28,12,1415,1377,1302,-75
2018,7,28,13,1418,1374,1333,-41
2018,7,28,14,1461,1431,1216,-215
2018,7,28,15,1547,1512,1287,-225
2018,7,28,16,1641,1579,1419,-160
2018,7,28,17,1734,1661,1578,-83
2018,7,28,18,1819,1721,1705,-16
2018,7,28,19,1916,1795,1860,65
2018,7,28,20,2011,1882,1910,28
2018,7,28,21,2091,1957,1936,-21
2018,7,28,22,2137,2033,1967,-66
2018,7,28,23,2162,2098,1893,-205
2018,7,29,0,2173,2112,1825,-287
2018,7,29,1,2151,2089,1749,-340
2018,7,29,2,2095,2043,1702,-341
2018,7,29,3,2044,2013,1730,-283
2018,7,29,4,1972,1941,1785,-156
2018,7,29,5,1851,1806,1761,-45
2018,7,29,6,1718,1678,1595,-83
2018,7,29,7,1644,1565,1509,-56
2018,7,29,8,1567,1490,1247,-243
2018,7,29,9,1501,1443,1285,-158
2018,7,29,10,1464,1414,1285,-129
2018,7,29,11,1445,1387,1207,-180
2018,7,29,12,1442,1382,1142,-240
2018,7,29,13,1426,1374,1152,-222
2018,7,29,14,1471,1418,1163,-255
2018,7,29,15,1555,1503,1169,-334
2018,7,29,16,1666,1602,1248,-354
2018,7,29,17,1783,1725,1293,-432
2018,7,29,18,1904,1823,1483,-340
2018,7,29,19,2017,1923,1648,-275
2018,7,29,20,2116,2018,1664,-354
2018,7,29,21,2197,2137,1748,-389
2018,7,29,22,2234,2221,1789,-432
2018,7,29,23,2279,2252,1748,-504
2018,7,30,0,2302,2290,1736,-554
2018,7,30,1,2286,2262,1683,-579
2018,7,30,2,2228,2186,1613,-573
2018,7,30,3,2159,2144,1619,-525
2018,7,30,4,2082,2057,1659,-398
2018,7,30,5,1935,1885,1538,-347
2018,7,30,6,1776,1726,1451,-275
2018,7,30,7,1673,1624,1279,-345
2018,7,30,8,1592,1546,1224,-322
2018,7,30,9,1534,1502,1173,-329
2018,7,30,10,1502,1475,1324,-151
2018,7,30,11,1503,1477,1397,-80
2018,7,30,12,1536,1516,1442,-74
2018,7,30,13,1593,1544,1401,-143
2018,7,30,14,1682,1631,1377,-254
2018,7,30,15,1768,1709,1408,-301
2018,7,30,16,1862,1827,1524,-303
2018,7,30,17,1977,1913,1596,-317
2018,7,30,18,2085,1974,1655,-319
2018,7,30,19,2188,2063,1688,-375
2018,7,30,20,2282,2153,1665,-488
2018,7,30,21,2370,2179,1765,-414
2018,7,30,22,2428,2256,1844,-412
2018,7,30,23,2455,2290,1872,-418
2018,7,31,0,2435,2279,1864,-415
2018,7,31,1,2377,2196,1695,-501
2018,7,31,2,2310,2052,1585,-467
2018,7,31,3,2257,1994,1550,-444
2018,7,31,4,2165,1924,1523,-401
2018,7,31,5,1997,1781,1422,-359
2018,7,31,6,1820,1655,1422,-233
2018,7,31,7,1694,1542,1347,-195
2018,7,31,8,1535,1475,1237,-238
2018,7,31,9,1488,1435,1178,-257
2018,7,31,10,1463,1414,1139,-275
2018,7,31,11,1469,1421,1128,-293
2018,7,31,12,1499,1478,1063,-415
2018,7,31,13,1571,1531,1127,-404
2018,7,31,14,1630,1587,1145,-442
2018,7,31,15,1688,1648,1267,-381
2018,7,31,16,1758,1765,1344,-421
2018,7,31,17,1849,1817,1369,-448
2018,7,31,18,1923,1897,1420,-477
2018,7,31,19,1979,1950,1458,-492
2018,7,31,20,2057,2017,1486,-531
2018,7,31,21,2162,2096,1510,-586
2018,7,31,22,2237,2166,1492,-674
2018,7,31,23,2279,2224,1524,-700
2018,8,1,0,2295,2229,1541,-688
2018,8,1,1,2263,2196,1447,-749
2018,8,1,2,2208,2128,1500,-628
2018,8,1,3,2159,2094,1484,-610
2018,8,1,4,2060,1951,1396,-555
2018,8,1,5,1903,1818,1284,-534
2018,8,1,6,1742,1654,1308,-346
2018,8,1,7,1639,1555,1152,-403
2018,8,1,8,1535,1475,1130,-345
2018,8,1,9,1482,1432,1056,-376
2018,8,1,10,1457,1403,1040,-363
2018,8,1,11,1452,1413,1055,-358
2018,8,1,12,1494,1464,1109,-355
2018,8,1,13,1555,1515,1093,-422
2018,8,1,14,1637,1569,1098,-471
2018,8,1,15,1713,1650,1189,-461
2018,8,1,16,1809,1743,1331,-412
2018,8,1,17,1901,1838,1440,-398
2018,8,1,18,1996,1921,1549,-372
2018,8,1,19,2090,2031,1566,-465
2018,8,1,20,2182,2133,1579,-554
2018,8,1,21,2260,2212,1529,-683
2018,8,1,22,2318,2294,1537,-757
2018,8,1,23,2368,2346,1510,-836
2018,8,2,0,2350,2337,1493,-844
2018,8,2,1,2269,2230,1558,-672
2018,8,2,2,2177,2054,1429,-625
2018,8,2,3,2117,1953,1453,-500
2018,8,2,4,2022,1859,1531,-328
2018,8,2,5,1872,1733,1539,-194
2018,8,2,6,1729,1612,1484,-128
2018,8,2,7,1613,1537,1347,-190
2018,8,2,8,1523,1483,1172,-311
2018,8,2,9,1471,1436,1007,-429
2018,8,2,10,1437,1409,943,-466
2018,8,2,11,1432,1413,970,-443
2018,8,2,12,1470,1451,1003,-448
2018,8,2,13,1536,1510,944,-566
2018,8,2,14,1605,1571,1012,-559
2018,8,2,15,1668,1641,1052,-589
2018,8,2,16,1758,1749,1158,-591
2018,8,2,17,1859,1843,1229,-614
2018,8,2,18,1962,1909,1357,-552
2018,8,2,19,2050,1991,1433,-558
2018,8,2,20,2122,2094,1429,-665
2018,8,2,21,2222,2182,1472,-710
2018,8,2,22,2291,2254,1487,-767
2018,8,2,23,2345,2293,1462,-831
2018,8,3,0,2329,2330,1490,-840
2018,8,3,1,2258,2266,1451,-815
2018,8,3,2,2183,2170,1437,-733
2018,8,3,3,2138,2113,1546,-567
2018,8,3,4,2046,1998,1577,-421
2018,8,3,5,1918,1836,1682,-154
2018,8,3,6,1759,1673,1563,-110
2018,8,3,7,1636,1603,1331,-272
2018,8,3,8,1564,1527,1333,-194
2018,8,3,9,1510,1486,1158,-328
2018,8,3,10,1480,1453,1118,-335
2018,8,3,11,1475,1461,1106,-355
2018,8,3,12,1511,1511,1142,-369
2018,8,3,13,1560,1568,1218,-350
2018,8,3,14,1638,1629,1326,-303
2018,8,3,15,1717,1700,1345,-355
2018,8,3,16,1808,1799,1472,-327
2018,8,3,17,1914,1892,1591,-301
2018,8,3,18,1993,1989,1734,-255
2018,8,3,19,2085,2067,1885,-182
2018,8,3,20,2168,2142,1928,-214
2018,8,3,21,2261,2143,2070,-73
2018,8,3,22,2304,2127,2074,-53
2018,8,3,23,2327,2158,2149,-9
2018,8,4,0,2276,2171,2207,36
2018,8,4,1,2202,2115,2053,-62
2018,8,4,2,2117,2028,1930,-98
2018,8,4,3,2049,2042,2006,-36
2018,8,4,4,1992,1971,2175,204
2018,8,4,5,1855,1833,2066,233
2018,8,4,6,1715,1684,1755,71
2018,8,4,7,1621,1574,1500,-74
2018,8,4,8,1566,1495,1456,-39
2018,8,4,9,1507,1435,1454,19
2018,8,4,10,1476,1400,1416,16
2018,8,4,11,1446,1371,1434,63
2018,8,4,12,1446,1376,1448,72
2018,8,4,13,1432,1375,1516,141
2018,8,4,14,1484,1441,1472,31
2018,8,4,15,1574,1537,1568,31
2018,8,4,16,1678,1644,1605,-39
2018,8,4,17,1784,1761,1640,-121
2018,8,4,18,1879,1870,1801,-69
2018,8,4,19,1984,1964,1841,-123
2018,8,4,20,2075,2055,1873,-182
2018,8,4,21,2177,2140,1922,-218
2018,8,4,22,2240,2205,1917,-288
2018,8,4,23,2283,2257,1916,-341
2018,8,5,0,2308,2282,1917,-365
2018,8,5,1,2290,2263,1863,-400
2018,8,5,2,2204,2166,1872,-294
2018,8,5,3,2125,2105,1923,-182
2018,8,5,4,2046,2011,1989,-22
2018,8,5,5,1911,1863,1917,54
2018,8,5,6,1771,1722,1805,83
2018,8,5,7,1682,1621,1632,11
2018,8,5,8,1613,1536,1634,98
2018,8,5,9,1535,1476,1584,108
2018,8,5,10,1491,1425,1458,33
2018,8,5,11,1475,1401,1454,53
2018,8,5,12,1454,1397,1471,74
2018,8,5,13,1439,1387,1499,112
2018,8,5,14,1487,1437,1540,103
2018,8,5,15,1575,1540,1576,36
2018,8,5,16,1697,1664,1587,-77
2018,8,5,17,1828,1785,1779,-6
2018,8,5,18,1937,1912,1836,-76
2018,8,5,19,2045,2036,1920,-116
2018,8,5,20,2126,2124,1979,-145
2018,8,5,21,2194,2189,2043,-146
2018,8,5,22,2270,2229,2153,-76
2018,8,5,23,2323,2236,2130,-106
2018,8,6,0,2324,2224,2104,-120
2018,8,6,1,2297,2186,2164,-22
2018,8,6,2,2213,2126,2212,86
2018,8,6,3,2156,2110,2218,108
2018,8,6,4,2070,2009,2253,244
2018,8,6,5,1925,1846,2225,379
2018,8,6,6,1774,1698,2104,406
2018,8,6,7,1640,1595,1859,264
2018,8,6,8,1572,1527,1751,224
2018,8,6,9,1509,1481,1623,142
2018,8,6,10,1486,1454,1562,108
2018,8,6,11,1478,1428,1498,70
2018,8,6,12,1497,1477,1517,40
2018,8,6,13,1554,1531,1546,15
2018,8,6,14,1647,1627,1631,4
2018,8,6,15,1743,1721,1630,-91
2018,8,6,16,1847,1835,1729,-106
2018,8,6,17,1980,1927,1767,-160
2018,8,6,18,2087,2026,1799,-227
2018,8,6,19,2203,2133,1848,-285
2018,8,6,20,2308,2262,1910,-352
2018,8,6,21,2413,2362,1914,-448
2018,8,6,22,2485,2431,2050,-381
2018,8,6,23,2507,2459,2203,-256
2018,8,7,0,2499,2455,2392,-63
2018,8,7,1,2418,2409,2352,-57
2018,8,7,2,2320,2304,2318,14
2018,8,7,3,2250,2276,2254,-22
2018,8,7,4,2150,2157,2136,-21
2018,8,7,5,1977,1946,1927,-19
2018,8,7,6,1800,1765,1808,43
2018,8,7,7,1684,1640,1721,81
2018,8,7,8,1591,1569,1600,31
2018,8,7,9,1531,1513,1569,56
2018,8,7,10,1486,1469,1605,136
2018,8,7,11,1479,1467,1560,93
2018,8,7,12,1511,1505,1509,4
2018,8,7,13,1565,1552,1511,-41
2018,8,7,14,1642,1612,1608,-4
2018,8,7,15,1727,1709,1684,-25
2018,8,7,16,1828,1821,1716,-105
2018,8,7,17,1953,1930,1784,-146
2018,8,7,18,2061,2041,1808,-233
2018,8,7,19,2167,2138,1825,-313
2018,8,7,20,2274,2256,1831,-425
2018,8,7,21,2371,2349,1877,-472
2018,8,7,22,2440,2388,1925,-463
2018,8,7,23,2450,2415,1931,-484
2018,8,8,0,2420,2402,1959,-443
2018,8,8,1,2360,2298,1908,-390
2018,8,8,2,2265,2223,1950,-273
2018,8,8,3,2194,2213,1977,-236
2018,8,8,4,2082,2099,1977,-122
2018,8,8,5,1918,1904,1898,-6
2018,8,8,6,1758,1735,1948,213
2018,8,8,7,1647,1602,1785,183
2018,8,8,8,1552,1532,1583,51
2018,8,8,9,1497,1475,1637,162
2018,8,8,10,1462,1439,1617,178
2018,8,8,11,1457,1438,1564,126
2018,8,8,12,1500,1489,1535,46
2018,8,8,13,1555,1554,1497,-57
2018,8,8,14,1639,1624,1475,-149
2018,8,8,15,1714,1699,1514,-185
2018,8,8,16,1814,1819,1560,-259
2018,8,8,17,1922,1893,1625,-268
2018,8,8,18,2025,1974,1764,-210
2018,8,8,19,2134,2076,1830,-246
2018,8,8,20,2233,2193,1901,-292
2018,8,8,21,2337,2286,2013,-273
2018,8,8,22,2411,2335,2102,-233
2018,8,8,23,2466,2364,2176,-188
2018,8,9,0,2450,2335,1968,-367
2018,8,9,1,2380,2269,1762,-507
2018,8,9,2,2269,2167,1667,-500
2018,8,9,3,2215,2145,1784,-361
2018,8,9,4,2105,2026,1905,-121
2018,8,9,5,1938,1824,1764,-60
2018,8,9,6,1762,1661,1638,-23
2018,8,9,7,1651,1561,1366,-195
2018,8,9,8,1534,1497,1148,-349
2018,8,9,9,1475,1448,1154,-294
2018,8,9,10,1441,1406,1118,-288
2018,8,9,11,1440,1421,1100,-321
2018,8,9,12,1486,1459,1105,-354
2018,8,9,13,1546,1525,1094,-431
2018,8,9,14,1605,1574,1175,-399
2018,8,9,15,1654,1657,1308,-349
2018,8,9,16,1740,1734,1315,-419
2018,8,9,17,1838,1831,1398,-433
2018,8,9,18,1928,1915,1549,-366
2018,8,9,19,2026,1990,1642,-348
2018,8,9,20,2113,2064,1776,-288
2018,8,9,21,2197,2142,1930,-212
2018,8,9,22,2239,2211,1975,-236
2018,8,9,23,2292,2233,1889,-344
2018,8,10,0,2252,2203,1791,-412
2018,8,10,1,2163,2093,1909,-184
2018,8,10,2,2084,1990,1867,-123
2018,8,10,3,2053,1945,1721,-224
2018,8,10,4,1950,1850,1760,-90
2018,8,10,5,1811,1688,1630,-58
2018,8,10,6,1672,1552,1579,27
2018,8,10,7,1553,1475,1524,49
2018,8,10,8,1459,1419,1407,-12
2018,8,10,9,1415,1382,1441,59
2018,8,10,10,1379,1362,1427,65
2018,8,10,11,1380,1371,1412,41
2018,8,10,12,1425,1421,1450,29
2018,8,10,13,1496,1495,1428,-67
2018,8,10,14,1556,1529,1411,-118
2018,8,10,15,1618,1575,1453,-122
2018,8,10,16,1711,1646,1488,-158
2018,8,10,17,1761,1713,1531,-182
2018,8,10,18,1820,1789,1481,-308
2018,8,10,19,1892,1845,1241,-604
2018,8,10,20,1962,1900,1525,-375
2018,8,10,21,2024,1980,1554,-426
2018,8,10,22,2040,2031,1657,-374
2018,8,10,23,2065,2017,1642,-375
2018,8,11,0,2023,1983,1718,-265
2018,8,11,1,1972,1915,1653,-262
2018,8,11,2,1909,1816,1774,-42
2018,8,11,3,1884,1779,1818,39
2018,8,11,4,1816,1750,1803,53
2018,8,11,5,1701,1629,1690,61
2018,8,11,6,1575,1514,1468,-46
2018,8,11,7,1476,1427,1185,-242
2018,8,11,8,1407,1364,1053,-311
2018,8,11,9,1359,1316,1005,-311
2018,8,11,10,1325,1289,1081,-208
2018,8,11,11,1310,1282,1069,-213
2018,8,11,12,1315,1303,1163,-140
2018,8,11,13,1325,1317,1382,65
2018,8,11,14,1359,1349,1372,23
2018,8,11,15,1430,1415,1408,-7
2018,8,11,16,1499,1493,1466,-27
2018,8,11,17,1583,1562,1662,100
2018,8,11,18,1647,1642,1713,71
2018,8,11,19,1722,1709,1661,-48
2018,8,11,20,1777,1773,1764,-9
2018,8,11,21,1830,1795,1850,55
2018,8,11,22,1867,1865,2075,210
2018,8,11,23,1902,1883,2115,232
2018,8,12,0,1932,1841,1981,140
2018,8,12,1,1897,1784,1937,153
2018,8,12,2,1860,1729,1785,56
2018,8,12,3,1838,1749,1704,-45
2018,8,12,4,1778,1691,1670,-21
2018,8,12,5,1672,1588,1407,-181
2018,8,12,6,1563,1475,1299,-176
2018,8,12,7,1459,1394,1285,-109
2018,8,12,8,1404,1341,1249,-92
2018,8,12,9,1349,1294,1221,-73
2018,8,12,10,1320,1266,1182,-84
2018,8,12,11,1304,1263,1151,-112
2018,8,12,12,1307,1267,1164,-103
2018,8,12,13,1304,1267,1187,-80
2018,8,12,14,1332,1298,1166,-132
2018,8,12,15,1401,1361,1177,-184
2018,8,12,16,1485,1431,1250,-181
2018,8,12,17,1570,1519,1440,-79
2018,8,12,18,1644,1600,1489,-111
2018,8,12,19,1719,1668,1540,-128
2018,8,12,20,1788,1740,1638,-102
2018,8,12,21,1849,1819,1764,-55
2018,8,12,22,1897,1902,1882,-20
2018,8,12,23,1948,1954,1928,-26
2018,8,13,0,1969,1988,1969,-19
2018,8,13,1,1948,1985,1893,-92
2018,8,13,2,1913,1931,1790,-141
2018,8,13,3,1882,1931,1894,-37
2018,8,13,4,1833,1829,1992,163
2018,8,13,5,1707,1682,1790,108
2018,8,13,6,1574,1541,1627,86
2018,8,13,7,1463,1446,1554,108
2018,8,13,8,1398,1379,1430,51
2018,8,13,9,1352,1337,1358,21
2018,8,13,10,1332,1316,1359,43
2018,8,13,11,1343,1316,1405,89
2018,8,13,12,1385,1371,1475,104
2018,8,13,13,1448,1446,1531,85
2018,8,13,14,1514,1505,1468,-37
2018,8,13,15,1572,1589,1585,-4
2018,8,13,16,1639,1661,1683,22
2018,8,13,17,1717,1731,1731,0
2018,8,13,18,1792,1819,1733,-86
2018,8,13,19,1891,1896,1807,-89
2018,8,13,20,1976,1980,1897,-83
2018,8,13,21,2069,2071,1941,-130
2018,8,13,22,2129,2169,2016,-153
2018,8,13,23,2189,2229,2024,-205
2018,8,14,0,2210,2244,1985,-259
2018,8,14,1,2156,2154,2058,-96
2018,8,14,2,2081,1995,1940,-55
2018,8,14,3,2033,2001,1921,-80
2018,8,14,4,1939,1893,1970,77
2018,8,14,5,1787,1732,1618,-114
2018,8,14,6,1632,1584,1530,-54
2018,8,14,7,1525,1526,1507,-19
2018,8,14,8,1466,1460,1487,27
2018,8,14,9,1418,1414,1381,-33
2018,8,14,10,1385,1386,1363,-23
2018,8,14,11,1379,1384,1372,-12
2018,8,14,12,1413,1446,1365,-81
2018,8,14,13,1476,1527,1418,-109
2018,8,14,14,1558,1576,1415,-161
2018,8,14,15,1624,1628,1437,-191
2018,8,14,16,1717,1708,1517,-191
2018,8,14,17,1808,1790,1555,-235
2018,8,14,18,1903,1896,1628,-268
2018,8,14,19,2010,2003,1704,-299
2018,8,14,20,2097,2107,1817,-290
2018,8,14,21,2203,2204,1908,-296
2018,8,14,22,2271,2283,1929,-354
2018,8,14,23,2301,2318,1958,-360
2018,8,15,0,2314,2313,1953,-360
2018,8,15,1,2245,2268,1922,-346
2018,8,15,2,2160,2186,1852,-334
2018,8,15,3,2121,2175,1887,-288
2018,8,15,4,2033,2052,1888,-164
2018,8,15,5,1865,1873,1653,-220
2018,8,15,6,1695,1721,1591,-130
2018,8,15,7,1576,1615,1522,-93
2018,8,15,8,1500,1544,1579,35
2018,8,15,9,1447,1497,1606,109
2018,8,15,10,1412,1461,1646,185
2018,8,15,11,1410,1458,1570,112
2018,8,15,12,1449,1518,1565,47
2018,8,15,13,1517,1606,1600,-6
2018,8,15,14,1584,1640,1640,0
2018,8,15,15,1654,1696,1695,-1
2018,8,15,16,1741,1795,1694,-101
2018,8,15,17,1834,1881,1647,-234
2018,8,15,18,1927,1994,1685,-309
2018,8,15,19,2022,2076,1782,-294
2018,8,15,20,2104,2160,1820,-340
2018,8,15,21,2200,2247,1908,-339
2018,8,15,22,2274,2305,1953,-352
2018,8,15,23,2308,2308,1999,-309
2018,8,16,0,2279,2142,2009,-133
2018,8,16,1,2216,2034,1857,-177
2018,8,16,2,2117,1997,1780,-217
2018,8,16,3,2078,2019,1966,-53
2018,8,16,4,1994,1929,1994,65
2018,8,16,5,1839,1771,1812,41
2018,8,16,6,1680,1631,1693,62
2018,8,16,7,1601,1561,1543,-18
2018,8,16,8,1559,1503,1554,51
2018,8,16,9,1506,1466,1549,83
2018,8,16,10,1476,1452,1566,114
2018,8,16,11,1465,1458,1558,100
2018,8,16,12,1512,1525,1559,34
2018,8,16,13,1576,1625,1592,-33
2018,8,16,14,1637,1667,1495,-172
2018,8,16,15,1700,1715,1488,-227
2018,8,16,16,1787,1805,1614,-191
2018,8,16,17,1882,1917,1663,-254
2018,8,16,18,1976,1994,1713,-281
2018,8,16,19,2080,2082,1920,-162
2018,8,16,20,2175,2165,2042,-123
2018,8,16,21,2267,2249,2053,-196
2018,8,16,22,2329,2301,2072,-229
2018,8,16,23,2346,2345,2130,-215
2018,8,17,0,2332,2318,2056,-262
2018,8,17,1,2261,2205,2060,-145
2018,8,17,2,2168,2120,1962,-158
2018,8,17,3,2121,2105,1925,-180
2018,8,17,4,2032,1997,1909,-88
2018,8,17,5,1886,1823,1960,137
2018,8,17,6,1737,1670,1782,112
2018,8,17,7,1624,1587,1611,24
2018,8,17,8,1531,1513,1547,34
2018,8,17,9,1482,1471,1629,158
2018,8,17,10,1455,1448,1658,210
2018,8,17,11,1446,1455,1649,194
2018,8,17,12,1489,1508,1635,127
2018,8,17,13,1564,1602,1687,85
2018,8,17,14,1621,1671,1671,0
2018,8,17,15,1684,1742,1694,-48
2018,8,17,16,1770,1832,1814,-18
2018,8,17,17,1861,1926,1814,-112
2018,8,17,18,1952,2037,1856,-181
2018,8,17,19,2043,2100,1955,-145
2018,8,17,20,2137,2173,1992,-181
2018,8,17,21,2216,2226,2157,-69
2018,8,17,22,2270,2281,2127,-154
2018,8,17,23,2292,2254,2187,-67
2018,8,18,0,2244,2123,2055,-68
2018,8,18,1,2158,1984,1890,-94
2018,8,18,2,2073,1928,1942,14
2018,8,18,3,2041,1962,2056,94
2018,8,18,4,1953,1902,1928,26
2018,8,18,5,1836,1774,1753,-21
2018,8,18,6,1711,1639,1738,99
2018,8,18,7,1609,1546,1673,127
2018,8,18,8,1523,1483,1688,205
2018,8,18,9,1466,1435,1612,177
2018,8,18,10,1436,1407,1594,187
2018,8,18,11,1420,1403,1549,146
2018,8,18,12,1431,1415,1544,129
2018,8,18,13,1437,1446,1549,103
2018,8,18,14,1469,1479,1520,41
2018,8,18,15,1541,1553,1583,30
2018,8,18,16,1626,1615,1601,-14
2018,8,18,17,1718,1683,1669,-14
2018,8,18,18,1801,1777,1758,-19
2018,8,18,19,1890,1861,1803,-58
2018,8,18,20,1974,1942,1922,-20
2018,8,18,21,2062,2005,2008,3
2018,8,18,22,2129,2075,2061,-14
2018,8,18,23,2187,2088,2107,19
2018,8,19,0,2191,2069,2139,70
2018,8,19,1,2140,2020,2182,162
2018,8,19,2,2074,1959,2043,84
2018,8,19,3,2023,1950,2001,51
2018,8,19,4,1944,1886,1887,1
2018,8,19,5,1820,1752,1720,-32
2018,8,19,6,1686,1624,1602,-22
2018,8,19,7,1583,1528,1578,50
2018,8,19,8,1528,1454,1506,52
2018,8,19,9,1472,1400,1484,84
2018,8,19,10,1436,1362,1520,158
2018,8,19,11,1415,1356,1499,143
2018,8,19,12,1416,1359,1514,155
2018,8,19,13,1415,1354,1463,109
2018,8,19,14,1438,1407,1477,70
2018,8,19,15,1520,1448,1590,142
2018,8,19,16,1613,1536,1641,105
2018,8,19,17,1712,1675,1688,13
2018,8,19,18,1819,1739,1674,-65
2018,8,19,19,1926,1831,1661,-170
2018,8,19,20,2020,1914,1786,-128
2018,8,19,21,2118,1984,1862,-122
2018,8,19,22,2192,2069,2064,-5
2018,8,19,23,2251,2141,2147,6
2018,8,20,0,2263,2178,2132,-46
2018,8,20,1,2209,2147,2063,-84
2018,8,20,2,2130,2081,2027,-54
2018,8,20,3,2091,2060,2039,-21
2018,8,20,4,2019,1941,2157,216
2018,8,20,5,1866,1772,1955,183
2018,8,20,6,1721,1624,1952,328
2018,8,20,7,1602,1544,1941,397
2018,8,20,8,1521,1481,1941,460
2018,8,20,9,1462,1441,1876,435
2018,8,20,10,1438,1416,1846,430
2018,8,20,11,1442,1416,1753,337
2018,8,20,12,1485,1462,1727,265
2018,8,20,13,1560,1547,1750,203
2018,8,20,14,1615,1600,1655,55
2018,8,20,15,1684,1650,1741,91
2018,8,20,16,1748,1731,1780,49
2018,8,20,17,1839,1801,1860,59
2018,8,20,18,1921,1893,1852,-41
2018,8,20,19,2002,1972,1857,-115
2018,8,20,20,2096,2060,1882,-178
2018,8,20,21,2178,2140,1943,-197
2018,8,20,22,2248,2218,1991,-227
2018,8,20,23,2304,2268,2004,-264
2018,8,21,0,2304,2300,2047,-253
2018,8,21,1,2242,2245,2035,-210
2018,8,21,2,2172,2154,2001,-153
2018,8,21,3,2132,2150,1988,-162
2018,8,21,4,2044,2013,2015,2
2018,8,21,5,1893,1826,1883,57
2018,8,21,6,1732,1674,1846,172
2018,8,21,7,1627,1573,1789,216
2018,8,21,8,1540,1505,1739,234
2018,8,21,9,1492,1459,1617,158
2018,8,21,10,1465,1437,1594,157
2018,8,21,11,1458,1446,1591,145
2018,8,21,12,1502,1493,1666,173
2018,8,21,13,1576,1580,1701,121
2018,8,21,14,1637,1645,1668,23
2018,8,21,15,1706,1715,1733,18
2018,8,21,16,1790,1801,1910,109
2018,8,21,17,1883,1898,1928,30
2018,8,21,18,1980,1986,1860,-126
2018,8,21,19,2080,2070,1884,-186
2018,8,21,20,2163,2165,1921,-244
2018,8,21,21,2235,2251,2073,-178
2018,8,21,22,2304,2227,2204,-23
2018,8,21,23,2315,2131,2080,-51
2018,8,22,0,2267,2068,2016,-52
2018,8,22,1,2178,1999,2043,44
2018,8,22,2,2105,1946,2132,186
2018,8,22,3,2089,1964,2186,222
2018,8,22,4,2002,1875,2084,209
2018,8,22,5,1850,1724,1859,135
2018,8,22,6,1704,1607,1664,57
2018,8,22,7,1595,1510,1606,96
2018,8,22,8,1530,1461,1509,48
2018,8,22,9,1483,1423,1495,72
2018,8,22,10,1447,1403,1507,104
2018,8,22,11,1451,1415,1510,95
2018,8,22,12,1501,1489,1649,160
2018,8,22,13,1585,1582,1716,134
2018,8,22,14,1642,1634,1683,49
2018,8,22,15,1696,1672,1680,8
2018,8,22,16,1765,1721,1665,-56
2018,8,22,17,1846,1776,1698,-78
2018,8,22,18,1922,1824,1727,-97
2018,8,22,19,1997,1822,1812,-10
2018,8,22,20,2079,1866,1848,-18
2018,8,22,21,2156,1920,1937,17
2018,8,22,22,2207,1996,2075,79
2018,8,22,23,2213,2013,2035,22
2018,8,23,0,2169,1988,1973,-15
2018,8,23,1,2088,1866,1818,-48
2018,8,23,2,2016,1799,1917,118
2018,8,23,3,2005,1809,2078,269
2018,8,23,4,1922,1739,2029,290
2018,8,23,5,1780,1605,1905,300
2018,8,23,6,1648,1484,1781,297
2018,8,23,7,1547,1418,1685,267
2018,8,23,8,1463,1371,1651,280
2018,8,23,9,1424,1338,1664,326
2018,8,23,10,1396,1329,1634,305
2018,8,23,11,1398,1333,1564,231
2018,8,23,12,1434,1384,1596,212
2018,8,23,13,1513,1474,1663,189
2018,8,23,14,1571,1538,1709,171
2018,8,23,15,1619,1580,1742,162
2018,8,23,16,1675,1653,1797,144
2018,8,23,17,1741,1698,1880,182
2018,8,23,18,1804,1764,2046,282
2018,8,23,19,1862,1817,2162,345
2018,8,23,20,1939,1882,2190,308
2018,8,23,21,2004,1960,2182,222
2018,8,23,22,2051,2017,2162,145
2018,8,23,23,2060,2065,2083,18
2018,8,24,0,2033,2052,1999,-53
2018,8,24,1,1982,1972,1965,-7
2018,8,24,2,1931,1938,2168,230
2018,8,24,3,1926,1972,2317,345
2018,8,24,4,1872,1867,2309,442
2018,8,24,5,1738,1724,2147,423
2018,8,24,6,1606,1574,1955,381
2018,8,24,7,1512,1487,1814,327
2018,8,24,8,1451,1429,1692,263
2018,8,24,9,1407,1394,1635,241
2018,8,24,10,1387,1371,1600,229
2018,8,24,11,1388,1376,1622,246
2018,8,24,12,1430,1427,1661,234
2018,8,24,13,1494,1513,1696,183
2018,8,24,14,1552,1557,1731,174
2018,8,24,15,1610,1618,1805,187
2018,8,24,16,1678,1689,1868,179
2018,8,24,17,1751,1764,1965,201
2018,8,24,18,1827,1828,1983,155
2018,8,24,19,1900,1899,1949,50
2018,8,24,20,1982,1979,1935,-44
2018,8,24,21,2062,2019,1923,-96
2018,8,24,22,2127,2032,1975,-57
2018,8,24,23,2144,2042,2056,14
2018,8,25,0,2134,2002,1985,-17
2018,8,25,1,2075,1925,1819,-106
2018,8,25,2,1992,1886,1795,-91
2018,8,25,3,1979,1924,1896,-28
2018,8,25,4,1912,1849,1828,-21
2018,8,25,5,1789,1745,1716,-29
2018,8,25,6,1659,1604,1603,-1
2018,8,25,7,1561,1522,1540,18
2018,8,25,8,1494,1455,1454,-1
2018,8,25,9,1441,1402,1462,60
2018,8,25,10,1412,1373,1487,114
2018,8,25,11,1384,1357,1486,129
2018,8,25,12,1390,1381,1461,80
2018,8,25,13,1395,1406,1395,-11
2018,8,25,14,1431,1436,1430,-6
2018,8,25,15,1500,1522,1620,98
2018,8,25,16,1590,1604,1737,133
2018,8,25,17,1666,1676,1877,201
2018,8,25,18,1738,1771,2008,237
2018,8,25,19,1800,1843,2159,316
2018,8,25,20,1859,1901,2218,317
2018,8,25,21,1919,1955,2332,377
2018,8,25,22,1960,1999,2403,404
2018,8,25,23,1970,1998,2367,369
2018,8,26,0,1950,1910,2179,269
2018,8,26,1,1894,1823,2070,247
2018,8,26,2,1866,1794,2119,325
2018,8,26,3,1859,1810,2039,229
2018,8,26,4,1812,1752,1881,129
2018,8,26,5,1705,1668,1736,68
2018,8,26,6,1593,1545,1634,89
2018,8,26,7,1498,1463,1566,103
2018,8,26,8,1443,1402,1528,126
2018,8,26,9,1393,1359,1473,114
2018,8,26,10,1367,1334,1496,162
2018,8,26,11,1351,1319,1503,184
2018,8,26,12,1357,1322,1518,196
2018,8,26,13,1366,1339,1538,199
2018,8,26,14,1390,1361,1566,205
2018,8,26,15,1449,1436,1668,232
2018,8,26,16,1532,1516,1760,244
2018,8,26,17,1600,1600,1906,306
2018,8,26,18,1680,1681,2001,320
2018,8,26,19,1757,1757,2121,364
2018,8,26,20,1829,1821,2187,366
2018,8,26,21,1902,1914,2274,360
2018,8,26,22,1962,2005,2318,313
2018,8,26,23,1998,2082,2347,265
2018,8,27,0,2009,2114,2319,205
2018,8,27,1,1980,2107,2167,60
2018,8,27,2,1951,2068,2110,42
2018,8,27,3,1941,2049,2113,64
2018,8,27,4,1874,1940,2003,63
2018,8,27,5,1742,1784,1937,153
2018,8,27,6,1613,1647,1843,196
2018,8,27,7,1511,1506,1711,205
2018,8,27,8,1444,1428,1851,423
2018,8,27,9,1400,1392,1687,295
2018,8,27,10,1382,1372,1554,182
2018,8,27,11,1384,1379,1604,225
2018,8,27,12,1427,1433,1673,240
2018,8,27,13,1508,1536,1688,152
2018,8,27,14,1573,1576,1650,74
2018,8,27,15,1630,1626,1682,56
2018,8,27,16,1698,1701,1737,36
2018,8,27,17,1775,1781,1893,112
2018,8,27,18,1855,1870,1898,28
2018,8,27,19,1940,1936,1975,39
2018,8,27,20,2021,2014,2084,70
2018,8,27,21,2101,2090,2162,72
2018,8,27,22,2163,2150,2172,22
2018,8,27,23,2192,2201,2190,-11
2018,8,28,0,2185,2208,2224,16
2018,8,28,1,2117,2161,2133,-28
2018,8,28,2,2054,2075,1995,-80
2018,8,28,3,2038,2090,1942,-148
2018,8,28,4,1965,1990,1846,-144
2018,8,28,5,1810,1753,1683,-70
2018,8,28,6,1658,1602,1679,77
2018,8,28,7,1549,1507,1633,126
2018,8,28,8,1488,1432,1661,229
2018,8,28,9,1429,1384,1712,328
2018,8,28,10,1407,1357,1763,406
2018,8,28,11,1405,1353,1711,358
2018,8,28,12,1450,1404,1709,305
2018,8,28,13,1529,1492,1726,234
2018,8,28,14,1590,1539,1727,188
2018,8,28,15,1641,1586,1797,211
2018,8,28,16,1702,1645,1799,154
2018,8,28,17,1783,1723,1915,192
2018,8,28,18,1861,1803,1938,135
2018,8,28,19,1940,1875,1967,92
2018,8,28,20,2011,1954,2035,81
2018,8,28,21,2105,2030,2072,42
2018,8,28,22,2190,2119,2131,12
2018,8,28,23,2241,2190,2203,13
2018,8,29,0,2234,2192,2140,-52
2018,8,29,1,2174,2159,2084,-75
2018,8,29,2,2119,2095,1906,-189
2018,8,29,3,2098,2064,1829,-235
2018,8,29,4,2005,1903,1760,-143
2018,8,29,5,1837,1717,1654,-63
2018,8,29,6,1678,1563,1554,-9
2018,8,29,7,1569,1480,1558,78
2018,8,29,8,1478,1411,1435,24
2018,8,29,9,1421,1358,1471,113
2018,8,29,10,1395,1332,1569,237
2018,8,29,11,1401,1331,1641,310
2018,8,29,12,1452,1370,1665,295
2018,8,29,13,1528,1457,1648,191
2018,8,29,14,1588,1497,1604,107
2018,8,29,15,1638,1543,1551,8
2018,8,29,16,1707,1598,1473,-125
2018,8,29,17,1784,1706,1485,-221
2018,8,29,18,1868,1794,1555,-239
2018,8,29,19,1958,1890,1710,-180
2018,8,29,20,2053,2002,1768,-234
2018,8,29,21,2154,2097,1851,-246
2018,8,29,22,2233,2190,1943,-247
2018,8,29,23,2285,2253,1954,-299
2018,8,30,0,2271,2261,1944,-317
2018,8,30,1,2204,2211,1996,-215
2018,8,30,2,2144,2144,2076,-68
2018,8,30,3,2101,2119,2064,-55
2018,8,30,4,2013,1984,2014,30
2018,8,30,5,1841,1784,1894,110
2018,8,30,6,1686,1620,1880,260
2018,8,30,7,1579,1514,1715,201
2018,8,30,8,1486,1451,1614,163
2018,8,30,9,1442,1407,1636,229
2018,8,30,10,1409,1385,1607,222
2018,8,30,11,1430,1379,1559,180
2018,8,30,12,1473,1451,1569,118
2018,8,30,13,1543,1541,1563,22
2018,8,30,14,1605,1573,1509,-64
2018,8,30,15,1679,1630,1537,-93
2018,8,30,16,1760,1695,1566,-129
2018,8,30,17,1836,1775,1643,-132
2018,8,30,18,1917,1874,1731,-143
2018,8,30,19,1999,1959,1748,-211
2018,8,30,20,2086,2057,1769,-288
2018,8,30,21,2180,2134,1994,-140
2018,8,30,22,2259,2232,2025,-207
2018,8,30,23,2289,2261,1991,-270
2018,8,31,0,2278,2264,2020,-244
2018,8,31,1,2218,2204,2017,-187
2018,8,31,2,2134,2142,1914,-228
2018,8,31,3,2115,2122,1972,-150
2018,8,31,4,2040,1998,1920,-78
2018,8,31,5,1893,1810,1776,-34
2018,8,31,6,1725,1666,1755,89
2018,8,31,7,1613,1547,1783,236
2018,8,31,8,1545,1487,1569,82
2018,8,31,9,1485,1434,1454,20
2018,8,31,10,1457,1391,1362,-29
2018,8,31,11,1449,1388,1326,-62
2018,8,31,12,1489,1431,1371,-60
2018,8,31,13,1557,1526,1394,-132
2018,8,31,14,1620,1564,1411,-153
2018,8,31,15,1683,1614,1489,-125
2018,8,31,16,1772,1696,1538,-158
2018,8,31,17,1864,1786,1612,-174
2018,8,31,18,1962,1890,1725,-165
2018,8,31,19,2052,1994,1766,-228
2018,8,31,20,2145,2098,1840,-258
2018,8,31,21,2225,2160,1990,-170
2018,8,31,22,2282,2195,1967,-228
2018,8,31,23,2297,2179,1873,-306
2018,9,1,0,2248,2176,2003,-173
2018,9,1,1,2161,2082,2002,-80
2018,9,1,2,2084,2039,1957,-82
2018,9,1,3,2065,2046,1957,-89
2018,9,1,4,1995,1944,1852,-92
2018,9,1,5,1862,1808,1638,-170
2018,9,1,6,1721,1674,1622,-52
2018,9,1,7,1611,1575,1590,15
2018,9,1,8,1508,1505,1514,9
2018,9,1,9,1456,1453,1473,20
2018,9,1,10,1419,1412,1500,88
2018,9,1,11,1408,1401,1515,114
2018,9,1,12,1429,1404,1606,202
2018,9,1,13,1448,1432,1611,179
2018,9,1,14,1477,1459,1461,2
2018,9,1,15,1538,1504,1561,57
2018,9,1,16,1602,1544,1572,28
2018,9,1,17,1665,1564,1560,-4
2018,9,1,18,1728,1560,1634,74
2018,9,1,19,1775,1536,1668,132
2018,9,1,20,1830,1528,1737,209
2018,9,1,21,1895,1549,1729,180
2018,9,1,22,1928,1595,1738,143
2018,9,1,23,1939,1632,1754,122
2018,9,2,0,1930,1654,1713,59
2018,9,2,1,1898,1643,1607,-36
2018,9,2,2,1863,1649,1563,-86
2018,9,2,3,1853,1680,1553,-127
2018,9,2,4,1791,1627,1491,-136
2018,9,2,5,1690,1518,1419,-99
2018,9,2,6,1571,1418,1491,73
2018,9,2,7,1480,1341,1442,101
2018,9,2,8,1409,1289,1474,185
2018,9,2,9,1367,1265,1497,232
2018,9,2,10,1325,1249,1506,257
2018,9,2,11,1312,1246,1528,282
2018,9,2,12,1325,1260,1537,277
2018,9,2,13,1334,1274,1587,313
2018,9,2,14,1355,1273,1594,321
2018,9,2,15,1395,1324,1576,252
2018,9,2,16,1454,1382,1598,216
2018,9,2,17,1520,1440,1610,170
2018,9,2,18,1588,1488,1658,170
2018,9,2,19,1671,1554,1686,132
2018,9,2,20,1749,1596,1711,115
2018,9,2,21,1808,1624,1778,154
2018,9,2,22,1862,1690,1703,13
2018,9,2,23,1886,1735,1669,-66
2018,9,3,0,1917,1780,1687,-93
2018,9,3,1,1899,1751,1579,-172
2018,9,3,2,1861,1743,1544,-199
2018,9,3,3,1859,1758,1601,-157
2018,9,3,4,1795,1682,1757,75
2018,9,3,5,1678,1573,1830,257
2018,9,3,6,1558,1469,1736,267
2018,9,3,7,1465,1385,1549,164
2018,9,3,8,1429,1334,1479,145
2018,9,3,9,1381,1298,1412,114
2018,9,3,10,1354,1269,1301,32
2018,9,3,11,1332,1266,1256,-10
2018,9,3,12,1339,1298,1252,-46
2018,9,3,13,1359,1328,1300,-28
2018,9,3,14,1380,1331,1321,-10
2018,9,3,15,1431,1396,1417,21
2018,9,3,16,1491,1421,1414,-7
2018,9,3,17,1557,1495,1443,-52
2018,9,3,18,1620,1565,1535,-30
2018,9,3,19,1682,1630,1697,67
2018,9,3,20,1752,1696,1752,56
2018,9,3,21,1816,1761,1784,23
2018,9,3,22,1873,1782,1888,106
2018,9,3,23,1917,1797,1856,59
2018,9,4,0,1934,1801,1707,-94
2018,9,4,1,1922,1773,1658,-115
2018,9,4,2,1886,1782,1698,-84
2018,9,4,3,1859,1810,1800,-10
2018,9,4,4,1802,1726,1820,94
2018,9,4,5,1672,1585,1767,182
2018,9,4,6,1559,1449,1501,52
2018,9,4,7,1466,1370,1300,-70
2018,9,4,8,1382,1310,1044,-266
2018,9,4,9,1337,1282,893,-389
2018,9,4,10,1325,1269,747,-522
2018,9,4,11,1324,1276,715,-561
2018,9,4,12,1371,1337,699,-638
2018,9,4,13,1449,1438,721,-717
2018,9,4,14,1504,1483,735,-748
2018,9,4,15,1550,1523,854,-669
2018,9,4,16,1615,1564,923,-641
2018,9,4,17,1677,1620,985,-635
2018,9,4,18,1739,1664,1014,-650
2018,9,4,19,1798,1721,1107,-614
2018,9,4,20,1863,1783,1119,-664
2018,9,4,21,1920,1852,1184,-668
2018,9,4,22,1974,1928,1173,-755
2018,9,4,23,2004,1882,1089,-793
2018,9,5,0,2008,1941,1103,-838
2018,9,5,1,1972,1867,1102,-765
2018,9,5,2,1933,1824,1080,-744
2018,9,5,3,1932,1828,1238,-590
2018,9,5,4,1858,1733,1133,-600
2018,9,5,5,1718,1580,1095,-485
2018,9,5,6,1572,1450,1061,-389
2018,9,5,7,1473,1364,1011,-353
2018,9,5,8,1372,1316,827,-489
2018,9,5,9,1332,1290,774,-516
2018,9,5,10,1313,1272,756,-516
2018,9,5,11,1309,1281,683,-598
2018,9,5,12,1364,1337,680,-657
2018,9,5,13,1447,1433,751,-682
2018,9,5,14,1511,1481,809,-672
2018,9,5,15,1550,1522,905,-617
2018,9,5,16,1609,1578,924,-654
2018,9,5,17,1663,1639,900,-739
2018,9,5,18,1734,1707,1043,-664
2018,9,5,19,1783,1769,1138,-631
2018,9,5,20,1842,1850,1167,-683
2018,9,5,21,1897,1915,1236,-679
2018,9,5,22,1937,1961,1299,-662
2018,9,5,23,1947,1987,1416,-571
2018,9,6,0,1930,1998,1574,-424
2018,9,6,1,1876,1910,1528,-382
2018,9,6,2,1861,1862,1448,-414
2018,9,6,3,1869,1834,1392,-442
2018,9,6,4,1804,1721,1195,-526
2018,9,6,5,1665,1587,999,-588
2018,9,6,6,1517,1464,971,-493
2018,9,6,7,1416,1384,878,-506
2018,9,6,8,1373,1330,840,-490
2018,9,6,9,1338,1308,854,-454
2018,9,6,10,1319,1265,898,-367
2018,9,6,11,1324,1273,775,-498
2018,9,6,12,1378,1336,785,-551
2018,9,6,13,1467,1462,846,-616
2018,9,6,14,1521,1494,815,-679
2018,9,6,15,1564,1509,853,-656
2018,9,6,16,1616,1558,880,-678
2018,9,6,17,1651,1586,893,-693
2018,9,6,18,1684,1625,956,-669
2018,9,6,19,1712,1642,999,-643
2018,9,6,20,1754,1696,1061,-635
2018,9,6,21,1778,1760,1119,-641
2018,9,6,22,1823,1808,1180,-628
2018,9,6,23,1838,1840,1218,-622
2018,9,7,0,1843,1852,1226,-626
2018,9,7,1,1813,1801,1134,-667
2018,9,7,2,1784,1768,1055,-713
2018,9,7,3,1812,1782,1063,-719
2018,9,7,4,1747,1672,1003,-669
2018,9,7,5,1622,1549,910,-639
2018,9,7,6,1492,1433,825,-608
2018,9,7,7,1402,1349,808,-541
2018,9,7,8,1342,1304,750,-554
2018,9,7,9,1308,1275,713,-562
2018,9,7,10,1288,1257,710,-547
2018,9,7,11,1290,1263,716,-547
2018,9,7,12,1334,1305,772,-533
2018,9,7,13,1412,1412,832,-580
2018,9,7,14,1473,1484,872,-612
2018,9,7,15,1512,1503,873,-630
2018,9,7,16,1559,1549,946,-603
2018,9,7,17,1601,1600,1026,-574
2018,9,7,18,1643,1656,1075,-581
2018,9,7,19,1676,1706,1170,-536
2018,9,7,20,1724,1773,1212,-561
2018,9,7,21,1766,1854,1332,-522
2018,9,7,22,1806,1891,1569,-322
2018,9,7,23,1833,1931,1600,-331
2018,9,8,0,1831,1933,1590,-343
2018,9,8,1,1800,1841,1461,-380
2018,9,8,2,1765,1823,1538,-285
2018,9,8,3,1790,1830,1749,-81
2018,9,8,4,1740,1749,1622,-127
2018,9,8,5,1623,1614,1519,-95
2018,9,8,6,1512,1503,1273,-230
2018,9,8,7,1419,1423,1180,-243
2018,9,8,8,1359,1362,1179,-183
2018,9,8,9,1319,1320,1173,-147
2018,9,8,10,1272,1293,1176,-117
2018,9,8,11,1260,1283,1175,-108
2018,9,8,12,1278,1300,1174,-126
2018,9,8,13,1307,1331,1181,-150
2018,9,8,14,1337,1337,1133,-204
2018,9,8,15,1386,1391,1206,-185
2018,9,8,16,1422,1448,1320,-128
2018,9,8,17,1474,1512,1358,-154
2018,9,8,18,1536,1578,1370,-208
2018,9,8,19,1588,1642,1350,-292
2018,9,8,20,1643,1725,1393,-332
2018,9,8,21,1697,1801,1463,-338
2018,9,8,22,1762,1867,1432,-435
2018,9,8,23,1806,1930,1432,-498
2018,9,9,0,1833,1965,1475,-490
2018,9,9,1,1821,1934,1540,-394
2018,9,9,2,1783,1895,1589,-306
2018,9,9,3,1775,1871,1621,-250
2018,9,9,4,1728,1757,1540,-217
2018,9,9,5,1625,1622,1488,-134
2018,9,9,6,1510,1500,1502,2
2018,9,9,7,1416,1406,1440,34
2018,9,9,8,1369,1337,1343,6
2018,9,9,9,1326,1308,1263,-45
2018,9,9,10,1302,1269,1250,-19
2018,9,9,11,1284,1265,1324,59
2018,9,9,12,1289,1275,1356,81
2018,9,9,13,1300,1296,1367,71
2018,9,9,14,1319,1298,1356,58
2018,9,9,15,1380,1361,1393,32
2018,9,9,16,1458,1424,1422,-2
2018,9,9,17,1523,1505,1479,-26
2018,9,9,18,1594,1586,1469,-117
2018,9,9,19,1671,1673,1440,-233
2018,9,9,20,1747,1773,1488,-285
2018,9,9,21,1819,1854,1694,-160
2018,9,9,22,1890,1926,1768,-158
2018,9,9,23,1941,1982,1796,-186
2018,9,10,0,1981,1987,1801,-186
2018,9,10,1,1951,1903,1810,-93
2018,9,10,2,1922,1835,1803,-32
2018,9,10,3,1900,1818,1881,63
2018,9,10,4,1832,1715,1861,146
2018,9,10,5,1691,1567,1820,253
2018,9,10,6,1561,1448,1570,122
2018,9,10,7,1461,1376,1498,122
2018,9,10,8,1387,1314,1444,130
2018,9,10,9,1346,1283,1449,166
2018,9,10,10,1326,1274,1478,204
2018,9,10,11,1329,1273,1460,187
2018,9,10,12,1372,1328,1440,112
2018,9,10,13,1456,1440,1461,21
2018,9,10,14,1520,1467,1510,43
2018,9,10,15,1574,1499,1545,46
2018,9,10,16,1625,1550,1529,-21
2018,9,10,17,1687,1616,1602,-14
2018,9,10,18,1747,1686,1682,-4
2018,9,10,19,1819,1759,1756,-3
2018,9,10,20,1902,1846,1844,-2
2018,9,10,21,1990,1936,1905,-31
2018,9,10,22,2065,2016,1934,-82
2018,9,10,23,2093,2079,1989,-90
2018,9,11,0,2093,2082,1985,-97
2018,9,11,1,2032,2048,1950,-98
2018,9,11,2,1973,1986,1935,-51
2018,9,11,3,1965,1963,2029,66
2018,9,11,4,1885,1822,1889,67
2018,9,11,5,1742,1665,1735,70
2018,9,11,6,1596,1520,1695,175
2018,9,11,7,1480,1461,1674,213
2018,9,11,8,1382,1359,1571,212
2018,9,11,9,1335,1326,1529,203
2018,9,11,10,1318,1295,1504,209
2018,9,11,11,1316,1300,1502,202
2018,9,11,12,1372,1354,1502,148
2018,9,11,13,1451,1456,1662,206
2018,9,11,14,1504,1485,1674,189
2018,9,11,15,1558,1533,1616,83
2018,9,11,16,1620,1591,1689,98
2018,9,11,17,1690,1661,1752,91
2018,9,11,18,1758,1725,1774,49
2018,9,11,19,1846,1801,1763,-38
2018,9,11,20,1922,1885,1833,-52
2018,9,11,21,2006,1974,1909,-65
2018,9,11,22,2072,2060,1955,-105
2018,9,11,23,2129,2101,1885,-216
2018,9,12,0,2122,2104,1889,-215
2018,9,12,1,2076,2060,1889,-171
2018,9,12,2,1978,2003,1917,-86
2018,9,12,3,2019,1977,2033,56
2018,9,12,4,1915,1863,1944,81
2018,9,12,5,1750,1684,1852,168
2018,9,12,6,1589,1539,1721,182
2018,9,12,7,1506,1450,1641,191
2018,9,12,8,1437,1411,1422,11
2018,9,12,9,1384,1352,1463,111
2018,9,12,10,1361,1331,1492,161
2018,9,12,11,1356,1331,1546,215
2018,9,12,12,1407,1376,1558,182
2018,9,12,13,1498,1473,1604,131
2018,9,12,14,1549,1507,1508,1
2018,9,12,15,1594,1539,1493,-46
2018,9,12,16,1660,1616,1528,-88
2018,9,12,17,1734,1686,1683,-3
2018,9,12,18,1811,1756,1755,-1
2018,9,12,19,1889,1838,1920,82
2018,9,12,20,1969,1922,1940,18
2018,9,12,21,2064,2018,2062,44
2018,9,12,22,2144,2096,2144,48
2018,9,12,23,2188,2158,2083,-75
2018,9,13,0,2188,2140,1981,-159
2018,9,13,1,2127,2106,1833,-273
2018,9,13,2,2063,2048,1761,-287
2018,9,13,3,2037,2008,1709,-299
2018,9,13,4,1935,1882,1655,-227
2018,9,13,5,1772,1701,1567,-134
2018,9,13,6,1616,1540,1570,30
2018,9,13,7,1519,1437,1546,109
2018,9,13,8,1456,1378,1674,296
2018,9,13,9,1401,1340,1720,380
2018,9,13,10,1373,1317,1756,439
2018,9,13,11,1459,1323,1606,283
2018,9,13,12,1501,1370,1597,227
2018,9,13,13,1583,1480,1607,127
2018,9,13,14,1636,1500,1592,92
2018,9,13,15,1685,1540,1643,103
2018,9,13,16,1737,1592,1607,15
2018,9,13,17,1801,1671,1831,160
2018,9,13,18,1887,1736,1964,228
2018,9,13,19,1941,1810,2018,208
2018,9,13,20,2020,1911,1983,72
2018,9,13,21,2084,1995,2030,35
2018,9,13,22,2148,2093,2071,-22
2018,9,13,23,2183,2146,2054,-92
2018,9,14,0,2179,2136,1982,-154
2018,9,14,1,2096,2083,1877,-206
2018,9,14,2,2036,2041,1769,-272
2018,9,14,3,2023,2001,1698,-303
2018,9,14,4,1949,1868,1652,-216
2018,9,14,5,1776,1690,1507,-183
2018,9,14,6,1626,1536,1451,-85
2018,9,14,7,1536,1433,1419,-14
2018,9,14,8,1434,1361,1460,99
2018,9,14,9,1387,1320,1455,135
2018,9,14,10,1362,1294,1650,356
2018,9,14,11,1362,1293,1674,381
2018,9,14,12,1398,1338,1584,246
2018,9,14,13,1477,1434,1514,80
2018,9,14,14,1529,1499,1577,78
2018,9,14,15,1578,1500,1531,31
2018,9,14,16,1643,1548,1536,-12
2018,9,14,17,1706,1612,1599,-13
2018,9,14,18,1791,1676,1608,-68
2018,9,14,19,1867,1765,1674,-91
2018,9,14,20,1961,1863,1710,-153
2018,9,14,21,2055,1959,1871,-88
2018,9,14,22,2129,2042,1960,-82
2018,9,14,23,2170,2087,2048,-39
2018,9,15,0,2148,2096,2103,7
2018,9,15,1,2079,2035,2050,15
2018,9,15,2,2019,1980,2157,177
2018,9,15,3,1994,1944,2133,189
2018,9,15,4,1908,1836,1974,138
2018,9,15,5,1762,1678,1782,104
2018,9,15,6,1625,1541,1605,64
2018,9,15,7,1524,1440,1567,127
2018,9,15,8,1439,1360,1475,115
2018,9,15,9,1385,1319,1407,88
2018,9,15,10,1355,1305,1359,54
2018,9,15,11,1345,1290,1360,70
2018,9,15,12,1359,1307,1390,83
2018,9,15,13,1386,1354,1455,101
2018,9,15,14,1404,1370,1405,35
2018,9,15,15,1469,1447,1480,33
2018,9,15,16,1535,1517,1552,35
2018,9,15,17,1613,1595,1660,65
2018,9,15,18,1693,1672,1711,39
2018,9,15,19,1762,1757,1741,-16
2018,9,15,20,1844,1848,1777,-71
2018,9,15,21,1922,1929,1936,7
2018,9,15,22,1997,1992,2017,25
2018,9,15,23,2036,2036,2056,20
2018,9,16,0,2027,2059,2084,25
2018,9,16,1,1976,2014,2097,83
2018,9,16,2,1931,1978,2189,211
2018,9,16,3,1916,1933,2194,261
2018,9,16,4,1833,1823,2087,264
2018,9,16,5,1702,1707,1900,193
2018,9,16,6,1581,1568,1897,329
2018,9,16,7,1474,1486,1801,315
2018,9,16,8,1418,1408,1488,80
2018,9,16,9,1369,1370,1440,70
2018,9,16,10,1333,1329,1391,62
2018,9,16,11,1324,1315,1409,94
2018,9,16,12,1331,1328,1430,102
2018,9,16,13,1349,1353,1433,80
2018,9,16,14,1364,1348,1437,89
2018,9,16,15,1419,1435,1509,74
2018,9,16,16,1486,1499,1540,41
2018,9,16,17,1569,1577,1614,37
2018,9,16,18,1655,1677,1763,86
2018,9,16,19,1730,1786,1800,14
2018,9,16,20,1821,1889,1803,-86
2018,9,16,21,1910,1962,1898,-64
2018,9,16,22,2001,2036,1965,-71
2018,9,16,23,2056,2097,2076,-21
2018,9,17,0,2080,2119,2140,21
2018,9,17,1,2040,2070,2203,133
2018,9,17,2,1993,2054,2144,90
2018,9,17,3,1970,1987,2093,106
2018,9,17,4,1877,1854,2082,228
2018,9,17,5,1733,1714,1894,180
2018,9,17,6,1587,1564,1710,146
2018,9,17,7,1478,1474,1569,95
2018,9,17,8,1396,1414,1530,116
2018,9,17,9,1354,1381,1543,162
2018,9,17,10,1331,1360,1409,49
2018,9,17,11,1341,1362,1404,42
2018,9,17,12,1380,1408,1462,54
2018,9,17,13,1474,1516,1506,-10
2018,9,17,14,1528,1547,1503,-44
2018,9,17,15,1575,1596,1557,-39
2018,9,17,16,1640,1668,1566,-102
2018,9,17,17,1709,1747,1575,-172
2018,9,17,18,1793,1825,1645,-180
2018,9,17,19,1880,1923,1750,-173
2018,9,17,20,1976,2032,1758,-274
2018,9,17,21,2075,2114,1849,-265
2018,9,17,22,2165,2192,1937,-255
2018,9,17,23,2210,2235,2086,-149
2018,9,18,0,2215,2231,2083,-148
2018,9,18,1,2149,2162,2134,-28
2018,9,18,2,2091,2046,2146,100
2018,9,18,3,2055,2052,2146,94
2018,9,18,4,1942,1904,1985,81
2018,9,18,5,1767,1704,1768,64
2018,9,18,6,1614,1545,1692,147
2018,9,18,7,1508,1452,1593,141
2018,9,18,8,1447,1397,1621,224
2018,9,18,9,1398,1354,1512,158
2018,9,18,10,1386,1341,1481,140
2018,9,18,11,1386,1350,1522,172
2018,9,18,12,1426,1407,1576,169
2018,9,18,13,1519,1509,1631,122
2018,9,18,14,1565,1546,1647,101
2018,9,18,15,1623,1588,1574,-14
2018,9,18,16,1690,1662,1642,-20
2018,9,18,17,1756,1754,1731,-23
2018,9,18,18,1846,1844,1846,2
2018,9,18,19,1933,1926,1827,-99
2018,9,18,20,2029,2027,1907,-120
2018,9,18,21,2131,2132,2019,-113
2018,9,18,22,2214,2204,2089,-115
2018,9,18,23,2259,2246,2131,-115
2018,9,19,0,2255,2237,2104,-133
2018,9,19,1,2187,2168,2012,-156
2018,9,19,2,2131,2122,2079,-43
2018,9,19,3,2094,2063,2060,-3
2018,9,19,4,1975,1903,1973,70
2018,9,19,5,1801,1728,1868,140
2018,9,19,6,1644,1587,1828,241
2018,9,19,7,1542,1500,1785,285
2018,9,19,8,1457,1433,1657,224
2018,9,19,9,1417,1401,1563,162
2018,9,19,10,1358,1381,1513,132
2018,9,19,11,1387,1385,1514,129
2018,9,19,12,1437,1443,1551,108
2018,9,19,13,1536,1556,1567,11
2018,9,19,14,1585,1585,1668,83
2018,9,19,15,1626,1642,1734,92
2018,9,19,16,1688,1734,1753,19
2018,9,19,17,1752,1827,1732,-95
2018,9,19,18,1832,1917,1750,-167
2018,9,19,19,1899,1990,1806,-184
2018,9,19,20,1981,2064,1937,-127
2018,9,19,21,2063,2118,2054,-64
2018,9,19,22,2099,2134,2109,-25
2018,9,19,23,2098,2108,2153,45
2018,9,20,0,2053,2014,2075,61
2018,9,20,1,1964,1930,1991,61
2018,9,20,2,1913,1906,1952,46
2018,9,20,3,1885,1886,1864,-22
2018,9,20,4,1786,1768,1722,-46
2018,9,20,5,1643,1625,1609,-16
2018,9,20,6,1523,1500,1580,80
2018,9,20,7,1441,1428,1577,149
2018,9,20,8,1360,1380,1547,167
2018,9,20,9,1328,1335,1571,236
2018,9,20,10,1311,1317,1534,217
2018,9,20,11,1317,1324,1530,206
2018,9,20,12,1371,1376,1514,138
2018,9,20,13,1464,1486,1586,100
2018,9,20,14,1516,1524,1572,48
2018,9,20,15,1550,1532,1579,47
2018,9,20,16,1600,1577,1569,-8
2018,9,20,17,1635,1605,1556,-49
2018,9,20,18,1676,1593,1490,-103
2018,9,20,19,1710,1622,1497,-125
2018,9,20,20,1759,1645,1555,-90
2018,9,20,21,1823,1683,1740,57
2018,9,20,22,1876,1696,1839,143
2018,9,20,23,1906,1722,1928,206
2018,9,21,0,1909,1754,1992,238
2018,9,21,1,1875,1726,1821,95
2018,9,21,2,1844,1748,1786,38
2018,9,21,3,1856,1745,1783,38
2018,9,21,4,1747,1646,1674,28
2018,9,21,5,1613,1516,1616,100
2018,9,21,6,1485,1384,1521,137
2018,9,21,7,1391,1316,1488,172
2018,9,21,8,1316,1267,1546,279
2018,9,21,9,1279,1233,1612,379
2018,9,21,10,1263,1222,1616,394
2018,9,21,11,1264,1232,1636,404
2018,9,21,12,1310,1295,1767,472
2018,9,21,13,1396,1401,1850,449
2018,9,21,14,1452,1430,1853,423
2018,9,21,15,1479,1457,1901,444
2018,9,21,16,1521,1489,2016,527
2018,9,21,17,1565,1540,2097,557
2018,9,21,18,1611,1583,2110,527
2018,9,21,19,1651,1628,2110,482
2018,9,21,20,1701,1676,2077,401
2018,9,21,21,1741,1707,2067,360
2018,9,21,22,1799,1771,2081,310
2018,9,21,23,1799,1796,2058,262
2018,9,22,0,1775,1796,1998,202
2018,9,22,1,1736,1735,1879,144
2018,9,22,2,1723,1724,1852,128
2018,9,22,3,1729,1724,1842,118
2018,9,22,4,1653,1640,1731,91
2018,9,22,5,1554,1538,1702,164
2018,9,22,6,1442,1440,1569,129
2018,9,22,7,1364,1368,1471,103
2018,9,22,8,1290,1313,1389,76
2018,9,22,9,1254,1278,1341,63
2018,9,22,10,1243,1263,1356,93
2018,9,22,11,1239,1253,1297,44
2018,9,22,12,1256,1268,1247,-21
2018,9,22,13,1287,1301,1285,-16
2018,9,22,14,1311,1319,1274,-45
2018,9,22,15,1345,1372,1386,14
2018,9,22,16,1387,1411,1441,30
2018,9,22,17,1416,1463,1507,44
2018,9,22,18,1443,1500,1512,12
2018,9,22,19,1479,1552,1511,-41
2018,9,22,20,1512,1600,1536,-64
2018,9,22,21,1567,1672,1568,-104
2018,9,22,22,1616,1735,1573,-162
2018,9,22,23,1662,1795,1614,-181
2018,9,23,0,1686,1812,1623,-189
2018,9,23,1,1692,1779,1588,-191
2018,9,23,2,1685,1761,1640,-121
2018,9,23,3,1692,1720,1780,60
2018,9,23,4,1628,1622,1758,136
2018,9,23,5,1524,1508,1657,149
2018,9,23,6,1417,1388,1382,-6
2018,9,23,7,1336,1300,1206,-94
2018,9,23,8,1284,1261,1112,-149
2018,9,23,9,1250,1233,1019,-214
2018,9,23,10,1230,1205,1000,-205
2018,9,23,11,1228,1203,996,-207
2018,9,23,12,1244,1225,987,-238
2018,9,23,13,1259,1252,1032,-220
2018,9,23,14,1279,1261,1092,-169
2018,9,23,15,1311,1300,1108,-192
2018,9,23,16,1364,1353,1033,-320
2018,9,23,17,1404,1404,1089,-315
2018,9,23,18,1451,1461,1136,-325
2018,9,23,19,1503,1525,1206,-319
2018,9,23,20,1558,1590,1245,-345
2018,9,23,21,1586,1663,1322,-341
2018,9,23,22,1653,1728,1395,-333
2018,9,23,23,1702,1775,1463,-312
2018,9,24,0,1738,1814,1472,-342
2018,9,24,1,1734,1780,1513,-267
2018,9,24,2,1714,1767,1596,-171
2018,9,24,3,1734,1819,1604,-215
2018,9,24,4,1664,1635,1453,-182
2018,9,24,5,1544,1528,1364,-164
2018,9,24,6,1426,1365,1261,-104
2018,9,24,7,1339,1294,1238,-56
2018,9,24,8,1276,1257,1245,-12
2018,9,24,9,1250,1227,1229,2
2018,9,24,10,1237,1215,1270,55
2018,9,24,11,1244,1228,1296,68
2018,9,24,12,1294,1282,1294,12
2018,9,24,13,1379,1388,1327,-61
2018,9,24,14,1436,1422,1347,-75
2018,9,24,15,1468,1450,1316,-134
2018,9,24,16,1503,1482,1279,-203
2018,9,24,17,1537,1538,1251,-287
2018,9,24,18,1579,1587,1286,-301
2018,9,24,19,1629,1642,1397,-245
2018,9,24,20,1696,1713,1453,-260
2018,9,24,21,1752,1789,1666,-123
2018,9,24,22,1807,1846,1718,-128
2018,9,24,23,1841,1898,1733,-165
2018,9,25,0,1840,1911,1658,-253
2018,9,25,1,1804,1868,1502,-366
2018,9,25,2,1780,1862,1513,-349
2018,9,25,3,1795,1812,1526,-286
2018,9,25,4,1713,1692,1423,-269
2018,9,25,5,1578,1543,1312,-231
2018,9,25,6,1440,1422,1288,-134
2018,9,25,7,1356,1350,1252,-98
2018,9,25,8,1325,1300,1203,-97
2018,9,25,9,1289,1270,1106,-164
2018,9,25,10,1267,1253,1133,-120
2018,9,25,11,1272,1261,1070,-191
2018,9,25,12,1327,1320,1114,-206
2018,9,25,13,1429,1429,1191,-238
2018,9,25,14,1481,1470,1296,-174
2018,9,25,15,1510,1509,1248,-261
2018,9,25,16,1555,1539,1297,-242
2018,9,25,17,1590,1594,1316,-278
2018,9,25,18,1648,1652,1363,-289
2018,9,25,19,1702,1732,1408,-324
2018,9,25,20,1761,1795,1536,-259
2018,9,25,21,1822,1859,1624,-235
2018,9,25,22,1867,1901,1734,-167
2018,9,25,23,1875,1887,1775,-112
2018,9,26,0,1867,1818,1738,-80
2018,9,26,1,1811,1764,1681,-83
2018,9,26,2,1781,1734,1695,-39
2018,9,26,3,1783,1689,1589,-100
2018,9,26,4,1693,1603,1413,-190
2018,9,26,5,1557,1474,1404,-70
2018,9,26,6,1488,1369,1279,-90
2018,9,26,7,1327,1298,1177,-121
2018,9,26,8,1304,1254,1207,-47
2018,9,26,9,1259,1225,1230,5
2018,9,26,10,1246,1199,1099,-100
2018,9,26,11,1252,1218,1065,-153
2018,9,26,12,1306,1274,1122,-152
2018,9,26,13,1407,1383,1154,-229
2018,9,26,14,1463,1426,1050,-376
2018,9,26,15,1481,1439,1097,-342
2018,9,26,16,1500,1461,1112,-349
2018,9,26,17,1520,1477,1256,-221
2018,9,26,18,1530,1488,1289,-199
2018,9,26,19,1535,1510,1270,-240
2018,9,26,20,1564,1544,1216,-328
2018,9,26,21,1594,1614,1213,-401
2018,9,26,22,1617,1628,1212,-416
2018,9,26,23,1633,1677,1199,-478
2018,9,27,0,1641,1693,1210,-483
2018,9,27,1,1638,1681,1189,-492
2018,9,27,2,1649,1716,1208,-508
2018,9,27,3,1671,1687,1254,-433
2018,9,27,4,1614,1596,1210,-386
2018,9,27,5,1502,1467,1103,-364
2018,9,27,6,1387,1350,1020,-330
2018,9,27,7,1315,1282,1056,-226
2018,9,27,8,1266,1240,1119,-121
2018,9,27,9,1237,1221,1136,-85
2018,9,27,10,1225,1198,1129,-69
2018,9,27,11,1236,1224,1121,-103
2018,9,27,12,1291,1281,1115,-166
2018,9,27,13,1385,1400,1220,-180
2018,9,27,14,1440,1434,1249,-185
2018,9,27,15,1458,1444,1284,-160
2018,9,27,16,1485,1457,1354,-103
2018,9,27,17,1496,1486,1347,-139
2018,9,27,18,1535,1520,1401,-119
2018,9,27,19,1568,1561,1467,-94
2018,9,27,20,1625,1612,1455,-157
2018,9,27,21,1685,1665,1482,-183
2018,9,27,22,1749,1739,1551,-188
2018,9,27,23,1796,1787,1534,-253
2018,9,28,0,1807,1786,1494,-292
2018,9,28,1,1782,1754,1451,-303
2018,9,28,2,1758,1758,1446,-312
2018,9,28,3,1765,1716,1472,-244
2018,9,28,4,1687,1620,1506,-114
2018,9,28,5,1553,1492,1352,-140
2018,9,28,6,1430,1367,1367,0
2018,9,28,7,1352,1291,1357,66
2018,9,28,8,1292,1249,1309,60
2018,9,28,9,1262,1217,1255,38
2018,9,28,10,1241,1205,1185,-20
2018,9,28,11,1251,1220,1174,-46
2018,9,28,12,1294,1276,1187,-89
2018,9,28,13,1373,1385,1231,-154
2018,9,28,14,1426,1417,1172,-245
2018,9,28,15,1457,1421,1096,-325
2018,9,28,16,1493,1443,1086,-357
2018,9,28,17,1530,1482,1112,-370
2018,9,28,18,1579,1526,1163,-363
2018,9,28,19,1630,1562,1206,-356
2018,9,28,20,1695,1635,1285,-350
2018,9,28,21,1767,1695,1350,-345
2018,9,28,22,1820,1771,1428,-343
2018,9,28,23,1868,1827,1493,-334
2018,9,29,0,1859,1830,1450,-380
2018,9,29,1,1821,1779,1437,-342
2018,9,29,2,1775,1767,1521,-246
2018,9,29,3,1774,1733,1602,-131
2018,9,29,4,1701,1635,1513,-122
2018,9,29,5,1584,1501,1337,-164
2018,9,29,6,1464,1382,1279,-103
2018,9,29,7,1380,1297,1187,-110
2018,9,29,8,1297,1247,1049,-198
2018,9,29,9,1261,1211,1020,-191
2018,9,29,10,1240,1197,969,-228
2018,9,29,11,1237,1210,914,-296
2018,9,29,12,1255,1223,881,-342
2018,9,29,13,1286,1279,888,-391
2018,9,29,14,1312,1281,884,-397
2018,9,29,15,1352,1310,1046,-264
2018,9,29,16,1396,1338,1085,-253
2018,9,29,17,1439,1394,1137,-257
2018,9,29,18,1493,1451,1207,-244
2018,9,29,19,1543,1507,1253,-254
2018,9,29,20,1608,1570,1365,-205
2018,9,29,21,1673,1645,1491,-154
2018,9,29,22,1741,1713,1562,-151
2018,9,29,23,1789,1778,1573,-205
2018,9,30,0,1815,1802,1512,-290
2018,9,30,1,1796,1767,1374,-393
2018,9,30,2,1758,1766,1326,-440
2018,9,30,3,1740,1709,1372,-337
2018,9,30,4,1668,1622,1404,-218
2018,9,30,5,1562,1509,1235,-274
2018,9,30,6,1445,1401,1198,-203
2018,9,30,7,1373,1333,1140,-193
2018,9,30,8,1330,1275,1150,-125
2018,9,30,9,1286,1241,1268,27
2018,9,30,10,1261,1215,1330,115
2018,9,30,11,1259,1220,1340,120
2018,9,30,12,1270,1239,1321,82
2018,9,30,13,1290,1259,1309,50
2018,9,30,14,1306,1250,1247,-3
2018,9,30,15,1359,1304,1147,-157
2018,9,30,16,1417,1354,1064,-290
2018,9,30,17,1471,1427,1068,-359
2018,9,30,18,1537,1498,1145,-353
2018,9,30,19,1601,1566,1208,-358
2018,9,30,20,1671,1631,1256,-375
2018,9,30,21,1740,1697,1261,-436
2018,9,30,22,1796,1761,1334,-427
2018,9,30,23,1850,1827,1314,-513
2018,10,1,0,1856,1843,1303,-540
2018,10,1,1,1842,1813,1246,-567
2018,10,1,2,1811,1833,1307,-526
2018,10,1,3,1804,1780,1380,-400
2018,10,1,4,1715,1679,1517,-162
2018,10,1,5,1594,1535,1409,-126
2018,10,1,6,1472,1410,1228,-182
2018,10,1,7,1392,1328,1149,-179
2018,10,1,8,1336,1282,1031,-251
2018,10,1,9,1294,1252,1073,-179
2018,10,1,10,1281,1248,1112,-136
2018,10,1,11,1283,1260,1163,-97
2018,10,1,12,1336,1311,1182,-129
2018,10,1,13,1426,1435,1300,-135
2018,10,1,14,1483,1476,1268,-208
2018,10,1,15,1513,1503,1156,-347
2018,10,1,16,1562,1545,1184,-361
2018,10,1,17,1613,1595,1295,-300
2018,10,1,18,1671,1661,1313,-348
2018,10,1,19,1733,1727,1378,-349
2018,10,1,20,1799,1789,1465,-324
2018,10,1,21,1850,1858,1499,-359
2018,10,1,22,1904,1886,1484,-402
2018,10,1,23,1925,1865,1458,-407
2018,10,2,0,1928,1829,1458,-371
2018,10,2,1,1870,1809,1442,-367
2018,10,2,2,1849,1830,1471,-359
2018,10,2,3,1834,1807,1518,-289
2018,10,2,4,1744,1689,1460,-229
2018,10,2,5,1610,1569,1234,-335
2018,10,2,6,1473,1445,1157,-288
2018,10,2,7,1383,1369,1135,-234
2018,10,2,8,1325,1312,1113,-199
2018,10,2,9,1297,1281,1112,-169
2018,10,2,10,1281,1256,1061,-195
2018,10,2,11,1285,1266,935,-331
2018,10,2,12,1337,1333,896,-437
2018,10,2,13,1434,1435,911,-524
2018,10,2,14,1489,1484,961,-523
2018,10,2,15,1525,1504,1006,-498
2018,10,2,16,1574,1534,1083,-451
2018,10,2,17,1636,1648,1244,-404
2018,10,2,18,1699,1665,1350,-315
2018,10,2,19,1764,1717,1477,-240
2018,10,2,20,1833,1784,1549,-235
2018,10,2,21,1898,1842,1649,-193
2018,10,2,22,1957,1833,1675,-158
2018,10,2,23,1970,1770,1656,-114
2018,10,3,0,1945,1722,1552,-170
2018,10,3,1,1885,1702,1583,-119
2018,10,3,2,1867,1739,1705,-34
2018,10,3,3,1845,1710,1567,-143
2018,10,3,4,1742,1621,1495,-126
2018,10,3,5,1604,1483,1337,-146
2018,10,3,6,1472,1379,1203,-176
2018,10,3,7,1382,1326,1077,-249
2018,10,3,8,1337,1281,1101,-180
2018,10,3,9,1302,1259,1125,-134
2018,10,3,10,1285,1251,1203,-48
2018,10,3,11,1291,1258,1284,26
2018,10,3,12,1348,1322,1320,-2
2018,10,3,13,1450,1423,1227,-196
2018,10,3,14,1504,1449,1371,-78
2018,10,3,15,1538,1487,1374,-113
2018,10,3,16,1580,1497,1441,-56
2018,10,3,17,1632,1544,1636,92
2018,10,3,18,1687,1599,1696,97
2018,10,3,19,1747,1673,1660,-13
2018,10,3,20,1819,1709,1675,-34
2018,10,3,21,1885,1766,1653,-113
2018,10,3,22,1942,1810,1602,-208
2018,10,3,23,1961,1850,1595,-255
2018,10,4,0,1949,1841,1503,-338
2018,10,4,1,1905,1809,1482,-327
2018,10,4,2,1885,1832,1451,-381
2018,10,4,3,1869,1796,1402,-394
2018,10,4,4,1768,1692,1433,-259
2018,10,4,5,1632,1552,1478,-74
2018,10,4,6,1491,1431,1396,-35
2018,10,4,7,1401,1350,1333,-17
2018,10,4,8,1309,1298,1205,-93
2018,10,4,9,1278,1267,1222,-45
2018,10,4,10,1266,1254,1256,2
2018,10,4,11,1270,1258,1228,-30
2018,10,4,12,1325,1315,1275,-40
2018,10,4,13,1422,1441,1283,-158
2018,10,4,14,1479,1468,1320,-148
2018,10,4,15,1503,1489,1323,-166
2018,10,4,16,1533,1525,1372,-153
2018,10,4,17,1572,1572,1387,-185
2018,10,4,18,1614,1611,1514,-97
2018,10,4,19,1661,1646,1576,-70
2018,10,4,20,1727,1697,1606,-91
2018,10,4,21,1801,1735,1711,-24
2018,10,4,22,1850,1763,1748,-15
2018,10,4,23,1871,1764,1769,5
2018,10,5,0,1861,1782,1785,3
2018,10,5,1,1827,1763,1666,-97
2018,10,5,2,1822,1785,1713,-72
2018,10,5,3,1797,1764,1785,21
2018,10,5,4,1708,1648,1742,94
2018,10,5,5,1577,1515,1716,201
2018,10,5,6,1447,1402,1509,107
2018,10,5,7,1360,1317,1415,98
2018,10,5,8,1274,1271,1364,93
2018,10,5,9,1252,1235,1170,-65
2018,10,5,10,1237,1223,1062,-161
2018,10,5,11,1244,1225,971,-254
2018,10,5,12,1293,1281,965,-316
2018,10,5,13,1385,1391,1075,-316
2018,10,5,14,1444,1408,1182,-226
2018,10,5,15,1458,1424,1301,-123
2018,10,5,16,1470,1449,1375,-74
2018,10,5,17,1495,1472,1470,-2
2018,10,5,18,1523,1505,1578,73
2018,10,5,19,1543,1545,1737,192
2018,10,5,20,1604,1579,1831,252
2018,10,5,21,1651,1622,1909,287
2018,10,5,22,1672,1663,1894,231
2018,10,5,23,1685,1688,1839,151
2018,10,6,0,1684,1685,1773,88
2018,10,6,1,1669,1653,1542,-111
2018,10,6,2,1671,1671,1301,-370
2018,10,6,3,1663,1689,1117,-572
2018,10,6,4,1600,1578,965,-613
2018,10,6,5,1504,1475,891,-584
2018,10,6,6,1387,1367,827,-540
2018,10,6,7,1325,1300,828,-472
2018,10,6,8,1270,1251,818,-433
2018,10,6,9,1239,1226,894,-332
2018,10,6,10,1220,1217,1036,-181
2018,10,6,11,1217,1224,1273,49
2018,10,6,12,1237,1244,1263,19
2018,10,6,13,1271,1294,1239,-55
2018,10,6,14,1301,1295,1191,-104
2018,10,6,15,1332,1325,1219,-106
2018,10,6,16,1367,1345,1193,-152
2018,10,6,17,1392,1370,1193,-177
2018,10,6,18,1416,1383,1192,-191
2018,10,6,19,1443,1392,1217,-175
2018,10,6,20,1469,1423,1272,-151
2018,10,6,21,1499,1458,1341,-117
2018,10,6,22,1529,1493,1423,-70
2018,10,6,23,1530,1525,1442,-83
2018,10,7,0,1575,1560,1444,-116
2018,10,7,1,1590,1561,1412,-149
2018,10,7,2,1609,1621,1353,-268
2018,10,7,3,1618,1584,1340,-244
2018,10,7,4,1570,1525,1214,-311
2018,10,7,5,1481,1432,1157,-275
2018,10,7,6,1380,1349,1040,-309
2018,10,7,7,1312,1292,1045,-247
2018,10,7,8,1270,1243,968,-275
2018,10,7,9,1239,1222,904,-318
2018,10,7,10,1220,1202,827,-375
2018,10,7,11,1217,1207,817,-390
2018,10,7,12,1231,1218,813,-405
2018,10,7,13,1259,1258,819,-439
2018,10,7,14,1275,1266,852,-414
2018,10,7,15,1307,1303,835,-468
2018,10,7,16,1345,1354,991,-363
2018,10,7,17,1373,1376,1149,-227
2018,10,7,18,1400,1414,1169,-245
2018,10,7,19,1421,1416,1255,-161
2018,10,7,20,1445,1450,1303,-147
2018,10,7,21,1473,1456,1317,-139
2018,10,7,22,1507,1474,1272,-202
2018,10,7,23,1524,1497,1229,-268
2018,10,8,0,1547,1515,1190,-325
2018,10,8,1,1562,1536,1182,-354
2018,10,8,2,1595,1581,1190,-391
2018,10,8,3,1609,1562,1119,-443
2018,10,8,4,1565,1481,1115,-366
2018,10,8,5,1474,1379,1096,-283
2018,10,8,6,1367,1280,901,-379
2018,10,8,7,1293,1216,811,-405
2018,10,8,8,1253,1191,764,-427
2018,10,8,9,1226,1179,681,-498
2018,10,8,10,1212,1178,652,-526
2018,10,8,11,1224,1189,684,-505
2018,10,8,12,1275,1251,819,-432
2018,10,8,13,1368,1356,990,-366
2018,10,8,14,1437,1387,1167,-220
2018,10,8,15,1453,1402,1154,-248
2018,10,8,16,1457,1401,1132,-269
2018,10,8,17,1466,1413,1240,-173
2018,10,8,18,1476,1420,1316,-104
2018,10,8,19,1481,1405,1326,-79
2018,10,8,20,1494,1401,1383,-18
2018,10,8,21,1510,1427,1345,-82
2018,10,8,22,1519,1430,1269,-161
2018,10,8,23,1530,1434,1235,-199
2018,10,9,0,1547,1454,1209,-245
2018,10,9,1,1573,1496,1178,-318
2018,10,9,2,1598,1577,1243,-334
2018,10,9,3,1627,1566,1273,-293
2018,10,9,4,1585,1490,1250,-240
2018,10,9,5,1484,1384,1185,-199
2018,10,9,6,1379,1293,1019,-274
2018,10,9,7,1307,1236,968,-268
2018,10,9,8,1276,1209,939,-270
2018,10,9,9,1250,1170,925,-245
2018,10,9,10,1245,1180,878,-302
2018,10,9,11,1256,1203,883,-320
2018,10,9,12,1306,1259,994,-265
2018,10,9,13,1398,1402,1030,-372
2018,10,9,14,1480,1423,1101,-322
2018,10,9,15,1489,1430,1150,-280
2018,10,9,16,1479,1439,1123,-316
2018,10,9,17,1469,1441,1130,-311
2018,10,9,18,1472,1428,1173,-255
2018,10,9,19,1463,1416,1225,-191
2018,10,9,20,1462,1417,1195,-222
2018,10,9,21,1475,1411,1110,-301
2018,10,9,22,1489,1439,1174,-265
2018,10,9,23,1498,1446,1123,-323
2018,10,10,0,1520,1465,1049,-416
2018,10,10,1,1552,1519,1063,-456
2018,10,10,2,1586,1590,1154,-436
2018,10,10,3,1621,1587,1107,-480
2018,10,10,4,1589,1528,1071,-457
2018,10,10,5,1500,1411,1062,-349
2018,10,10,6,1393,1316,1040,-276
2018,10,10,7,1311,1256,1057,-199
2018,10,10,8,1264,1222,1056,-166
2018,10,10,9,1248,1212,994,-218
2018,10,10,10,1247,1217,1040,-177
2018,10,10,11,1259,1243,1108,-135
2018,10,10,12,1314,1298,1281,-17
2018,10,10,13,1423,1419,1403,-16
2018,10,10,14,1490,1460,1470,10
2018,10,10,15,1488,1446,1320,-126
2018,10,10,16,1471,1419,1369,-50
2018,10,10,17,1462,1408,1491,83
2018,10,10,18,1466,1389,1559,170
2018,10,10,19,1462,1381,1606,225
2018,10,10,20,1451,1412,1637,225
2018,10,10,21,1473,1408,1653,245
2018,10,10,22,1493,1416,1671,255
2018,10,10,23,1509,1442,1682,240
2018,10,11,0,1521,1466,1597,131
2018,10,11,1,1539,1502,1527,25
2018,10,11,2,1584,1581,1552,-29
2018,10,11,3,1612,1571,1512,-59
2018,10,11,4,1570,1504,1447,-57
2018,10,11,5,1474,1407,1362,-45
2018,10,11,6,1369,1319,1258,-61
2018,10,11,7,1304,1264,1250,-14
2018,10,11,8,1264,1227,1230,3
2018,10,11,9,1241,1206,1221,15
2018,10,11,10,1235,1198,1199,1
2018,10,11,11,1248,1225,1205,-20
2018,10,11,12,1308,1295,1194,-101
2018,10,11,13,1412,1413,1307,-106
2018,10,11,14,1463,1454,1353,-101
2018,10,11,15,1460,1457,1379,-78
2018,10,11,16,1456,1451,1388,-63
2018,10,11,17,1456,1462,1340,-122
2018,10,11,18,1460,1453,1360,-93
2018,10,11,19,1461,1459,1401,-58
2018,10,11,20,1461,1472,1430,-42
2018,10,11,21,1485,1458,1513,55
2018,10,11,22,1514,1476,1693,217
2018,10,11,23,1522,1483,1758,275
2018,10,12,0,1524,1489,1740,251
2018,10,12,1,1545,1526,1750,224
2018,10,12,2,1586,1596,1760,164
2018,10,12,3,1623,1600,1709,109
2018,10,12,4,1581,1526,1670,144
2018,10,12,5,1481,1428,1633,205
2018,10,12,6,1372,1324,1496,172
2018,10,12,7,1306,1279,1257,-22
2018,10,12,8,1252,1233,987,-246
2018,10,12,9,1230,1219,861,-358
2018,10,12,10,1214,1213,864,-349
2018,10,12,11,1226,1234,898,-336
2018,10,12,12,1274,1301,1040,-261
2018,10,12,13,1368,1396,1054,-342
2018,10,12,14,1427,1434,1031,-403
2018,10,12,15,1437,1426,891,-535
2018,10,12,16,1438,1422,852,-570
2018,10,12,17,1452,1445,895,-550
2018,10,12,18,1459,1433,955,-478
2018,10,12,19,1464,1451,1018,-433
2018,10,12,20,1479,1459,1052,-407
2018,10,12,21,1485,1461,1058,-403
2018,10,12,22,1483,1449,1072,-377
2018,10,12,23,1494,1460,1109,-351
2018,10,13,0,1507,1452,1127,-325
2018,10,13,1,1513,1477,1192,-285
2018,10,13,2,1547,1543,1305,-238
2018,10,13,3,1571,1541,1232,-309
2018,10,13,4,1542,1495,1166,-329
2018,10,13,5,1462,1413,1136,-277
2018,10,13,6,1366,1331,1013,-318
2018,10,13,7,1302,1266,922,-344
2018,10,13,8,1258,1238,675,-563
2018,10,13,9,1227,1217,654,-563
2018,10,13,10,1218,1221,729,-492
2018,10,13,11,1217,1231,819,-412
2018,10,13,12,1237,1250,906,-344
2018,10,13,13,1275,1294,967,-327
2018,10,13,14,1304,1313,996,-317
2018,10,13,15,1336,1338,1073,-265
2018,10,13,16,1361,1333,1178,-155
2018,10,13,17,1383,1324,1268,-56
2018,10,13,18,1389,1319,1358,39
2018,10,13,19,1387,1358,1469,111
2018,10,13,20,1405,1376,1473,97
2018,10,13,21,1415,1394,1531,137
2018,10,13,22,1440,1414,1594,180
2018,10,13,23,1459,1440,1669,229
2018,10,14,0,1482,1460,1578,118
2018,10,14,1,1526,1508,1513,5
2018,10,14,2,1555,1556,1504,-52
2018,10,14,3,1568,1530,1535,5
2018,10,14,4,1518,1481,1545,64
2018,10,14,5,1442,1266,1413,147
2018,10,14,6,1354,1322,1512,190
2018,10,14,7,1292,1264,1460,196
2018,10,14,8,1255,1227,1452,225
2018,10,14,9,1223,1195,1423,228
2018,10,14,10,1213,1178,1378,200
2018,10,14,11,1211,1183,1381,198
2018,10,14,12,1236,1205,1384,179
2018,10,14,13,1269,1250,1330,80
2018,10,14,14,1287,1280,1281,1
2018,10,14,15,1311,1333,1329,-4
2018,10,14,16,1353,1366,1307,-59
2018,10,14,17,1372,1431,1398,-33
2018,10,14,18,1376,1407,1454,47
2018,10,14,19,1392,1397,1579,182
2018,10,14,20,1403,1406,1593,187
2018,10,14,21,1404,1425,1649,224
2018,10,14,22,1416,1437,1695,258
2018,10,14,23,1445,1445,1656,211
2018,10,15,0,1478,1478,1584,106
2018,10,15,1,1521,1538,1568,30
2018,10,15,2,1573,1611,1557,-54
2018,10,15,3,1600,1587,1495,-92
2018,10,15,4,1557,1525,1501,-24
2018,10,15,5,1478,1441,1399,-42
2018,10,15,6,1377,1351,1339,-12
2018,10,15,7,1312,1301,1290,-11
2018,10,15,8,1313,1265,1302,37
2018,10,15,9,1289,1256,1275,19
2018,10,15,10,1291,1245,1267,22
2018,10,15,11,1303,1276,1212,-64
2018,10,15,12,1351,1352,1193,-159
2018,10,15,13,1450,1486,1251,-235
2018,10,15,14,1539,1566,1334,-232
2018,10,15,15,1569,1590,1251,-339
2018,10,15,16,1567,1598,1219,-379
2018,10,15,17,1552,1593,1221,-372
2018,10,15,18,1539,1582,1205,-377
2018,10,15,19,1544,1554,1167,-387
2018,10,15,20,1544,1537,1099,-438
2018,10,15,21,1541,1549,1130,-419
2018,10,15,22,1546,1539,1120,-419
2018,10,15,23,1550,1541,1236,-305
2018,10,16,0,1572,1571,1249,-322
2018,10,16,1,1632,1649,1392,-257
2018,10,16,2,1685,1707,1473,-234
2018,10,16,3,1733,1712,1454,-258
2018,10,16,4,1705,1627,1430,-197
2018,10,16,5,1618,1503,1404,-99
2018,10,16,6,1507,1407,1359,-48
2018,10,16,7,1431,1349,1306,-43
2018,10,16,8,1376,1315,1176,-139
2018,10,16,9,1345,1299,1203,-96
2018,10,16,10,1330,1299,1181,-118
2018,10,16,11,1337,1318,1174,-144
2018,10,16,12,1383,1385,1314,-71
2018,10,16,13,1484,1527,1400,-127
2018,10,16,14,1578,1583,1438,-145
2018,10,16,15,1598,1608,1529,-79
2018,10,16,16,1580,1532,1568,36
2018,10,16,17,1567,1513,1636,123
2018,10,16,18,1552,1507,1636,129
2018,10,16,19,1529,1470,1607,137
2018,10,16,20,1512,1487,1679,192
2018,10,16,21,1507,1513,1701,188
2018,10,16,22,1505,1538,1672,134
2018,10,16,23,1499,1551,1658,107
2018,10,17,0,1524,1585,1677,92
2018,10,17,1,1581,1654,1694,40
2018,10,17,2,1656,1685,1710,25
2018,10,17,3,1696,1680,1741,61
2018,10,17,4,1668,1604,1662,58
2018,10,17,5,1582,1496,1568,72
2018,10,17,6,1478,1400,1559,159
2018,10,17,7,1401,1334,1470,136
2018,10,17,8,1334,1334,1347,13
2018,10,17,9,1311,1270,1226,-44
2018,10,17,10,1303,1262,1255,-7
2018,10,17,11,1311,1285,1360,75
2018,10,17,12,1364,1371,1491,120
2018,10,17,13,1470,1506,1544,38
2018,10,17,14,1553,1551,1537,-14
2018,10,17,15,1571,1536,1538,2
2018,10,17,16,1556,1533,1547,14
2018,10,17,17,1545,1504,1631,127
2018,10,17,18,1529,1476,1599,123
2018,10,17,19,1516,1430,1575,145
2018,10,17,20,1510,1435,1659,224
2018,10,17,21,1506,1444,1612,168
2018,10,17,22,1504,1406,1568,162
2018,10,17,23,1508,1478,1554,76
2018,10,18,0,1531,1509,1617,108
2018,10,18,1,1585,1590,1637,47
2018,10,18,2,1647,1642,1664,22
2018,10,18,3,1686,1630,1652,22
2018,10,18,4,1655,1556,1594,38
2018,10,18,5,1569,1446,1526,80
2018,10,18,6,1463,1354,1527,173
2018,10,18,7,1388,1302,1430,128
2018,10,18,8,1316,1267,1412,145
2018,10,18,9,1282,1252,1377,125
2018,10,18,10,1272,1251,1331,80
2018,10,18,11,1291,1266,1304,38
2018,10,18,12,1339,1353,1293,-60
2018,10,18,13,1450,1491,1275,-216
2018,10,18,14,1543,1548,1309,-239
2018,10,18,15,1550,1545,1363,-182
2018,10,18,16,1545,1553,1311,-242
2018,10,18,17,1536,1550,1275,-275
2018,10,18,18,1527,1515,1215,-300
2018,10,18,19,1514,1502,1230,-272
2018,10,18,20,1513,1504,1185,-319
2018,10,18,21,1508,1499,1154,-345
2018,10,18,22,1505,1498,1114,-384
2018,10,18,23,1511,1505,1129,-376
2018,10,19,0,1527,1524,1103,-421
2018,10,19,1,1581,1596,1169,-427
2018,10,19,2,1634,1659,1232,-427
2018,10,19,3,1656,1648,1223,-425
2018,10,19,4,1620,1578,1189,-389
2018,10,19,5,1534,1466,1139,-327
2018,10,19,6,1434,1384,1133,-251
2018,10,19,7,1355,1318,1204,-114
2018,10,19,8,1270,1283,1281,-2
2018,10,19,9,1239,1261,1278,17
2018,10,19,10,1232,1252,1277,25
2018,10,19,11,1247,1281,1333,52
2018,10,19,12,1292,1349,1365,16
2018,10,19,13,1397,1478,1421,-57
2018,10,19,14,1471,1524,1421,-103
2018,10,19,15,1482,1506,1279,-227
2018,10,19,16,1472,1467,1099,-368
2018,10,19,17,1456,1446,1077,-369
2018,10,19,18,1443,1427,1159,-268
2018,10,19,19,1434,1402,1220,-182
2018,10,19,20,1431,1402,1250,-152
2018,10,19,21,1428,1403,1291,-112
2018,10,19,22,1425,1406,1300,-106
2018,10,19,23,1444,1419,1292,-127
2018,10,20,0,1464,1431,1405,-26
2018,10,20,1,1504,1479,1403,-76
2018,10,20,2,1553,1540,1431,-109
2018,10,20,3,1568,1553,1414,-139
2018,10,20,4,1529,1509,1370,-139
2018,10,20,5,1459,1426,1334,-92
2018,10,20,6,1368,1343,1323,-20
2018,10,20,7,1304,1295,1260,-35
2018,10,20,8,1259,1259,1217,-42
2018,10,20,9,1227,1296,1229,-67
2018,10,20,10,1218,1231,1289,58
2018,10,20,11,1222,1241,1282,41
2018,10,20,12,1253,1272,1351,79
2018,10,20,13,1305,1328,1369,41
2018,10,20,14,1335,1361,1309,-52
2018,10,20,15,1362,1393,1220,-173
2018,10,20,16,1383,1374,1146,-228
2018,10,20,17,1384,1358,1156,-202
2018,10,20,18,1376,1353,1210,-143
2018,10,20,19,1373,1327,1146,-181
2018,10,20,20,1390,1324,1135,-189
2018,10,20,21,1400,1334,1078,-256
2018,10,20,22,1410,1357,1120,-237
2018,10,20,23,1420,1400,1020,-380
2018,10,21,0,1453,1420,905,-515
2018,10,21,1,1503,1485,922,-563
2018,10,21,2,1548,1539,942,-597
2018,10,21,3,1555,1523,866,-657
2018,10,21,4,1508,1472,874,-598
2018,10,21,5,1437,1397,908,-489
2018,10,21,6,1368,1330,875,-455
2018,10,21,7,1311,1275,805,-470
2018,10,21,8,1275,1231,749,-482
2018,10,21,9,1241,1211,731,-480
2018,10,21,10,1226,1202,744,-458
2018,10,21,11,1239,1207,777,-430
2018,10,21,12,1263,1237,706,-531
2018,10,21,13,1306,1285,679,-606
2018,10,21,14,1326,1310,674,-636
2018,10,21,15,1349,1364,773,-591
2018,10,21,16,1372,1357,829,-528
2018,10,21,17,1386,1346,943,-403
2018,10,21,18,1387,1352,1035,-317
2018,10,21,19,1391,1343,1069,-274
2018,10,21,20,1399,1341,1071,-270
2018,10,21,21,1402,1369,1056,-313
2018,10,21,22,1418,1358,987,-371
2018,10,21,23,1435,1402,1022,-380
2018,10,22,0,1459,1447,972,-475
2018,10,22,1,1520,1534,985,-549
2018,10,22,2,1581,1586,1047,-539
2018,10,22,3,1599,1570,1073,-497
2018,10,22,4,1545,1496,1005,-491
2018,10,22,5,1453,1396,1008,-388
2018,10,22,6,1358,1306,874,-432
2018,10,22,7,1297,1244,862,-382
2018,10,22,8,1254,1220,1043,-177
2018,10,22,9,1229,1198,1059,-139
2018,10,22,10,1217,1202,1055,-147
2018,10,22,11,1236,1213,1071,-142
2018,10,22,12,1299,1280,1019,-261
2018,10,22,13,1409,1406,911,-495
2018,10,22,14,1480,1476,863,-613
2018,10,22,15,1488,1468,738,-730
2018,10,22,16,1483,1457,760,-697
2018,10,22,17,1483,1465,802,-663
2018,10,22,18,1480,1451,850,-601
2018,10,22,19,1472,1457,862,-595
2018,10,22,20,1482,1448,896,-552
2018,10,22,21,1486,1463,911,-552
2018,10,22,22,1498,1490,911,-579
2018,10,22,23,1510,1508,999,-509
2018,10,23,0,1527,1506,1012,-494
2018,10,23,1,1566,1575,1043,-532
2018,10,23,2,1606,1591,1160,-431
2018,10,23,3,1621,1592,1086,-506
2018,10,23,4,1563,1510,945,-565
2018,10,23,5,1464,1400,847,-553
2018,10,23,6,1363,1302,802,-500
2018,10,23,7,1296,1251,700,-551
2018,10,23,8,1253,1208,704,-504
2018,10,23,9,1225,1195,710,-485
2018,10,23,10,1214,1193,710,-483
2018,10,23,11,1225,1215,728,-487
2018,10,23,12,1286,1283,781,-502
2018,10,23,13,1400,1427,785,-642
2018,10,23,14,1466,1486,808,-678
2018,10,23,15,1486,1472,765,-707
2018,10,23,16,1490,1485,787,-698
2018,10,23,17,1491,1477,821,-656
2018,10,23,18,1497,1478,797,-681
2018,10,23,19,1493,1479,822,-657
2018,10,23,20,1491,1482,788,-694
2018,10,23,21,1507,1530,866,-664
2018,10,23,22,1511,1535,860,-675
2018,10,23,23,1520,1547,851,-696
2018,10,24,0,1542,1566,936,-630
2018,10,24,1,1578,1622,965,-657
2018,10,24,2,1609,1640,919,-721
2018,10,24,3,1619,1625,919,-706
2018,10,24,4,1556,1540,962,-578
2018,10,24,5,1449,1442,952,-490
2018,10,24,6,1350,1347,1040,-307
2018,10,24,7,1285,1294,1189,-105
2018,10,24,8,1251,1258,1253,-5
2018,10,24,9,1227,1237,1274,37
2018,10,24,10,1215,1242,1245,3
2018,10,24,11,1226,1262,1279,17
2018,10,24,12,1287,1341,1364,23
2018,10,24,13,1407,1466,1352,-114
2018,10,24,14,1480,1530,1346,-184
2018,10,24,15,1487,1545,1326,-219
2018,10,24,16,1485,1554,1279,-275
2018,10,24,17,1486,1554,1191,-363
2018,10,24,18,1483,1518,1126,-392
2018,10,24,19,1477,1519,1219,-300
2018,10,24,20,1485,1493,1231,-262
2018,10,24,21,1491,1500,1205,-295
2018,10,24,22,1491,1486,1244,-242
2018,10,24,23,1507,1469,1204,-265
2018,10,25,0,1529,1497,1188,-309
2018,10,25,1,1574,1552,1274,-278
2018,10,25,2,1609,1619,1342,-277
2018,10,25,3,1618,1602,1397,-205
2018,10,25,4,1556,1537,1468,-69
2018,10,25,5,1455,1432,1430,-2
2018,10,25,6,1351,1344,1324,-20
2018,10,25,7,1285,1304,1206,-98
2018,10,25,8,1240,1269,1127,-142
2018,10,25,9,1219,1243,1125,-118
2018,10,25,10,1212,1249,1131,-118
2018,10,25,11,1247,1265,1283,18
2018,10,25,12,1310,1337,1372,35
2018,10,25,13,1433,1486,1445,-41
2018,10,25,14,1496,1527,1453,-74
2018,10,25,15,1486,1518,1463,-55
2018,10,25,16,1477,1480,1408,-72
2018,10,25,17,1466,1451,1401,-50
2018,10,25,18,1462,1422,1397,-25
2018,10,25,19,1454,1401,1281,-120
2018,10,25,20,1453,1410,1239,-171
2018,10,25,21,1473,1420,1304,-116
2018,10,25,22,1481,1435,1277,-158
2018,10,25,23,1487,1453,1224,-229
2018,10,26,0,1502,1454,1237,-217
2018,10,26,1,1557,1529,1211,-318
2018,10,26,2,1595,1582,1285,-297
2018,10,26,3,1602,1573,1236,-337
2018,10,26,4,1544,1522,1215,-307
2018,10,26,5,1447,1425,1104,-321
2018,10,26,6,1344,1344,1104,-240
2018,10,26,7,1276,1284,1135,-149
2018,10,26,8,1252,1225,1130,-95
2018,10,26,9,1232,1239,1187,-52
2018,10,26,10,1231,1240,1121,-119
2018,10,26,11,1245,1262,1119,-143
2018,10,26,12,1307,1342,1169,-173
2018,10,26,13,1424,1467,1292,-175
2018,10,26,14,1492,1527,1303,-224
2018,10,26,15,1497,1512,1270,-242
2018,10,26,16,1483,1472,1177,-295
2018,10,26,17,1463,1446,1197,-249
2018,10,26,18,1441,1421,1235,-186
2018,10,26,19,1432,1389,1282,-107
2018,10,26,20,1429,1397,1284,-113
2018,10,26,21,1438,1403,1311,-92
2018,10,26,22,1433,1402,1321,-81
2018,10,26,23,1444,1414,1353,-61
2018,10,27,0,1447,1424,1366,-58
2018,10,27,1,1485,1481,1350,-131
2018,10,27,2,1541,1538,1397,-141
2018,10,27,3,1563,1535,1424,-111
2018,10,27,4,1523,1491,1393,-98
2018,10,27,5,1447,1425,1215,-210
2018,10,27,6,1361,1354,1160,-194
2018,10,27,7,1305,1300,1197,-103
2018,10,27,8,1271,1265,1237,-28
2018,10,27,9,1250,1249,1273,24
2018,10,27,10,1238,1238,1260,22
2018,10,27,11,1243,1251,1212,-39
2018,10,27,12,1281,1285,1198,-87
2018,10,27,13,1336,1345,1163,-182
2018,10,27,14,1365,1386,1176,-210
2018,10,27,15,1385,1402,1145,-257
2018,10,27,16,1387,1382,1058,-324
2018,10,27,17,1381,1367,1084,-283
2018,10,27,18,1370,1351,1147,-204
2018,10,27,19,1360,1347,1163,-184
2018,10,27,20,1373,1346,1141,-205
2018,10,27,21,1381,1338,1193,-145
2018,10,27,22,1387,1396,1303,-93
2018,10,27,23,1414,1391,1298,-93
2018,10,28,0,1437,1511,1367,-144
2018,10,28,1,1488,1488,1367,-121
2018,10,28,2,1537,1533,1395,-138
2018,10,28,3,1548,1521,1393,-128
2018,10,28,4,1503,1474,1370,-104
2018,10,28,5,1427,1407,1391,-16
2018,10,28,6,1347,1348,1383,35
2018,10,28,7,1292,1289,1303,14
2018,10,28,8,1252,1238,1307,69
2018,10,28,9,1232,1230,1325,95
2018,10,28,10,1221,1218,1283,65
2018,10,28,11,1224,1231,1289,58
2018,10,28,12,1249,1254,1246,-8
2018,10,28,13,1298,1303,1204,-99
2018,10,28,14,1317,1330,1184,-146
2018,10,28,15,1333,1350,1242,-108
2018,10,28,16,1341,1337,1279,-58
2018,10,28,17,1348,1322,1200,-122
2018,10,28,18,1353,1323,937,-386
2018,10,28,19,1360,1327,817,-510
2018,10,28,20,1379,1331,795,-536
2018,10,28,21,1390,1340,793,-547
2018,10,28,22,1412,1365,790,-575
2018,10,28,23,1442,1404,856,-548
2018,10,29,0,1471,1452,792,-660
2018,10,29,1,1528,1536,826,-710
2018,10,29,2,1567,1568,898,-670
2018,10,29,3,1576,1543,828,-715
2018,10,29,4,1518,1469,786,-683
2018,10,29,5,1424,1358,878,-480
2018,10,29,6,1331,1292,962,-330
2018,10,29,7,1273,1226,908,-318
2018,10,29,8,1228,1205,894,-311
2018,10,29,9,1211,1196,921,-275
2018,10,29,10,1203,1200,945,-255
2018,10,29,11,1222,1223,967,-256
2018,10,29,12,1282,1298,1009,-289
2018,10,29,13,1400,1435,1173,-262
2018,10,29,14,1467,1449,1092,-357
2018,10,29,15,1473,1474,1203,-271
2018,10,29,16,1473,1441,1187,-254
2018,10,29,17,1472,1432,1198,-234
2018,10,29,18,1468,1427,1204,-223
2018,10,29,19,1477,1425,1160,-265
2018,10,29,20,1490,1413,1140,-273
2018,10,29,21,1503,1426,1195,-231
2018,10,29,22,1519,1458,1288,-170
2018,10,29,23,1529,1459,1219,-240
2018,10,30,0,1529,1469,1198,-271
2018,10,30,1,1565,1548,1288,-260
2018,10,30,2,1602,1574,1413,-161
2018,10,30,3,1610,1567,1445,-122
2018,10,30,4,1547,1509,1440,-69
2018,10,30,5,1446,1395,1409,14
2018,10,30,6,1344,1304,1396,92
2018,10,30,7,1279,1241,1287,46
2018,10,30,8,1243,1206,1137,-69
2018,10,30,9,1218,1193,1135,-58
2018,10,30,10,1211,1230,1180,-50
2018,10,30,11,1228,1218,1159,-59
2018,10,30,12,1295,1294,1128,-166
2018,10,30,13,1416,1430,1125,-305
2018,10,30,14,1485,1502,1173,-329
2018,10,30,15,1490,1486,1120,-366
2018,10,30,16,1479,1478,1069,-409
2018,10,30,17,1470,1468,1023,-445
2018,10,30,18,1461,1459,1058,-401
2018,10,30,19,1462,1433,1101,-332
2018,10,30,20,1471,1425,1152,-273
2018,10,30,21,1491,1415,1084,-331
2018,10,30,22,1489,1436,1089,-347
2018,10,30,23,1503,1441,1081,-360
2018,10,31,0,1510,1478,1254,-224
2018,10,31,1,1546,1551,1327,-224
2018,10,31,2,1591,1598,1297,-301
2018,10,31,3,1603,1581,1254,-327
2018,10,31,4,1547,1507,1332,-175
2018,10,31,5,1443,1421,1258,-163
2018,10,31,6,1350,1310,1135,-175
2018,10,31,7,1292,1258,1098,-160
2018,10,31,8,1277,1216,1159,-57
2018,10,31,9,1251,1197,1146,-51
2018,10,31,10,1251,1187,1047,-140
2018,10,31,11,1267,1217,1197,-20
2018,10,31,12,1326,1281,1257,-24
2018,10,31,13,1448,1427,1263,-164
2018,10,31,14,1533,1498,1418,-80
2018,10,31,15,1549,1538,1430,-108
2018,10,31,16,1537,1521,1391,-130
2018,10,31,17,1529,1499,1362,-137
2018,10,31,18,1517,1480,1366,-114
2018,10,31,19,1507,1455,1371,-84
2018,10,31,20,1502,1469,1350,-119
2018,10,31,21,1511,1425,1287,-138
2018,10,31,22,1512,1431,1219,-212
2018,10,31,23,1524,1450,1250,-200
2018,11,1,0,1552,1468,1187,-281
2018,11,1,1,1620,1537,1165,-372
2018,11,1,2,1666,1568,1155,-413
2018,11,1,3,1680,1580,1185,-395
2018,11,1,4,1633,1549,1216,-333
2018,11,1,5,1542,1474,1116,-358
2018,11,1,6,1437,1383,1186,-197
2018,11,1,7,1370,1330,1155,-175
2018,11,1,8,1346,1292,1137,-155
2018,11,1,9,1331,1279,1133,-146
2018,11,1,10,1327,1282,1187,-95
2018,11,1,11,1345,1308,1352,44
2018,11,1,12,1407,1381,1444,63
2018,11,1,13,1537,1522,1442,-80
2018,11,1,14,1634,1586,1503,-83
2018,11,1,15,1629,1565,1514,-51
2018,11,1,16,1591,1504,1587,83
2018,11,1,17,1550,1465,1667,202
2018,11,1,18,1515,1430,1669,239
2018,11,1,19,1485,1395,1610,215
2018,11,1,20,1464,1382,1600,218
2018,11,1,21,1457,1376,1622,246
2018,11,1,22,1463,1414,1637,223
2018,11,1,23,1473,1420,1569,149
2018,11,2,0,1499,1471,1420,-51
2018,11,2,1,1564,1586,1309,-277
2018,11,2,2,1638,1639,1270,-369
2018,11,2,3,1663,1634,1257,-377
2018,11,2,4,1623,1584,1249,-335
2018,11,2,5,1540,1488,1215,-273
2018,11,2,6,1440,1389,1069,-320
2018,11,2,7,1372,1325,1081,-244
2018,11,2,8,1338,1303,1059,-244
2018,11,2,9,1319,1295,1040,-255
2018,11,2,10,1308,1301,1123,-178
2018,11,2,11,1322,1332,1219,-113
2018,11,2,12,1371,1410,1328,-82
2018,11,2,13,1493,1547,1371,-176
2018,11,2,14,1580,1603,1497,-106
2018,11,2,15,1598,1560,1517,-43
2018,11,2,16,1563,1510,1540,30
2018,11,2,17,1516,1463,1563,100
2018,11,2,18,1473,1436,1576,140
2018,11,2,19,1435,1393,1575,182
2018,11,2,20,1423,1389,1630,241
2018,11,2,21,1412,1395,1784,389
2018,11,2,22,1406,1395,1932,537
2018,11,2,23,1425,1409,1992,583
2018,11,3,0,1448,1435,1939,504
2018,11,3,1,1501,1534,2027,493
2018,11,3,2,1563,1572,1988,416
2018,11,3,3,1588,1583,1907,324
2018,11,3,4,1561,1535,1879,344
2018,11,3,5,1507,1464,1821,357
2018,11,3,6,1425,1386,1704,318
2018,11,3,7,1365,1332,1701,369
2018,11,3,8,1320,1302,1735,433
2018,11,3,9,1293,1290,1690,400
2018,11,3,10,1288,1283,1652,369
2018,11,3,11,1293,1291,1684,393
2018,11,3,12,1314,1318,1691,373
2018,11,3,13,1385,1377,1726,349
2018,11,3,14,1425,1428,1734,306
2018,11,3,15,1449,1436,1768,332
2018,11,3,16,1449,1428,1851,423
2018,11,3,17,1439,1410,1905,495
2018,11,3,18,1423,1394,1888,494
2018,11,3,19,1399,1365,1788,423
2018,11,3,20,1375,1354,1771,417
2018,11,3,21,1360,1358,1735,377
2018,11,3,22,1380,1369,1734,365
2018,11,3,23,1398,1392,1629,237
2018,11,4,0,1443,1433,1567,134
2018,11,4,1,1522,1539,1567,28
2018,11,4,2,1584,1571,1413,-158
2018,11,4,3,1594,1564,1445,-119
2018,11,4,4,1562,1520,1324,-196
2018,11,4,5,1507,1448,1333,-115
2018,11,4,6,1430,1378,1312,-66
2018,11,4,7,1367,1327,1275,-52
2018,11,4,8,1327,1297,1335,38
2018,11,4,9,1305,1282,1329,47
2018,11,4,10,1297,1272,1307,35
2018,11,4,11,1299,1283,1287,4
2018,11,4,12,1307,1302,1300,-2
2018,11,4,13,1389,1342,1317,-25
2018,11,4,14,1419,1393,1341,-52
2018,11,4,15,1431,1395,1294,-101
2018,11,4,16,1430,1389,1325,-64
2018,11,4,17,1413,1364,1411,47
2018,11,4,18,1402,1347,1590,243
2018,11,4,19,1395,1362,1758,396
2018,11,4,20,1390,1346,1821,475
2018,11,4,21,1402,1356,1851,495
2018,11,4,22,1410,1387,1914,527
2018,11,4,23,1454,1416,1901,485
2018,11,5,0,1540,1482,1861,379
2018,11,5,1,1608,1614,1901,287
2018,11,5,2,1631,1649,1928,279
2018,11,5,3,1589,1632,1931,299
2018,11,5,4,1508,1605,1974,369
2018,11,5,5,1459,1564,1976,412
2018,11,5,6,1412,1428,1845,417
2018,11,5,7,1347,1347,1873,526
2018,11,5,8,1296,1306,1818,512
2018,11,5,9,1276,1274,1719,445
2018,11,5,10,1267,1261,1703,442
2018,11,5,11,1282,1275,1699,424
2018,11,5,12,1309,1294,1707,413
2018,11,5,13,1454,1378,1728,350
2018,11,5,14,1547,1498,1760,262
2018,11,5,15,1550,1498,1720,222
2018,11,5,16,1528,1464,1729,265
2018,11,5,17,1505,1432,1749,317
2018,11,5,18,1484,1429,1785,356
2018,11,5,19,1471,1421,1838,417
2018,11,5,20,1460,1400,1904,504
2018,11,5,21,1469,1392,1996,604
2018,11,5,22,1469,1406,2027,621
2018,11,5,23,1511,1425,1997,572
2018,11,6,0,1589,1462,1850,388
2018,11,6,1,1653,1570,1763,193
2018,11,6,2,1666,1608,1724,116
2018,11,6,3,1617,1582,1699,117
2018,11,6,4,1523,1565,1664,99
2018,11,6,5,1469,1489,1564,75
2018,11,6,6,1411,1400,1516,116
2018,11,6,7,1338,1306,1486,180
2018,11,6,8,1315,1267,1444,177
2018,11,6,9,1286,1250,1505,255
2018,11,6,10,1271,1237,1618,381
2018,11,6,11,1279,1241,1683,442
2018,11,6,12,1320,1273,1671,398
2018,11,6,13,1432,1361,1673,312
2018,11,6,14,1545,1476,1698,222
2018,11,6,15,1546,1484,1728,244
2018,11,6,16,1513,1432,1735,303
2018,11,6,17,1481,1410,1796,386
2018,11,6,18,1456,1392,1865,473
2018,11,6,19,1454,1393,1952,559
2018,11,6,20,1443,1384,1947,563
2018,11,6,21,1454,1390,1963,573
2018,11,6,22,1469,1413,1939,526
2018,11,6,23,1478,1418,1847,429
2018,11,7,0,1505,1454,1719,265
2018,11,7,1,1592,1559,1785,226
2018,11,7,2,1654,1587,1789,202
2018,11,7,3,1653,1575,1740,165
2018,11,7,4,1623,1555,1730,175
2018,11,7,5,1546,1481,1618,137
2018,11,7,6,1440,1378,1558,180
2018,11,7,7,1361,1292,1502,210
2018,11,7,8,1312,1254,1473,219
2018,11,7,9,1291,1234,1558,324
2018,11,7,10,1279,1221,1530,309
2018,11,7,11,1289,1223,1474,251
2018,11,7,12,1318,1249,1445,196
2018,11,7,13,1426,1345,1450,105
2018,11,7,14,1560,1473,1419,-54
2018,11,7,15,1558,1485,1468,-17
2018,11,7,16,1506,1445,1502,57
2018,11,7,17,1456,1419,1472,53
2018,11,7,18,1445,1413,1428,15
2018,11,7,19,1429,1383,1405,22
2018,11,7,20,1414,1394,1434,40
2018,11,7,21,1414,1377,1532,155
2018,11,7,22,1425,1379,1623,244
2018,11,7,23,1445,1412,1561,149
2018,11,8,0,1477,1448,1481,33
2018,11,8,1,1568,1551,1564,13
2018,11,8,2,1602,1604,1661,57
2018,11,8,3,1593,1580,1532,-48
2018,11,8,4,1573,1558,1578,20
2018,11,8,5,1494,1493,1557,64
2018,11,8,6,1391,1396,1551,155
2018,11,8,7,1312,1327,1519,192
2018,11,8,8,1287,1280,1459,179
2018,11,8,9,1257,1254,1426,172
2018,11,8,10,1242,1238,1403,165
2018,11,8,11,1252,1238,1368,130
2018,11,8,12,1284,1270,1371,101
2018,11,8,13,1388,1357,1336,-21
2018,11,8,14,1521,1486,1388,-98
2018,11,8,15,1517,1496,1434,-62
2018,11,8,16,1484,1451,1470,19
2018,11,8,17,1451,1417,1472,55
2018,11,8,18,1435,1390,1515,125
2018,11,8,19,1438,1377,1550,173
2018,11,8,20,1421,1377,1565,188
2018,11,8,21,1421,1402,1638,236
2018,11,8,22,1421,1394,1691,297
2018,11,8,23,1429,1425,1705,280
2018,11,9,0,1474,1472,1613,141
2018,11,9,1,1582,1597,1697,100
2018,11,9,2,1608,1627,1710,83
2018,11,9,3,1611,1633,1782,149
2018,11,9,4,1600,1619,1818,199
2018,11,9,5,1534,1551,1794,243
2018,11,9,6,1433,1453,1782,329
2018,11,9,7,1345,1374,1674,300
2018,11,9,8,1326,1336,1561,225
2018,11,9,9,1307,1310,1477,167
2018,11,9,10,1294,1309,1399,90
2018,11,9,11,1286,1304,1375,71
2018,11,9,12,1313,1343,1359,16
2018,11,9,13,1414,1430,1323,-107
2018,11,9,14,1540,1562,1431,-131
2018,11,9,15,1572,1572,1478,-94
2018,11,9,16,1538,1528,1505,-23
2018,11,9,17,1505,1505,1552,47
2018,11,9,18,1489,1478,1588,110
2018,11,9,19,1463,1434,1524,90
2018,11,9,20,1464,1406,1518,112
2018,11,9,21,1448,1396,1513,117
2018,11,9,22,1426,1393,1494,101
2018,11,9,23,1460,1400,1457,57
2018,11,10,0,1498,1447,1410,-37
2018,11,10,1,1605,1577,1506,-71
2018,11,10,2,1632,1614,1519,-95
2018,11,10,3,1619,1603,1458,-145
2018,11,10,4,1611,1614,1466,-148
2018,11,10,5,1567,1573,1430,-143
2018,11,10,6,1479,1512,1391,-121
2018,11,10,7,1409,1438,1395,-43
2018,11,10,8,1377,1390,1416,26
2018,11,10,9,1346,1355,1428,73
2018,11,10,10,1324,1340,1457,117
2018,11,10,11,1321,1341,1516,175
2018,11,10,12,1333,1358,1567,209
2018,11,10,13,1384,1396,1588,192
2018,11,10,14,1470,1444,1624,180
2018,11,10,15,1483,1479,1657,178
2018,11,10,16,1442,1491,1714,223
2018,11,10,17,1405,1487,1845,358
2018,11,10,18,1362,1447,1892,445
2018,11,10,19,1338,1411,1916,505
2018,11,10,20,1326,1378,1898,520
2018,11,10,21,1312,1351,1854,503
2018,11,10,22,1338,1353,1884,531
2018,11,10,23,1392,1377,1861,484
2018,11,11,0,1458,1419,1888,469
2018,11,11,1,1563,1555,1963,408
2018,11,11,2,1582,1602,1912,310
2018,11,11,3,1586,1586,1877,291
2018,11,11,4,1574,1573,1974,401
2018,11,11,5,1541,1522,1972,450
2018,11,11,6,1452,1447,1902,455
2018,11,11,7,1377,1377,1776,399
2018,11,11,8,1365,1332,1798,466
2018,11,11,9,1334,1304,1751,447
2018,11,11,10,1316,1287,1777,490
2018,11,11,11,1313,1283,1752,469
2018,11,11,12,1322,1292,1745,453
2018,11,11,13,1368,1320,1697,377
2018,11,11,14,1424,1371,1662,291
2018,11,11,15,1433,1386,1681,295
2018,11,11,16,1421,1400,1697,297
2018,11,11,17,1400,1397,1728,331
2018,11,11,18,1387,1407,1751,344
2018,11,11,19,1376,1404,1793,389
2018,11,11,20,1369,1411,1857,446
2018,11,11,21,1372,1411,1879,468
2018,11,11,22,1389,1436,1988,552
2018,11,11,23,1419,1474,2040,566
2018,11,12,0,1481,1535,1899,364
2018,11,12,1,1607,1674,1912,238
2018,11,12,2,1654,1700,1936,236
2018,11,12,3,1692,1685,1914,229
2018,11,12,4,1653,1651,1972,321
2018,11,12,5,1595,1590,1907,317
2018,11,12,6,1500,1502,1881,379
2018,11,12,7,1416,1439,1835,396
2018,11,12,8,1383,1391,1826,435
2018,11,12,9,1360,1369,1868,499
2018,11,12,10,1347,1366,1798,432
2018,11,12,11,1364,1367,1758,391
2018,11,12,12,1402,1407,1784,377
2018,11,12,13,1503,1489,1778,289
2018,11,12,14,1651,1611,1869,258
2018,11,12,15,1682,1653,1947,294
2018,11,12,16,1644,1643,1978,335
2018,11,12,17,1616,1649,2014,365
2018,11,12,18,1589,1652,1914,262
2018,11,12,19,1570,1600,1882,282
2018,11,12,20,1559,1595,1782,187
2018,11,12,21,1553,1581,1701,120
2018,11,12,22,1556,1588,1596,8
2018,11,12,23,1580,1610,1670,60
2018,11,13,0,1619,1693,1647,-46
2018,11,13,1,1745,1836,1799,-37
2018,11,13,2,1798,1874,1811,-63
2018,11,13,3,1842,1850,1760,-90
2018,11,13,4,1821,1836,1799,-37
2018,11,13,5,1743,1756,1692,-64
2018,11,13,6,1626,1645,1683,38
2018,11,13,7,1527,1558,1625,67
2018,11,13,8,1503,1500,1641,141
2018,11,13,9,1475,1477,1689,212
2018,11,13,10,1463,1472,1801,329
2018,11,13,11,1467,1467,1796,329
2018,11,13,12,1506,1501,1784,283
2018,11,13,13,1612,1595,1791,196
2018,11,13,14,1760,1714,1926,212
2018,11,13,15,1768,1725,2023,298
2018,11,13,16,1697,1664,2007,343
2018,11,13,17,1640,1632,1955,323
2018,11,13,18,1597,1588,1908,320
2018,11,13,19,1574,1545,1814,269
2018,11,13,20,1529,1521,1783,262
2018,11,13,21,1523,1492,1762,270
2018,11,13,22,1525,1493,1724,231
2018,11,13,23,1547,1512,1691,179
2018,11,14,0,1599,1576,1669,93
2018,11,14,1,1722,1741,1780,39
2018,11,14,2,1779,1797,1852,55
2018,11,14,3,1822,1782,1803,21
2018,11,14,4,1801,1777,1774,-3
2018,11,14,5,1728,1706,1733,27
2018,11,14,6,1619,1609,1738,129
2018,11,14,7,1524,1534,1698,164
2018,11,14,8,1503,1480,1772,292
2018,11,14,9,1478,1456,1725,269
2018,11,14,10,1469,1443,1742,299
2018,11,14,11,1478,1455,1799,344
2018,11,14,12,1515,1488,1735,247
2018,11,14,13,1619,1580,1703,123
2018,11,14,14,1747,1723,1765,42
2018,11,14,15,1755,1715,1936,221
2018,11,14,16,1688,1657,1883,226
2018,11,14,17,1637,1607,1764,157
2018,11,14,18,1592,1566,1710,144
2018,11,14,19,1553,1510,1702,192
2018,11,14,20,1514,1469,1716,247
2018,11,14,21,1503,1470,1739,269
2018,11,14,22,1498,1471,1620,149
2018,11,14,23,1511,1491,1583,92
2018,11,15,0,1572,1568,1602,34
2018,11,15,1,1698,1725,1713,-12
2018,11,15,2,1783,1768,1785,17
2018,11,15,3,1777,1764,1752,-12
2018,11,15,4,1765,1742,1729,-13
2018,11,15,5,1706,1664,1774,110
2018,11,15,6,1605,1563,1683,120
2018,11,15,7,1517,1477,1629,152
2018,11,15,8,1474,1437,1615,178
2018,11,15,9,1444,1417,1629,212
2018,11,15,10,1428,1408,1675,267
2018,11,15,11,1432,1420,1698,278
2018,11,15,12,1465,1462,1686,224
2018,11,15,13,1564,1544,1720,176
2018,11,15,14,1689,1677,1832,155
2018,11,15,15,1688,1681,1750,69
2018,11,15,16,1624,1604,1638,34
2018,11,15,17,1573,1559,1716,157
2018,11,15,18,1536,1496,1711,215
2018,11,15,19,1505,1476,1585,109
2018,11,15,20,1474,1430,1493,63
2018,11,15,21,1458,1419,1493,74
2018,11,15,22,1453,1412,1428,16
2018,11,15,23,1470,1426,1406,-20
2018,11,16,0,1519,1486,1418,-68
2018,11,16,1,1640,1615,1559,-56
2018,11,16,2,1730,1670,1601,-69
2018,11,16,3,1727,1657,1535,-122
2018,11,16,4,1719,1652,1459,-193
2018,11,16,5,1660,1598,1475,-123
2018,11,16,6,1570,1513,1419,-94
2018,11,16,7,1487,1419,1372,-47
2018,11,16,8,1423,1388,1284,-104
2018,11,16,9,1398,1355,1195,-160
2018,11,16,10,1387,1357,1168,-189
2018,11,16,11,1397,1361,1179,-182
2018,11,16,12,1431,1397,1141,-256
2018,11,16,13,1533,1478,1260,-218
2018,11,16,14,1662,1613,1275,-338
2018,11,16,15,1657,1626,1374,-252
2018,11,16,16,1606,1553,1367,-186
2018,11,16,17,1564,1499,1340,-159
2018,11,16,18,1525,1463,1327,-136
2018,11,16,19,1495,1415,1343,-72
2018,11,16,20,1466,1396,1372,-24
2018,11,16,21,1449,1381,1378,-3
2018,11,16,22,1451,1382,1451,69
2018,11,16,23,1469,1403,1533,130
2018,11,17,0,1512,1472,1534,62
2018,11,17,1,1625,1603,1679,76
2018,11,17,2,1664,1626,1702,76
2018,11,17,3,1688,1625,1666,41
2018,11,17,4,1671,1638,1699,61
2018,11,17,5,1629,1612,1689,77
2018,11,17,6,1548,1537,1603,66
2018,11,17,7,1472,1463,1311,-152
2018,11,17,8,1413,1420,1091,-329
2018,11,17,9,1375,1396,1132,-264
2018,11,17,10,1363,1399,1143,-256
2018,11,17,11,1362,1401,1023,-378
2018,11,17,12,1373,1408,1039,-369
2018,11,17,13,1419,1458,1028,-430
2018,11,17,14,1480,1519,913,-606
2018,11,17,15,1496,1535,955,-580
2018,11,17,16,1479,1531,966,-565
2018,11,17,17,1462,1491,996,-495
2018,11,17,18,1434,1476,1066,-410
2018,11,17,19,1421,1430,1046,-384
2018,11,17,20,1393,1398,1106,-292
2018,11,17,21,1377,1387,1152,-235
2018,11,17,22,1375,1384,1287,-97
2018,11,17,23,1398,1405,1320,-85
2018,11,18,0,1460,1467,1356,-111
2018,11,18,1,1590,1618,1548,-70
2018,11,18,2,1634,1643,1687,44
2018,11,18,3,1630,1635,1697,62
2018,11,18,4,1615,1617,1719,102
2018,11,18,5,1571,1584,1676,92
2018,11,18,6,1502,1517,1628,111
2018,11,18,7,1427,1463,1552,89
2018,11,18,8,1382,1417,1510,93
2018,11,18,9,1346,1394,1487,93
2018,11,18,10,1335,1389,1514,125
2018,11,18,11,1330,1392,1528,136
2018,11,18,12,1342,1402,1511,109
2018,11,18,13,1385,1438,1469,31
2018,11,18,14,1439,1493,1472,-21
2018,11,18,15,1451,1516,1497,-19
2018,11,18,16,1451,1523,1603,80
2018,11,18,17,1440,1499,1555,56
2018,11,18,18,1422,1460,1543,83
2018,11,18,19,1410,1440,1528,88
2018,11,18,20,1391,1419,1544,125
2018,11,18,21,1379,1409,1590,181
2018,11,18,22,1381,1408,1622,214
2018,11,18,23,1409,1428,1662,234
2018,11,19,0,1502,1490,1713,223
2018,11,19,1,1641,1657,1812,155
2018,11,19,2,1697,1708,1691,-17
2018,11,19,3,1703,1704,1703,-1
2018,11,19,4,1683,1681,1729,48
2018,11,19,5,1626,1605,1809,204
2018,11,19,6,1531,1519,1816,297
2018,11,19,7,1461,1444,1838,394
2018,11,19,8,1410,1397,1855,458
2018,11,19,9,1393,1375,1926,551
2018,11,19,10,1397,1377,2000,623
2018,11,19,11,1412,1382,2008,626
2018,11,19,12,1449,1423,2003,580
2018,11,19,13,1548,1508,1994,486
2018,11,19,14,1675,1633,1976,343
2018,11,19,15,1688,1648,1959,311
2018,11,19,16,1646,1603,2026,423
2018,11,19,17,1611,1563,1948,385
2018,11,19,18,1576,1526,1830,304
2018,11,19,19,1556,1497,1835,338
2018,11,19,20,1526,1467,1823,356
2018,11,19,21,1516,1462,1818,356
2018,11,19,22,1521,1457,1794,337
2018,11,19,23,1533,1490,1768,278
2018,11,20,0,1586,1554,1819,265
2018,11,20,1,1713,1699,1819,120
2018,11,20,2,1776,1710,1749,39
2018,11,20,3,1779,1724,1782,58
2018,11,20,4,1762,1714,1832,118
2018,11,20,5,1698,1660,1775,115
2018,11,20,6,1591,1568,1795,227
2018,11,20,7,1505,1479,1773,294
2018,11,20,8,1439,1428,1687,259
2018,11,20,9,1418,1413,1684,271
2018,11,20,10,1410,1418,1645,227
2018,11,20,11,1421,1413,1637,224
2018,11,20,12,1460,1456,1664,208
2018,11,20,13,1563,1539,1593,54
2018,11,20,14,1685,1662,1561,-101
2018,11,20,15,1691,1682,1661,-21
2018,11,20,16,1645,1639,1745,106
2018,11,20,17,1600,1589,1800,211
2018,11,20,18,1563,1557,1784,227
2018,11,20,19,1537,1525,1783,258
2018,11,20,20,1510,1485,1726,241
2018,11,20,21,1501,1480,1736,256
2018,11,20,22,1502,1483,1775,292
2018,11,20,23,1516,1499,1779,280
2018,11,21,0,1572,1556,1714,158
2018,11,21,1,1703,1709,1828,119
2018,11,21,2,1756,1747,1845,98
2018,11,21,3,1750,1722,1803,81
2018,11,21,4,1732,1723,1799,76
2018,11,21,5,1662,1660,1708,48
2018,11,21,6,1562,1552,1668,116
2018,11,21,7,1472,1473,1638,165
2018,11,21,8,1426,1418,1676,258
2018,11,21,9,1396,1392,1587,195
2018,11,21,10,1384,1392,1528,136
2018,11,21,11,1396,1395,1521,126
2018,11,21,12,1430,1437,1558,121
2018,11,21,13,1530,1516,1555,39
2018,11,21,14,1653,1611,1651,40
2018,11,21,15,1649,1639,1715,76
2018,11,21,16,1602,1615,1757,142
2018,11,21,17,1557,1567,1768,201
2018,11,21,18,1520,1543,1675,132
2018,11,21,19,1492,1493,1711,218
2018,11,21,20,1466,1453,1742,289
2018,11,21,21,1456,1447,1717,270
2018,11,21,22,1456,1445,1711,266
2018,11,21,23,1475,1469,1657,188
2018,11,22,0,1531,1508,1620,112
2018,11,22,1,1666,1650,1746,96
2018,11,22,2,1708,1688,1805,117
2018,11,22,3,1707,1696,1727,31
2018,11,22,4,1696,1682,1697,15
2018,11,22,5,1628,1648,1723,75
2018,11,22,6,1539,1578,1746,168
2018,11,22,7,1462,1503,1740,237
2018,11,22,8,1426,1424,1807,383
2018,11,22,9,1391,1424,1880,456
2018,11,22,10,1375,1402,1760,358
2018,11,22,11,1368,1401,1695,294
2018,11,22,12,1383,1412,1700,288
2018,11,22,13,1430,1457,1711,254
2018,11,22,14,1489,1498,1714,216
2018,11,22,15,1510,1531,1685,154
2018,11,22,16,1528,1565,1690,125
2018,11,22,17,1539,1616,1716,100
2018,11,22,18,1532,1634,1755,121
2018,11,22,19,1517,1628,1791,163
2018,11,22,20,1464,1607,1828,221
2018,11,22,21,1400,1545,1839,294
2018,11,22,22,1356,1505,1835,330
2018,11,22,23,1365,1476,1766,290
2018,11,23,0,1397,1500,1638,138
2018,11,23,1,1493,1575,1740,165
2018,11,23,2,1540,1603,1821,218
2018,11,23,3,1532,1602,1836,234
2018,11,23,4,1544,1626,1887,261
2018,11,23,5,1512,1591,1932,341
2018,11,23,6,1470,1542,1971,429
2018,11,23,7,1421,1472,1955,483
2018,11,23,8,1378,1430,1949,519
2018,11,23,9,1350,1403,1918,515
2018,11,23,10,1340,1389,1902,513
2018,11,23,11,1336,1388,1912,524
2018,11,23,12,1359,1408,1934,526
2018,11,23,13,1421,1463,1960,497
2018,11,23,14,1493,1517,1952,435
2018,11,23,15,1501,1518,1898,380
2018,11,23,16,1507,1499,1918,419
2018,11,23,17,1497,1480,1882,402
2018,11,23,18,1483,1450,1915,465
2018,11,23,19,1466,1418,1941,523
2018,11,23,20,1437,1398,1969,571
2018,11,23,21,1426,1382,1997,615
2018,11,23,22,1436,1374,1972,598
2018,11,23,23,1459,1399,1973,574
2018,11,24,0,1529,1470,1925,455
2018,11,24,1,1664,1631,1837,206
2018,11,24,2,1677,1651,1879,228
2018,11,24,3,1660,1644,1898,254
2018,11,24,4,1678,1656,1915,259
2018,11,24,5,1619,1617,1862,245
2018,11,24,6,1557,1553,1831,278
2018,11,24,7,1489,1485,1853,368
2018,11,24,8,1422,1443,1817,374
2018,11,24,9,1388,1409,1753,344
2018,11,24,10,1373,1393,1760,367
2018,11,24,11,1369,1389,1814,425
2018,11,24,12,1384,1413,1818,405
2018,11,24,13,1429,1452,1819,367
2018,11,24,14,1487,1508,1828,320
2018,11,24,15,1504,1515,1863,348
2018,11,24,16,1494,1503,1917,414
2018,11,24,17,1479,1489,1918,429
2018,11,24,18,1450,1467,2001,534
2018,11,24,19,1426,1444,2054,610
2018,11,24,20,1400,1417,2004,587
2018,11,24,21,1397,1408,1942,534
2018,11,24,22,1409,1408,1938,530
2018,11,24,23,1437,1443,1945,502
2018,11,25,0,1512,1500,1875,375
2018,11,25,1,1652,1637,1757,120
2018,11,25,2,1678,1651,1691,40
2018,11,25,3,1663,1650,1682,32
2018,11,25,4,1641,1603,1731,128
2018,11,25,5,1597,1573,1755,182
2018,11,25,6,1520,1489,1749,260
2018,11,25,7,1449,1424,1844,420
2018,11,25,8,1437,1399,1805,406
2018,11,25,9,1409,1384,1759,375
2018,11,25,10,1397,1384,1905,521
2018,11,25,11,1395,1394,1847,453
2018,11,25,12,1410,1413,1823,410
2018,11,25,13,1452,1456,1802,346
2018,11,25,14,1502,1499,1803,304
2018,11,25,15,1522,1519,1833,314
2018,11,25,16,1526,1516,1772,256
2018,11,25,17,1515,1486,1732,246
2018,11,25,18,1494,1465,1707,242
2018,11,25,19,1486,1464,1661,197
2018,11,25,20,1465,1443,1606,163
2018,11,25,21,1465,1432,1530,98
2018,11,25,22,1474,1435,1482,47
2018,11,25,23,1508,1468,1479,11
2018,11,26,0,1586,1540,1509,-31
2018,11,26,1,1746,1724,1670,-54
2018,11,26,2,1793,1777,1751,-26
2018,11,26,3,1778,1788,1762,-26
2018,11,26,4,1757,1771,1781,10
2018,11,26,5,1692,1695,1731,36
2018,11,26,6,1592,1595,1644,49
2018,11,26,7,1511,1525,1645,120
2018,11,26,8,1463,1467,1611,144
2018,11,26,9,1437,1456,1556,100
2018,11,26,10,1430,1456,1528,72
2018,11,26,11,1442,1473,1546,73
2018,11,26,12,1480,1522,1559,37
2018,11,26,13,1578,1594,1551,-43
2018,11,26,14,1703,1720,1748,28
2018,11,26,15,1717,1751,1866,115
2018,11,26,16,1677,1713,1876,163
2018,11,26,17,1643,1657,1842,185
2018,11,26,18,1604,1621,1945,324
2018,11,26,19,1576,1577,2032,455
2018,11,26,20,1543,1544,2086,542
2018,11,26,21,1532,1526,2053,527
2018,11,26,22,1532,1519,1987,468
2018,11,26,23,1551,1537,1948,411
2018,11,27,0,1616,1607,1844,237
2018,11,27,1,1768,1779,1794,15
2018,11,27,2,1822,1835,1852,17
2018,11,27,3,1805,1827,1913,86
2018,11,27,4,1782,1818,1910,92
2018,11,27,5,1707,1791,1848,57
2018,11,27,6,1599,1629,1799,170
2018,11,27,7,1510,1547,1866,319
2018,11,27,8,1481,1502,1966,464
2018,11,27,9,1459,1475,1974,499
2018,11,27,10,1456,1464,2015,551
2018,11,27,11,1464,1467,1973,506
2018,11,27,12,1504,1500,1965,465
2018,11,27,13,1602,1598,1970,372
2018,11,27,14,1734,1733,2007,274
2018,11,27,15,1739,1744,2019,275
2018,11,27,16,1679,1672,2039,367
2018,11,27,17,1629,1617,2002,385
2018,11,27,18,1583,1568,2031,463
2018,11,27,19,1547,1517,2029,512
2018,11,27,20,1513,1486,2049,563
2018,11,27,21,1503,1481,2061,580
2018,11,27,22,1501,1486,2019,533
2018,11,27,23,1521,1511,2031,520
2018,11,28,0,1576,1576,2028,452
2018,11,28,1,1730,1747,2113,366
2018,11,28,2,1787,1781,2000,219
2018,11,28,3,1783,1779,2050,271
2018,11,28,4,1757,1768,1987,219
2018,11,28,5,1685,1703,2045,342
2018,11,28,6,1577,1589,2038,449
2018,11,28,7,1486,1514,2091,577
2018,11,28,8,1443,1467,1918,451
2018,11,28,9,1416,1441,1822,381
2018,11,28,10,1408,1421,1786,365
2018,11,28,11,1415,1434,1830,396
2018,11,28,12,1453,1465,1796,331
2018,11,28,13,1545,1552,1810,258
2018,11,28,14,1669,1682,1867,185
2018,11,28,15,1676,1650,1977,327
2018,11,28,16,1629,1621,2068,447
2018,11,28,17,1583,1578,1991,413
2018,11,28,18,1543,1555,1952,397
2018,11,28,19,1503,1540,2012,472
2018,11,28,20,1482,1515,1902,387
2018,11,28,21,1480,1497,1782,285
2018,11,28,22,1476,1497,1905,408
2018,11,28,23,1497,1518,1880,362
2018,11,29,0,1556,1578,1818,240
2018,11,29,1,1688,1718,1864,146
2018,11,29,2,1728,1740,1873,133
2018,11,29,3,1725,1741,1860,119
2018,11,29,4,1713,1725,1828,103
2018,11,29,5,1657,1662,1747,85
2018,11,29,6,1560,1557,1651,94
2018,11,29,7,1473,1462,1651,189
2018,11,29,8,1412,1413,1680,267
2018,11,29,9,1387,1394,1691,297
2018,11,29,10,1378,1382,1669,287
2018,11,29,11,1385,1387,1689,302
2018,11,29,12,1425,1432,1666,234
2018,11,29,13,1515,1518,1680,162
2018,11,29,14,1651,1655,1752,97
2018,11,29,15,1661,1664,1807,143
2018,11,29,16,1594,1628,1826,198
2018,11,29,17,1544,1562,1864,302
2018,11,29,18,1503,1547,1934,387
2018,11,29,19,1472,1535,1883,348
2018,11,29,20,1449,1497,1823,326
2018,11,29,21,1474,1498,1837,339
2018,11,29,22,1485,1517,1805,288
2018,11,29,23,1508,1534,1755,221
2018,11,30,0,1569,1584,1694,110
2018,11,30,1,1700,1701,1733,32
2018,11,30,2,1734,1719,1737,18
2018,11,30,3,1734,1720,1746,26
2018,11,30,4,1718,1700,1744,44
2018,11,30,5,1655,1623,1689,66
2018,11,30,6,1548,1522,1533,11
2018,11,30,7,1454,1418,1512,94
2018,11,30,8,1404,1368,1440,72
2018,11,30,9,1383,1340,1447,107
2018,11,30,10,1374,1329,1475,146
2018,11,30,11,1381,1333,1456,123
2018,11,30,12,1409,1368,1447,79
2018,11,30,13,1495,1454,1445,-9
2018,11,30,14,1632,1580,1610,30
2018,11,30,15,1651,1636,1692,56
2018,11,30,16,1629,1635,1822,187
2018,11,30,17,1604,1642,1875,233
2018,11,30,18,1588,1638,1931,293
2018,11,30,19,1562,1634,1973,339
2018,11,30,20,1548,1619,1987,368
2018,11,30,21,1531,1621,2026,405
2018,11,30,22,1529,1595,2012,417
2018,11,30,23,1552,1604,1913,309
2018,12,1,0,1609,1660,1928,268
2018,12,1,1,1733,1782,1948,166
2018,12,1,2,1761,1788,1940,152
2018,12,1,3,1744,1768,1859,91
2018,12,1,4,1741,1761,1848,87
2018,12,1,5,1692,1715,1865,150
2018,12,1,6,1593,1637,1825,188
2018,12,1,7,1500,1551,1714,163
2018,12,1,8,1457,1494,1665,171
2018,12,1,9,1426,1466,1636,170
2018,12,1,10,1419,1438,1650,212
2018,12,1,11,1408,1433,1619,186
2018,12,1,12,1419,1449,1618,169
2018,12,1,13,1456,1489,1626,137
2018,12,1,14,1522,1549,1643,94
2018,12,1,15,1548,1570,1590,20
2018,12,1,16,1553,1571,1616,45
2018,12,1,17,1545,1576,1698,122
2018,12,1,18,1531,1560,1776,216
2018,12,1,19,1504,1550,1757,207
2018,12,1,20,1470,1514,1706,192
2018,12,1,21,1457,1496,1715,219
2018,12,1,22,1465,1484,1722,238
2018,12,1,23,1498,1513,1810,297
2018,12,2,0,1562,1568,1684,116
2018,12,2,1,1709,1726,1714,-12
2018,12,2,2,1739,1778,1687,-91
2018,12,2,3,1733,1750,1629,-121
2018,12,2,4,1716,1744,1708,-36
2018,12,2,5,1670,1694,1712,18
2018,12,2,6,1591,1619,1640,21
2018,12,2,7,1514,1535,1581,46
2018,12,2,8,1478,1481,1532,51
2018,12,2,9,1446,1457,1568,111
2018,12,2,10,1432,1437,1543,106
2018,12,2,11,1424,1437,1526,89
2018,12,2,12,1433,1455,1511,56
2018,12,2,13,1466,1489,1510,21
2018,12,2,14,1526,1537,1516,-21
2018,12,2,15,1554,1571,1574,3
2018,12,2,16,1566,1604,1630,26
2018,12,2,17,1562,1630,1737,107
2018,12,2,18,1546,1626,1846,220
2018,12,2,19,1541,1632,1807,175
2018,12,2,20,1523,1638,1831,193
2018,12,2,21,1513,1615,1948,333
2018,12,2,22,1517,1623,1976,353
2018,12,2,23,1554,1653,1926,273
2018,12,3,0,1628,1713,1894,181
2018,12,3,1,1800,1869,1943,74
2018,12,3,2,1840,1887,1926,39
2018,12,3,3,1832,1875,1981,106
2018,12,3,4,1805,1849,1898,49
2018,12,3,5,1744,1780,1798,18
2018,12,3,6,1646,1676,1855,179
2018,12,3,7,1561,1579,1883,304
2018,12,3,8,1518,1582,1883,301
2018,12,3,9,1499,1501,1803,302
2018,12,3,10,1492,1501,1937,436
2018,12,3,11,1505,1509,1843,334
2018,12,3,12,1546,1549,1801,252
2018,12,3,13,1633,1643,1804,161
2018,12,3,14,1778,1779,1810,31
2018,12,3,15,1808,1801,1836,35
2018,12,3,16,1767,1758,1851,93
2018,12,3,17,1730,1708,1802,94
2018,12,3,18,1692,1669,1789,120
2018,12,3,19,1667,1619,1758,139
2018,12,3,20,1628,1584,1686,102
2018,12,3,21,1610,1559,1720,161
2018,12,3,22,1610,1556,1730,174
2018,12,3,23,1630,1574,1838,264
2018,12,4,0,1700,1653,1884,231
2018,12,4,1,1861,1829,2040,211
2018,12,4,2,1926,1881,2071,190
2018,12,4,3,1921,1883,2069,186
2018,12,4,4,1908,1874,2049,175
2018,12,4,5,1840,1807,2024,217
2018,12,4,6,1721,1698,1955,257
2018,12,4,7,1624,1603,2000,397
2018,12,4,8,1569,1565,1905,340
2018,12,4,9,1544,1545,1803,258
2018,12,4,10,1535,1540,1772,232
2018,12,4,11,1546,1548,1854,306
2018,12,4,12,1584,1588,1823,235
2018,12,4,13,1674,1681,1899,218
2018,12,4,14,1809,1826,1989,163
2018,12,4,15,1829,1832,1999,167
2018,12,4,16,1784,1791,1924,133
2018,12,4,17,1740,1737,1884,147
2018,12,4,18,1704,1676,1934,258
2018,12,4,19,1670,1610,1911,301
2018,12,4,20,1624,1595,1913,318
2018,12,4,21,1605,1578,1879,301
2018,12,4,22,1602,1570,1798,228
2018,12,4,23,1624,1606,1758,152
2018,12,5,0,1689,1686,1811,125
2018,12,5,1,1846,1874,1908,34
2018,12,5,2,1902,1919,1933,14
2018,12,5,3,1900,1905,1879,-26
2018,12,5,4,1884,1894,1888,-6
2018,12,5,5,1821,1830,1796,-34
2018,12,5,6,1708,1704,1679,-25
2018,12,5,7,1609,1603,1656,53
2018,12,5,8,1552,1572,1711,139
2018,12,5,9,1524,1539,1716,177
2018,12,5,10,1516,1534,1726,192
2018,12,5,11,1526,1543,1691,148
2018,12,5,12,1568,1570,1693,123
2018,12,5,13,1662,1653,1754,101
2018,12,5,14,1792,1791,1846,55
2018,12,5,15,1803,1808,1876,68
2018,12,5,16,1748,1760,1964,204
2018,12,5,17,1694,1708,1993,285
2018,12,5,18,1647,1674,1996,322
2018,12,5,19,1611,1638,1969,331
2018,12,5,20,1574,1629,1993,364
2018,12,5,21,1553,1620,2079,459
2018,12,5,22,1550,1605,2103,498
2018,12,5,23,1565,1614,2050,436
2018,12,6,0,1635,1667,2026,359
2018,12,6,1,1788,1840,2095,255
2018,12,6,2,1840,1894,2098,204
2018,12,6,3,1840,1878,2127,249
2018,12,6,4,1831,1866,2140,274
2018,12,6,5,1768,1795,2147,352
2018,12,6,6,1664,1679,2073,394
2018,12,6,7,1568,1574,2013,439
2018,12,6,8,1506,1525,1978,453
2018,12,6,9,1481,1482,1993,511
2018,12,6,10,1472,1458,1920,462
2018,12,6,11,1480,1465,1888,423
2018,12,6,12,1518,1506,1883,377
2018,12,6,13,1609,1592,1904,312
2018,12,6,14,1739,1727,1891,164
2018,12,6,15,1758,1747,1975,228
2018,12,6,16,1718,1733,1943,210
2018,12,6,17,1684,1690,1933,243
2018,12,6,18,1645,1680,1942,262
2018,12,6,19,1612,1651,1930,279
2018,12,6,20,1588,1606,1898,292
2018,12,6,21,1572,1586,1858,272
2018,12,6,22,1570,1567,1889,322
2018,12,6,23,1595,1596,1846,250
2018,12,7,0,1658,1677,1893,216
2018,12,7,1,1788,1819,1897,78
2018,12,7,2,1838,1848,1911,63
2018,12,7,3,1838,1822,1820,-2
2018,12,7,4,1826,1802,1739,-63
2018,12,7,5,1761,1733,1759,26
2018,12,7,6,1658,1624,1672,48
2018,12,7,7,1560,1525,1572,47
2018,12,7,8,1481,1469,1556,87
2018,12,7,9,1449,1434,1662,228
2018,12,7,10,1442,1417,1694,277
2018,12,7,11,1447,1430,1662,232
2018,12,7,12,1482,1456,1682,226
2018,12,7,13,1562,1533,1678,145
2018,12,7,14,1681,1665,1746,81
2018,12,7,15,1702,1706,1672,-34
2018,12,7,16,1677,1700,1708,8
2018,12,7,17,1654,1678,1662,-16
2018,12,7,18,1630,1652,1725,73
2018,12,7,19,1602,1607,1719,112
2018,12,7,20,1577,1573,1679,106
2018,12,7,21,1563,1569,1683,114
2018,12,7,22,1555,1574,1668,94
2018,12,7,23,1576,1600,1738,138
2018,12,8,0,1633,1661,1841,180
2018,12,8,1,1763,1780,1989,209
2018,12,8,2,1793,1770,1971,201
2018,12,8,3,1778,1750,1925,175
2018,12,8,4,1769,1750,1945,195
2018,12,8,5,1722,1701,1842,141
2018,12,8,6,1631,1626,1726,100
2018,12,8,7,1540,1538,1622,84
2018,12,8,8,1493,1480,1534,54
2018,12,8,9,1458,1447,1493,46
2018,12,8,10,1445,1421,1445,24
2018,12,8,11,1444,1417,1420,3
2018,12,8,12,1461,1421,1402,-19
2018,12,8,13,1501,1464,1423,-41
2018,12,8,14,1563,1534,1425,-109
2018,12,8,15,1592,1565,1478,-87
2018,12,8,16,1598,1604,1590,-14
2018,12,8,17,1584,1582,1577,-5
2018,12,8,18,1561,1556,1707,151
2018,12,8,19,1538,1519,1803,284
2018,12,8,20,1509,1466,1889,423
2018,12,8,21,1487,1440,1916,476
2018,12,8,22,1482,1440,1909,469
2018,12,8,23,1519,1475,1920,445
2018,12,9,0,1594,1538,2015,477
2018,12,9,1,1744,1712,2081,369
2018,12,9,2,1777,1749,2074,325
2018,12,9,3,1764,1739,2034,295
2018,12,9,4,1746,1723,1984,261
2018,12,9,5,1711,1693,1888,195
2018,12,9,6,1631,1621,1768,147
2018,12,9,7,1554,1541,1868,327
2018,12,9,8,1509,1493,1764,271
2018,12,9,9,1478,1459,1738,279
2018,12,9,10,1465,1439,1745,306
2018,12,9,11,1462,1450,1813,363
2018,12,9,12,1470,1468,1778,310
2018,12,9,13,1503,1492,1781,289
2018,12,9,14,1562,1555,1821,266
2018,12,9,15,1584,1581,1854,273
2018,12,9,16,1581,1577,1820,243
2018,12,9,17,1560,1548,1777,229
2018,12,9,18,1541,1526,1794,268
2018,12,9,19,1524,1498,1771,273
2018,12,9,20,1491,1476,1750,274
2018,12,9,21,1474,1466,1766,300
2018,12,9,22,1477,1467,1782,315
2018,12,9,23,1519,1489,1793,304
2018,12,10,0,1610,1584,1839,255
2018,12,10,1,1782,1771,1912,141
2018,12,10,2,1830,1830,1962,132
2018,12,10,3,1820,1827,1898,71
2018,12,10,4,1800,1811,2001,190
2018,12,10,5,1740,1745,1898,153
2018,12,10,6,1640,1656,1693,37
2018,12,10,7,1552,1565,1530,-35
2018,12,10,8,1504,1510,1483,-27
2018,12,10,9,1476,1477,1523,46
2018,12,10,10,1471,1472,1609,137
2018,12,10,11,1487,1486,1671,185
2018,12,10,12,1527,1528,1745,217
2018,12,10,13,1617,1620,1829,209
2018,12,10,14,1750,1783,1846,63
2018,12,10,15,1775,1817,1913,96
2018,12,10,16,1729,1762,1888,126
2018,12,10,17,1681,1702,1779,77
2018,12,10,18,1643,1652,1592,-60
2018,12,10,19,1619,1614,1491,-123
2018,12,10,20,1584,1580,1426,-154
2018,12,10,21,1568,1571,1464,-107
2018,12,10,22,1568,1537,1530,-7
2018,12,10,23,1590,1546,1547,1
2018,12,11,0,1659,1653,1634,-19
2018,12,11,1,1812,1841,1833,-8
2018,12,11,2,1863,1887,1853,-34
2018,12,11,3,1855,1883,1872,-11
2018,12,11,4,1842,1875,1887,12
2018,12,11,5,1779,1795,1865,70
2018,12,11,6,1667,1666,1759,93
2018,12,11,7,1571,1565,1890,325
2018,12,11,8,1502,1516,1871,355
2018,12,11,9,1473,1487,1956,469
2018,12,11,10,1465,1471,1924,453
2018,12,11,11,1471,1469,1959,490
2018,12,11,12,1511,1499,1950,451
2018,12,11,13,1599,1581,2025,444
2018,12,11,14,1730,1730,2108,378
2018,12,11,15,1754,1740,2076,336
2018,12,11,16,1720,1710,2071,361
2018,12,11,17,1674,1681,2098,417
2018,12,11,18,1642,1663,2070,407
2018,12,11,19,1610,1637,1975,338
2018,12,11,20,1580,1568,1817,249
2018,12,11,21,1567,1582,1883,301
2018,12,11,22,1566,1558,1936,378
2018,12,11,23,1588,1576,1858,282
2018,12,12,0,1654,1643,1865,222
2018,12,12,1,1797,1812,2054,242
2018,12,12,2,1847,1867,2084,217
2018,12,12,3,1843,1850,1961,111
2018,12,12,4,1830,1859,2028,169
2018,12,12,5,1764,1776,1940,164
2018,12,12,6,1654,1670,1918,248
2018,12,12,7,1557,1577,1911,334
2018,12,12,8,1483,1516,1760,244
2018,12,12,9,1456,1487,1671,184
2018,12,12,10,1447,1485,1662,177
2018,12,12,11,1456,1486,1633,147
2018,12,12,12,1498,1507,1660,153
2018,12,12,13,1592,1600,1830,230
2018,12,12,14,1727,1736,1973,237
2018,12,12,15,1741,1767,1995,228
2018,12,12,16,1691,1696,1871,175
2018,12,12,17,1643,1641,1895,254
2018,12,12,18,1602,1605,2007,402
2018,12,12,19,1573,1578,2052,474
2018,12,12,20,1541,1527,1990,463
2018,12,12,21,1529,1509,1987,478
2018,12,12,22,1522,1527,2042,515
2018,12,12,23,1553,1573,2056,483
2018,12,13,0,1621,1636,2095,459
2018,12,13,1,1765,1794,2137,343
2018,12,13,2,1792,1840,2146,306
2018,12,13,3,1799,1836,2073,237
2018,12,13,4,1790,1826,2098,272
2018,12,13,5,1727,1767,1997,230
2018,12,13,6,1623,1665,1992,327
2018,12,13,7,1529,1569,1980,411
2018,12,13,8,1510,1538,1905,367
2018,12,13,9,1482,1503,1940,437
2018,12,13,10,1473,1490,1936,446
2018,12,13,11,1485,1485,1933,448
2018,12,13,12,1524,1521,1829,308
2018,12,13,13,1623,1609,1799,190
2018,12,13,14,1770,1747,1891,144
2018,12,13,15,1795,1769,1900,131
2018,12,13,16,1760,1741,1852,111
2018,12,13,17,1718,1690,1883,193
2018,12,13,18,1684,1647,1885,238
2018,12,13,19,1650,1613,1923,310
2018,12,13,20,1621,1586,2067,481
2018,12,13,21,1612,1572,2073,501
2018,12,13,22,1604,1564,2019,455
2018,12,13,23,1626,1589,2004,415
2018,12,14,0,1702,1651,2028,377
2018,12,14,1,1859,1836,2146,310
2018,12,14,2,1908,1892,2103,211
2018,12,14,3,1908,1904,2129,225
2018,12,14,4,1903,1894,2153,259
2018,12,14,5,1834,1827,2157,330
2018,12,14,6,1722,1725,2128,403
2018,12,14,7,1625,1626,2004,378
2018,12,14,8,1565,1578,1931,353
2018,12,14,9,1536,1545,1828,283
2018,12,14,10,1535,1536,1640,104
2018,12,14,11,1539,1537,1558,21
2018,12,14,12,1571,1542,1573,31
2018,12,14,13,1656,1652,1618,-34
2018,12,14,14,1789,1806,1687,-119
2018,12,14,15,1803,1830,1673,-157
2018,12,14,16,1755,1769,1802,33
2018,12,14,17,1700,1699,1804,105
2018,12,14,18,1662,1647,1748,101
2018,12,14,19,1619,1597,1685,88
2018,12,14,20,1569,1556,1607,51
2018,12,14,21,1529,1540,1569,29
2018,12,14,22,1522,1536,1584,48
2018,12,14,23,1562,1558,1572,14
2018,12,15,0,1642,1637,1575,-62
2018,12,15,1,1790,1806,1632,-174
2018,12,15,2,1834,1826,1599,-227
2018,12,15,3,1828,1815,1567,-248
2018,12,15,4,1829,1824,1737,-87
2018,12,15,5,1794,1789,1883,94
2018,12,15,6,1707,1715,1895,180
2018,12,15,7,1618,1631,1834,203
2018,12,15,8,1567,1583,1793,210
2018,12,15,9,1534,1540,1753,213
2018,12,15,10,1520,1525,1781,256
2018,12,15,11,1520,1519,1765,246
2018,12,15,12,1530,1532,1781,249
2018,12,15,13,1565,1576,1779,203
2018,12,15,14,1631,1637,1653,16
2018,12,15,15,1660,1659,1663,4
2018,12,15,16,1658,1679,1740,61
2018,12,15,17,1628,1641,1794,153
2018,12,15,18,1591,1589,1690,101
2018,12,15,19,1553,1546,1716,170
2018,12,15,20,1515,1537,1805,268
2018,12,15,21,1498,1521,1832,311
2018,12,15,22,1490,1534,1729,195
2018,12,15,23,1515,1565,1812,247
2018,12,16,0,1593,1640,1907,267
2018,12,16,1,1746,1790,1988,198
2018,12,16,2,1797,1818,1946,128
2018,12,16,3,1792,1801,2024,223
2018,12,16,4,1783,1797,1939,142
2018,12,16,5,1743,1753,1895,142
2018,12,16,6,1666,1675,1787,112
2018,12,16,7,1582,1601,1750,149
2018,12,16,8,1512,1533,1704,171
2018,12,16,9,1481,1500,1830,330
2018,12,16,10,1462,1484,1767,283
2018,12,16,11,1457,1481,1713,232
2018,12,16,12,1447,1489,1742,253
2018,12,16,13,1492,1527,1766,239
2018,12,16,14,1556,1585,1718,133
2018,12,16,15,1579,1611,1695,84
2018,12,16,16,1575,1621,1666,45
2018,12,16,17,1549,1590,1653,63
2018,12,16,18,1512,1551,1664,113
2018,12,16,19,1495,1518,1621,103
2018,12,16,20,1474,1499,1634,135
2018,12,16,21,1464,1477,1619,142
2018,12,16,22,1462,1472,1579,107
2018,12,16,23,1494,1501,1575,74
2018,12,17,0,1573,1581,1616,35
2018,12,17,1,1749,1775,1602,-173
2018,12,17,2,1801,1824,1544,-280
2018,12,17,3,1790,1838,1538,-300
2018,12,17,4,1775,1818,1508,-310
2018,12,17,5,1715,1754,1502,-252
2018,12,17,6,1622,1638,1420,-218
2018,12,17,7,1533,1543,1478,-65
2018,12,17,8,1468,1477,1434,-43
2018,12,17,9,1442,1443,1466,23
2018,12,17,10,1431,1435,1510,75
2018,12,17,11,1442,1444,1524,80
2018,12,17,12,1476,1463,1460,-3
2018,12,17,13,1567,1549,1461,-88
2018,12,17,14,1698,1684,1571,-113
2018,12,17,15,1725,1724,1647,-77
2018,12,17,16,1696,1724,1599,-125
2018,12,17,17,1658,1724,1609,-115
2018,12,17,18,1621,1714,1744,30
2018,12,17,19,1599,1680,1633,-47
2018,12,17,20,1570,1639,1572,-67
2018,12,17,21,1557,1634,1591,-43
2018,12,17,22,1556,1634,1651,17
2018,12,17,23,1576,1640,1568,-72
2018,12,18,0,1649,1711,1612,-99
2018,12,18,1,1801,1851,1776,-75
2018,12,18,2,1836,1870,1827,-43
2018,12,18,3,1828,1855,1799,-56
2018,12,18,4,1818,1828,1886,58
2018,12,18,5,1749,1755,1944,189
2018,12,18,6,1644,1633,1919,286
2018,12,18,7,1542,1521,1749,228
2018,12,18,8,1465,1457,1711,254
2018,12,18,9,1436,1427,1711,284
2018,12,18,10,1425,1407,1697,290
2018,12,18,11,1426,1403,1762,359
2018,12,18,12,1438,1435,1746,311
2018,12,18,13,1525,1526,1766,240
2018,12,18,14,1671,1664,1877,213
2018,12,18,15,1705,1714,1859,145
2018,12,18,16,1679,1698,1900,202
2018,12,18,17,1642,1646,1893,247
2018,12,18,18,1605,1616,1839,223
2018,12,18,19,1574,1583,1692,109
2018,12,18,20,1550,1582,1734,152
2018,12,18,21,1539,1548,1724,176
2018,12,18,22,1540,1547,1883,336
2018,12,18,23,1571,1555,1878,323
2018,12,19,0,1640,1601,1886,285
2018,12,19,1,1799,1781,2046,265
2018,12,19,2,1835,1830,2093,263
2018,12,19,3,1823,1826,2076,250
2018,12,19,4,1815,1816,2039,223
2018,12,19,5,1748,1752,2048,296
2018,12,19,6,1640,1647,1968,321
2018,12,19,7,1538,1540,1943,403
2018,12,19,8,1472,1487,1920,433
2018,12,19,9,1446,1452,1913,461
2018,12,19,10,1436,1443,1908,465
2018,12,19,11,1441,1445,1937,492
2018,12,19,12,1475,1475,1815,340
2018,12,19,13,1567,1574,1892,318
2018,12,19,14,1698,1692,1958,266
2018,12,19,15,1714,1721,1989,268
2018,12,19,16,1678,1682,1929,247
2018,12,19,17,1635,1623,2052,429
2018,12,19,18,1597,1590,2112,522
2018,12,19,19,1556,1562,2167,605
2018,12,19,20,1527,1543,2161,618
2018,12,19,21,1521,1528,2140,612
2018,12,19,22,1526,1521,2118,597
2018,12,19,23,1550,1541,2067,526
2018,12,20,0,1627,1598,1973,375
2018,12,20,1,1775,1771,2097,326
2018,12,20,2,1804,1823,2070,247
2018,12,20,3,1798,1833,2075,242
2018,12,20,4,1785,1835,2068,233
2018,12,20,5,1720,1759,1982,223
2018,12,20,6,1616,1656,1952,296
2018,12,20,7,1518,1545,1765,220
2018,12,20,8,1485,1488,1603,115
2018,12,20,9,1459,1465,1573,108
2018,12,20,10,1451,1449,1542,93
2018,12,20,11,1458,1452,1570,118
2018,12,20,12,1496,1486,1535,49
2018,12,20,13,1583,1581,1598,17
2018,12,20,14,1722,1713,1671,-42
2018,12,20,15,1741,1754,1688,-66
2018,12,20,16,1694,1692,1680,-12
2018,12,20,17,1635,1638,1733,95
2018,12,20,18,1591,1596,1752,156
2018,12,20,19,1563,1555,1742,187
2018,12,20,20,1550,1528,1742,214
2018,12,20,21,1540,1499,1794,295
2018,12,20,22,1538,1506,1839,333
2018,12,20,23,1558,1530,1771,241
2018,12,21,0,1629,1570,1783,213
2018,12,21,1,1780,1737,1944,207
2018,12,21,2,1821,1796,2062,266
2018,12,21,3,1825,1793,2061,268
2018,12,21,4,1817,1793,2080,287
2018,12,21,5,1758,1752,2023,271
2018,12,21,6,1651,1650,1931,281
2018,12,21,7,1549,1560,1822,262
2018,12,21,8,1497,1503,1851,348
2018,12,21,9,1474,1478,1935,457
2018,12,21,10,1464,1468,1937,469
2018,12,21,11,1471,1467,1911,444
2018,12,21,12,1505,1496,1830,334
2018,12,21,13,1592,1575,1888,313
2018,12,21,14,1710,1688,2004,316
2018,12,21,15,1717,1724,2082,358
2018,12,21,16,1676,1690,2146,456
2018,12,21,17,1626,1649,2164,515
2018,12,21,18,1580,1606,2092,486
2018,12,21,19,1539,1575,2082,507
2018,12,21,20,1505,1516,2064,548
2018,12,21,21,1489,1504,2085,581
2018,12,21,22,1485,1493,2059,566
2018,12,21,23,1507,1518,2038,520
2018,12,22,0,1572,1579,2043,464
2018,12,22,1,1716,1739,2077,338
2018,12,22,2,1752,1765,2002,237
2018,12,22,3,1759,1744,1973,229
2018,12,22,4,1763,1742,2024,282
2018,12,22,5,1723,1690,2041,351
2018,12,22,6,1637,1593,2053,460
2018,12,22,7,1544,1501,1839,338
2018,12,22,8,1492,1455,1757,302
2018,12,22,9,1456,1433,1874,441
2018,12,22,10,1441,1407,1857,450
2018,12,22,11,1430,1395,1836,441
2018,12,22,12,1440,1408,1843,435
2018,12,22,13,1473,1455,1855,400
2018,12,22,14,1539,1515,1877,362
2018,12,22,15,1575,1532,1890,358
2018,12,22,16,1572,1565,1902,337
2018,12,22,17,1556,1522,1883,361
2018,12,22,18,1525,1482,1982,500
2018,12,22,19,1493,1450,1992,542
2018,12,22,20,1468,1413,1949,536
2018,12,22,21,1449,1400,1977,577
2018,12,22,22,1447,1421,1990,569
2018,12,22,23,1482,1451,2068,617
2018,12,23,0,1564,1516,2081,565
2018,12,23,1,1726,1680,2105,425
2018,12,23,2,1761,1746,2088,342
2018,12,23,3,1760,1754,2053,299
2018,12,23,4,1747,1733,2009,276
2018,12,23,5,1704,1665,2019,354
2018,12,23,6,1631,1607,1891,284
2018,12,23,7,1545,1544,1699,155
2018,12,23,8,1514,1493,1678,185
2018,12,23,9,1485,1464,1641,177
2018,12,23,10,1473,1451,1585,134
2018,12,23,11,1466,1441,1546,105
2018,12,23,12,1480,1467,1539,72
2018,12,23,13,1515,1514,1451,-63
2018,12,23,14,1570,1579,1458,-121
2018,12,23,15,1597,1612,1479,-133
2018,12,23,16,1600,1629,1516,-113
2018,12,23,17,1587,1589,1480,-109
2018,12,23,18,1558,1603,1562,-41
2018,12,23,19,1541,1575,1629,54
2018,12,23,20,1529,1506,1587,81
2018,12,23,21,1515,1469,1609,140
2018,12,23,22,1522,1447,1668,221
2018,12,23,23,1553,1464,1688,224
2018,12,24,0,1634,1530,1873,343
2018,12,24,1,1811,1709,2072,363
2018,12,24,2,1849,1782,2009,227
2018,12,24,3,1842,1780,1985,205
2018,12,24,4,1825,1765,1999,234
2018,12,24,5,1741,1725,1950,225
2018,12,24,6,1660,1643,1855,212
2018,12,24,7,1579,1555,1735,180
2018,12,24,8,1523,1489,1783,294
2018,12,24,9,1493,1447,1784,337
2018,12,24,10,1470,1429,1860,431
2018,12,24,11,1454,1427,1881,454
2018,12,24,12,1470,1452,1892,440
2018,12,24,13,1528,1507,1886,379
2018,12,24,14,1593,1571,1897,326
2018,12,24,15,1628,1615,1911,296
2018,12,24,16,1646,1598,1881,283
2018,12,24,17,1652,1557,1848,291
2018,12,24,18,1618,1530,2000,470
2018,12,24,19,1584,1502,2006,504
2018,12,24,20,1540,1471,2030,559
2018,12,24,21,1512,1456,1996,540
2018,12,24,22,1506,1442,1964,522
2018,12,24,23,1511,1452,1869,417
2018,12,25,0,1572,1500,1770,270
2018,12,25,1,1711,1627,1885,258
2018,12,25,2,1735,1636,1840,204
2018,12,25,3,1714,1618,1691,73
2018,12,25,4,1701,1618,1713,95
2018,12,25,5,1646,1615,1674,59
2018,12,25,6,1606,1561,1564,3
2018,12,25,7,1561,1502,1574,72
2018,12,25,8,1520,1450,1505,55
2018,12,25,9,1485,1422,1425,3
2018,12,25,10,1464,1395,1424,29
2018,12,25,11,1446,1389,1415,26
2018,12,25,12,1459,1400,1520,120
2018,12,25,13,1495,1422,1541,119
2018,12,25,14,1547,1488,1567,79
2018,12,25,15,1568,1514,1591,77
2018,12,25,16,1568,1510,1648,138
2018,12,25,17,1567,1488,1604,116
2018,12,25,18,1558,1445,1603,158
2018,12,25,19,1514,1436,1652,216
2018,12,25,20,1472,1426,1630,204
2018,12,25,21,1439,1403,1636,233
2018,12,25,22,1420,1409,1578,169
2018,12,25,23,1435,1426,1605,179
2018,12,26,0,1493,1474,1548,74
2018,12,26,1,1652,1601,1646,45
2018,12,26,2,1703,1635,1657,22
2018,12,26,3,1705,1628,1666,38
2018,12,26,4,1705,1631,1762,131
2018,12,26,5,1649,1599,1803,204
2018,12,26,6,1590,1534,1719,185
2018,12,26,7,1525,1457,1546,89
2018,12,26,8,1469,1406,1541,135
2018,12,26,9,1439,1383,1553,170
2018,12,26,10,1428,1375,1562,187
2018,12,26,11,1424,1380,1552,172
2018,12,26,12,1460,1413,1549,136
2018,12,26,13,1564,1478,1524,46
2018,12,26,14,1705,1547,1508,-39
2018,12,26,15,1740,1602,1554,-48
2018,12,26,16,1712,1684,1543,-141
2018,12,26,17,1684,1722,1585,-137
2018,12,26,18,1660,1752,1573,-179
2018,12,26,19,1635,1747,1649,-98
2018,12,26,20,1617,1740,1720,-20
2018,12,26,21,1607,1714,1747,33
2018,12,26,22,1603,1717,1728,11
2018,12,26,23,1631,1725,1842,117
2018,12,27,0,1710,1769,1822,53
2018,12,27,1,1877,1888,1981,93
2018,12,27,2,1925,1899,2138,239
2018,12,27,3,1910,1878,2177,299
2018,12,27,4,1899,1853,2155,302
2018,12,27,5,1816,1783,2161,378
2018,12,27,6,1702,1668,2106,438
2018,12,27,7,1598,1567,2024,457
2018,12,27,8,1529,1504,1894,390
2018,12,27,9,1501,1475,1834,359
2018,12,27,10,1492,1456,1814,358
2018,12,27,11,1494,1456,1823,367
2018,12,27,12,1527,1477,1808,331
2018,12,27,13,1610,1529,1825,296
2018,12,27,14,1728,1622,1779,157
2018,12,27,15,1762,1661,1754,93
2018,12,27,16,1740,1664,1765,101
2018,12,27,17,1705,1646,1786,140
2018,12,27,18,1667,1624,1822,198
2018,12,27,19,1646,1612,1820,208
2018,12,27,20,1618,1598,1793,195
2018,12,27,21,1608,1599,1697,98
2018,12,27,22,1607,1605,1702,97
2018,12,27,23,1631,1656,1637,-19
2018,12,28,0,1705,1733,1665,-68
2018,12,28,1,1859,1878,1715,-163
2018,12,28,2,1901,1923,1732,-191
2018,12,28,3,1892,1917,1823,-94
2018,12,28,4,1885,1892,1926,34
2018,12,28,5,1820,1825,1808,-17
2018,12,28,6,1716,1722,1755,33
2018,12,28,7,1619,1606,1770,164
2018,12,28,8,1563,1554,1840,286
2018,12,28,9,1537,1524,1886,362
2018,12,28,10,1527,1507,1734,227
2018,12,28,11,1529,1501,1705,204
2018,12,28,12,1553,1541,1709,168
2018,12,28,13,1624,1583,1688,105
2018,12,28,14,1750,1671,1639,-32
2018,12,28,15,1809,1732,1709,-23
2018,12,28,16,1813,1773,1800,27
2018,12,28,17,1810,1799,1807,8
2018,12,28,18,1787,1819,1764,-55
2018,12,28,19,1754,1823,1821,-2
2018,12,28,20,1720,1820,1858,38
2018,12,28,21,1693,1805,1810,5
2018,12,28,22,1697,1793,1756,-37
2018,12,28,23,1732,1799,1705,-94
2018,12,29,0,1805,1839,1642,-197
2018,12,29,1,1952,1998,1710,-288
2018,12,29,2,1970,2029,1722,-307
2018,12,29,3,1951,2009,1639,-370
2018,12,29,4,1959,2001,1622,-379
2018,12,29,5,1914,1951,1564,-387
2018,12,29,6,1828,1858,1550,-308
2018,12,29,7,1740,1764,1512,-252
2018,12,29,8,1746,1704,1589,-115
2018,12,29,9,1715,1668,1595,-73
2018,12,29,10,1702,1655,1629,-26
2018,12,29,11,1697,1657,1613,-44
2018,12,29,12,1715,1667,1605,-62
2018,12,29,13,1717,1707,1664,-43
2018,12,29,14,1765,1770,1682,-88
2018,12,29,15,1799,1790,1712,-78
2018,12,29,16,1840,1801,1748,-53
2018,12,29,17,1836,1796,1720,-76
2018,12,29,18,1794,1773,1742,-31
2018,12,29,19,1735,1732,1727,-5
2018,12,29,20,1693,1673,1720,47
2018,12,29,21,1639,1651,1709,58
2018,12,29,22,1630,1644,1676,32
2018,12,29,23,1662,1657,1668,11
2018,12,30,0,1740,1721,1696,-25
2018,12,30,1,1914,1903,1801,-102
2018,12,30,2,1969,1975,1908,-67
2018,12,30,3,1974,1978,1846,-132
2018,12,30,4,1963,1950,1835,-115
2018,12,30,5,1925,1902,1837,-65
2018,12,30,6,1849,1824,1789,-35
2018,12,30,7,1778,1739,1746,7
2018,12,30,8,1745,1684,1671,-13
2018,12,30,9,1721,1669,1681,12
2018,12,30,10,1697,1638,1637,-1
2018,12,30,11,1697,1637,1628,-9
2018,12,30,12,1713,1693,1679,-14
2018,12,30,13,1728,1696,1661,-35
2018,12,30,14,1761,1751,1703,-48
2018,12,30,15,1783,1779,1755,-24
2018,12,30,16,1809,1792,1867,75
2018,12,30,17,1794,1749,1910,161
2018,12,30,18,1750,1710,1861,151
2018,12,30,19,1705,1670,1760,90
2018,12,30,20,1677,1642,1751,109
2018,12,30,21,1629,1622,1740,118
2018,12,30,22,1637,1597,1764,167
2018,12,30,23,1660,1622,1804,182
2018,12,31,0,1727,1683,1788,105
2018,12,31,1,1898,1889,1889,0
2018,12,31,2,1977,1957,1920,-37
2018,12,31,3,1990,1958,1881,-77
2018,12,31,4,1978,1944,1849,-95
2018,12,31,5,1925,1885,1877,-8
2018,12,31,6,1830,1800,1848,48
2018,12,31,7,1741,1717,1798,81
2018,12,31,8,1665,1655,1781,126
2018,12,31,9,1651,1621,1762,141
2018,12,31,10,1643,1607,1753,146
2018,12,31,11,1649,1603,1715,112
2018,12,31,12,1692,1624,1687,63
2018,12,31,13,1771,1678,1686,8
2018,12,31,14,1881,1765,1680,-85
2018,12,31,15,1921,1809,1683,-126
2018,12,31,16,1904,1811,1705,-106
2018,12,31,17,1873,1784,1747,-37
2018,12,31,18,1837,1766,1749,-17
2018,12,31,19,1797,1789,1811,22
2018,12,31,20,1769,1781,1803,22
2018,12,31,21,1747,1778,1814,36
2018,12,31,22,1733,1773,1716,-57
2018,12,31,23,1739,1786,1669,-117
2019,1,1,0,1779,1822,1657,-165
2019,1,1,1,1921,1971,1683,-288
2019,1,1,2,1984,1998,1668,-330
2019,1,1,3,1998,1950,1726,-224
2019,1,1,4,1994,1917,1857,-60
2019,1,1,5,1900,1862,1881,19
2019,1,1,6,1820,1779,1864,85
2019,1,1,7,1743,1713,1836,123
2019,1,1,8,1705,1648,1785,137
2019,1,1,9,1672,1608,1832,224
2019,1,1,10,1651,1594,1776,182
2019,1,1,11,1639,1590,1770,180
2019,1,1,12,1622,1594,1749,155
2019,1,1,13,1640,1618,1742,124
2019,1,1,14,1699,1651,1759,108
2019,1,1,15,1744,1682,1758,76
2019,1,1,16,1788,1705,1753,48
2019,1,1,17,1800,1742,1760,18
2019,1,1,18,1787,1762,1797,35
2019,1,1,19,1754,1781,1814,33
2019,1,1,20,1744,1782,1758,-24
2019,1,1,21,1705,1766,1713,-53
2019,1,1,22,1700,1768,1670,-98
2019,1,1,23,1720,1787,1635,-152
2019,1,2,0,1783,1835,1615,-220
2019,1,2,1,1919,1988,1675,-313
2019,1,2,2,1989,2026,1708,-318
2019,1,2,3,1997,2007,1690,-317
2019,1,2,4,1994,1976,1686,-290
2019,1,2,5,1923,1910,1751,-159
2019,1,2,6,1843,1811,1679,-132
2019,1,2,7,1772,1721,1611,-110
2019,1,2,8,1672,1661,1566,-95
2019,1,2,9,1649,1648,1529,-119
2019,1,2,10,1648,1630,1555,-75
2019,1,2,11,1659,1641,1562,-79
2019,1,2,12,1699,1674,1500,-174
2019,1,2,13,1773,1727,1509,-218
2019,1,2,14,1905,1820,1527,-293
2019,1,2,15,1962,1853,1508,-345
2019,1,2,16,1952,1895,1596,-299
2019,1,2,17,1921,1901,1627,-274
2019,1,2,18,1886,1861,1668,-193
2019,1,2,19,1841,1832,1634,-198
2019,1,2,20,1816,1797,1527,-270
2019,1,2,21,1787,1782,1640,-142
2019,1,2,22,1771,1771,1566,-205
2019,1,2,23,1787,1793,1559,-234
2019,1,3,0,1848,1832,1594,-238
2019,1,3,1,2009,1991,1733,-258
2019,1,3,2,2093,2042,1723,-319
2019,1,3,3,2092,2031,1726,-305
2019,1,3,4,2075,2012,1719,-293
2019,1,3,5,1999,1949,1624,-325
2019,1,3,6,1879,1845,1542,-303
2019,1,3,7,1786,1742,1426,-316
2019,1,3,8,1702,1697,1396,-301
2019,1,3,9,1683,1678,1397,-281
2019,1,3,10,1676,1670,1376,-294
2019,1,3,11,1688,1676,1357,-319
2019,1,3,12,1727,1704,1394,-310
2019,1,3,13,1811,1771,1399,-372
2019,1,3,14,1947,1872,1332,-540
2019,1,3,15,1985,1942,1236,-706
2019,1,3,16,1929,1897,1298,-599
2019,1,3,17,1889,1862,1341,-521
2019,1,3,18,1847,1825,1346,-479
2019,1,3,19,1797,1772,1370,-402
2019,1,3,20,1757,1722,1307,-415
2019,1,3,21,1723,1692,1257,-435
2019,1,3,22,1714,1667,1338,-329
2019,1,3,23,1726,1673,1301,-372
2019,1,4,0,1813,1728,1304,-424
2019,1,4,1,1972,1895,1383,-512
2019,1,4,2,2054,1972,1361,-611
2019,1,4,3,2049,1970,1313,-657
2019,1,4,4,2030,1964,1365,-599
2019,1,4,5,1963,1903,1336,-567
2019,1,4,6,1848,1830,1288,-542
2019,1,4,7,1751,1738,1259,-479
2019,1,4,8,1677,1673,1307,-366
2019,1,4,9,1650,1634,1331,-303
2019,1,4,10,1644,1623,1351,-272
2019,1,4,11,1658,1632,1359,-273
2019,1,4,12,1698,1666,1454,-212
2019,1,4,13,1784,1734,1565,-169
2019,1,4,14,1904,1831,1594,-237
2019,1,4,15,1931,1866,1675,-191
2019,1,4,16,1902,1846,1706,-140
2019,1,4,17,1851,1802,1682,-120
2019,1,4,18,1803,1764,1761,-3
2019,1,4,19,1748,1708,1752,44
2019,1,4,20,1707,1662,1603,-59
2019,1,4,21,1678,1653,1501,-152
2019,1,4,22,1666,1605,1395,-210
2019,1,4,23,1685,1605,1136,-469
2019,1,5,0,1745,1659,1193,-466
2019,1,5,1,1909,1817,1302,-515
2019,1,5,2,1964,1885,1364,-521
2019,1,5,3,1960,1882,1322,-560
2019,1,5,4,1952,1881,1323,-558
2019,1,5,5,1905,1848,1350,-498
2019,1,5,6,1812,1767,1348,-419
2019,1,5,7,1731,1684,1386,-298
2019,1,5,8,1677,1640,1376,-264
2019,1,5,9,1640,1606,1367,-239
2019,1,5,10,1621,1588,1296,-292
2019,1,5,11,1621,1619,1298,-321
2019,1,5,12,1629,1630,1278,-352
2019,1,5,13,1664,1661,1323,-338
2019,1,5,14,1717,1714,1362,-352
2019,1,5,15,1765,1746,1426,-320
2019,1,5,16,1775,1740,1426,-314
2019,1,5,17,1760,1708,1428,-280
2019,1,5,18,1720,1665,1447,-218
2019,1,5,19,1681,1626,1488,-138
2019,1,5,20,1646,1608,1467,-141
2019,1,5,21,1615,1578,1464,-114
2019,1,5,22,1606,1566,1499,-67
2019,1,5,23,1625,1583,1439,-144
2019,1,6,0,1695,1648,1419,-229
2019,1,6,1,1843,1808,1537,-271
2019,1,6,2,1902,1847,1564,-283
2019,1,6,3,1896,1833,1540,-293
2019,1,6,4,1883,1809,1499,-310
2019,1,6,5,1836,1756,1466,-290
2019,1,6,6,1767,1676,1448,-228
2019,1,6,7,1686,1584,1446,-138
2019,1,6,8,1594,1539,1425,-114
2019,1,6,9,1558,1500,1416,-84
2019,1,6,10,1532,1464,1479,15
2019,1,6,11,1525,1458,1462,4
2019,1,6,12,1527,1474,1452,-22
2019,1,6,13,1552,1493,1541,48
2019,1,6,14,1604,1542,1326,-216
2019,1,6,15,1654,1588,1269,-319
2019,1,6,16,1679,1639,1207,-432
2019,1,6,17,1673,1643,1264,-379
2019,1,6,18,1672,1640,1315,-325
2019,1,6,19,1657,1655,1427,-228
2019,1,6,20,1637,1674,1522,-152
2019,1,6,21,1622,1673,1577,-96
2019,1,6,22,1624,1677,1599,-78
2019,1,6,23,1647,1680,1590,-90
2019,1,7,0,1717,1698,1552,-146
2019,1,7,1,1870,1852,1537,-315
2019,1,7,2,1920,1912,1564,-348
2019,1,7,3,1917,1881,1641,-240
2019,1,7,4,1895,1850,1698,-152
2019,1,7,5,1838,1784,1710,-74
2019,1,7,6,1741,1681,1685,4
2019,1,7,7,1657,1600,1704,104
2019,1,7,8,1567,1609,1777,168
2019,1,7,9,1537,1521,1781,260
2019,1,7,10,1523,1518,1826,308
2019,1,7,11,1534,1528,1720,192
2019,1,7,12,1568,1558,1699,141
2019,1,7,13,1650,1628,1710,82
2019,1,7,14,1780,1762,1791,29
2019,1,7,15,1823,1809,1823,14
2019,1,7,16,1805,1777,1831,54
2019,1,7,17,1772,1723,1811,88
2019,1,7,18,1740,1685,1858,173
2019,1,7,19,1711,1646,1851,205
2019,1,7,20,1682,1607,1807,200
2019,1,7,21,1665,1578,1819,241
2019,1,7,22,1660,1583,1802,219
2019,1,7,23,1678,1595,1717,122
2019,1,8,0,1748,1637,1591,-46
2019,1,8,1,1909,1791,1649,-142
2019,1,8,2,1965,1869,1727,-142
2019,1,8,3,1958,1877,1853,-24
2019,1,8,4,1948,1860,1776,-84
2019,1,8,5,1880,1784,1754,-30
2019,1,8,6,1772,1680,1741,61
2019,1,8,7,1675,1574,1761,187
2019,1,8,8,1586,1529,1772,243
2019,1,8,9,1549,1498,1820,322
2019,1,8,10,1539,1484,1858,374
2019,1,8,11,1546,1494,1757,263
2019,1,8,12,1582,1529,1759,230
2019,1,8,13,1668,1627,1802,175
2019,1,8,14,1805,1773,1850,77
2019,1,8,15,1831,1810,1860,50
2019,1,8,16,1795,1764,1694,-70
2019,1,8,17,1762,1707,1634,-73
2019,1,8,18,1718,1651,1603,-48
2019,1,8,19,1684,1596,1553,-43
2019,1,8,20,1656,1567,1524,-43
2019,1,8,21,1640,1535,1443,-92
2019,1,8,22,1631,1543,1437,-106
2019,1,8,23,1651,1560,1441,-119
2019,1,9,0,1715,1608,1444,-164
2019,1,9,1,1887,1750,1517,-233
2019,1,9,2,1939,1825,1585,-240
2019,1,9,3,1933,1822,1596,-226
2019,1,9,4,1923,1819,1561,-258
2019,1,9,5,1861,1751,1512,-239
2019,1,9,6,1754,1643,1506,-137
2019,1,9,7,1655,1549,1541,-8
2019,1,9,8,1586,1505,1508,3
2019,1,9,9,1552,1490,1495,5
2019,1,9,10,1540,1485,1498,13
2019,1,9,11,1551,1485,1531,46
2019,1,9,12,1585,1520,1530,10
2019,1,9,13,1670,1656,1622,-34
2019,1,9,14,1806,1740,1626,-114
2019,1,9,15,1840,1777,1650,-127
2019,1,9,16,1804,1741,1705,-36
2019,1,9,17,1757,1706,1680,-26
2019,1,9,18,1718,1655,1682,27
2019,1,9,19,1688,1605,1660,55
2019,1,9,20,1658,1589,1603,14
2019,1,9,21,1644,1568,1589,21
2019,1,9,22,1642,1588,1429,-159
2019,1,9,23,1656,1624,1253,-371
2019,1,10,0,1713,1636,1249,-387
2019,1,10,1,1871,1773,1337,-436
2019,1,10,2,1917,1817,1315,-502
2019,1,10,3,1918,1797,1345,-452
2019,1,10,4,1908,1772,1285,-487
2019,1,10,5,1844,1705,1291,-414
2019,1,10,6,1744,1601,1263,-338
2019,1,10,7,1642,1517,1334,-183
2019,1,10,8,1564,1467,1404,-63
2019,1,10,9,1531,1449,1471,22
2019,1,10,10,1516,1442,1485,43
2019,1,10,11,1526,1449,1426,-23
2019,1,10,12,1560,1484,1404,-80
2019,1,10,13,1651,1568,1400,-168
2019,1,10,14,1778,1709,1479,-230
2019,1,10,15,1814,1756,1468,-288
2019,1,10,16,1776,1713,1453,-260
2019,1,10,17,1729,1666,1437,-229
2019,1,10,18,1682,1619,1386,-233
2019,1,10,19,1650,1565,1391,-174
2019,1,10,20,1627,1574,1417,-157
2019,1,10,21,1613,1562,1367,-195
2019,1,10,22,1616,1570,1382,-188
2019,1,10,23,1630,1606,1384,-222
2019,1,11,0,1693,1685,1480,-205
2019,1,11,1,1836,1769,1573,-196
2019,1,11,2,1900,1812,1612,-200
2019,1,11,3,1890,1800,1572,-228
2019,1,11,4,1880,1774,1570,-204
2019,1,11,5,1815,1697,1571,-126
2019,1,11,6,1703,1593,1546,-47
2019,1,11,7,1607,1509,1536,27
2019,1,11,8,1513,1442,1443,1
2019,1,11,9,1480,1414,1520,106
2019,1,11,10,1470,1403,1530,127
2019,1,11,11,1473,1400,1554,154
2019,1,11,12,1502,1443,1546,103
2019,1,11,13,1581,1522,1557,35
2019,1,11,14,1710,1649,1637,-12
2019,1,11,15,1746,1708,1602,-106
2019,1,11,16,1733,1701,1543,-158
2019,1,11,17,1710,1696,1599,-97
2019,1,11,18,1686,1678,1588,-90
2019,1,11,19,1661,1659,1538,-121
2019,1,11,20,1641,1641,1547,-94
2019,1,11,21,1625,1627,1587,-40
2019,1,11,22,1624,1622,1621,-1
2019,1,11,23,1646,1629,1595,-34
2019,1,12,0,1704,1660,1535,-125
2019,1,12,1,1848,1770,1582,-188
2019,1,12,2,1878,1804,1606,-198
2019,1,12,3,1861,1774,1610,-164
2019,1,12,4,1858,1779,1612,-167
2019,1,12,5,1810,1721,1498,-223
2019,1,12,6,1718,1630,1449,-181
2019,1,12,7,1629,1551,1411,-140
2019,1,12,8,1572,1506,1374,-132
2019,1,12,9,1543,1464,1352,-112
2019,1,12,10,1521,1455,1353,-102
2019,1,12,11,1514,1460,1319,-141
2019,1,12,12,1529,1478,1309,-169
2019,1,12,13,1562,1519,1290,-229
2019,1,12,14,1633,1588,1286,-302
2019,1,12,15,1675,1627,1335,-292
2019,1,12,16,1680,1650,1385,-265
2019,1,12,17,1670,1664,1456,-208
2019,1,12,18,1629,1640,1394,-246
2019,1,12,19,1593,1594,1381,-213
2019,1,12,20,1570,1554,1335,-219
2019,1,12,21,1552,1508,1301,-207
2019,1,12,22,1542,1501,1332,-169
2019,1,12,23,1572,1514,1313,-201
2019,1,13,0,1642,1579,1308,-271
2019,1,13,1,1798,1697,1446,-251
2019,1,13,2,1847,1765,1504,-261
2019,1,13,3,1833,1745,1533,-212
2019,1,13,4,1822,1719,1536,-183
2019,1,13,5,1768,1676,1563,-113
2019,1,13,6,1696,1598,1517,-81
2019,1,13,7,1617,1527,1516,-11
2019,1,13,8,1570,1490,1444,-46
2019,1,13,9,1533,1456,1450,-6
2019,1,13,10,1512,1432,1493,61
2019,1,13,11,1507,1427,1508,81
2019,1,13,12,1514,1435,1508,73
2019,1,13,13,1544,1480,1487,7
2019,1,13,14,1600,1541,1493,-48
2019,1,13,15,1651,1639,1504,-135
2019,1,13,16,1665,1638,1481,-157
2019,1,13,17,1653,1672,1529,-143
2019,1,13,18,1628,1687,1518,-169
2019,1,13,19,1611,1702,1483,-219
2019,1,13,20,1611,1711,1461,-250
2019,1,13,21,1602,1709,1451,-258
2019,1,13,22,1603,1699,1401,-298
2019,1,13,23,1624,1718,1378,-340
2019,1,14,0,1699,1749,1397,-352
2019,1,14,1,1859,1865,1441,-424
2019,1,14,2,1915,1895,1468,-427
2019,1,14,3,1899,1858,1438,-420
2019,1,14,4,1878,1819,1500,-319
2019,1,14,5,1810,1734,1485,-249
2019,1,14,6,1712,1634,1416,-218
2019,1,14,7,1627,1545,1338,-207
2019,1,14,8,1571,1485,1206,-279
2019,1,14,9,1541,1448,1248,-200
2019,1,14,10,1529,1443,1250,-193
2019,1,14,11,1534,1442,1265,-177
2019,1,14,12,1565,1478,1279,-199
2019,1,14,13,1649,1546,1234,-312
2019,1,14,14,1780,1680,1293,-387
2019,1,14,15,1824,1750,1296,-454
2019,1,14,16,1786,1719,1374,-345
2019,1,14,17,1752,1710,1432,-278
2019,1,14,18,1714,1673,1406,-267
2019,1,14,19,1684,1618,1388,-230
2019,1,14,20,1657,1614,1428,-186
2019,1,14,21,1645,1607,1471,-136
2019,1,14,22,1643,1568,1491,-77
2019,1,14,23,1659,1585,1468,-117
2019,1,15,0,1721,1649,1491,-158
2019,1,15,1,1873,1766,1572,-194
2019,1,15,2,1935,1835,1522,-313
2019,1,15,3,1922,1818,1575,-243
2019,1,15,4,1908,1799,1542,-257
2019,1,15,5,1836,1729,1495,-234
2019,1,15,6,1726,1638,1473,-165
2019,1,15,7,1631,1536,1490,-46
2019,1,15,8,1550,1483,1383,-100
2019,1,15,9,1515,1463,1405,-58
2019,1,15,10,1510,1461,1465,4
2019,1,15,11,1516,1466,1502,36
2019,1,15,12,1554,1501,1596,95
2019,1,15,13,1642,1600,1539,-61
2019,1,15,14,1770,1741,1563,-178
2019,1,15,15,1806,1760,1614,-146
2019,1,15,16,1777,1748,1596,-152
2019,1,15,17,1746,1701,1604,-97
2019,1,15,18,1709,1666,1641,-25
2019,1,15,19,1670,1629,1604,-25
2019,1,15,20,1650,1585,1585,0
2019,1,15,21,1644,1576,1561,-15
2019,1,15,22,1644,1568,1628,60
2019,1,15,23,1655,1581,1611,30
2019,1,16,0,1709,1637,1590,-47
2019,1,16,1,1843,1769,1632,-137
2019,1,16,2,1894,1827,1653,-174
2019,1,16,3,1882,1817,1687,-130
2019,1,16,4,1861,1802,1705,-97
2019,1,16,5,1782,1713,1629,-84
2019,1,16,6,1680,1600,1563,-37
2019,1,16,7,1587,1512,1590,78
2019,1,16,8,1523,1483,1466,-17
2019,1,16,9,1492,1428,1344,-84
2019,1,16,10,1482,1416,1289,-127
2019,1,16,11,1487,1425,1300,-125
2019,1,16,12,1524,1455,1317,-138
2019,1,16,13,1612,1546,1347,-199
2019,1,16,14,1736,1683,1446,-237
2019,1,16,15,1770,1723,1488,-235
2019,1,16,16,1744,1694,1503,-191
2019,1,16,17,1720,1652,1524,-128
2019,1,16,18,1685,1617,1634,17
2019,1,16,19,1651,1574,1634,60
2019,1,16,20,1631,1567,1648,81
2019,1,16,21,1620,1539,1639,100
2019,1,16,22,1615,1522,1601,79
2019,1,16,23,1629,1539,1567,28
2019,1,17,0,1685,1582,1523,-59
2019,1,17,1,1815,1704,1727,23
2019,1,17,2,1872,1773,1828,55
2019,1,17,3,1867,1756,1663,-93
2019,1,17,4,1848,1750,1715,-35
2019,1,17,5,1775,1698,1620,-78
2019,1,17,6,1671,1590,1470,-120
2019,1,17,7,1579,1503,1445,-58
2019,1,17,8,1531,1447,1418,-29
2019,1,17,9,1499,1430,1421,-9
2019,1,17,10,1492,1426,1389,-37
2019,1,17,11,1502,1429,1376,-53
2019,1,17,12,1540,1449,1367,-82
2019,1,17,13,1634,1548,1394,-154
2019,1,17,14,1762,1689,1508,-181
2019,1,17,15,1793,1726,1563,-163
2019,1,17,16,1734,1679,1613,-66
2019,1,17,17,1690,1613,1548,-65
2019,1,17,18,1661,1571,1528,-43
2019,1,17,19,1632,1532,1560,28
2019,1,17,20,1604,1494,1553,59
2019,1,17,21,1594,1455,1599,144
2019,1,17,22,1582,1450,1621,171
2019,1,17,23,1596,1457,1620,163
2019,1,18,0,1676,1522,1537,15
2019,1,18,1,1816,1625,1528,-97
2019,1,18,2,1866,1706,1474,-232
2019,1,18,3,1853,1691,1470,-221
2019,1,18,4,1838,1673,1447,-226
2019,1,18,5,1766,1606,1431,-175
2019,1,18,6,1663,1503,1341,-162
2019,1,18,7,1569,1423,1290,-133
2019,1,18,8,1505,1381,1262,-119
2019,1,18,9,1465,1362,1286,-76
2019,1,18,10,1456,1352,1339,-13
2019,1,18,11,1456,1359,1376,17
2019,1,18,12,1488,1399,1426,27
2019,1,18,13,1580,1477,1434,-43
2019,1,18,14,1708,1599,1459,-140
2019,1,18,15,1751,1650,1494,-156
2019,1,18,16,1740,1666,1565,-101
2019,1,18,17,1726,1671,1636,-35
2019,1,18,18,1709,1661,1542,-119
2019,1,18,19,1683,1626,1558,-68
2019,1,18,20,1666,1565,1581,16
2019,1,18,21,1650,1583,1613,30
2019,1,18,22,1645,1571,1564,-7
2019,1,18,23,1663,1575,1528,-47
2019,1,19,0,1716,1624,1513,-111
2019,1,19,1,1836,1738,1571,-167
2019,1,19,2,1864,1793,1556,-237
2019,1,19,3,1845,1775,1562,-213
2019,1,19,4,1838,1769,1568,-201
2019,1,19,5,1790,1727,1480,-247
2019,1,19,6,1703,1651,1400,-251
2019,1,19,7,1616,1561,1367,-194
2019,1,19,8,1565,1516,1389,-127
2019,1,19,9,1539,1486,1396,-90
2019,1,19,10,1524,1475,1459,-16
2019,1,19,11,1525,1475,1470,-5
2019,1,19,12,1538,1493,1460,-33
2019,1,19,13,1583,1528,1449,-79
2019,1,19,14,1649,1627,1497,-130
2019,1,19,15,1692,1650,1548,-102
2019,1,19,16,1685,1645,1615,-30
2019,1,19,17,1671,1608,1582,-26
2019,1,19,18,1634,1566,1586,20
2019,1,19,19,1594,1523,1551,28
2019,1,19,20,1558,1503,1472,-31
2019,1,19,21,1524,1442,1439,-3
2019,1,19,22,1513,1430,1445,15
2019,1,19,23,1536,1450,1466,16
2019,1,20,0,1594,1493,1385,-108
2019,1,20,1,1724,1645,1433,-212
2019,1,20,2,1779,1723,1521,-202
2019,1,20,3,1774,1714,1498,-216
2019,1,20,4,1757,1713,1442,-271
2019,1,20,5,1704,1667,1431,-236
2019,1,20,6,1631,1626,1462,-164
2019,1,20,7,1562,1541,1486,-55
2019,1,20,8,1542,1435,1490,55
2019,1,20,9,1510,1451,1422,-29
2019,1,20,10,1501,1431,1405,-26
2019,1,20,11,1502,1431,1451,20
2019,1,20,12,1512,1449,1465,16
2019,1,20,13,1548,1489,1493,4
2019,1,20,14,1602,1554,1487,-67
2019,1,20,15,1632,1575,1475,-100
2019,1,20,16,1631,1586,1563,-23
2019,1,20,17,1605,1548,1620,72
2019,1,20,18,1573,1518,1660,142
2019,1,20,19,1560,1466,1616,150
2019,1,20,20,1538,1430,1644,214
2019,1,20,21,1526,1413,1683,270
2019,1,20,22,1525,1418,1797,379
2019,1,20,23,1541,1430,1801,371
2019,1,21,0,1607,1493,1714,221
2019,1,21,1,1758,1644,1685,41
2019,1,21,2,1819,1729,1738,9
2019,1,21,3,1816,1709,1779,70
2019,1,21,4,1788,1706,1789,83
2019,1,21,5,1727,1655,1779,124
2019,1,21,6,1631,1574,1785,211
2019,1,21,7,1548,1495,1760,265
2019,1,21,8,1498,1446,1736,290
2019,1,21,9,1470,1412,1718,306
2019,1,21,10,1458,1403,1668,265
2019,1,21,11,1463,1401,1675,274
2019,1,21,12,1502,1431,1651,220
2019,1,21,13,1593,1486,1676,190
2019,1,21,14,1716,1589,1673,84
2019,1,21,15,1747,1630,1687,57
2019,1,21,16,1719,1638,1782,144
2019,1,21,17,1691,1642,1817,175
2019,1,21,18,1650,1604,1863,259
2019,1,21,19,1624,1570,1865,295
2019,1,21,20,1598,1534,1824,290
2019,1,21,21,1586,1508,1768,260
2019,1,21,22,1587,1490,1726,236
2019,1,21,23,1599,1512,1745,233
2019,1,22,0,1659,1562,1905,343
2019,1,22,1,1791,1686,1950,264
2019,1,22,2,1847,1769,2053,284
2019,1,22,3,1837,1767,2012,245
2019,1,22,4,1819,1756,2011,255
2019,1,22,5,1749,1701,1934,233
2019,1,22,6,1648,1585,1837,252
2019,1,22,7,1551,1498,1882,384
2019,1,22,8,1520,1458,1829,371
2019,1,22,9,1496,1445,1843,398
2019,1,22,10,1487,1429,1809,380
2019,1,22,11,1494,1420,1769,349
2019,1,22,12,1533,1452,1746,294
2019,1,22,13,1629,1538,1764,226
2019,1,22,14,1766,1689,1828,139
2019,1,22,15,1811,1765,1788,23
2019,1,22,16,1794,1764,1826,62
2019,1,22,17,1773,1728,1903,175
2019,1,22,18,1740,1679,1884,205
2019,1,22,19,1719,1672,1903,231
2019,1,22,20,1699,1669,1933,264
2019,1,22,21,1687,1684,1843,159
2019,1,22,22,1680,1677,1703,26
2019,1,22,23,1689,1686,1614,-72
2019,1,23,0,1753,1706,1580,-126
2019,1,23,1,1879,1809,1656,-153
2019,1,23,2,1938,1893,1665,-228
2019,1,23,3,1935,1881,1684,-197
2019,1,23,4,1915,1846,1705,-141
2019,1,23,5,1833,1776,1626,-150
2019,1,23,6,1725,1666,1515,-151
2019,1,23,7,1635,1558,1579,21
2019,1,23,8,1581,1538,1606,68
2019,1,23,9,1558,1512,1674,162
2019,1,23,10,1550,1509,1691,182
2019,1,23,11,1558,1521,1700,179
2019,1,23,12,1593,1560,1733,173
2019,1,23,13,1685,1658,1798,140
2019,1,23,14,1821,1785,1861,76
2019,1,23,15,1852,1806,1835,29
2019,1,23,16,1816,1751,1711,-40
2019,1,23,17,1778,1697,1626,-71
2019,1,23,18,1733,1653,1601,-52
2019,1,23,19,1691,1602,1566,-36
2019,1,23,20,1657,1560,1520,-40
2019,1,23,21,1638,1534,1506,-28
2019,1,23,22,1628,1515,1557,42
2019,1,23,23,1633,1529,1619,90
2019,1,24,0,1695,1572,1605,33
2019,1,24,1,1825,1691,1776,85
2019,1,24,2,1890,1812,1958,146
2019,1,24,3,1886,1823,2058,235
2019,1,24,4,1875,1815,2048,233
2019,1,24,5,1808,1767,1996,229
2019,1,24,6,1706,1657,1894,237
2019,1,24,7,1614,1570,1823,253
2019,1,24,8,1581,1519,1834,315
2019,1,24,9,1550,1500,1793,293
2019,1,24,10,1543,1492,1836,344
2019,1,24,11,1557,1500,1871,371
2019,1,24,12,1592,1535,1860,325
2019,1,24,13,1677,1625,1895,270
2019,1,24,14,1813,1764,1890,126
2019,1,24,15,1849,1804,1888,84
2019,1,24,16,1804,1740,1863,123
2019,1,24,17,1759,1686,1806,120
2019,1,24,18,1703,1635,1759,124
2019,1,24,19,1662,1590,1723,133
2019,1,24,20,1635,1555,1714,159
2019,1,24,21,1617,1526,1732,206
2019,1,24,22,1609,1500,1735,235
2019,1,24,23,1619,1500,1727,227
2019,1,25,0,1672,1545,1656,111
2019,1,25,1,1816,1666,1733,67
2019,1,25,2,1887,1773,1801,28
2019,1,25,3,1886,1788,1800,12
2019,1,25,4,1882,1789,1880,91
2019,1,25,5,1816,1747,1799,52
2019,1,25,6,1709,1643,1680,37
2019,1,25,7,1620,1572,1689,117
2019,1,25,8,1583,1522,1602,80
2019,1,25,9,1558,1503,1673,170
2019,1,25,10,1553,1493,1730,237
2019,1,25,11,1561,1508,1750,242
2019,1,25,12,1599,1539,1803,264
2019,1,25,13,1689,1637,1812,175
2019,1,25,14,1815,1773,1768,-5
2019,1,25,15,1841,1804,1698,-106
2019,1,25,16,1802,1755,1633,-122
2019,1,25,17,1759,1664,1691,27
2019,1,25,18,1716,1608,1724,116
2019,1,25,19,1669,1552,1785,233
2019,1,25,20,1634,1516,1751,235
2019,1,25,21,1610,1488,1678,190
2019,1,25,22,1593,1478,1587,109
2019,1,25,23,1603,1506,1511,5
2019,1,26,0,1650,1568,1482,-86
2019,1,26,1,1787,1664,1622,-42
2019,1,26,2,1851,1764,1646,-118
2019,1,26,3,1847,1767,1608,-159
2019,1,26,4,1850,1766,1660,-106
2019,1,26,5,1804,1733,1610,-123
2019,1,26,6,1726,1645,1481,-164
2019,1,26,7,1638,1574,1476,-98
2019,1,26,8,1605,1519,1516,-3
2019,1,26,9,1575,1493,1517,24
2019,1,26,10,1566,1492,1521,29
2019,1,26,11,1565,1484,1550,66
2019,1,26,12,1576,1499,1576,77
2019,1,26,13,1619,1554,1662,108
2019,1,26,14,1688,1621,1733,112
2019,1,26,15,1727,1665,1779,114
2019,1,26,16,1723,1657,1797,140
2019,1,26,17,1703,1615,1775,160
2019,1,26,18,1659,1567,1771,204
2019,1,26,19,1606,1523,1792,269
2019,1,26,20,1572,1491,1834,343
2019,1,26,21,1539,1450,1840,390
2019,1,26,22,1508,1433,1832,399
2019,1,26,23,1509,1449,1823,374
2019,1,27,0,1569,1480,1793,313
2019,1,27,1,1705,1594,1833,239
2019,1,27,2,1786,1690,1838,148
2019,1,27,3,1790,1684,1756,72
2019,1,27,4,1797,1668,1643,-25
2019,1,27,5,1763,1627,1552,-75
2019,1,27,6,1695,1565,1494,-71
2019,1,27,7,1618,1500,1463,-37
2019,1,27,8,1574,1469,1447,-22
2019,1,27,9,1546,1451,1377,-74
2019,1,27,10,1533,1435,1430,-5
2019,1,27,11,1529,1426,1432,6
2019,1,27,12,1536,1440,1455,15
2019,1,27,13,1577,1478,1506,28
2019,1,27,14,1639,1537,1640,103
2019,1,27,15,1675,1554,1686,132
2019,1,27,16,1675,1556,1675,119
2019,1,27,17,1634,1525,1765,240
2019,1,27,18,1589,1489,1852,363
2019,1,27,19,1553,1458,1878,420
2019,1,27,20,1524,1437,1858,421
2019,1,27,21,1502,1456,1878,422
2019,1,27,22,1493,1468,1891,423
2019,1,27,23,1517,1489,1908,419
2019,1,28,0,1586,1387,1749,362
2019,1,28,1,1729,1692,1856,164
2019,1,28,2,1807,1778,1839,61
2019,1,28,3,1815,1762,1804,42
2019,1,28,4,1790,1765,1842,77
2019,1,28,5,1736,1690,1843,153
2019,1,28,6,1643,1604,1776,172
2019,1,28,7,1564,1508,1685,177
2019,1,28,8,1510,1453,1684,231
2019,1,28,9,1486,1431,1696,265
2019,1,28,10,1479,1430,1621,191
2019,1,28,11,1491,1435,1692,257
2019,1,28,12,1527,1468,1682,214
2019,1,28,13,1618,1561,1769,208
2019,1,28,14,1746,1706,1767,61
2019,1,28,15,1784,1733,1816,83
2019,1,28,16,1753,1672,1797,125
2019,1,28,17,1714,1618,1814,196
2019,1,28,18,1674,1577,1724,147
2019,1,28,19,1635,1534,1663,129
2019,1,28,20,1602,1499,1681,182
2019,1,28,21,1587,1476,1696,220
2019,1,28,22,1579,1486,1741,255
2019,1,28,23,1591,1493,1882,389
2019,1,29,0,1645,1549,1912,363
2019,1,29,1,1777,1660,1929,269
2019,1,29,2,1848,1766,1865,99
2019,1,29,3,1847,1774,1812,38
2019,1,29,4,1840,1771,1803,32
2019,1,29,5,1771,1707,1662,-45
2019,1,29,6,1674,1618,1614,-4
2019,1,29,7,1583,1536,1573,37
2019,1,29,8,1545,1487,1501,14
2019,1,29,9,1515,1471,1473,2
2019,1,29,10,1514,1466,1489,23
2019,1,29,11,1521,1470,1535,65
2019,1,29,12,1559,1505,1648,143
2019,1,29,13,1655,1591,1704,113
2019,1,29,14,1794,1738,1794,56
2019,1,29,15,1827,1776,1939,163
2019,1,29,16,1786,1767,2053,286
2019,1,29,17,1740,1758,1978,220
2019,1,29,18,1690,1726,1937,211
2019,1,29,19,1652,1699,1898,199
2019,1,29,20,1621,1657,1880,223
2019,1,29,21,1604,1637,1839,202
2019,1,29,22,1603,1619,1777,158
2019,1,29,23,1617,1645,1747,102
2019,1,30,0,1663,1683,1678,-5
2019,1,30,1,1795,1780,1663,-117
2019,1,30,2,1869,1860,1654,-206
2019,1,30,3,1865,1851,1603,-248
2019,1,30,4,1854,1830,1639,-191
2019,1,30,5,1787,1761,1616,-145
2019,1,30,6,1683,1627,1530,-97
2019,1,30,7,1592,1518,1551,33
2019,1,30,8,1544,1478,1579,101
2019,1,30,9,1519,1457,1558,101
2019,1,30,10,1513,1455,1588,133
2019,1,30,11,1522,1473,1611,138
2019,1,30,12,1558,1517,1663,146
2019,1,30,13,1660,1622,1647,25
2019,1,30,14,1791,1767,1627,-140
2019,1,30,15,1813,1800,1669,-131
2019,1,30,16,1764,1743,1694,-49
2019,1,30,17,1710,1688,1719,31
2019,1,30,18,1665,1624,1702,78
2019,1,30,19,1620,1576,1737,161
2019,1,30,20,1580,1524,1720,196
2019,1,30,21,1562,1512,1728,216
2019,1,30,22,1560,1491,1771,280
2019,1,30,23,1570,1499,1819,320
2019,1,31,0,1619,1543,1817,274
2019,1,31,1,1737,1640,1860,220
2019,1,31,2,1822,1768,2035,267
2019,1,31,3,1828,1787,1999,212
2019,1,31,4,1818,1774,2003,229
2019,1,31,5,1755,1704,1992,288
2019,1,31,6,1656,1611,1922,311
2019,1,31,7,1571,1528,1884,356
2019,1,31,8,1516,1490,1841,351
2019,1,31,9,1491,1472,1803,331
2019,1,31,10,1486,1466,1863,397
2019,1,31,11,1496,1474,1866,392
2019,1,31,12,1537,1515,1806,291
2019,1,31,13,1636,1610,1788,178
2019,1,31,14,1770,1761,1830,69
2019,1,31,15,1785,1776,1844,68
2019,1,31,16,1735,1704,1812,108
2019,1,31,17,1684,1635,1674,39
2019,1,31,18,1633,1572,1609,37
2019,1,31,19,1582,1523,1494,-29
2019,1,31,20,1555,1499,1482,-17
2019,1,31,21,1536,1483,1502,19
2019,1,31,22,1527,1475,1487,12
2019,1,31,23,1539,1471,1582,111
2019,2,1,0,1587,1517,1659,142
2019,2,1,1,1703,1614,1759,145
2019,2,1,2,1792,1721,1831,110
2019,2,1,3,1793,1720,1814,94
2019,2,1,4,1788,1718,1883,165
2019,2,1,5,1719,1663,1839,176
2019,2,1,6,1610,1566,1714,148
2019,2,1,7,1517,1491,1683,192
2019,2,1,8,1451,1452,1625,173
2019,2,1,9,1431,1433,1570,137
2019,2,1,10,1432,1422,1562,140
2019,2,1,11,1444,1427,1569,142
2019,2,1,12,1486,1466,1552,86
2019,2,1,13,1577,1550,1613,63
2019,2,1,14,1703,1703,1641,-62
2019,2,1,15,1725,1743,1652,-91
2019,2,1,16,1682,1709,1652,-57
2019,2,1,17,1637,1640,1598,-42
2019,2,1,18,1594,1588,1612,24
2019,2,1,19,1547,1532,1648,116
2019,2,1,20,1519,1486,1648,162
2019,2,1,21,1507,1463,1697,234
2019,2,1,22,1497,1457,1730,273
2019,2,1,23,1510,1495,1755,260
2019,2,2,0,1549,1479,1696,217
2019,2,2,1,1653,1576,1684,108
2019,2,2,2,1724,1662,1716,54
2019,2,2,3,1731,1658,1750,92
2019,2,2,4,1720,1672,1739,67
2019,2,2,5,1677,1636,1725,89
2019,2,2,6,1596,1568,1663,95
2019,2,2,7,1514,1488,1646,158
2019,2,2,8,1459,1477,1659,182
2019,2,2,9,1428,1414,1644,230
2019,2,2,10,1414,1404,1675,271
2019,2,2,11,1419,1401,1666,265
2019,2,2,12,1429,1424,1636,212
2019,2,2,13,1473,1472,1659,187
2019,2,2,14,1540,1543,1720,177
2019,2,2,15,1572,1585,1760,175
2019,2,2,16,1559,1570,1763,193
2019,2,2,17,1526,1532,1717,185
2019,2,2,18,1486,1495,1839,344
2019,2,2,19,1466,1450,1876,426
2019,2,2,20,1443,1409,1883,474
2019,2,2,21,1422,1387,1855,468
2019,2,2,22,1415,1385,1845,460
2019,2,2,23,1432,1402,1803,401
2019,2,3,0,1484,1450,1786,336
2019,2,3,1,1601,1542,1795,253
2019,2,3,2,1673,1646,1848,202
2019,2,3,3,1668,1646,1888,242
2019,2,3,4,1653,1628,1864,236
2019,2,3,5,1612,1587,1863,276
2019,2,3,6,1529,1513,1824,311
2019,2,3,7,1459,1443,1785,342
2019,2,3,8,1407,1399,1796,397
2019,2,3,9,1380,1372,1812,440
2019,2,3,10,1361,1358,1790,432
2019,2,3,11,1358,1355,1811,456
2019,2,3,12,1363,1363,1815,452
2019,2,3,13,1399,1396,1820,424
2019,2,3,14,1460,1446,1859,413
2019,2,3,15,1493,1464,1899,435
2019,2,3,16,1510,1502,1894,392
2019,2,3,17,1497,1531,1967,436
2019,2,3,18,1480,1505,1969,464
2019,2,3,19,1457,1463,1888,425
2019,2,3,20,1440,1455,1921,466
2019,2,3,21,1435,1443,1908,465
2019,2,3,22,1431,1451,1960,509
2019,2,3,23,1450,1469,1979,510
2019,2,4,0,1501,1485,1907,422
2019,2,4,1,1616,1533,1835,302
2019,2,4,2,1689,1626,1856,230
2019,2,4,3,1675,1612,1910,298
2019,2,4,4,1652,1610,1953,343
2019,2,4,5,1592,1570,1943,373
2019,2,4,6,1501,1493,1890,397
2019,2,4,7,1414,1398,1834,436
2019,2,4,8,1366,1353,1824,471
2019,2,4,9,1340,1327,1804,477
2019,2,4,10,1329,1321,1803,482
2019,2,4,11,1341,1323,1815,492
2019,2,4,12,1375,1353,1792,439
2019,2,4,13,1462,1446,1755,309
2019,2,4,14,1592,1573,1786,213
2019,2,4,15,1628,1615,1815,200
2019,2,4,16,1607,1583,1727,144
2019,2,4,17,1583,1566,1763,197
2019,2,4,18,1548,1529,1804,275
2019,2,4,19,1523,1493,1845,352
2019,2,4,20,1504,1484,1917,433
2019,2,4,21,1504,1487,1908,421
2019,2,4,22,1504,1481,1892,411
2019,2,4,23,1517,1488,1858,370
2019,2,5,0,1563,1509,1780,271
2019,2,5,1,1661,1591,1696,105
2019,2,5,2,1732,1685,1765,80
2019,2,5,3,1718,1668,1780,112
2019,2,5,4,1704,1643,1838,195
2019,2,5,5,1630,1573,1855,282
2019,2,5,6,1525,1471,1820,349
2019,2,5,7,1434,1388,1838,450
2019,2,5,8,1365,1328,1794,466
2019,2,5,9,1341,1324,1849,525
2019,2,5,10,1336,1303,1793,490
2019,2,5,11,1344,1303,1773,470
2019,2,5,12,1376,1327,1837,510
2019,2,5,13,1475,1423,1857,434
2019,2,5,14,1597,1554,1882,328
2019,2,5,15,1627,1592,1877,285
2019,2,5,16,1608,1584,1858,274
2019,2,5,17,1592,1554,1847,293
2019,2,5,18,1568,1520,1801,281
2019,2,5,19,1540,1489,1866,377
2019,2,5,20,1517,1469,1889,420
2019,2,5,21,1514,1454,1925,471
2019,2,5,22,1511,1452,1944,492
2019,2,5,23,1525,1457,1975,518
2019,2,6,0,1555,1495,1894,399
2019,2,6,1,1649,1570,1841,271
2019,2,6,2,1715,1679,1821,142
2019,2,6,3,1716,1681,1829,148
2019,2,6,4,1693,1659,1934,275
2019,2,6,5,1619,1610,1912,302
2019,2,6,6,1520,1519,1869,350
2019,2,6,7,1425,1431,1897,466
2019,2,6,8,1408,1387,1907,520
2019,2,6,9,1383,1361,1894,533
2019,2,6,10,1375,1348,1884,536
2019,2,6,11,1373,1336,1923,587
2019,2,6,12,1409,1388,1973,585
2019,2,6,13,1494,1483,2003,520
2019,2,6,14,1632,1603,2106,503
2019,2,6,15,1670,1633,2179,546
2019,2,6,16,1649,1590,2091,501
2019,2,6,17,1631,1559,2104,545
2019,2,6,18,1613,1538,2128,590
2019,2,6,19,1590,1585,2240,655
2019,2,6,20,1573,1580,2195,615
2019,2,6,21,1560,1555,2128,573
2019,2,6,22,1562,1546,2116,570
2019,2,6,23,1576,1568,2168,600
2019,2,7,0,1620,1593,2101,508
2019,2,7,1,1737,1695,2186,491
2019,2,7,2,1812,1832,2344,512
2019,2,7,3,1806,1831,2353,522
2019,2,7,4,1795,1813,2282,469
2019,2,7,5,1733,1721,2275,554
2019,2,7,6,1631,1616,2219,603
2019,2,7,7,1545,1536,2111,575
2019,2,7,8,1528,1498,1976,478
2019,2,7,9,1504,1475,1993,518
2019,2,7,10,1497,1476,1980,504
2019,2,7,11,1505,1492,1990,498
2019,2,7,12,1544,1536,2004,468
2019,2,7,13,1634,1630,2097,467
2019,2,7,14,1783,1775,2150,375
2019,2,7,15,1819,1801,2210,409
2019,2,7,16,1772,1722,2166,444
2019,2,7,17,1728,1675,2117,442
2019,2,7,18,1685,1656,2139,483
2019,2,7,19,1647,1613,2096,483
2019,2,7,20,1611,1561,2059,498
2019,2,7,21,1586,1549,2030,481
2019,2,7,22,1577,1513,1992,479
2019,2,7,23,1592,1528,1958,430
2019,2,8,0,1639,1571,1956,385
2019,2,8,1,1749,1669,2102,433
2019,2,8,2,1864,1823,2262,439
2019,2,8,3,1868,1838,2212,374
2019,2,8,4,1867,1828,2156,328
2019,2,8,5,1805,1775,2171,396
2019,2,8,6,1712,1676,2096,420
2019,2,8,7,1621,1596,1941,345
2019,2,8,8,1575,1555,1838,283
2019,2,8,9,1555,1541,1769,228
2019,2,8,10,1547,1545,1809,264
2019,2,8,11,1555,1556,1753,197
2019,2,8,12,1595,1604,1690,86
2019,2,8,13,1680,1690,1824,134
2019,2,8,14,1811,1817,1915,98
2019,2,8,15,1820,1819,1999,180
2019,2,8,16,1758,1762,1990,228
2019,2,8,17,1705,1691,1989,298
2019,2,8,18,1644,1636,2010,374
2019,2,8,19,1594,1593,2007,414
2019,2,8,20,1551,1540,2024,484
2019,2,8,21,1520,1524,2061,537
2019,2,8,22,1495,1494,2168,674
2019,2,8,23,1507,1498,2177,679
2019,2,9,0,1544,1528,2172,644
2019,2,9,1,1661,1603,2170,567
2019,2,9,2,1775,1727,2264,537
2019,2,9,3,1776,1743,2238,495
2019,2,9,4,1768,1752,2235,483
2019,2,9,5,1710,1719,2207,488
2019,2,9,6,1629,1650,2108,458
2019,2,9,7,1554,1575,1988,413
2019,2,9,8,1524,1535,1879,344
2019,2,9,9,1491,1506,1821,315
2019,2,9,10,1481,1497,1726,229
2019,2,9,11,1481,1494,1730,236
2019,2,9,12,1493,1509,1722,213
2019,2,9,13,1544,1560,1706,146
2019,2,9,14,1620,1617,1694,77
2019,2,9,15,1658,1645,1775,130
2019,2,9,16,1646,1634,1849,215
2019,2,9,17,1624,1586,1776,190
2019,2,9,18,1586,1550,1841,291
2019,2,9,19,1544,1532,1920,388
2019,2,9,20,1501,1557,1931,374
2019,2,9,21,1477,1494,1936,442
2019,2,9,22,1459,1460,2022,562
2019,2,9,23,1477,1506,2113,607
2019,2,10,0,1524,1560,2100,540
2019,2,10,1,1626,1646,2091,445
2019,2,10,2,1729,1734,2202,468
2019,2,10,3,1727,1727,2238,511
2019,2,10,4,1716,1690,2198,508
2019,2,10,5,1675,1639,2168,529
2019,2,10,6,1606,1558,1993,435
2019,2,10,7,1535,1505,1876,371
2019,2,10,8,1478,1433,1761,328
2019,2,10,9,1457,1409,1718,309
2019,2,10,10,1442,1399,1659,260
2019,2,10,11,1445,1397,1678,281
2019,2,10,12,1450,1413,1582,169
2019,2,10,13,1491,1456,1464,8
2019,2,10,14,1556,1509,1383,-126
2019,2,10,15,1578,1529,1394,-135
2019,2,10,16,1580,1534,1447,-87
2019,2,10,17,1555,1547,1524,-23
2019,2,10,18,1528,1519,1520,1
2019,2,10,19,1495,1476,1546,70
2019,2,10,20,1475,1467,1656,189
2019,2,10,21,1459,1464,1682,218
2019,2,10,22,1453,1443,1714,271
2019,2,10,23,1469,1466,1743,277
2019,2,11,0,1518,1516,1721,205
2019,2,11,1,1645,1614,1861,247
2019,2,11,2,1746,1738,1960,222
2019,2,11,3,1748,1748,1917,169
2019,2,11,4,1732,1728,1897,169
2019,2,11,5,1678,1662,1856,194
2019,2,11,6,1579,1561,1829,268
2019,2,11,7,1505,1477,1680,203
2019,2,11,8,1465,1433,1732,299
2019,2,11,9,1442,1406,1710,304
2019,2,11,10,1436,1392,1696,304
2019,2,11,11,1447,1405,1667,262
2019,2,11,12,1486,1445,1623,178
2019,2,11,13,1571,1534,1732,198
2019,2,11,14,1715,1664,1762,98
2019,2,11,15,1759,1699,1761,62
2019,2,11,16,1737,1677,1795,118
2019,2,11,17,1712,1696,1893,197
2019,2,11,18,1678,1729,1951,222
2019,2,11,19,1648,1707,1938,231
2019,2,11,20,1622,1644,1904,260
2019,2,11,21,1609,1634,1826,192
2019,2,11,22,1594,1608,1835,227
2019,2,11,23,1606,1594,1814,220
2019,2,12,0,1653,1629,1827,198
2019,2,12,1,1766,1710,1885,175
2019,2,12,2,1861,1857,1953,96
2019,2,12,3,1860,1869,1956,87
2019,2,12,4,1847,1843,1962,119
2019,2,12,5,1781,1772,1903,131
2019,2,12,6,1675,1671,1747,76
2019,2,12,7,1580,1563,1637,74
2019,2,12,8,1531,1513,1493,-20
2019,2,12,9,1511,1497,1459,-38
2019,2,12,10,1504,1485,1396,-89
2019,2,12,11,1514,1497,1409,-88
2019,2,12,12,1557,1531,1558,27
2019,2,12,13,1651,1636,1605,-31
2019,2,12,14,1792,1777,1655,-122
2019,2,12,15,1813,1795,1708,-87
2019,2,12,16,1743,1722,1591,-131
2019,2,12,17,1694,1657,1541,-116
2019,2,12,18,1642,1598,1625,27
2019,2,12,19,1590,1554,1675,121
2019,2,12,20,1554,1516,1674,158
2019,2,12,21,1531,1487,1627,140
2019,2,12,22,1518,1489,1665,176
2019,2,12,23,1530,1482,1691,209
2019,2,13,0,1572,1516,1618,102
2019,2,13,1,1680,1604,1529,-75
2019,2,13,2,1788,1758,1687,-71
2019,2,13,3,1796,1774,1681,-93
2019,2,13,4,1788,1762,1641,-121
2019,2,13,5,1723,1713,1608,-105
2019,2,13,6,1629,1614,1534,-80
2019,2,13,7,1542,1540,1584,44
2019,2,13,8,1489,1495,1640,145
2019,2,13,9,1465,1463,1661,198
2019,2,13,10,1462,1443,1744,301
2019,2,13,11,1473,1471,1733,262
2019,2,13,12,1517,1503,1655,152
2019,2,13,13,1611,1596,1726,130
2019,2,13,14,1739,1729,1826,97
2019,2,13,15,1752,1755,1850,95
2019,2,13,16,1703,1733,1814,81
2019,2,13,17,1661,1682,1873,191
2019,2,13,18,1623,1635,1852,217
2019,2,13,19,1578,1597,1842,245
2019,2,13,20,1544,1542,1775,233
2019,2,13,21,1525,1542,1803,261
2019,2,13,22,1516,1573,1899,326
2019,2,13,23,1526,1574,1932,358
2019,2,14,0,1559,1606,1913,307
2019,2,14,1,1652,1676,1915,239
2019,2,14,2,1754,1776,1976,200
2019,2,14,3,1762,1770,1956,186
2019,2,14,4,1752,1753,1957,204
2019,2,14,5,1688,1677,1883,206
2019,2,14,6,1587,1575,1892,317
2019,2,14,7,1495,1482,1841,359
2019,2,14,8,1417,1431,1815,384
2019,2,14,9,1389,1398,1921,523
2019,2,14,10,1381,1387,1916,529
2019,2,14,11,1388,1390,1914,524
2019,2,14,12,1424,1424,1930,506
2019,2,14,13,1516,1543,1942,399
2019,2,14,14,1642,1631,1963,332
2019,2,14,15,1669,1677,1988,311
2019,2,14,16,1638,1664,1959,295
2019,2,14,17,1608,1666,2009,343
2019,2,14,18,1583,1632,2005,373
2019,2,14,19,1551,1614,2059,445
2019,2,14,20,1528,1583,2045,462
2019,2,14,21,1520,1567,2055,488
2019,2,14,22,1515,1586,2032,446
2019,2,14,23,1523,1612,1997,385
2019,2,15,0,1552,1641,1966,325
2019,2,15,1,1623,1704,2026,322
2019,2,15,2,1715,1763,2029,266
2019,2,15,3,1717,1730,1985,255
2019,2,15,4,1699,1696,2014,318
2019,2,15,5,1629,1623,2025,402
2019,2,15,6,1531,1532,1919,387
2019,2,15,7,1445,1439,1959,520
2019,2,15,8,1341,1387,1979,592
2019,2,15,9,1316,1360,2014,654
2019,2,15,10,1303,1339,1989,650
2019,2,15,11,1307,1331,2014,683
2019,2,15,12,1369,1361,1996,635
2019,2,15,13,1457,1439,1983,544
2019,2,15,14,1571,1547,2035,488
2019,2,15,15,1609,1574,2109,535
2019,2,15,16,1588,1566,2092,526
2019,2,15,17,1571,1538,2111,573
2019,2,15,18,1544,1516,2104,588
2019,2,15,19,1520,1491,2155,664
2019,2,15,20,1504,1461,2090,629
2019,2,15,21,1488,1438,2025,587
2019,2,15,22,1479,1438,2002,564
2019,2,15,23,1483,1429,2004,575
2019,2,16,0,1509,1458,1923,465
2019,2,16,1,1601,1511,1868,357
2019,2,16,2,1687,1587,1802,215
2019,2,16,3,1673,1593,1720,127
2019,2,16,4,1668,1589,1702,113
2019,2,16,5,1611,1539,1683,144
2019,2,16,6,1513,1465,1645,180
2019,2,16,7,1424,1389,1745,356
2019,2,16,8,1415,1385,1708,323
2019,2,16,9,1384,1292,1772,480
2019,2,16,10,1371,1301,1763,462
2019,2,16,11,1366,1297,1768,471
2019,2,16,12,1372,1315,1811,496
2019,2,16,13,1406,1367,1905,538
2019,2,16,14,1481,1418,1982,564
2019,2,16,15,1519,1468,2004,536
2019,2,16,16,1527,1497,2004,507
2019,2,16,17,1532,1489,2053,564
2019,2,16,18,1511,1495,2061,566
2019,2,16,19,1485,1491,1988,497
2019,2,16,20,1473,1479,2039,560
2019,2,16,21,1453,1477,2058,581
2019,2,16,22,1456,1468,2102,634
2019,2,16,23,1479,1476,1986,510
2019,2,17,0,1533,1521,1957,436
2019,2,17,1,1635,1617,2115,498
2019,2,17,2,1715,1732,2156,424
2019,2,17,3,1707,1725,2107,382
2019,2,17,4,1689,1705,2086,381
2019,2,17,5,1642,1660,2058,398
2019,2,17,6,1565,1600,2000,400
2019,2,17,7,1491,1515,1900,385
2019,2,17,8,1483,1445,1763,318
2019,2,17,9,1451,1436,1645,209
2019,2,17,10,1433,1418,1544,126
2019,2,17,11,1422,1428,1528,100
2019,2,17,12,1428,1444,1488,44
2019,2,17,13,1464,1477,1498,21
2019,2,17,14,1539,1537,1516,-21
2019,2,17,15,1570,1554,1546,-8
2019,2,17,16,1579,1545,1588,43
2019,2,17,17,1578,1517,1565,48
2019,2,17,18,1558,1510,1590,80
2019,2,17,19,1529,1515,1687,172
2019,2,17,20,1504,1502,1839,337
2019,2,17,21,1478,1483,1886,403
2019,2,17,22,1477,1464,1887,423
2019,2,17,23,1496,1487,1872,385
2019,2,18,0,1550,1534,1919,385
2019,2,18,1,1673,1621,1791,170
2019,2,18,2,1770,1756,1685,-71
2019,2,18,3,1773,1750,1674,-76
2019,2,18,4,1746,1730,1662,-68
2019,2,18,5,1685,1669,1684,15
2019,2,18,6,1596,1585,1547,-38
2019,2,18,7,1513,1519,1572,53
2019,2,18,8,1481,1469,1584,115
2019,2,18,9,1456,1467,1563,96
2019,2,18,10,1452,1430,1565,135
2019,2,18,11,1463,1441,1557,116
2019,2,18,12,1497,1470,1529,59
2019,2,18,13,1585,1537,1620,83
2019,2,18,14,1727,1637,1687,50
2019,2,18,15,1764,1663,1843,180
2019,2,18,16,1734,1647,2050,403
2019,2,18,17,1711,1613,2103,490
2019,2,18,18,1675,1606,2130,524
2019,2,18,19,1639,1577,2144,567
2019,2,18,20,1603,1584,2135,551
2019,2,18,21,1582,1562,2083,521
2019,2,18,22,1580,1586,2102,516
2019,2,18,23,1589,1622,2070,448
2019,2,19,0,1632,1677,2074,397
2019,2,19,1,1745,1781,2106,325
2019,2,19,2,1853,1904,2124,220
2019,2,19,3,1849,1902,2127,225
2019,2,19,4,1837,1884,2102,218
2019,2,19,5,1765,1813,2036,223
2019,2,19,6,1659,1705,1960,255
2019,2,19,7,1568,1605,1871,266
2019,2,19,8,1508,1557,1851,294
2019,2,19,9,1485,1532,1845,313
2019,2,19,10,1481,1516,1834,318
2019,2,19,11,1488,1517,1776,259
2019,2,19,12,1530,1560,1741,181
2019,2,19,13,1622,1637,1706,69
2019,2,19,14,1758,1763,1739,-24
2019,2,19,15,1804,1793,1722,-71
2019,2,19,16,1783,1810,1687,-123
2019,2,19,17,1758,1815,1808,-7
2019,2,19,18,1731,1799,1738,-61
2019,2,19,19,1702,1737,1600,-137
2019,2,19,20,1678,1708,1570,-138
2019,2,19,21,1657,1678,1540,-138
2019,2,19,22,1646,1660,1468,-192
2019,2,19,23,1655,1668,1551,-117
2019,2,20,0,1688,1701,1712,11
2019,2,20,1,1781,1779,1792,13
2019,2,20,2,1899,1887,2006,119
2019,2,20,3,1895,1884,2128,244
2019,2,20,4,1873,1870,2139,269
2019,2,20,5,1803,1808,2219,411
2019,2,20,6,1695,1701,2176,475
2019,2,20,7,1610,1613,2152,539
2019,2,20,8,1576,1563,2051,488
2019,2,20,9,1548,1553,2025,472
2019,2,20,10,1540,1541,2093,552
2019,2,20,11,1548,1537,2106,569
2019,2,20,12,1590,1580,2188,608
2019,2,20,13,1680,1681,2163,482
2019,2,20,14,1820,1801,2033,232
2019,2,20,15,1846,1818,2068,250
2019,2,20,16,1797,1766,2143,377
2019,2,20,17,1755,1706,2093,387
2019,2,20,18,1709,1662,2076,414
2019,2,20,19,1668,1635,2125,490
2019,2,20,20,1632,1594,2072,478
2019,2,20,21,1602,1560,2045,485
2019,2,20,22,1591,1546,2016,470
2019,2,20,23,1605,1548,1991,443
2019,2,21,0,1651,1571,2001,430
2019,2,21,1,1760,1650,1990,340
2019,2,21,2,1885,1802,1892,90
2019,2,21,3,1889,1806,1794,-12
2019,2,21,4,1870,1806,1799,-7
2019,2,21,5,1808,1745,1901,156
2019,2,21,6,1704,1644,1849,205
2019,2,21,7,1621,1551,1892,341
2019,2,21,8,1548,1508,1841,333
2019,2,21,9,1518,1483,1843,360
2019,2,21,10,1508,1478,1812,334
2019,2,21,11,1516,1479,1764,285
2019,2,21,12,1557,1514,1821,307
2019,2,21,13,1646,1601,1812,211
2019,2,21,14,1773,1730,1730,0
2019,2,21,15,1790,1766,1828,62
2019,2,21,16,1748,1746,1807,61
2019,2,21,17,1711,1760,1902,142
2019,2,21,18,1670,1714,1988,274
2019,2,21,19,1631,1643,1916,273
2019,2,21,20,1601,1584,1977,393
2019,2,21,21,1581,1625,2100,475
2019,2,21,22,1574,1593,2093,500
2019,2,21,23,1588,1611,1999,388
2019,2,22,0,1627,1653,1973,320
2019,2,22,1,1715,1715,1937,222
2019,2,22,2,1820,1804,1814,10
2019,2,22,3,1824,1803,1732,-71
2019,2,22,4,1808,1785,1759,-26
2019,2,22,5,1747,1716,1834,118
2019,2,22,6,1645,1610,1786,176
2019,2,22,7,1558,1514,1864,350
2019,2,22,8,1480,1456,1833,377
2019,2,22,9,1448,1445,1732,287
2019,2,22,10,1441,1435,1755,320
2019,2,22,11,1444,1434,1622,188
2019,2,22,12,1476,1464,1719,255
2019,2,22,13,1560,1547,1778,231
2019,2,22,14,1690,1667,1768,101
2019,2,22,15,1720,1678,1804,126
2019,2,22,16,1699,1630,1875,245
2019,2,22,17,1679,1621,1908,287
2019,2,22,18,1650,1616,2019,403
2019,2,22,19,1626,1628,1997,369
2019,2,22,20,1600,1592,2041,449
2019,2,22,21,1585,1573,2059,486
2019,2,22,22,1576,1586,1987,401
2019,2,22,23,1589,1621,1991,370
2019,2,23,0,1628,1691,2022,331
2019,2,23,1,1715,1758,2101,343
2019,2,23,2,1809,1815,2141,326
2019,2,23,3,1792,1805,2112,307
2019,2,23,4,1803,1798,2048,250
2019,2,23,5,1750,1752,1829,77
2019,2,23,6,1665,1677,1836,159
2019,2,23,7,1582,1595,2008,413
2019,2,23,8,1537,1549,2055,506
2019,2,23,9,1509,1509,2047,538
2019,2,23,10,1498,1507,1973,466
2019,2,23,11,1494,1506,2000,494
2019,2,23,12,1504,1524,2076,552
2019,2,23,13,1540,1574,2146,572
2019,2,23,14,1608,1626,2083,457
2019,2,23,15,1637,1661,1994,333
2019,2,23,16,1635,1684,2071,387
2019,2,23,17,1642,1681,2133,452
2019,2,23,18,1611,1664,2181,517
2019,2,23,19,1571,1628,2120,492
2019,2,23,20,1532,1589,2113,524
2019,2,23,21,1506,1555,2084,529
2019,2,23,22,1500,1513,1986,473
2019,2,23,23,1516,1499,1944,445
2019,2,24,0,1560,1539,1988,449
2019,2,24,1,1667,1621,1967,346
2019,2,24,2,1791,1765,2036,271
2019,2,24,3,1792,1784,2061,277
2019,2,24,4,1790,1778,1994,216
2019,2,24,5,1749,1736,1976,240
2019,2,24,6,1675,1672,1909,237
2019,2,24,7,1598,1602,1813,211
2019,2,24,8,1560,1557,1794,237
2019,2,24,9,1536,1534,1800,266
2019,2,24,10,1527,1522,1754,232
2019,2,24,11,1526,1527,1737,210
2019,2,24,12,1537,1546,1661,115
2019,2,24,13,1575,1585,1601,16
2019,2,24,14,1627,1635,1607,-28
2019,2,24,15,1643,1638,1598,-40
2019,2,24,16,1636,1613,1570,-43
2019,2,24,17,1617,1596,1613,17
2019,2,24,18,1577,1551,1620,69
2019,2,24,19,1533,1515,1615,100
2019,2,24,20,1502,1480,1639,159
2019,2,24,21,1480,1475,1723,248
2019,2,24,22,1473,1469,1802,333
2019,2,24,23,1487,1476,1827,351
2019,2,25,0,1530,1524,1831,307
2019,2,25,1,1632,1618,1795,177
2019,2,25,2,1762,1769,2003,234
2019,2,25,3,1775,1795,2082,287
2019,2,25,4,1768,1776,2014,238
2019,2,25,5,1717,1715,1820,105
2019,2,25,6,1633,1628,1701,73
2019,2,25,7,1551,1538,1504,-34
2019,2,25,8,1500,1491,1512,21
2019,2,25,9,1477,1466,1548,82
2019,2,25,10,1475,1463,1530,67
2019,2,25,11,1488,1474,1606,132
2019,2,25,12,1528,1522,1472,-50
2019,2,25,13,1621,1603,1604,1
2019,2,25,14,1737,1725,1569,-156
2019,2,25,15,1755,1729,1444,-285
2019,2,25,16,1715,1655,1359,-296
2019,2,25,17,1675,1603,1459,-144
2019,2,25,18,1626,1566,1616,50
2019,2,25,19,1586,1512,1664,152
2019,2,25,20,1552,1478,1662,184
2019,2,25,21,1541,1469,1664,195
2019,2,25,22,1531,1445,1669,224
2019,2,25,23,1540,1450,1657,207
2019,2,26,0,1580,1481,1620,139
2019,2,26,1,1670,1554,1574,20
2019,2,26,2,1780,1690,1597,-93
2019,2,26,3,1786,1715,1643,-72
2019,2,26,4,1782,1710,1619,-91
2019,2,26,5,1712,1650,1542,-108
2019,2,26,6,1610,1553,1419,-134
2019,2,26,7,1529,1458,1389,-69
2019,2,26,8,1466,1422,1448,26
2019,2,26,9,1442,1408,1414,6
2019,2,26,10,1438,1407,1459,52
2019,2,26,11,1449,1410,1476,66
2019,2,26,12,1485,1447,1435,-12
2019,2,26,13,1586,1550,1504,-46
2019,2,26,14,1710,1674,1650,-24
2019,2,26,15,1713,1677,1754,77
2019,2,26,16,1665,1604,1727,123
2019,2,26,17,1629,1546,1755,209
2019,2,26,18,1592,1509,1756,247
2019,2,26,19,1551,1497,1704,207
2019,2,26,20,1525,1455,1730,275
2019,2,26,21,1513,1439,1742,303
2019,2,26,22,1510,1440,1776,336
2019,2,26,23,1520,1450,1769,319
2019,2,27,0,1553,1484,1708,224
2019,2,27,1,1633,1536,1604,68
2019,2,27,2,1738,1672,1659,-13
2019,2,27,3,1747,1704,1687,-17
2019,2,27,4,1736,1690,1668,-22
2019,2,27,5,1668,1621,1608,-13
2019,2,27,6,1569,1519,1540,21
2019,2,27,7,1483,1413,1514,101
2019,2,27,8,1422,1356,1488,132
2019,2,27,9,1398,1334,1429,95
2019,2,27,10,1388,1332,1455,123
2019,2,27,11,1395,1339,1477,138
2019,2,27,12,1433,1381,1527,146
2019,2,27,13,1531,1466,1600,134
2019,2,27,14,1653,1595,1684,89
2019,2,27,15,1663,1605,1644,39
2019,2,27,16,1625,1559,1544,-15
2019,2,27,17,1589,1518,1544,26
2019,2,27,18,1558,1474,1464,-10
2019,2,27,19,1529,1473,1558,85
2019,2,27,20,1499,1468,1525,57
2019,2,27,21,1493,1436,1447,11
2019,2,27,22,1496,1423,1467,44
2019,2,27,23,1506,1435,1568,133
2019,2,28,0,1534,1449,1587,138
2019,2,28,1,1611,1504,1465,-39
2019,2,28,2,1701,1602,1600,-2
2019,2,28,3,1711,1637,1754,117
2019,2,28,4,1701,1628,1783,155
2019,2,28,5,1633,1576,1688,112
2019,2,28,6,1529,1487,1589,102
2019,2,28,7,1445,1403,1519,116
2019,2,28,8,1397,1358,1492,134
2019,2,28,9,1375,1341,1488,147
2019,2,28,10,1369,1330,1539,209
2019,2,28,11,1377,1342,1572,230
2019,2,28,12,1420,1383,1535,152
2019,2,28,13,1513,1472,1643,171
2019,2,28,14,1625,1595,1701,106
2019,2,28,15,1634,1586,1708,122
2019,2,28,16,1598,1525,1639,114
2019,2,28,17,1562,1488,1620,132
2019,2,28,18,1530,1455,1651,196
2019,2,28,19,1505,1426,1637,211
2019,2,28,20,1474,1412,1674,262
2019,2,28,21,1467,1415,1700,285
2019,2,28,22,1468,1423,1719,296
2019,2,28,23,1486,1422,1739,317
2019,3,1,0,1513,1451,1787,336
2019,3,1,1,1591,1503,1817,314
2019,3,1,2,1677,1609,1780,171
2019,3,1,3,1680,1625,1749,124
2019,3,1,4,1670,1614,1676,62
2019,3,1,5,1600,1548,1477,-71
2019,3,1,6,1507,1469,1381,-88
2019,3,1,7,1400,1393,1264,-129
2019,3,1,8,1355,1344,1171,-173
2019,3,1,9,1330,1322,1180,-142
2019,3,1,10,1328,1312,1230,-82
2019,3,1,11,1339,1320,1264,-56
2019,3,1,12,1377,1365,1323,-42
2019,3,1,13,1460,1445,1314,-131
2019,3,1,14,1573,1557,1369,-188
2019,3,1,15,1588,1581,1367,-214
2019,3,1,16,1558,1531,1383,-148
2019,3,1,17,1530,1506,1453,-53
2019,3,1,18,1496,1470,1472,2
2019,3,1,19,1479,1446,1483,37
2019,3,1,20,1478,1427,1511,84
2019,3,1,21,1461,1428,1505,77
2019,3,1,22,1455,1417,1446,29
2019,3,1,23,1459,1416,1411,-5
2019,3,2,0,1484,1442,1330,-112
2019,3,2,1,1550,1480,1225,-255
2019,3,2,2,1633,1514,1104,-410
2019,3,2,3,1640,1572,1046,-526
2019,3,2,4,1639,1603,1034,-569
2019,3,2,5,1585,1557,1086,-471
2019,3,2,6,1501,1478,1145,-333
2019,3,2,7,1422,1399,1110,-289
2019,3,2,8,1359,1353,1168,-185
2019,3,2,9,1328,1321,1176,-145
2019,3,2,10,1316,1300,1178,-122
2019,3,2,11,1317,1299,1180,-119
2019,3,2,12,1333,1309,1260,-49
2019,3,2,13,1366,1344,1358,14
2019,3,2,14,1429,1395,1383,-12
2019,3,2,15,1450,1414,1369,-45
2019,3,2,16,1457,1453,1389,-64
2019,3,2,17,1454,1471,1463,-8
2019,3,2,18,1441,1448,1501,53
2019,3,2,19,1424,1418,1446,28
2019,3,2,20,1405,1379,1461,82
2019,3,2,21,1394,1380,1571,191
2019,3,2,22,1392,1405,1691,286
2019,3,2,23,1413,1442,1711,269
2019,3,3,0,1459,1464,1722,258
2019,3,3,1,1539,1506,1653,147
2019,3,3,2,1616,1603,1713,110
2019,3,3,3,1615,1600,1760,160
2019,3,3,4,1599,1586,1799,213
2019,3,3,5,1544,1544,1777,233
2019,3,3,6,1467,1457,1614,157
2019,3,3,7,1392,1398,1624,226
2019,3,3,8,1349,1345,1546,201
2019,3,3,9,1319,1316,1457,141
2019,3,3,10,1296,1284,1463,179
2019,3,3,11,1296,1279,1454,175
2019,3,3,12,1304,1289,1406,117
2019,3,3,13,1333,1316,1355,39
2019,3,3,14,1390,1357,1399,42
2019,3,3,15,1417,1384,1455,71
2019,3,3,16,1428,1395,1553,158
2019,3,3,17,1427,1389,1595,206
2019,3,3,18,1422,1410,1485,75
2019,3,3,19,1418,1391,1350,-41
2019,3,3,20,1412,1361,1407,46
2019,3,3,21,1406,1359,1419,60
2019,3,3,22,1411,1346,1484,138
2019,3,3,23,1437,1372,1427,55
2019,3,4,0,1486,1404,1453,49
2019,3,4,1,1573,1478,1455,-23
2019,3,4,2,1650,1601,1463,-138
2019,3,4,3,1646,1633,1407,-226
2019,3,4,4,1624,1617,1256,-361
2019,3,4,5,1561,1572,1176,-396
2019,3,4,6,1471,1476,1150,-326
2019,3,4,7,1388,1404,1128,-276
2019,3,4,8,1347,1376,1142,-234
2019,3,4,9,1328,1359,1144,-215
2019,3,4,10,1321,1353,1085,-268
2019,3,4,11,1331,1360,926,-434
2019,3,4,12,1366,1398,839,-559
2019,3,4,13,1448,1486,876,-610
2019,3,4,14,1567,1609,958,-651
2019,3,4,15,1588,1619,995,-624
2019,3,4,16,1567,1590,1061,-529
2019,3,4,17,1541,1566,1059,-507
2019,3,4,18,1515,1533,984,-549
2019,3,4,19,1494,1512,991,-521
2019,3,4,20,1481,1474,994,-480
2019,3,4,21,1469,1473,958,-515
2019,3,4,22,1473,1486,1018,-468
2019,3,4,23,1490,1489,1167,-322
2019,3,5,0,1525,1513,1119,-394
2019,3,5,1,1601,1542,1081,-461
2019,3,5,2,1678,1658,1113,-545
2019,3,5,3,1676,1688,1102,-586
2019,3,5,4,1666,1677,1110,-567
2019,3,5,5,1594,1608,1051,-557
2019,3,5,6,1497,1508,1061,-447
2019,3,5,7,1411,1433,911,-522
2019,3,5,8,1402,1400,900,-500
2019,3,5,9,1381,1380,862,-518
2019,3,5,10,1360,1371,849,-522
2019,3,5,11,1362,1378,855,-523
2019,3,5,12,1404,1409,877,-532
2019,3,5,13,1494,1505,948,-557
2019,3,5,14,1612,1621,976,-645
2019,3,5,15,1622,1614,967,-647
2019,3,5,16,1583,1549,987,-562
2019,3,5,17,1548,1514,976,-538
2019,3,5,18,1514,1489,1001,-488
2019,3,5,19,1486,1459,1071,-388
2019,3,5,20,1465,1417,1033,-384
2019,3,5,21,1451,1420,1024,-396
2019,3,5,22,1449,1417,1081,-336
2019,3,5,23,1458,1418,1093,-325
2019,3,6,0,1490,1449,1212,-237
2019,3,6,1,1562,1497,1184,-313
2019,3,6,2,1661,1596,1186,-410
2019,3,6,3,1665,1646,1109,-537
2019,3,6,4,1657,1641,1031,-610
2019,3,6,5,1590,1575,977,-598
2019,3,6,6,1492,1487,806,-681
2019,3,6,7,1403,1413,793,-620
2019,3,6,8,1337,1363,741,-622
2019,3,6,9,1320,1350,849,-501
2019,3,6,10,1311,1351,1046,-305
2019,3,6,11,1317,1367,1118,-249
2019,3,6,12,1368,1398,1204,-194
2019,3,6,13,1467,1487,1349,-138
2019,3,6,14,1569,1605,1342,-263
2019,3,6,15,1572,1579,1363,-216
2019,3,6,16,1544,1524,1377,-147
2019,3,6,17,1512,1477,1328,-149
2019,3,6,18,1492,1449,1407,-42
2019,3,6,19,1465,1407,1379,-28
2019,3,6,20,1460,1397,1458,61
2019,3,6,21,1461,1388,1538,150
2019,3,6,22,1483,1408,1524,116
2019,3,6,23,1490,1436,1524,88
2019,3,7,0,1513,1462,1498,36
2019,3,7,1,1547,1489,1463,-26
2019,3,7,2,1622,1588,1594,6
2019,3,7,3,1647,1607,1615,8
2019,3,7,4,1628,1588,1583,-5
2019,3,7,5,1550,1515,1583,68
2019,3,7,6,1454,1408,1555,147
2019,3,7,7,1375,1330,1431,101
2019,3,7,8,1334,1291,1438,147
2019,3,7,9,1310,1276,1447,171
2019,3,7,10,1304,1275,1444,169
2019,3,7,11,1309,1287,1450,163
2019,3,7,12,1348,1319,1476,157
2019,3,7,13,1430,1390,1572,182
2019,3,7,14,1548,1496,1614,118
2019,3,7,15,1558,1514,1659,145
2019,3,7,16,1538,1496,1637,141
2019,3,7,17,1515,1489,1642,153
2019,3,7,18,1513,1478,1680,202
2019,3,7,19,1503,1473,1600,127
2019,3,7,20,1493,1465,1616,151
2019,3,7,21,1494,1456,1623,167
2019,3,7,22,1496,1444,1618,174
2019,3,7,23,1497,1454,1619,165
2019,3,8,0,1523,1503,1609,106
2019,3,8,1,1570,1517,1560,43
2019,3,8,2,1641,1609,1630,21
2019,3,8,3,1656,1607,1536,-71
2019,3,8,4,1644,1583,1485,-98
2019,3,8,5,1568,1544,1469,-75
2019,3,8,6,1465,1451,1447,-4
2019,3,8,7,1388,1379,1287,-92
2019,3,8,8,1329,1310,1384,74
2019,3,8,9,1305,1297,1311,14
2019,3,8,10,1294,1284,1260,-24
2019,3,8,11,1296,1277,1247,-30
2019,3,8,12,1333,1302,1251,-51
2019,3,8,13,1417,1371,1340,-31
2019,3,8,14,1524,1477,1373,-104
2019,3,8,15,1518,1488,1400,-88
2019,3,8,16,1497,1480,1376,-104
2019,3,8,17,1479,1464,1497,33
2019,3,8,18,1468,1450,1506,56
2019,3,8,19,1446,1460,1531,71
2019,3,8,20,1440,1450,1537,87
2019,3,8,21,1440,1469,1611,142
2019,3,8,22,1435,1474,1626,152
2019,3,8,23,1442,1484,1493,9
2019,3,9,0,1461,1509,1490,-19
2019,3,9,1,1513,1515,1563,48
2019,3,9,2,1586,1607,1625,18
2019,3,9,3,1598,1647,1687,40
2019,3,9,4,1591,1652,1534,-118
2019,3,9,5,1538,1604,1575,-29
2019,3,9,6,1451,1549,1594,45
2019,3,9,7,1368,1469,1494,25
2019,3,9,8,1360,1433,1540,107
2019,3,9,9,1342,1419,1606,187
2019,3,9,10,1341,1411,1559,148
2019,3,9,11,1349,1407,1532,125
2019,3,9,12,1367,1417,1542,125
2019,3,9,13,1403,1469,1463,-6
2019,3,9,14,1469,1507,1411,-96
2019,3,9,15,1488,1512,1391,-121
2019,3,9,16,1485,1488,1420,-68
2019,3,9,17,1481,1537,1526,-11
2019,3,9,18,1457,1484,1542,58
2019,3,9,19,1436,1389,1455,66
2019,3,9,20,1414,1370,1512,142
2019,3,9,21,1396,1351,1531,180
2019,3,9,22,1396,1348,1533,185
2019,3,9,23,1408,1358,1497,139
2019,3,10,0,1451,1396,1460,64
2019,3,10,1,1512,1454,1430,-24
2019,3,10,2,1614,1569,1404,-165
2019,3,10,3,1620,1593,1371,-222
2019,3,10,4,1611,1579,1281,-298
2019,3,10,5,1576,1532,1187,-345
2019,3,10,6,1501,1450,1154,-296
2019,3,10,7,1425,1392,1059,-333
2019,3,10,8,1372,1350,1010,-340
2019,3,10,9,1354,1321,941,-380
2019,3,10,10,1339,1332,915,-417
2019,3,10,11,1331,1334,959,-375
2019,3,10,12,1343,1353,978,-375
2019,3,10,13,1374,1401,1008,-393
2019,3,10,14,1423,1441,1160,-281
2019,3,10,15,1441,1450,1253,-197
2019,3,10,16,1447,1462,1283,-179
2019,3,10,17,1437,1434,1192,-242
2019,3,10,18,1417,1409,1116,-293
2019,3,10,19,1400,1368,1102,-266
2019,3,10,20,1385,1356,1079,-277
2019,3,10,21,1376,1331,1101,-230
2019,3,10,22,1381,1328,1145,-183
2019,3,10,23,1384,1348,1148,-200
2019,3,11,0,1410,1399,1194,-205
2019,3,11,1,1471,1441,1238,-203
2019,3,11,2,1545,1564,1284,-280
2019,3,11,3,1629,1589,1338,-251
2019,3,11,4,1638,1578,1312,-266
2019,3,11,5,1549,1479,1302,-177
2019,3,11,6,1459,1391,1227,-164
2019,3,11,7,1381,1333,1223,-110
2019,3,11,8,1336,1299,1185,-114
2019,3,11,9,1314,1283,1160,-123
2019,3,11,10,1307,1280,1108,-172
2019,3,11,11,1312,1299,1030,-269
2019,3,11,12,1353,1357,960,-397
2019,3,11,13,1447,1474,964,-510
2019,3,11,14,1557,1551,1007,-544
2019,3,11,15,1581,1567,998,-569
2019,3,11,16,1568,1591,999,-592
2019,3,11,17,1550,1591,956,-635
2019,3,11,18,1527,1549,887,-662
2019,3,11,19,1506,1562,916,-646
2019,3,11,20,1494,1501,966,-535
2019,3,11,21,1479,1474,1047,-427
2019,3,11,22,1477,1486,1152,-334
2019,3,11,23,1479,1495,1121,-374
2019,3,12,0,1486,1495,1140,-355
2019,3,12,1,1525,1560,1291,-269
2019,3,12,2,1589,1642,1431,-211
2019,3,12,3,1680,1649,1316,-333
2019,3,12,4,1694,1599,1059,-540
2019,3,12,5,1597,1512,1046,-466
2019,3,12,6,1496,1410,997,-413
2019,3,12,7,1410,1338,1015,-323
2019,3,12,8,1343,1344,1078,-266
2019,3,12,9,1323,1287,1034,-253
2019,3,12,10,1314,1284,1038,-246
2019,3,12,11,1325,1303,1069,-234
2019,3,12,12,1370,1376,1107,-269
2019,3,12,13,1462,1476,1205,-271
2019,3,12,14,1558,1539,1094,-445
2019,3,12,15,1569,1506,1100,-406
2019,3,12,16,1554,1491,1174,-317
2019,3,12,17,1540,1473,1178,-295
2019,3,12,18,1523,1511,1090,-421
2019,3,12,19,1496,1498,1039,-459
2019,3,12,20,1476,1503,1079,-424
2019,3,12,21,1474,1508,1023,-485
2019,3,12,22,1473,1546,1020,-526
2019,3,12,23,1481,1552,1024,-528
2019,3,13,0,1510,1597,1079,-518
2019,3,13,1,1557,1649,1134,-515
2019,3,13,2,1640,1700,1298,-402
2019,3,13,3,1667,1712,1258,-454
2019,3,13,4,1663,1696,1241,-455
2019,3,13,5,1574,1558,1064,-494
2019,3,13,6,1475,1471,1121,-350
2019,3,13,7,1399,1415,1089,-326
2019,3,13,8,1354,1395,1056,-339
2019,3,13,9,1334,1396,1003,-393
2019,3,13,10,1332,1387,1000,-387
2019,3,13,11,1345,1405,1017,-388
2019,3,13,12,1400,1491,1020,-471
2019,3,13,13,1503,1592,986,-606
2019,3,13,14,1604,1655,1031,-624
2019,3,13,15,1615,1657,1001,-656
2019,3,13,16,1584,1696,1004,-692
2019,3,13,17,1567,1666,937,-729
2019,3,13,18,1535,1589,903,-686
2019,3,13,19,1525,1524,920,-604
2019,3,13,20,1496,1474,882,-592
2019,3,13,21,1484,1468,859,-609
2019,3,13,22,1495,1454,915,-539
2019,3,13,23,1511,1475,960,-515
2019,3,14,0,1535,1514,987,-527
2019,3,14,1,1602,1568,1047,-521
2019,3,14,2,1683,1688,1129,-559
2019,3,14,3,1712,1744,1288,-456
2019,3,14,4,1701,1708,1389,-319
2019,3,14,5,1628,1611,1326,-285
2019,3,14,6,1525,1511,1274,-237
2019,3,14,7,1447,1453,1152,-301
2019,3,14,8,1434,1434,1109,-325
2019,3,14,9,1425,1433,1105,-328
2019,3,14,10,1425,1428,1120,-308
2019,3,14,11,1456,1449,1144,-305
2019,3,14,12,1524,1505,1148,-357
2019,3,14,13,1632,1596,1215,-381
2019,3,14,14,1726,1662,1115,-547
2019,3,14,15,1703,1655,1050,-605
2019,3,14,16,1661,1638,1133,-505
2019,3,14,17,1631,1637,1136,-501
2019,3,14,18,1631,1588,1043,-545
2019,3,14,19,1584,1519,897,-622
2019,3,14,20,1552,1486,924,-562
2019,3,14,21,1527,1495,1054,-441
2019,3,14,22,1519,1494,1121,-373
2019,3,14,23,1519,1494,1067,-427
2019,3,15,0,1562,1518,937,-581
2019,3,15,1,1614,1543,937,-606
2019,3,15,2,1708,1634,984,-650
2019,3,15,3,1722,1688,1041,-647
2019,3,15,4,1745,1665,1046,-619
2019,3,15,5,1627,1600,1042,-558
2019,3,15,6,1554,1516,1034,-482
2019,3,15,7,1491,1458,1054,-404
2019,3,15,8,1469,1420,1050,-370
2019,3,15,9,1459,1400,1045,-355
2019,3,15,10,1456,1400,1031,-369
2019,3,15,11,1473,1435,1012,-423
2019,3,15,12,1521,1492,977,-515
2019,3,15,13,1636,1601,964,-637
2019,3,15,14,1729,1694,997,-697
2019,3,15,15,1738,1663,982,-681
2019,3,15,16,1708,1591,1014,-577
2019,3,15,17,1675,1557,1033,-524
2019,3,15,18,1618,1495,1018,-477
2019,3,15,19,1550,1456,1091,-365
2019,3,15,20,1500,1406,1114,-292
2019,3,15,21,1479,1351,1085,-266
2019,3,15,22,1470,1344,1074,-270
2019,3,15,23,1478,1348,1086,-262
2019,3,16,0,1502,1374,1116,-258
2019,3,16,1,1555,1408,1123,-285
2019,3,16,2,1666,1520,1221,-299
2019,3,16,3,1706,1579,1149,-430
2019,3,16,4,1698,1566,1115,-451
2019,3,16,5,1650,1503,1034,-469
2019,3,16,6,1571,1444,1096,-348
2019,3,16,7,1506,1408,1211,-197
2019,3,16,8,1453,1378,1282,-96
2019,3,16,9,1435,1344,1235,-109
2019,3,16,10,1430,1345,1234,-111
2019,3,16,11,1436,1372,1235,-137
2019,3,16,12,1457,1398,1247,-151
2019,3,16,13,1512,1454,1232,-222
2019,3,16,14,1554,1489,1185,-304
2019,3,16,15,1573,1536,1127,-409
2019,3,16,16,1571,1499,1100,-399
2019,3,16,17,1566,1459,1156,-303
2019,3,16,18,1523,1434,1136,-298
2019,3,16,19,1466,1398,1153,-245
2019,3,16,20,1434,1356,1063,-293
2019,3,16,21,1412,1329,1010,-319
2019,3,16,22,1407,1322,974,-348
2019,3,16,23,1412,1338,966,-372
2019,3,17,0,1452,1376,1021,-355
2019,3,17,1,1502,1413,1028,-385
2019,3,17,2,1607,1524,1106,-418
2019,3,17,3,1648,1573,1034,-539
2019,3,17,4,1640,1554,1003,-551
2019,3,17,5,1588,1491,978,-513
2019,3,17,6,1518,1426,891,-535
2019,3,17,7,1459,1387,837,-550
2019,3,17,8,1422,1364,836,-528
2019,3,17,9,1401,1349,826,-523
2019,3,17,10,1394,1357,835,-522
2019,3,17,11,1397,1363,795,-568
2019,3,17,12,1414,1393,781,-612
2019,3,17,13,1455,1466,735,-731
2019,3,17,14,1490,1503,766,-737
2019,3,17,15,1498,1485,824,-661
2019,3,17,16,1496,1440,850,-590
2019,3,17,17,1491,1406,858,-548
2019,3,17,18,1460,1382,839,-543
2019,3,17,19,1423,1356,838,-518
2019,3,17,20,1397,1325,834,-491
2019,3,17,21,1390,1313,839,-474
2019,3,17,22,1396,1313,882,-431
2019,3,17,23,1405,1331,871,-460
2019,3,18,0,1452,1369,861,-508
2019,3,18,1,1503,1404,884,-520
2019,3,18,2,1606,1520,955,-565
2019,3,18,3,1661,1578,1141,-437
2019,3,18,4,1643,1533,1137,-396
2019,3,18,5,1574,1442,1010,-432
2019,3,18,6,1483,1353,921,-432
2019,3,18,7,1415,1297,831,-466
2019,3,18,8,1374,1283,784,-499
2019,3,18,9,1360,1276,794,-482
2019,3,18,10,1354,1285,791,-494
2019,3,18,11,1379,1308,753,-555
2019,3,18,12,1433,1389,801,-588
2019,3,18,13,1529,1531,899,-632
2019,3,18,14,1608,1586,953,-633
2019,3,18,15,1612,1536,857,-679
2019,3,18,16,1587,1476,877,-599
2019,3,18,17,1574,1445,949,-496
2019,3,18,18,1559,1386,846,-540
2019,3,18,19,1519,1363,825,-538
2019,3,18,20,1494,1340,792,-548
2019,3,18,21,1485,1332,769,-563
2019,3,18,22,1484,1332,741,-591
2019,3,18,23,1489,1336,701,-635
2019,3,19,0,1520,1364,726,-638
2019,3,19,1,1562,1409,723,-686
2019,3,19,2,1651,1498,837,-661
2019,3,19,3,1692,1553,915,-638
2019,3,19,4,1672,1517,965,-552
2019,3,19,5,1587,1458,1001,-457
2019,3,19,6,1491,1341,851,-490
2019,3,19,7,1420,1307,879,-428
2019,3,19,8,1352,1265,879,-386
2019,3,19,9,1337,1261,869,-392
2019,3,19,10,1332,1257,853,-404
2019,3,19,11,1358,1287,995,-292
2019,3,19,12,1421,1374,1103,-271
2019,3,19,13,1537,1486,1174,-312
2019,3,19,14,1621,1524,1194,-330
2019,3,19,15,1601,1502,1202,-300
2019,3,19,16,1563,1436,1242,-194
2019,3,19,17,1539,1393,1029,-364
2019,3,19,18,1515,1356,970,-386
2019,3,19,19,1482,1331,974,-357
2019,3,19,20,1454,1359,978,-381
2019,3,19,21,1447,1379,1087,-292
2019,3,19,22,1449,1359,985,-374
2019,3,19,23,1454,1376,1089,-287
2019,3,20,0,1475,1388,1059,-329
2019,3,20,1,1508,1420,916,-504
2019,3,20,2,1587,1516,1156,-360
2019,3,20,3,1637,1567,1244,-323
2019,3,20,4,1609,1526,1270,-256
2019,3,20,5,1513,1430,1209,-221
2019,3,20,6,1410,1354,1213,-141
2019,3,20,7,1343,1304,1296,-8
2019,3,20,8,1311,1277,1293,16
2019,3,20,9,1296,1265,1234,-31
2019,3,20,10,1298,1250,1191,-59
2019,3,20,11,1321,1268,1125,-143
2019,3,20,12,1388,1345,1063,-282
2019,3,20,13,1508,1484,1027,-457
2019,3,20,14,1579,1546,975,-571
2019,3,20,15,1570,1509,1024,-485
2019,3,20,16,1535,1478,1026,-452
2019,3,20,17,1507,1436,1018,-418
2019,3,20,18,1469,1420,967,-453
2019,3,20,19,1437,1385,992,-393
2019,3,20,20,1413,1365,941,-424
2019,3,20,21,1405,1346,893,-453
2019,3,20,22,1405,1349,864,-485
2019,3,20,23,1411,1366,875,-491
2019,3,21,0,1430,1386,898,-488
2019,3,21,1,1461,1415,907,-508
2019,3,21,2,1539,1515,1011,-504
2019,3,21,3,1593,1563,1092,-471
2019,3,21,4,1575,1516,1042,-474
2019,3,21,5,1502,1417,1043,-374
2019,3,21,6,1407,1324,1001,-323
2019,3,21,7,1345,1276,1031,-245
2019,3,21,8,1291,1253,1011,-242
2019,3,21,9,1275,1238,1025,-213
2019,3,21,10,1282,1245,1060,-185
2019,3,21,11,1299,1273,1053,-220
2019,3,21,12,1370,1338,1100,-238
2019,3,21,13,1504,1468,1181,-287
2019,3,21,14,1575,1538,1171,-367
2019,3,21,15,1566,1553,1132,-421
2019,3,21,16,1535,1556,1235,-321
2019,3,21,17,1508,1563,1216,-347
2019,3,21,18,1477,1538,1230,-308
2019,3,21,19,1450,1500,1148,-352
2019,3,21,20,1439,1463,1123,-340
2019,3,21,21,1431,1433,1172,-261
2019,3,21,22,1428,1426,1158,-268
2019,3,21,23,1438,1451,1149,-302
2019,3,22,0,1459,1483,1138,-345
2019,3,22,1,1492,1512,1175,-337
2019,3,22,2,1571,1610,1161,-449
2019,3,22,3,1604,1634,1224,-410
2019,3,22,4,1581,1588,1207,-381
2019,3,22,5,1498,1499,1133,-366
2019,3,22,6,1411,1402,1016,-386
2019,3,22,7,1347,1350,1022,-328
2019,3,22,8,1299,1317,1056,-261
2019,3,22,9,1272,1297,1078,-219
2019,3,22,10,1266,1296,1071,-225
2019,3,22,11,1284,1310,1067,-243
2019,3,22,12,1341,1384,1001,-383
2019,3,22,13,1451,1495,1097,-398
2019,3,22,14,1529,1542,1116,-426
2019,3,22,15,1525,1519,1113,-406
2019,3,22,16,1505,1493,1289,-204
2019,3,22,17,1480,1455,1432,-23
2019,3,22,18,1451,1453,1540,87
2019,3,22,19,1418,1417,1563,146
2019,3,22,20,1398,1381,1668,287
2019,3,22,21,1377,1362,1655,293
2019,3,22,22,1374,1348,1621,273
2019,3,22,23,1383,1366,1643,277
2019,3,23,0,1405,1397,1643,246
2019,3,23,1,1442,1401,1607,206
2019,3,23,2,1509,1530,1656,126
2019,3,23,3,1551,1625,1708,83
2019,3,23,4,1537,1577,1740,163
2019,3,23,5,1479,1482,1629,147
2019,3,23,6,1404,1384,1524,140
2019,3,23,7,1351,1345,1459,114
2019,3,23,8,1333,1322,1421,99
2019,3,23,9,1314,1320,1466,146
2019,3,23,10,1310,1349,1564,215
2019,3,23,11,1318,1314,1653,339
2019,3,23,12,1343,1363,1671,308
2019,3,23,13,1401,1417,1656,239
2019,3,23,14,1442,1444,1663,219
2019,3,23,15,1460,1434,1738,304
2019,3,23,16,1445,1396,1807,411
2019,3,23,17,1429,1367,1808,441
2019,3,23,18,1387,1333,1757,424
2019,3,23,19,1344,1315,1790,475
2019,3,23,20,1315,1292,1763,471
2019,3,23,21,1299,1293,1767,474
2019,3,23,22,1307,1293,1745,452
2019,3,23,23,1331,1324,1788,464
2019,3,24,0,1380,1350,1780,430
2019,3,24,1,1432,1382,1657,275
2019,3,24,2,1519,1459,1529,70
2019,3,24,3,1552,1508,1568,60
2019,3,24,4,1538,1467,1394,-73
2019,3,24,5,1485,1404,1267,-137
2019,3,24,6,1419,1328,1213,-115
2019,3,24,7,1368,1274,1195,-79
2019,3,24,8,1328,1247,1200,-47
2019,3,24,9,1305,1232,1157,-75
2019,3,24,10,1299,1225,1176,-49
2019,3,24,11,1304,1236,1133,-103
2019,3,24,12,1328,1265,1157,-108
2019,3,24,13,1367,1319,1154,-165
2019,3,24,14,1388,1349,1105,-244
2019,3,24,15,1394,1371,1005,-366
2019,3,24,16,1385,1330,1126,-204
2019,3,24,17,1374,1309,1267,-42
2019,3,24,18,1350,1277,1403,126
2019,3,24,19,1323,1268,1486,218
2019,3,24,20,1306,1256,1546,290
2019,3,24,21,1301,1269,1555,286
2019,3,24,22,1315,1272,1688,416
2019,3,24,23,1337,1311,1759,448
2019,3,25,0,1379,1344,1753,409
2019,3,25,1,1430,1376,1671,295
2019,3,25,2,1512,1447,1220,-227
2019,3,25,3,1549,1516,1054,-462
2019,3,25,4,1525,1477,969,-508
2019,3,25,5,1457,1387,969,-418
2019,3,25,6,1368,1308,992,-316
2019,3,25,7,1310,1245,972,-273
2019,3,25,8,1278,1227,940,-287
2019,3,25,9,1268,1217,789,-428
2019,3,25,10,1265,1216,774,-442
2019,3,25,11,1282,1244,673,-571
2019,3,25,12,1345,1325,615,-710
2019,3,25,13,1452,1471,574,-897
2019,3,25,14,1526,1510,576,-934
2019,3,25,15,1524,1486,715,-771
2019,3,25,16,1492,1433,726,-707
2019,3,25,17,1470,1393,755,-638
2019,3,25,18,1442,1364,768,-596
2019,3,25,19,1414,1335,811,-524
2019,3,25,20,1393,1327,869,-458
2019,3,25,21,1390,1340,841,-499
2019,3,25,22,1395,1336,793,-543
2019,3,25,23,1409,1347,772,-575
2019,3,26,0,1437,1368,779,-589
2019,3,26,1,1464,1400,733,-667
2019,3,26,2,1533,1485,734,-751
2019,3,26,3,1573,1554,768,-786
2019,3,26,4,1547,1498,756,-742
2019,3,26,5,1464,1402,726,-676
2019,3,26,6,1369,1306,664,-642
2019,3,26,7,1307,1266,547,-719
2019,3,26,8,1253,1239,508,-731
2019,3,26,9,1239,1226,480,-746
2019,3,26,10,1236,1230,468,-762
2019,3,26,11,1253,1254,490,-764
2019,3,26,12,1315,1340,481,-859
2019,3,26,13,1424,1473,554,-919
2019,3,26,14,1494,1501,554,-947
2019,3,26,15,1495,1465,632,-833
2019,3,26,16,1469,1416,622,-794
2019,3,26,17,1449,1378,694,-684
2019,3,26,18,1430,1377,831,-546
2019,3,26,19,1413,1344,882,-462
2019,3,26,20,1398,1341,923,-418
2019,3,26,21,1412,1399,1020,-379
2019,3,26,22,1431,1367,1124,-243
2019,3,26,23,1448,1407,1197,-210
2019,3,27,0,1463,1414,1210,-204
2019,3,27,1,1475,1422,1168,-254
2019,3,27,2,1531,1502,1191,-311
2019,3,27,3,1569,1551,1225,-326
2019,3,27,4,1541,1498,1235,-263
2019,3,27,5,1451,1405,1246,-159
2019,3,27,6,1353,1293,1205,-88
2019,3,27,7,1286,1239,1151,-88
2019,3,27,8,1244,1200,1039,-161
2019,3,27,9,1223,1206,1031,-175
2019,3,27,10,1215,1194,971,-223
2019,3,27,11,1226,1195,1004,-191
2019,3,27,12,1289,1251,1086,-165
2019,3,27,13,1399,1385,1189,-196
2019,3,27,14,1460,1415,1152,-263
2019,3,27,15,1466,1403,1014,-389
2019,3,27,16,1452,1394,1065,-329
2019,3,27,17,1444,1376,1246,-130
2019,3,27,18,1444,1379,1348,-31
2019,3,27,19,1436,1358,1396,38
2019,3,27,20,1438,1371,1430,59
2019,3,27,21,1444,1388,1432,44
2019,3,27,22,1465,1406,1443,37
2019,3,27,23,1480,1429,1459,30
2019,3,28,0,1507,1450,1385,-65
2019,3,28,1,1526,1461,1310,-151
2019,3,28,2,1556,1525,1369,-156
2019,3,28,3,1605,1578,1399,-179
2019,3,28,4,1563,1518,1403,-115
2019,3,28,5,1466,1409,1445,36
2019,3,28,6,1369,1307,1415,108
2019,3,28,7,1307,1247,1422,175
2019,3,28,8,1254,1209,1424,215
2019,3,28,9,1235,1178,1442,264
2019,3,28,10,1230,1169,1250,81
2019,3,28,11,1240,1186,1165,-21
2019,3,28,12,1300,1257,1174,-83
2019,3,28,13,1407,1368,1257,-111
2019,3,28,14,1466,1403,1378,-25
2019,3,28,15,1465,1383,1390,7
2019,3,28,16,1455,1362,1450,88
2019,3,28,17,1444,1380,1491,111
2019,3,28,18,1443,1365,1432,67
2019,3,28,19,1443,1364,1473,109
2019,3,28,20,1445,1366,1534,168
2019,3,28,21,1459,1378,1565,187
2019,3,28,22,1492,1405,1611,206
2019,3,28,23,1534,1428,1594,166
2019,3,29,0,1540,1457,1594,137
2019,3,29,1,1543,1462,1439,-23
2019,3,29,2,1565,1504,1381,-123
2019,3,29,3,1591,1555,1454,-101
2019,3,29,4,1544,1495,1440,-55
2019,3,29,5,1446,1387,1384,-3
2019,3,29,6,1353,1292,1368,76
2019,3,29,7,1286,1225,1203,-22
2019,3,29,8,1219,1179,1288,109
2019,3,29,9,1202,1163,1460,297
2019,3,29,10,1189,1161,1469,308
2019,3,29,11,1233,1187,1517,330
2019,3,29,12,1298,1248,1547,299
2019,3,29,13,1397,1365,1609,244
2019,3,29,14,1447,1406,1603,197
2019,3,29,15,1450,1383,1698,315
2019,3,29,16,1437,1363,1730,367
2019,3,29,17,1416,1350,1789,439
2019,3,29,18,1404,1333,1814,481
2019,3,29,19,1400,1332,1825,493
2019,3,29,20,1395,1338,1873,535
2019,3,29,21,1403,1352,1869,517
2019,3,29,22,1405,1358,1861,503
2019,3,29,23,1422,1365,1838,473
2019,3,30,0,1439,1389,1835,446
2019,3,30,1,1456,1392,1778,386
2019,3,30,2,1485,1464,1790,326
2019,3,30,3,1539,1529,1826,297
2019,3,30,4,1512,1478,1760,282
2019,3,30,5,1431,1411,1661,250
2019,3,30,6,1344,1329,1400,71
2019,3,30,7,1284,1266,1190,-76
2019,3,30,8,1289,1233,1064,-169
2019,3,30,9,1269,1217,938,-279
2019,3,30,10,1262,1209,857,-352
2019,3,30,11,1269,1243,852,-391
2019,3,30,12,1295,1264,893,-371
2019,3,30,13,1337,1343,950,-393
2019,3,30,14,1370,1374,1050,-324
2019,3,30,15,1391,1376,1185,-191
2019,3,30,16,1391,1352,1241,-111
2019,3,30,17,1384,1330,1255,-75
2019,3,30,18,1368,1312,1204,-108
2019,3,30,19,1338,1300,1152,-148
2019,3,30,20,1322,1286,1151,-135
2019,3,30,21,1308,1277,1169,-108
2019,3,30,22,1318,1276,1140,-136
2019,3,30,23,1335,1281,1104,-177
2019,3,31,0,1377,1305,1117,-188
2019,3,31,1,1421,1350,1063,-287
2019,3,31,2,1479,1429,1090,-339
2019,3,31,3,1523,1494,1166,-328
2019,3,31,4,1501,1466,1147,-319
2019,3,31,5,1447,1414,1097,-317
2019,3,31,6,1375,1327,1045,-282
2019,3,31,7,1321,1304,1010,-294
2019,3,31,8,1302,1256,915,-341
2019,3,31,9,1280,1248,870,-378
2019,3,31,10,1277,1239,864,-375
2019,3,31,11,1277,1253,846,-407
2019,3,31,12,1307,1283,899,-384
2019,3,31,13,1356,1331,900,-431
2019,3,31,14,1388,1358,923,-435
2019,3,31,15,1416,1408,971,-437
2019,3,31,16,1429,1432,1122,-310
2019,3,31,17,1428,1454,1083,-371
2019,3,31,18,1411,1443,1014,-429
2019,3,31,19,1391,1445,977,-468
2019,3,31,20,1369,1459,949,-510
2019,3,31,21,1363,1435,921,-514
2019,3,31,22,1359,1443,902,-541
2019,3,31,23,1372,1497,878,-619
2019,4,1,0,1419,1544,896,-648
2019,4,1,1,1470,1575,778,-797
2019,4,1,2,1560,1629,802,-827
2019,4,1,3,1609,1659,828,-831
2019,4,1,4,1584,1586,785,-801
2019,4,1,5,1507,1487,747,-740
2019,4,1,6,1423,1393,670,-723
2019,4,1,7,1361,1344,662,-682
2019,4,1,8,1321,1324,667,-657
2019,4,1,9,1311,1311,668,-643
2019,4,1,10,1316,1328,652,-676
2019,4,1,11,1336,1351,682,-669
2019,4,1,12,1408,1434,715,-719
2019,4,1,13,1530,1571,828,-743
2019,4,1,14,1601,1606,869,-737
2019,4,1,15,1590,1565,1015,-550
2019,4,1,16,1540,1535,1010,-525
2019,4,1,17,1503,1489,995,-494
2019,4,1,18,1470,1440,1078,-362
2019,4,1,19,1442,1392,1040,-352
2019,4,1,20,1405,1357,1093,-264
2019,4,1,21,1384,1343,1049,-294
2019,4,1,22,1378,1350,1010,-340
2019,4,1,23,1389,1366,1055,-311
2019,4,2,0,1415,1389,1152,-237
2019,4,2,1,1440,1419,1206,-213
2019,4,2,2,1519,1494,1183,-311
2019,4,2,3,1593,1592,1254,-338
2019,4,2,4,1564,1541,1281,-260
2019,4,2,5,1478,1442,1110,-332
2019,4,2,6,1381,1349,1004,-345
2019,4,2,7,1328,1294,1021,-273
2019,4,2,8,1286,1269,991,-278
2019,4,2,9,1275,1267,1002,-265
2019,4,2,10,1272,1268,1043,-225
2019,4,2,11,1290,1293,1152,-141
2019,4,2,12,1363,1367,1121,-246
2019,4,2,13,1485,1499,1144,-355
2019,4,2,14,1561,1512,1121,-391
2019,4,2,15,1545,1488,1049,-439
2019,4,2,16,1505,1435,977,-458
2019,4,2,17,1469,1419,935,-484
2019,4,2,18,1441,1373,1020,-353
2019,4,2,19,1411,1354,1113,-241
2019,4,2,20,1396,1350,1089,-261
2019,4,2,21,1390,1355,1050,-305
2019,4,2,22,1395,1341,1024,-317
2019,4,2,23,1404,1351,1055,-296
2019,4,3,0,1425,1367,1023,-344
2019,4,3,1,1446,1389,1020,-369
2019,4,3,2,1509,1459,1034,-425
2019,4,3,3,1568,1525,1096,-429
2019,4,3,4,1545,1482,1063,-419
2019,4,3,5,1455,1387,982,-405
2019,4,3,6,1360,1307,1018,-289
2019,4,3,7,1298,1258,930,-328
2019,4,3,8,1263,1229,991,-238
2019,4,3,9,1243,1210,923,-287
2019,4,3,10,1245,1196,875,-321
2019,4,3,11,1267,1206,886,-320
2019,4,3,12,1334,1307,887,-420
2019,4,3,13,1447,1447,947,-500
2019,4,3,14,1519,1480,990,-490
2019,4,3,15,1516,1459,971,-488
2019,4,3,16,1490,1443,1113,-330
2019,4,3,17,1464,1429,1233,-196
2019,4,3,18,1441,1403,1249,-154
2019,4,3,19,1415,1409,1303,-106
2019,4,3,20,1401,1419,1350,-69
2019,4,3,21,1403,1406,1427,21
2019,4,3,22,1411,1409,1421,12
2019,4,3,23,1424,1428,1438,10
2019,4,4,0,1438,1429,1290,-139
2019,4,4,1,1460,1447,1395,-52
2019,4,4,2,1516,1501,1407,-94
2019,4,4,3,1585,1586,1351,-235
2019,4,4,4,1558,1547,1314,-233
2019,4,4,5,1474,1504,1286,-218
2019,4,4,6,1380,1363,1070,-293
2019,4,4,7,1320,1306,1054,-252
2019,4,4,8,1269,1278,1061,-217
2019,4,4,9,1257,1265,1085,-180
2019,4,4,10,1255,1269,1065,-204
2019,4,4,11,1265,1293,1107,-186
2019,4,4,12,1340,1374,1074,-300
2019,4,4,13,1452,1508,932,-576
2019,4,4,14,1509,1537,968,-569
2019,4,4,15,1509,1486,942,-544
2019,4,4,16,1482,1443,974,-469
2019,4,4,17,1456,1414,961,-453
2019,4,4,18,1430,1381,912,-469
2019,4,4,19,1407,1377,883,-494
2019,4,4,20,1404,1358,915,-443
2019,4,4,21,1403,1363,925,-438
2019,4,4,22,1418,1368,950,-418
2019,4,4,23,1431,1382,954,-428
2019,4,5,0,1448,1398,1007,-391
2019,4,5,1,1463,1433,1002,-431
2019,4,5,2,1513,1485,976,-509
2019,4,5,3,1579,1548,1006,-542
2019,4,5,4,1545,1506,1017,-489
2019,4,5,5,1457,1411,1049,-362
2019,4,5,6,1361,1315,957,-358
2019,4,5,7,1299,1256,893,-363
2019,4,5,8,1275,1228,960,-268
2019,4,5,9,1257,1210,961,-249
2019,4,5,10,1255,1213,990,-223
2019,4,5,11,1267,1239,1016,-223
2019,4,5,12,1324,1316,1002,-314
2019,4,5,13,1426,1429,951,-478
2019,4,5,14,1492,1463,884,-579
2019,4,5,15,1490,1466,919,-547
2019,4,5,16,1475,1435,1030,-405
2019,4,5,17,1454,1417,947,-470
2019,4,5,18,1430,1417,926,-491
2019,4,5,19,1412,1354,1001,-353
2019,4,5,20,1400,1364,1153,-211
2019,4,5,21,1398,1362,1224,-138
2019,4,5,22,1407,1356,1243,-113
2019,4,5,23,1421,1371,1220,-151
2019,4,6,0,1428,1380,1186,-194
2019,4,6,1,1447,1388,1098,-290
2019,4,6,2,1493,1429,1081,-348
2019,4,6,3,1548,1547,1068,-479
2019,4,6,4,1535,1492,1071,-421
2019,4,6,5,1473,1406,1106,-300
2019,4,6,6,1386,1331,1098,-233
2019,4,6,7,1325,1279,1114,-165
2019,4,6,8,1270,1255,1147,-108
2019,4,6,9,1246,1244,1150,-94
2019,4,6,10,1237,1228,1086,-142
2019,4,6,11,1243,1238,1092,-146
2019,4,6,12,1265,1278,1127,-151
2019,4,6,13,1313,1337,1036,-301
2019,4,6,14,1349,1359,1043,-316
2019,4,6,15,1374,1355,1065,-290
2019,4,6,16,1378,1331,1164,-167
2019,4,6,17,1370,1311,1200,-111
2019,4,6,18,1354,1293,1090,-203
2019,4,6,19,1341,1280,1080,-200
2019,4,6,20,1322,1281,1036,-245
2019,4,6,21,1321,1281,1053,-228
2019,4,6,22,1327,1298,1066,-232
2019,4,6,23,1331,1315,1065,-250
2019,4,7,0,1365,1354,1075,-279
2019,4,7,1,1405,1365,1091,-274
2019,4,7,2,1459,1419,1138,-281
2019,4,7,3,1521,1477,1195,-282
2019,4,7,4,1502,1454,1209,-245
2019,4,7,5,1439,1390,1142,-248
2019,4,7,6,1360,1313,1137,-176
2019,4,7,7,1307,1271,1073,-198
2019,4,7,8,1258,1235,1036,-199
2019,4,7,9,1236,1216,1099,-117
2019,4,7,10,1226,1207,1123,-84
2019,4,7,11,1231,1210,1140,-70
2019,4,7,12,1252,1251,1110,-141
2019,4,7,13,1292,1294,1133,-161
2019,4,7,14,1322,1306,1157,-149
2019,4,7,15,1341,1312,1184,-128
2019,4,7,16,1341,1303,1184,-119
2019,4,7,17,1336,1291,1182,-109
2019,4,7,18,1333,1275,1079,-196
2019,4,7,19,1324,1276,1062,-214
2019,4,7,20,1327,1269,995,-274
2019,4,7,21,1324,1275,924,-351
2019,4,7,22,1334,1298,886,-412
2019,4,7,23,1362,1348,918,-430
2019,4,8,0,1405,1393,960,-433
2019,4,8,1,1441,1429,994,-435
2019,4,8,2,1485,1486,1000,-486
2019,4,8,3,1526,1541,1089,-452
2019,4,8,4,1502,1485,1082,-403
2019,4,8,5,1433,1386,1038,-348
2019,4,8,6,1347,1293,980,-313
2019,4,8,7,1282,1229,944,-285
2019,4,8,8,1228,1200,948,-252
2019,4,8,9,1217,1191,836,-355
2019,4,8,10,1207,1171,819,-352
2019,4,8,11,1223,1204,838,-366
2019,4,8,12,1285,1276,920,-356
2019,4,8,13,1400,1395,977,-418
2019,4,8,14,1459,1440,1038,-402
2019,4,8,15,1456,1423,1050,-373
2019,4,8,16,1446,1388,1094,-294
2019,4,8,17,1443,1384,1129,-255
2019,4,8,18,1440,1383,1135,-248
2019,4,8,19,1432,1360,1080,-280
2019,4,8,20,1423,1379,1108,-271
2019,4,8,21,1434,1396,1089,-307
2019,4,8,22,1457,1449,1114,-335
2019,4,8,23,1475,1455,1124,-331
2019,4,9,0,1499,1482,1174,-308
2019,4,9,1,1518,1480,1183,-297
2019,4,9,2,1555,1501,1089,-412
2019,4,9,3,1606,1578,1116,-462
2019,4,9,4,1566,1515,1074,-441
2019,4,9,5,1460,1405,950,-455
2019,4,9,6,1357,1306,807,-499
2019,4,9,7,1287,1228,622,-606
2019,4,9,8,1237,1196,548,-648
2019,4,9,9,1209,1170,530,-640
2019,4,9,10,1199,1166,560,-606
2019,4,9,11,1222,1200,610,-590
2019,4,9,12,1284,1273,668,-605
2019,4,9,13,1394,1388,747,-641
2019,4,9,14,1454,1412,766,-646
2019,4,9,15,1450,1396,782,-614
2019,4,9,16,1448,1386,813,-573
2019,4,9,17,1464,1383,911,-472
2019,4,9,18,1487,1391,1032,-359
2019,4,9,19,1491,1394,1121,-273
2019,4,9,20,1518,1436,1212,-224
2019,4,9,21,1550,1481,1299,-182
2019,4,9,22,1587,1489,1328,-161
2019,4,9,23,1631,1517,1315,-202
2019,4,10,0,1638,1534,1276,-258
2019,4,10,1,1632,1508,1200,-308
2019,4,10,2,1633,1532,1190,-342
2019,4,10,3,1648,1605,1271,-334
2019,4,10,4,1595,1534,1296,-238
2019,4,10,5,1481,1425,1141,-284
2019,4,10,6,1367,1327,1041,-286
2019,4,10,7,1295,1259,988,-271
2019,4,10,8,1238,1225,1100,-125
2019,4,10,9,1211,1202,1111,-91
2019,4,10,10,1204,1196,1074,-122
2019,4,10,11,1219,1197,1040,-157
2019,4,10,12,1278,1275,1045,-230
2019,4,10,13,1389,1398,1047,-351
2019,4,10,14,1451,1418,1064,-354
2019,4,10,15,1461,1431,1219,-212
2019,4,10,16,1457,1426,1237,-189
2019,4,10,17,1451,1406,1222,-184
2019,4,10,18,1435,1370,1163,-207
2019,4,10,19,1415,1373,1093,-280
2019,4,10,20,1410,1371,1141,-230
2019,4,10,21,1439,1339,1292,-47
2019,4,10,22,1445,1346,1194,-152
2019,4,10,23,1452,1352,1041,-311
2019,4,11,0,1473,1383,962,-421
2019,4,11,1,1494,1434,1038,-396
2019,4,11,2,1528,1515,1253,-262
2019,4,11,3,1571,1589,1344,-245
2019,4,11,4,1552,1540,1262,-278
2019,4,11,5,1464,1452,1220,-232
2019,4,11,6,1371,1371,1165,-206
2019,4,11,7,1307,1318,1108,-210
2019,4,11,8,1303,1293,1100,-193
2019,4,11,9,1284,1265,1072,-193
2019,4,11,10,1281,1267,1050,-217
2019,4,11,11,1300,1285,1036,-249
2019,4,11,12,1361,1363,1062,-301
2019,4,11,13,1470,1487,1120,-367
2019,4,11,14,1550,1507,1067,-440
2019,4,11,15,1547,1496,1132,-364
2019,4,11,16,1515,1491,1217,-274
2019,4,11,17,1487,1452,1181,-271
2019,4,11,18,1448,1445,1049,-396
2019,4,11,19,1420,1427,1006,-421
2019,4,11,20,1412,1416,988,-428
2019,4,11,21,1402,1404,1078,-326
2019,4,11,22,1397,1400,1137,-263
2019,4,11,23,1413,1405,1158,-247
2019,4,12,0,1433,1417,1160,-257
2019,4,12,1,1453,1471,1216,-255
2019,4,12,2,1511,1528,1203,-325
2019,4,12,3,1581,1619,1241,-378
2019,4,12,4,1565,1566,1178,-388
2019,4,12,5,1497,1459,990,-469
2019,4,12,6,1410,1367,903,-464
2019,4,12,7,1351,1320,786,-534
2019,4,12,8,1338,1289,680,-609
2019,4,12,9,1322,1283,592,-691
2019,4,12,10,1325,1287,600,-687
2019,4,12,11,1335,1313,597,-716
2019,4,12,12,1406,1382,619,-763
2019,4,12,13,1517,1494,702,-792
2019,4,12,14,1597,1522,707,-815
2019,4,12,15,1592,1521,718,-803
2019,4,12,16,1563,1484,722,-762
2019,4,12,17,1523,1445,721,-724
2019,4,12,18,1487,1417,711,-706
2019,4,12,19,1459,1400,810,-590
2019,4,12,20,1438,1392,836,-556
2019,4,12,21,1412,1402,839,-563
2019,4,12,22,1405,1406,751,-655
2019,4,12,23,1405,1410,730,-680
2019,4,13,0,1427,1421,694,-727
2019,4,13,1,1458,1433,709,-724
2019,4,13,2,1523,1501,711,-790
2019,4,13,3,1601,1581,833,-748
2019,4,13,4,1594,1551,892,-659
2019,4,13,5,1542,1486,827,-659
2019,4,13,6,1470,1409,785,-624
2019,4,13,7,1407,1351,751,-600
2019,4,13,8,1370,1309,762,-547
2019,4,13,9,1346,1297,759,-538
2019,4,13,10,1336,1280,733,-547
2019,4,13,11,1345,1294,711,-583
2019,4,13,12,1374,1335,874,-461
2019,4,13,13,1433,1385,821,-564
2019,4,13,14,1463,1434,837,-597
2019,4,13,15,1475,1460,911,-549
2019,4,13,16,1466,1446,924,-522
2019,4,13,17,1445,1418,870,-548
2019,4,13,18,1413,1386,850,-536
2019,4,13,19,1384,1358,835,-523
2019,4,13,20,1358,1365,832,-533
2019,4,13,21,1336,1372,817,-555
2019,4,13,22,1333,1377,798,-579
2019,4,13,23,1349,1373,808,-565
2019,4,14,0,1378,1394,774,-620
2019,4,14,1,1424,1430,747,-683
2019,4,14,2,1495,1475,758,-717
2019,4,14,3,1556,1541,768,-773
2019,4,14,4,1554,1511,761,-750
2019,4,14,5,1506,1448,732,-716
2019,4,14,6,1437,1377,695,-682
2019,4,14,7,1386,1328,716,-612
2019,4,14,8,1332,1296,754,-542
2019,4,14,9,1312,1286,797,-489
2019,4,14,10,1304,1283,852,-431
2019,4,14,11,1314,1298,948,-350
2019,4,14,12,1343,1328,1030,-298
2019,4,14,13,1387,1378,1095,-283
2019,4,14,14,1405,1399,1192,-207
2019,4,14,15,1416,1392,1189,-203
2019,4,14,16,1397,1365,1094,-271
2019,4,14,17,1371,1345,1160,-185
2019,4,14,18,1342,1329,1204,-125
2019,4,14,19,1325,1310,1217,-93
2019,4,14,20,1317,1312,1307,-5
2019,4,14,21,1315,1314,1324,10
2019,4,14,22,1336,1328,1331,3
2019,4,14,23,1361,1365,1352,-13
2019,4,15,0,1391,1419,1366,-53
2019,4,15,1,1431,1452,1339,-113
2019,4,15,2,1484,1494,1287,-207
2019,4,15,3,1558,1572,1330,-242
2019,4,15,4,1535,1526,1205,-321
2019,4,15,5,1457,1431,1206,-225
2019,4,15,6,1366,1332,1125,-207
2019,4,15,7,1306,1275,1156,-119
2019,4,15,8,1258,1239,1101,-138
2019,4,15,9,1241,1223,1000,-223
2019,4,15,10,1239,1224,927,-297
2019,4,15,11,1261,1260,950,-310
2019,4,15,12,1327,1333,1005,-328
2019,4,15,13,1445,1438,1056,-382
2019,4,15,14,1499,1457,1097,-360
2019,4,15,15,1493,1430,967,-463
2019,4,15,16,1469,1409,1011,-398
2019,4,15,17,1459,1412,1133,-279
2019,4,15,18,1449,1417,1205,-212
2019,4,15,19,1424,1425,1250,-175
2019,4,15,20,1424,1427,1242,-185
2019,4,15,21,1435,1446,1221,-225
2019,4,15,22,1450,1461,1241,-220
2019,4,15,23,1463,1478,1203,-275
2019,4,16,0,1491,1491,1040,-451
2019,4,16,1,1494,1494,1043,-451
2019,4,16,2,1542,1522,1085,-437
2019,4,16,3,1613,1594,1190,-404
2019,4,16,4,1577,1535,1164,-371
2019,4,16,5,1475,1434,1178,-256
2019,4,16,6,1377,1338,1218,-120
2019,4,16,7,1311,1285,1152,-133
2019,4,16,8,1261,1241,1142,-99
2019,4,16,9,1236,1221,1077,-144
2019,4,16,10,1227,1199,947,-252
2019,4,16,11,1247,1230,975,-255
2019,4,16,12,1309,1311,1135,-176
2019,4,16,13,1415,1417,1098,-319
2019,4,16,14,1476,1431,1056,-375
2019,4,16,15,1476,1417,1040,-377
2019,4,16,16,1461,1404,1101,-303
2019,4,16,17,1457,1285,992,-293
2019,4,16,18,1450,1396,1054,-342
2019,4,16,19,1441,1398,1039,-359
2019,4,16,20,1434,1408,1049,-359
2019,4,16,21,1440,1420,1065,-355
2019,4,16,22,1460,1446,1101,-345
2019,4,16,23,1460,1463,1073,-390
2019,4,17,0,1474,1470,1111,-359
2019,4,17,1,1489,1492,1136,-356
2019,4,17,2,1521,1521,996,-525
2019,4,17,3,1592,1589,1068,-521
2019,4,17,4,1560,1535,1223,-312
2019,4,17,5,1465,1425,1170,-255
2019,4,17,6,1363,1335,1090,-245
2019,4,17,7,1297,1269,827,-442
2019,4,17,8,1266,1232,719,-513
2019,4,17,9,1244,1209,630,-579
2019,4,17,10,1237,1208,642,-566
2019,4,17,11,1256,1224,835,-389
2019,4,17,12,1319,1294,922,-372
2019,4,17,13,1436,1408,1034,-374
2019,4,17,14,1494,1449,845,-604
2019,4,17,15,1498,1449,888,-561
2019,4,17,16,1483,1447,847,-600
2019,4,17,17,1477,1430,760,-670
2019,4,17,18,1456,1427,792,-635
2019,4,17,19,1442,1392,924,-468
2019,4,17,20,1438,1443,858,-585
2019,4,17,21,1437,1457,850,-607
2019,4,17,22,1435,1466,855,-611
2019,4,17,23,1451,1454,916,-538
2019,4,18,0,1464,1467,912,-555
2019,4,18,1,1477,1486,900,-586
2019,4,18,2,1515,1523,956,-567
2019,4,18,3,1579,1574,991,-583
2019,4,18,4,1558,1523,977,-546
2019,4,18,5,1469,1432,961,-471
2019,4,18,6,1375,1346,947,-399
2019,4,18,7,1313,1298,940,-358
2019,4,18,8,1282,1271,894,-377
2019,4,18,9,1259,1247,862,-385
2019,4,18,10,1256,1242,829,-413
2019,4,18,11,1273,1277,861,-416
2019,4,18,12,1340,1358,897,-461
2019,4,18,13,1453,1468,870,-598
2019,4,18,14,1503,1484,912,-572
2019,4,18,15,1497,1456,960,-496
2019,4,18,16,1470,1412,904,-508
2019,4,18,17,1435,1391,817,-574
2019,4,18,18,1429,1381,741,-640
2019,4,18,19,1414,1362,666,-696
2019,4,18,20,1409,1359,720,-639
2019,4,18,21,1413,1354,827,-527
2019,4,18,22,1422,1362,974,-388
2019,4,18,23,1452,1390,1041,-349
2019,4,19,0,1473,1419,1050,-369
2019,4,19,1,1485,1441,1078,-363
2019,4,19,2,1524,1472,1042,-430
2019,4,19,3,1588,1553,1138,-415
2019,4,19,4,1556,1512,1166,-346
2019,4,19,5,1473,1390,1202,-188
2019,4,19,6,1374,1328,1128,-200
2019,4,19,7,1314,1265,940,-325
2019,4,19,8,1271,1225,685,-540
2019,4,19,9,1251,1199,583,-616
2019,4,19,10,1240,1201,449,-752
2019,4,19,11,1259,1226,361,-865
2019,4,19,12,1316,1285,394,-891
2019,4,19,13,1422,1354,402,-952
2019,4,19,14,1473,1385,380,-1005
2019,4,19,15,1474,1383,398,-985
2019,4,19,16,1453,1365,392,-973
2019,4,19,17,1438,1352,413,-939
2019,4,19,18,1426,1347,457,-890
2019,4,19,19,1417,1328,478,-850
2019,4,19,20,1422,1331,469,-862
2019,4,19,21,1430,1358,498,-860
2019,4,19,22,1446,1380,497,-883
2019,4,19,23,1457,1415,509,-906
2019,4,20,0,1473,1452,596,-856
2019,4,20,1,1499,1462,590,-872
2019,4,20,2,1522,1474,658,-816
2019,4,20,3,1582,1557,758,-799
2019,4,20,4,1562,1513,709,-804
2019,4,20,5,1480,1432,561,-871
2019,4,20,6,1391,1337,512,-825
2019,4,20,7,1319,1268,585,-683
2019,4,20,8,1258,1221,615,-606
2019,4,20,9,1234,1197,613,-584
2019,4,20,10,1216,1200,640,-560
2019,4,20,11,1222,1205,622,-583
2019,4,20,12,1250,1233,565,-668
2019,4,20,13,1287,1263,613,-650
2019,4,20,14,1307,1280,621,-659
2019,4,20,15,1331,1298,651,-647
2019,4,20,16,1350,1293,682,-611
2019,4,20,17,1363,1305,724,-581
2019,4,20,18,1385,1325,722,-603
2019,4,20,19,1388,1350,753,-597
2019,4,20,20,1407,1345,804,-541
2019,4,20,21,1406,1373,909,-464
2019,4,20,22,1438,1395,886,-509
2019,4,20,23,1480,1427,910,-517
2019,4,21,0,1482,1459,905,-554
2019,4,21,1,1499,1501,990,-511
2019,4,21,2,1509,1504,1049,-455
2019,4,21,3,1549,1562,1164,-398
2019,4,21,4,1530,1519,1185,-334
2019,4,21,5,1444,1439,1130,-309
2019,4,21,6,1360,1341,982,-359
2019,4,21,7,1296,1277,965,-312
2019,4,21,8,1239,1230,976,-254
2019,4,21,9,1218,1200,948,-252
2019,4,21,10,1201,1183,998,-185
2019,4,21,11,1209,1181,1018,-163
2019,4,21,12,1230,1203,975,-228
2019,4,21,13,1266,1220,937,-283
2019,4,21,14,1286,1235,995,-240
2019,4,21,15,1312,1270,1108,-162
2019,4,21,16,1330,1285,1203,-82
2019,4,21,17,1340,1287,1221,-66
2019,4,21,18,1348,1292,1225,-67
2019,4,21,19,1349,1287,1199,-88
2019,4,21,20,1361,1289,1210,-79
2019,4,21,21,1372,1294,1223,-71
2019,4,21,22,1406,1307,1215,-92
2019,4,21,23,1446,1347,1144,-203
2019,4,22,0,1477,1394,1042,-352
2019,4,22,1,1506,1406,930,-476
2019,4,22,2,1522,1440,839,-601
2019,4,22,3,1574,1520,909,-611
2019,4,22,4,1550,1477,919,-558
2019,4,22,5,1451,1378,966,-412
2019,4,22,6,1357,1281,973,-308
2019,4,22,7,1282,1220,917,-303
2019,4,22,8,1213,1190,793,-397
2019,4,22,9,1195,1176,758,-418
2019,4,22,10,1200,1179,851,-328
2019,4,22,11,1219,1197,833,-364
2019,4,22,12,1280,1247,930,-317
2019,4,22,13,1382,1332,1007,-325
2019,4,22,14,1439,1402,1079,-323
2019,4,22,15,1447,1376,1115,-261
2019,4,22,16,1441,1388,1244,-144
2019,4,22,17,1442,1401,1268,-133
2019,4,22,18,1443,1428,1153,-275
2019,4,22,19,1444,1425,1118,-307
2019,4,22,20,1425,1420,1085,-335
2019,4,22,21,1422,1427,1093,-334
2019,4,22,22,1437,1432,1119,-313
2019,4,22,23,1453,1444,1223,-221
2019,4,23,0,1476,1454,1233,-221
2019,4,23,1,1511,1477,1218,-259
2019,4,23,2,1529,1507,1194,-313
2019,4,23,3,1585,1561,1183,-378
2019,4,23,4,1558,1493,975,-518
2019,4,23,5,1454,1386,825,-561
2019,4,23,6,1353,1289,778,-511
2019,4,23,7,1286,1240,925,-315
2019,4,23,8,1266,1214,871,-343
2019,4,23,9,1246,1194,860,-334
2019,4,23,10,1236,1188,987,-201
2019,4,23,11,1252,1205,979,-226
2019,4,23,12,1311,1280,987,-293
2019,4,23,13,1420,1393,1017,-376
2019,4,23,14,1476,1438,981,-457
2019,4,23,15,1480,1459,930,-529
2019,4,23,16,1469,1466,976,-490
2019,4,23,17,1452,1467,956,-511
2019,4,23,18,1430,1439,911,-528
2019,4,23,19,1418,1439,906,-533
2019,4,23,20,1416,1440,925,-515
2019,4,23,21,1415,1433,939,-494
2019,4,23,22,1415,1410,904,-506
2019,4,23,23,1433,1418,959,-459
2019,4,24,0,1447,1424,985,-439
2019,4,24,1,1470,1444,868,-576
2019,4,24,2,1505,1483,858,-625
2019,4,24,3,1572,1553,868,-685
2019,4,24,4,1549,1500,818,-682
2019,4,24,5,1461,1395,732,-663
2019,4,24,6,1365,1303,648,-655
2019,4,24,7,1296,1263,539,-724
2019,4,24,8,1259,1239,557,-682
2019,4,24,9,1242,1222,592,-630
2019,4,24,10,1237,1216,684,-532
2019,4,24,11,1256,1242,771,-471
2019,4,24,12,1321,1318,802,-516
2019,4,24,13,1424,1405,819,-586
2019,4,24,14,1475,1426,764,-662
2019,4,24,15,1459,1394,723,-671
2019,4,24,16,1440,1363,773,-590
2019,4,24,17,1415,1351,788,-563
2019,4,24,18,1406,1370,821,-549
2019,4,24,19,1400,1330,764,-566
2019,4,24,20,1402,1339,734,-605
2019,4,24,21,1408,1399,785,-614
2019,4,24,22,1427,1404,821,-583
2019,4,24,23,1446,1433,691,-742
2019,4,25,0,1459,1447,703,-744
2019,4,25,1,1479,1442,724,-718
2019,4,25,2,1498,1472,782,-690
2019,4,25,3,1567,1557,822,-735
2019,4,25,4,1542,1510,845,-665
2019,4,25,5,1441,1399,878,-521
2019,4,25,6,1347,1283,945,-338
2019,4,25,7,1276,1230,840,-390
2019,4,25,8,1238,1193,809,-384
2019,4,25,9,1215,1180,803,-377
2019,4,25,10,1205,1176,789,-387
2019,4,25,11,1220,1194,772,-422
2019,4,25,12,1283,1268,788,-480
2019,4,25,13,1388,1371,787,-584
2019,4,25,14,1437,1406,816,-590
2019,4,25,15,1438,1388,830,-558
2019,4,25,16,1435,1377,833,-544
2019,4,25,17,1432,1386,895,-491
2019,4,25,18,1428,1394,914,-480
2019,4,25,19,1426,1412,995,-417
2019,4,25,20,1445,1434,924,-510
2019,4,25,21,1459,1468,1026,-442
2019,4,25,22,1480,1492,988,-504
2019,4,25,23,1504,1521,960,-561
2019,4,26,0,1512,1533,1012,-521
2019,4,26,1,1516,1540,1086,-454
2019,4,26,2,1528,1540,1137,-403
2019,4,26,3,1588,1593,1254,-339
2019,4,26,4,1557,1541,1285,-256
2019,4,26,5,1453,1427,1083,-344
2019,4,26,6,1358,1322,899,-423
2019,4,26,7,1282,1264,979,-285
2019,4,26,8,1233,1227,925,-302
2019,4,26,9,1210,1205,934,-271
2019,4,26,10,1189,1181,909,-272
2019,4,26,11,1204,1197,867,-330
2019,4,26,12,1268,1255,822,-433
2019,4,26,13,1357,1347,814,-533
2019,4,26,14,1403,1388,760,-628
2019,4,26,15,1413,1398,879,-519
2019,4,26,16,1421,1413,947,-466
2019,4,26,17,1431,1428,956,-472
2019,4,26,18,1445,1442,951,-491
2019,4,26,19,1444,1457,986,-471
2019,4,26,20,1436,1482,1104,-378
2019,4,26,21,1491,1547,1194,-353
2019,4,26,22,1508,1535,1191,-344
2019,4,26,23,1530,1549,1042,-507
2019,4,27,0,1528,1517,1053,-464
2019,4,27,1,1523,1521,1055,-466
2019,4,27,2,1522,1515,1135,-380
2019,4,27,3,1579,1585,1039,-546
2019,4,27,4,1546,1532,945,-587
2019,4,27,5,1464,1454,1022,-432
2019,4,27,6,1361,1362,1070,-292
2019,4,27,7,1287,1291,978,-313
2019,4,27,8,1239,1248,986,-262
2019,4,27,9,1217,1212,1011,-201
2019,4,27,10,1194,1205,1063,-142
2019,4,27,11,1191,1201,996,-205
2019,4,27,12,1211,1233,1040,-193
2019,4,27,13,1242,1253,948,-305
2019,4,27,14,1273,1278,847,-431
2019,4,27,15,1302,1309,806,-503
2019,4,27,16,1335,1329,853,-476
2019,4,27,17,1354,1353,984,-369
2019,4,27,18,1388,1372,1010,-362
2019,4,27,19,1416,1407,1115,-292
2019,4,27,20,1435,1437,1086,-351
2019,4,27,21,1467,1464,1061,-403
2019,4,27,22,1497,1485,1106,-379
2019,4,27,23,1528,1519,1086,-433
2019,4,28,0,1541,1539,1072,-467
2019,4,28,1,1544,1563,1016,-547
2019,4,28,2,1540,1560,907,-653
2019,4,28,3,1557,1606,898,-708
2019,4,28,4,1523,1541,841,-700
2019,4,28,5,1438,1437,864,-573
2019,4,28,6,1361,1358,1011,-347
2019,4,28,7,1281,1292,945,-347
2019,4,28,8,1244,1250,883,-367
2019,4,28,9,1217,1213,802,-411
2019,4,28,10,1197,1191,694,-497
2019,4,28,11,1199,1192,597,-595
2019,4,28,12,1212,1206,576,-630
2019,4,28,13,1235,1211,615,-596
2019,4,28,14,1260,1230,763,-467
2019,4,28,15,1284,1262,823,-439
2019,4,28,16,1321,1278,890,-388
2019,4,28,17,1344,1305,1041,-264
2019,4,28,18,1382,1325,1089,-236
2019,4,28,19,1408,1360,1154,-206
2019,4,28,20,1441,1397,1235,-162
2019,4,28,21,1465,1428,1281,-147
2019,4,28,22,1496,1465,1316,-149
2019,4,28,23,1538,1517,1333,-184
2019,4,29,0,1542,1570,1295,-275
2019,4,29,1,1590,1584,1230,-354
2019,4,29,2,1593,1575,1091,-484
2019,4,29,3,1608,1619,1059,-560
2019,4,29,4,1562,1555,997,-558
2019,4,29,5,1464,1442,887,-555
2019,4,29,6,1381,1330,940,-390
2019,4,29,7,1295,1272,1080,-192
2019,4,29,8,1242,1226,1028,-198
2019,4,29,9,1216,1209,1023,-186
2019,4,29,10,1202,1203,1024,-179
2019,4,29,11,1215,1213,949,-264
2019,4,29,12,1270,1275,841,-434
2019,4,29,13,1370,1355,819,-536
2019,4,29,14,1421,1402,835,-567
2019,4,29,15,1428,1420,952,-468
2019,4,29,16,1446,1434,1035,-399
2019,4,29,17,1462,1482,1144,-338
2019,4,29,18,1478,1488,1148,-340
2019,4,29,19,1480,1516,1182,-334
2019,4,29,20,1498,1499,1173,-326
2019,4,29,21,1514,1497,1168,-329
2019,4,29,22,1532,1508,1154,-354
2019,4,29,23,1536,1510,1181,-329
2019,4,30,0,1541,1524,1227,-297
2019,4,30,1,1547,1523,1206,-317
2019,4,30,2,1556,1523,1237,-286
2019,4,30,3,1605,1584,1326,-258
2019,4,30,4,1563,1533,1307,-226
2019,4,30,5,1465,1418,1252,-166
2019,4,30,6,1364,1319,1222,-97
2019,4,30,7,1290,1263,1233,-30
2019,4,30,8,1248,1228,1238,10
2019,4,30,9,1226,1206,1128,-78
2019,4,30,10,1216,1199,1095,-104
2019,4,30,11,1232,1223,1086,-137
2019,4,30,12,1292,1286,1048,-238
2019,4,30,13,1392,1371,1080,-291
2019,4,30,14,1441,1408,1079,-329
2019,4,30,15,1444,1416,1161,-255
2019,4,30,16,1440,1422,1305,-117
2019,4,30,17,1437,1406,1360,-46
2019,4,30,18,1430,1414,1451,37
2019,4,30,19,1418,1397,1486,89
2019,4,30,20,1433,1405,1459,54
2019,4,30,21,1448,1403,1492,89
2019,4,30,22,1462,1438,1538,100
2019,4,30,23,1477,1458,1614,156
2019,5,1,0,1496,1464,1600,136
2019,5,1,1,1513,1475,1529,54
2019,5,1,2,1532,1492,1352,-140
2019,5,1,3,1588,1577,1322,-255
2019,5,1,4,1556,1525,1333,-192
2019,5,1,5,1451,1413,1234,-179
2019,5,1,6,1347,1315,1081,-234
2019,5,1,7,1282,1255,1023,-232
2019,5,1,8,1261,1227,1081,-146
2019,5,1,9,1238,1203,1180,-23
2019,5,1,10,1230,1203,1218,15
2019,5,1,11,1250,1219,1233,14
2019,5,1,12,1312,1294,1300,6
2019,5,1,13,1414,1384,1334,-50
2019,5,1,14,1463,1416,1324,-92
2019,5,1,15,1453,1397,1386,-11
2019,5,1,16,1440,1410,1468,58
2019,5,1,17,1440,1408,1548,140
2019,5,1,18,1433,1414,1576,162
2019,5,1,19,1434,1395,1574,179
2019,5,1,20,1444,1432,1624,192
2019,5,1,21,1458,1466,1650,184
2019,5,1,22,1459,1488,1600,112
2019,5,1,23,1469,1512,1562,50
2019,5,2,0,1496,1535,1469,-66
2019,5,2,1,1510,1538,1304,-234
2019,5,2,2,1503,1541,1187,-354
2019,5,2,3,1585,1619,1207,-412
2019,5,2,4,1564,1560,1244,-316
2019,5,2,5,1460,1427,1185,-242
2019,5,2,6,1368,1338,1198,-140
2019,5,2,7,1301,1278,1172,-106
2019,5,2,8,1266,1247,1284,37
2019,5,2,9,1247,1232,1403,171
2019,5,2,10,1231,1231,1403,172
2019,5,2,11,1248,1237,1412,175
2019,5,2,12,1311,1304,1409,105
2019,5,2,13,1408,1393,1373,-20
2019,5,2,14,1456,1430,1366,-64
2019,5,2,15,1445,1403,1291,-112
2019,5,2,16,1445,1408,1279,-129
2019,5,2,17,1438,1408,1260,-148
2019,5,2,18,1443,1414,1173,-241
2019,5,2,19,1436,1417,1186,-231
2019,5,2,20,1454,1445,1180,-265
2019,5,2,21,1461,1463,1198,-265
2019,5,2,22,1495,1498,1267,-231
2019,5,2,23,1515,1510,1259,-251
2019,5,3,0,1515,1550,1388,-162
2019,5,3,1,1523,1530,1435,-95
2019,5,3,2,1540,1542,1409,-133
2019,5,3,3,1602,1634,1474,-160
2019,5,3,4,1574,1564,1541,-23
2019,5,3,5,1472,1461,1526,65
2019,5,3,6,1379,1350,1398,48
2019,5,3,7,1308,1289,1295,6
2019,5,3,8,1265,1247,1233,-14
2019,5,3,9,1245,1229,1254,25
2019,5,3,10,1230,1210,1203,-7
2019,5,3,11,1243,1224,1159,-65
2019,5,3,12,1298,1290,1173,-117
2019,5,3,13,1385,1372,1194,-178
2019,5,3,14,1429,1403,1238,-165
2019,5,3,15,1430,1398,1110,-288
2019,5,3,16,1430,1404,1082,-322
2019,5,3,17,1417,1409,1173,-236
2019,5,3,18,1417,1402,1188,-214
2019,5,3,19,1411,1405,1184,-221
2019,5,3,20,1429,1438,1260,-178
2019,5,3,21,1471,1449,1328,-121
2019,5,3,22,1478,1476,1354,-122
2019,5,3,23,1493,1487,1412,-75
2019,5,4,0,1500,1521,1336,-185
2019,5,4,1,1510,1513,1382,-131
2019,5,4,2,1509,1520,1285,-235
2019,5,4,3,1578,1576,1231,-345
2019,5,4,4,1563,1536,1187,-349
2019,5,4,5,1465,1445,1161,-284
2019,5,4,6,1384,1352,1166,-186
2019,5,4,7,1316,1287,1170,-117
2019,5,4,8,1275,1240,1168,-72
2019,5,4,9,1253,1221,1109,-112
2019,5,4,10,1236,1206,1080,-126
2019,5,4,11,1239,1214,1079,-135
2019,5,4,12,1262,1254,1045,-209
2019,5,4,13,1297,1269,1061,-208
2019,5,4,14,1312,1282,1151,-131
2019,5,4,15,1335,1308,1172,-136
2019,5,4,16,1359,1306,1088,-218
2019,5,4,17,1370,1311,1101,-210
2019,5,4,18,1378,1321,1118,-203
2019,5,4,19,1384,1336,1146,-190
2019,5,4,20,1403,1360,1182,-178
2019,5,4,21,1420,1379,1276,-103
2019,5,4,22,1450,1432,1321,-111
2019,5,4,23,1485,1476,1424,-52
2019,5,5,0,1506,1510,1380,-130
2019,5,5,1,1520,1505,1424,-81
2019,5,5,2,1530,1501,1307,-194
2019,5,5,3,1571,1548,1290,-258
2019,5,5,4,1549,1502,1312,-190
2019,5,5,5,1467,1414,1319,-95
2019,5,5,6,1379,1333,1258,-75
2019,5,5,7,1312,1262,1169,-93
2019,5,5,8,1267,1217,996,-221
2019,5,5,9,1238,1180,960,-220
2019,5,5,10,1219,1190,980,-210
2019,5,5,11,1222,1192,1027,-165
2019,5,5,12,1240,1209,1033,-176
2019,5,5,13,1255,1210,956,-254
2019,5,5,14,1271,1232,941,-291
2019,5,5,15,1297,1268,915,-353
2019,5,5,16,1324,1294,973,-321
2019,5,5,17,1346,1310,1085,-225
2019,5,5,18,1369,1336,1164,-172
2019,5,5,19,1387,1360,1175,-185
2019,5,5,20,1431,1388,1252,-136
2019,5,5,21,1462,1413,1359,-54
2019,5,5,22,1496,1472,1446,-26
2019,5,5,23,1540,1500,1372,-128
2019,5,6,0,1583,1545,1333,-212
2019,5,6,1,1603,1558,1192,-366
2019,5,6,2,1606,1556,1141,-415
2019,5,6,3,1637,1608,1163,-445
2019,5,6,4,1598,1550,1118,-432
2019,5,6,5,1503,1429,1073,-356
2019,5,6,6,1391,1333,923,-410
2019,5,6,7,1319,1265,975,-290
2019,5,6,8,1266,1221,998,-223
2019,5,6,9,1241,1202,979,-223
2019,5,6,10,1224,1189,1007,-182
2019,5,6,11,1238,1206,1025,-181
2019,5,6,12,1293,1269,1054,-215
2019,5,6,13,1374,1359,1132,-227
2019,5,6,14,1425,1389,1107,-282
2019,5,6,15,1448,1409,1020,-389
2019,5,6,16,1471,1422,980,-442
2019,5,6,17,1498,1423,937,-486
2019,5,6,18,1527,1461,935,-526
2019,5,6,19,1548,1495,981,-514
2019,5,6,20,1596,1543,1056,-487
2019,5,6,21,1628,1545,1185,-360
2019,5,6,22,1658,1591,1161,-430
2019,5,6,23,1687,1621,1094,-527
2019,5,7,0,1689,1640,1089,-551
2019,5,7,1,1669,1614,1117,-497
2019,5,7,2,1661,1605,1084,-521
2019,5,7,3,1692,1665,1110,-555
2019,5,7,4,1646,1606,1182,-424
2019,5,7,5,1527,1478,1218,-260
2019,5,7,6,1408,1360,1199,-161
2019,5,7,7,1329,1284,1222,-62
2019,5,7,8,1266,1241,965,-276
2019,5,7,9,1241,1211,846,-365
2019,5,7,10,1240,1197,858,-339
2019,5,7,11,1255,1213,759,-454
2019,5,7,12,1306,1273,834,-439
2019,5,7,13,1388,1364,865,-499
2019,5,7,14,1443,1405,905,-500
2019,5,7,15,1462,1427,884,-543
2019,5,7,16,1478,1449,905,-544
2019,5,7,17,1488,1471,959,-512
2019,5,7,18,1498,1465,976,-489
2019,5,7,19,1504,1449,981,-468
2019,5,7,20,1519,1450,1078,-372
2019,5,7,21,1538,1458,1233,-225
2019,5,7,22,1560,1463,1262,-201
2019,5,7,23,1581,1484,1279,-205
2019,5,8,0,1579,1518,1324,-194
2019,5,8,1,1583,1507,1277,-230
2019,5,8,2,1590,1489,1281,-208
2019,5,8,3,1638,1560,1347,-213
2019,5,8,4,1603,1508,1347,-161
2019,5,8,5,1499,1413,1287,-126
2019,5,8,6,1393,1320,911,-409
2019,5,8,7,1321,1270,972,-298
2019,5,8,8,1269,1237,1093,-144
2019,5,8,9,1249,1209,1142,-67
2019,5,8,10,1237,1203,1152,-51
2019,5,8,11,1250,1229,1149,-80
2019,5,8,12,1311,1301,1129,-172
2019,5,8,13,1401,1374,1084,-290
2019,5,8,14,1456,1393,1132,-261
2019,5,8,15,1461,1395,1263,-132
2019,5,8,16,1459,1397,1218,-179
2019,5,8,17,1426,1407,1135,-272
2019,5,8,18,1423,1397,1114,-283
2019,5,8,19,1439,1423,1094,-329
2019,5,8,20,1455,1453,1040,-413
2019,5,8,21,1455,1434,1012,-422
2019,5,8,22,1473,1430,1044,-386
2019,5,8,23,1488,1455,1081,-374
2019,5,9,0,1491,1465,1142,-323
2019,5,9,1,1502,1469,1203,-266
2019,5,9,2,1518,1483,1135,-348
2019,5,9,3,1596,1573,988,-585
2019,5,9,4,1575,1530,949,-581
2019,5,9,5,1476,1431,890,-541
2019,5,9,6,1376,1333,852,-481
2019,5,9,7,1306,1279,873,-406
2019,5,9,8,1288,1253,929,-324
2019,5,9,9,1266,1240,932,-308
2019,5,9,10,1256,1236,969,-267
2019,5,9,11,1273,1262,989,-273
2019,5,9,12,1334,1326,1005,-321
2019,5,9,13,1430,1414,1056,-358
2019,5,9,14,1483,1447,1133,-314
2019,5,9,15,1497,1417,1156,-261
2019,5,9,16,1481,1415,1148,-267
2019,5,9,17,1471,1424,1052,-372
2019,5,9,18,1457,1432,1029,-403
2019,5,9,19,1439,1424,1060,-364
2019,5,9,20,1443,1422,1012,-410
2019,5,9,21,1435,1428,975,-453
2019,5,9,22,1409,1438,976,-462
2019,5,9,23,1428,1459,1100,-359
2019,5,10,0,1450,1470,1165,-305
2019,5,10,1,1455,1485,1190,-295
2019,5,10,2,1465,1508,1227,-281
2019,5,10,3,1573,1597,1250,-347
2019,5,10,4,1563,1549,1256,-293
2019,5,10,5,1480,1448,1188,-260
2019,5,10,6,1384,1348,1201,-147
2019,5,10,7,1322,1290,1154,-136
2019,5,10,8,1293,1259,1086,-173
2019,5,10,9,1274,1234,1012,-222
2019,5,10,10,1268,1236,1021,-215
2019,5,10,11,1284,1249,981,-268
2019,5,10,12,1349,1317,1052,-265
2019,5,10,13,1438,1426,1117,-309
2019,5,10,14,1494,1479,1076,-403
2019,5,10,15,1502,1528,1039,-489
2019,5,10,16,1502,1563,1065,-498
2019,5,10,17,1494,1562,1004,-558
2019,5,10,18,1449,1531,943,-588
2019,5,10,19,1436,1493,861,-632
2019,5,10,20,1452,1488,815,-673
2019,5,10,21,1440,1474,765,-709
2019,5,10,22,1423,1463,715,-748
2019,5,10,23,1447,1459,684,-775
2019,5,11,0,1481,1471,682,-789
2019,5,11,1,1478,1472,667,-805
2019,5,11,2,1508,1499,649,-850
2019,5,11,3,1587,1581,683,-898
2019,5,11,4,1585,1549,688,-861
2019,5,11,5,1514,1463,697,-766
2019,5,11,6,1432,1381,687,-694
2019,5,11,7,1366,1321,680,-641
2019,5,11,8,1336,1279,668,-611
2019,5,11,9,1312,1256,648,-608
2019,5,11,10,1305,1237,607,-630
2019,5,11,11,1305,1252,387,-865
2019,5,11,12,1336,1283,360,-923
2019,5,11,13,1382,1309,398,-911
2019,5,11,14,1404,1341,411,-930
2019,5,11,15,1384,1365,497,-868
2019,5,11,16,1381,1383,576,-807
2019,5,11,17,1396,1359,702,-657
2019,5,11,18,1389,1333,857,-476
2019,5,11,19,1372,1321,779,-542
2019,5,11,20,1358,1329,774,-555
2019,5,11,21,1357,1343,775,-568
2019,5,11,22,1348,1340,855,-485
2019,5,11,23,1371,1346,843,-503
2019,5,12,0,1393,1381,717,-664
2019,5,12,1,1431,1394,657,-737
2019,5,12,2,1477,1431,673,-758
2019,5,12,3,1548,1505,635,-870
2019,5,12,4,1534,1487,668,-819
2019,5,12,5,1467,1406,605,-801
2019,5,12,6,1386,1319,614,-705
2019,5,12,7,1327,1262,613,-649
2019,5,12,8,1285,1222,638,-584
2019,5,12,9,1259,1208,638,-570
2019,5,12,10,1246,1204,586,-618
2019,5,12,11,1251,1213,612,-601
2019,5,12,12,1271,1236,634,-602
2019,5,12,13,1305,1243,646,-597
2019,5,12,14,1320,1258,659,-599
2019,5,12,15,1344,1278,724,-554
2019,5,12,16,1356,1285,742,-543
2019,5,12,17,1352,1272,764,-508
2019,5,12,18,1350,1275,748,-527
2019,5,12,19,1353,1316,730,-586
2019,5,12,20,1354,1325,659,-666
2019,5,12,21,1356,1294,652,-642
2019,5,12,22,1369,1301,683,-618
2019,5,12,23,1389,1343,719,-624
2019,5,13,0,1421,1391,762,-629
2019,5,13,1,1447,1404,708,-696
2019,5,13,2,1488,1431,648,-783
2019,5,13,3,1554,1507,681,-826
2019,5,13,4,1548,1489,668,-821
2019,5,13,5,1466,1405,500,-905
2019,5,13,6,1371,1296,309,-987
2019,5,13,7,1303,1243,304,-939
2019,5,13,8,1264,1212,381,-831
2019,5,13,9,1238,1202,419,-783
2019,5,13,10,1231,1194,420,-774
2019,5,13,11,1241,1223,440,-783
2019,5,13,12,1307,1285,420,-865
2019,5,13,13,1406,1362,400,-962
2019,5,13,14,1457,1407,454,-953
2019,5,13,15,1452,1402,462,-940
2019,5,13,16,1442,1408,448,-960
2019,5,13,17,1449,1418,481,-937
2019,5,13,18,1450,1432,500,-932
2019,5,13,19,1450,1450,528,-922
2019,5,13,20,1461,1467,615,-852
2019,5,13,21,1462,1498,727,-771
2019,5,13,22,1478,1521,785,-736
2019,5,13,23,1475,1552,861,-691
2019,5,14,0,1489,1571,783,-788
2019,5,14,1,1502,1585,800,-785
2019,5,14,2,1526,1560,915,-645
2019,5,14,3,1604,1621,1040,-581
2019,5,14,4,1582,1574,1090,-484
2019,5,14,5,1481,1454,1145,-309
2019,5,14,6,1376,1332,1046,-286
2019,5,14,7,1301,1273,1037,-236
2019,5,14,8,1256,1238,1035,-203
2019,5,14,9,1231,1204,1011,-193
2019,5,14,10,1220,1192,1037,-155
2019,5,14,11,1240,1207,951,-256
2019,5,14,12,1300,1270,888,-382
2019,5,14,13,1386,1338,903,-435
2019,5,14,14,1432,1374,872,-502
2019,5,14,15,1448,1377,915,-462
2019,5,14,16,1460,1402,940,-462
2019,5,14,17,1477,1429,960,-469
2019,5,14,18,1490,1457,970,-487
2019,5,14,19,1512,1494,991,-503
2019,5,14,20,1543,1532,968,-564
2019,5,14,21,1568,1584,1019,-565
2019,5,14,22,1602,1636,1123,-513
2019,5,14,23,1629,1644,1276,-368
2019,5,15,0,1650,1664,1070,-594
2019,5,15,1,1631,1654,1169,-485
2019,5,15,2,1626,1641,1257,-384
2019,5,15,3,1673,1677,1170,-507
2019,5,15,4,1638,1635,1075,-560
2019,5,15,5,1524,1506,965,-541
2019,5,15,6,1417,1388,903,-485
2019,5,15,7,1334,1307,829,-478
2019,5,15,8,1298,1252,816,-436
2019,5,15,9,1266,1230,821,-409
2019,5,15,10,1249,1212,856,-356
2019,5,15,11,1259,1229,869,-360
2019,5,15,12,1310,1271,886,-385
2019,5,15,13,1387,1346,941,-405
2019,5,15,14,1443,1385,993,-392
2019,5,15,15,1471,1403,930,-473
2019,5,15,16,1498,1431,1045,-386
2019,5,15,17,1535,1467,1109,-358
2019,5,15,18,1571,1511,1157,-354
2019,5,15,19,1603,1533,1198,-335
2019,5,15,20,1646,1589,1225,-364
2019,5,15,21,1691,1632,1259,-373
2019,5,15,22,1729,1677,1336,-341
2019,5,15,23,1767,1722,1311,-411
2019,5,16,0,1773,1749,1321,-428
2019,5,16,1,1753,1709,1289,-420
2019,5,16,2,1742,1680,1210,-470
2019,5,16,3,1758,1646,1241,-405
2019,5,16,4,1717,1683,1314,-369
2019,5,16,5,1597,1547,1252,-295
2019,5,16,6,1456,1417,1190,-227
2019,5,16,7,1372,1337,1118,-219
2019,5,16,8,1330,1298,970,-328
2019,5,16,9,1305,1265,753,-512
2019,5,16,10,1275,1249,821,-428
2019,5,16,11,1278,1257,805,-452
2019,5,16,12,1325,1317,877,-440
2019,5,16,13,1399,1365,969,-396
2019,5,16,14,1453,1405,1080,-325
2019,5,16,15,1497,1437,1181,-256
2019,5,16,16,1537,1474,1201,-273
2019,5,16,17,1574,1526,1346,-180
2019,5,16,18,1623,1554,1444,-110
2019,5,16,19,1657,1592,1464,-128
2019,5,16,20,1695,1623,1538,-85
2019,5,16,21,1740,1640,1494,-146
2019,5,16,22,1791,1655,1562,-93
2019,5,16,23,1809,1674,1490,-184
2019,5,17,0,1823,1685,1380,-305
2019,5,17,1,1780,1689,1406,-283
2019,5,17,2,1764,1673,1308,-365
2019,5,17,3,1772,1732,1369,-363
2019,5,17,4,1730,1675,1340,-335
2019,5,17,5,1606,1567,1264,-303
2019,5,17,6,1467,1423,1219,-204
2019,5,17,7,1374,1350,1191,-159
2019,5,17,8,1311,1305,1169,-136
2019,5,17,9,1276,1276,1211,-65
2019,5,17,10,1263,1286,1220,-66
2019,5,17,11,1272,1290,1217,-73
2019,5,17,12,1305,1337,1227,-110
2019,5,17,13,1390,1393,1233,-160
2019,5,17,14,1440,1437,1161,-276
2019,5,17,15,1469,1471,1252,-219
2019,5,17,16,1480,1474,1393,-81
2019,5,17,17,1499,1478,1475,-3
2019,5,17,18,1504,1493,1661,168
2019,5,17,19,1509,1499,1696,197
2019,5,17,20,1519,1525,1713,188
2019,5,17,21,1530,1531,1677,146
2019,5,17,22,1533,1545,1643,98
2019,5,17,23,1533,1562,1640,78
2019,5,18,0,1552,1567,1632,65
2019,5,18,1,1560,1553,1623,70
2019,5,18,2,1563,1534,1607,73
2019,5,18,3,1602,1597,1580,-17
2019,5,18,4,1588,1575,1600,25
2019,5,18,5,1498,1489,1550,61
2019,5,18,6,1400,1387,1482,95
2019,5,18,7,1329,1323,1466,143
2019,5,18,8,1279,1264,1377,113
2019,5,18,9,1259,1236,1371,135
2019,5,18,10,1245,1222,1339,117
2019,5,18,11,1246,1222,1327,105
2019,5,18,12,1268,1259,1299,40
2019,5,18,13,1294,1269,1296,27
2019,5,18,14,1319,1291,1391,100
2019,5,18,15,1343,1318,1431,113
2019,5,18,16,1363,1339,1575,236
2019,5,18,17,1363,1350,1601,251
2019,5,18,18,1358,1357,1635,278
2019,5,18,19,1361,1354,1651,297
2019,5,18,20,1360,1360,1668,308
2019,5,18,21,1363,1361,1692,331
2019,5,18,22,1376,1382,1812,430
2019,5,18,23,1411,1410,1769,359
2019,5,19,0,1454,1454,1761,307
2019,5,19,1,1478,1474,1732,258
2019,5,19,2,1505,1474,1644,170
2019,5,19,3,1553,1519,1545,26
2019,5,19,4,1535,1498,1483,-15
2019,5,19,5,1461,1420,1465,45
2019,5,19,6,1370,1342,1324,-18
2019,5,19,7,1305,1277,1173,-104
2019,5,19,8,1268,1256,1036,-220
2019,5,19,9,1246,1239,1002,-237
2019,5,19,10,1233,1225,1016,-209
2019,5,19,11,1230,1223,1004,-219
2019,5,19,12,1248,1232,1040,-192
2019,5,19,13,1271,1234,1054,-180
2019,5,19,14,1284,1275,1126,-149
2019,5,19,15,1309,1307,1196,-111
2019,5,19,16,1330,1341,1245,-96
2019,5,19,17,1341,1362,1281,-81
2019,5,19,18,1343,1353,1330,-23
2019,5,19,19,1350,1343,1387,44
2019,5,19,20,1360,1351,1429,78
2019,5,19,21,1372,1378,1542,164
2019,5,19,22,1393,1390,1566,176
2019,5,19,23,1430,1415,1561,146
2019,5,20,0,1472,1445,1482,37
2019,5,20,1,1492,1468,1526,58
2019,5,20,2,1518,1502,1551,49
2019,5,20,3,1580,1567,1648,81
2019,5,20,4,1567,1531,1670,139
2019,5,20,5,1484,1436,1550,114
2019,5,20,6,1381,1346,1479,133
2019,5,20,7,1305,1276,1340,64
2019,5,20,8,1270,1240,1249,9
2019,5,20,9,1244,1222,1215,-7
2019,5,20,10,1236,1222,1263,41
2019,5,20,11,1243,1233,1319,86
2019,5,20,12,1294,1289,1325,36
2019,5,20,13,1384,1366,1316,-50
2019,5,20,14,1439,1431,1298,-133
2019,5,20,15,1453,1458,1463,5
2019,5,20,16,1461,1467,1507,40
2019,5,20,17,1469,1483,1613,130
2019,5,20,18,1472,1497,1659,162
2019,5,20,19,1474,1507,1627,120
2019,5,20,20,1478,1537,1585,48
2019,5,20,21,1470,1466,1536,70
2019,5,20,22,1466,1570,1585,15
2019,5,20,23,1475,1571,1681,110
2019,5,21,0,1494,1574,1568,-6
2019,5,21,1,1506,1568,1436,-132
2019,5,21,2,1520,1552,1464,-88
2019,5,21,3,1582,1595,1299,-296
2019,5,21,4,1571,1555,1269,-286
2019,5,21,5,1486,1455,1386,-69
2019,5,21,6,1382,1357,1412,55
2019,5,21,7,1316,1221,1318,97
2019,5,21,8,1302,1280,1302,22
2019,5,21,9,1288,1277,1296,19
2019,5,21,10,1285,1280,1279,-1
2019,5,21,11,1299,1301,1291,-10
2019,5,21,12,1352,1377,1338,-39
2019,5,21,13,1441,1455,1389,-66
2019,5,21,14,1498,1500,1389,-111
2019,5,21,15,1497,1511,1408,-103
2019,5,21,16,1487,1522,1442,-80
2019,5,21,17,1466,1498,1423,-75
2019,5,21,18,1443,1486,1416,-70
2019,5,21,19,1436,1480,1436,-44
2019,5,21,20,1435,1472,1468,-4
2019,5,21,21,1440,1467,1476,9
2019,5,21,22,1448,1457,1587,130
2019,5,21,23,1450,1451,1526,75
2019,5,22,0,1476,1477,1590,113
2019,5,22,1,1474,1481,1545,64
2019,5,22,2,1499,1499,1471,-28
2019,5,22,3,1577,1570,1410,-160
2019,5,22,4,1568,1537,1390,-147
2019,5,22,5,1486,1437,1287,-150
2019,5,22,6,1382,1341,1216,-125
2019,5,22,7,1339,1285,1159,-126
2019,5,22,8,1281,1257,1139,-118
2019,5,22,9,1261,1243,1108,-135
2019,5,22,10,1257,1238,1000,-238
2019,5,22,11,1277,1261,973,-288
2019,5,22,12,1340,1340,1014,-326
2019,5,22,13,1431,1399,1088,-311
2019,5,22,14,1480,1439,1081,-358
2019,5,22,15,1480,1430,1075,-355
2019,5,22,16,1469,1423,1088,-335
2019,5,22,17,1460,1401,1259,-142
2019,5,22,18,1451,1396,1410,14
2019,5,22,19,1441,1398,1454,56
2019,5,22,20,1457,1416,1474,58
2019,5,22,21,1453,1431,1509,78
2019,5,22,22,1478,1470,1590,120
2019,5,22,23,1503,1501,1660,159
2019,5,23,0,1530,1529,1704,175
2019,5,23,1,1515,1537,1669,132
2019,5,23,2,1530,1518,1604,86
2019,5,23,3,1603,1598,1596,-2
2019,5,23,4,1586,1560,1582,22
2019,5,23,5,1500,1445,1334,-111
2019,5,23,6,1394,1348,1191,-157
2019,5,23,7,1327,1269,1144,-125
2019,5,23,8,1269,1234,1010,-224
2019,5,23,9,1247,1214,945,-269
2019,5,23,10,1239,1222,942,-280
2019,5,23,11,1253,1233,893,-340
2019,5,23,12,1314,1293,944,-349
2019,5,23,13,1405,1351,962,-389
2019,5,23,14,1446,1405,1027,-378
2019,5,23,15,1455,1453,1159,-294
2019,5,23,16,1466,1458,1243,-215
2019,5,23,17,1460,1462,1359,-103
2019,5,23,18,1457,1457,1569,112
2019,5,23,19,1451,1463,1598,135
2019,5,23,20,1450,1475,1658,183
2019,5,23,21,1447,1493,1774,281
2019,5,23,22,1457,1488,1748,260
2019,5,23,23,1471,1490,1667,177
2019,5,24,0,1496,1495,1768,273
2019,5,24,1,1498,1499,1704,205
2019,5,24,2,1519,1501,1567,66
2019,5,24,3,1600,1573,1477,-96
2019,5,24,4,1581,1563,1384,-179
2019,5,24,5,1489,1453,1333,-120
2019,5,24,6,1384,1353,1382,29
2019,5,24,7,1320,1291,1341,50
2019,5,24,8,1274,1264,1336,72
2019,5,24,9,1257,1255,1160,-95
2019,5,24,10,1247,1250,1085,-165
2019,5,24,11,1279,1267,1056,-211
2019,5,24,12,1332,1317,1120,-197
2019,5,24,13,1420,1369,1232,-137
2019,5,24,14,1461,1397,1406,9
2019,5,24,15,1466,1399,1473,74
2019,5,24,16,1463,1390,1508,118
2019,5,24,17,1462,1395,1567,172
2019,5,24,18,1463,1393,1500,107
2019,5,24,19,1463,1398,1534,136
2019,5,24,20,1477,1414,1634,220
2019,5,24,21,1488,1439,1735,296
2019,5,24,22,1495,1478,1805,327
2019,5,24,23,1529,1503,1851,348
2019,5,25,0,1528,1534,1865,331
2019,5,25,1,1546,1523,1854,331
2019,5,25,2,1542,1534,1742,208
2019,5,25,3,1608,1596,1673,77
2019,5,25,4,1593,1579,1713,134
2019,5,25,5,1491,1484,1630,146
2019,5,25,6,1402,1381,1539,158
2019,5,25,7,1330,1311,1541,230
2019,5,25,8,1282,1261,1534,273
2019,5,25,9,1260,1232,1483,251
2019,5,25,10,1248,1209,1377,168
2019,5,25,11,1248,1212,1367,155
2019,5,25,12,1270,1233,1313,80
2019,5,25,13,1280,1237,1270,33
2019,5,25,14,1297,1240,1309,69
2019,5,25,15,1333,1264,1386,122
2019,5,25,16,1368,1308,1686,378
2019,5,25,17,1384,1343,1736,393
2019,5,25,18,1403,1359,1744,385
2019,5,25,19,1422,1378,1816,438
2019,5,25,20,1450,1396,1819,423
2019,5,25,21,1471,1429,1895,466
2019,5,25,22,1510,1483,1997,514
2019,5,25,23,1549,1532,2036,504
2019,5,26,0,1583,1575,1999,424
2019,5,26,1,1578,1606,1965,359
2019,5,26,2,1577,1595,1938,343
2019,5,26,3,1618,1613,1899,286
2019,5,26,4,1598,1577,1943,366
2019,5,26,5,1523,1468,1804,336
2019,5,26,6,1423,1363,1645,282
2019,5,26,7,1351,1303,1456,153
2019,5,26,8,1288,1261,1498,237
2019,5,26,9,1259,1218,1521,303
2019,5,26,10,1240,1204,1398,194
2019,5,26,11,1234,1199,1344,145
2019,5,26,12,1248,1205,1332,127
2019,5,26,13,1251,1195,1314,119
2019,5,26,14,1267,1230,1384,154
2019,5,26,15,1314,1264,1415,151
2019,5,26,16,1356,1305,1522,217
2019,5,26,17,1388,1331,1611,280
2019,5,26,18,1415,1369,1707,338
2019,5,26,19,1449,1403,1817,414
2019,5,26,20,1485,1444,1913,469
2019,5,26,21,1510,1479,1919,440
2019,5,26,22,1536,1506,1824,318
2019,5,26,23,1550,1455,1628,173
2019,5,27,0,1561,1458,1673,215
2019,5,27,1,1559,1467,1554,87
2019,5,27,2,1555,1458,1606,148
2019,5,27,3,1595,1509,1565,56
2019,5,27,4,1580,1483,1681,198
2019,5,27,5,1487,1407,1599,192
2019,5,27,6,1389,1324,1597,273
2019,5,27,7,1325,1274,1651,377
2019,5,27,8,1286,1233,1710,477
2019,5,27,9,1246,1210,1693,483
2019,5,27,10,1229,1198,1701,503
2019,5,27,11,1218,1204,1619,415
2019,5,27,12,1232,1218,1554,336
2019,5,27,13,1250,1221,1534,313
2019,5,27,14,1266,1264,1427,163
2019,5,27,15,1297,1258,1464,206
2019,5,27,16,1331,1296,1567,271
2019,5,27,17,1355,1315,1709,394
2019,5,27,18,1374,1334,1782,448
2019,5,27,19,1395,1355,1857,502
2019,5,27,20,1425,1393,1925,532
2019,5,27,21,1446,1425,1940,515
2019,5,27,22,1479,1456,1946,490
2019,5,27,23,1513,1481,1970,489
2019,5,28,0,1545,1539,1990,451
2019,5,28,1,1555,1549,1956,407
2019,5,28,2,1565,1541,1883,342
2019,5,28,3,1597,1596,1930,334
2019,5,28,4,1574,1575,1899,324
2019,5,28,5,1472,1480,1852,372
2019,5,28,6,1382,1361,1739,378
2019,5,28,7,1314,1279,1663,384
2019,5,28,8,1252,1249,1583,334
2019,5,28,9,1236,1229,1570,341
2019,5,28,10,1232,1222,1527,305
2019,5,28,11,1241,1233,1487,254
2019,5,28,12,1304,1298,1431,133
2019,5,28,13,1389,1337,1250,-87
2019,5,28,14,1439,1386,1391,5
2019,5,28,15,1452,1397,1553,156
2019,5,28,16,1467,1390,1541,151
2019,5,28,17,1465,1265,1421,156
2019,5,28,18,1453,1434,1589,155
2019,5,28,19,1456,1451,1619,168
2019,5,28,20,1475,1460,1687,227
2019,5,28,21,1479,1492,1647,155
2019,5,28,22,1498,1521,1627,106
2019,5,28,23,1526,1547,1606,59
2019,5,29,0,1545,1559,1543,-16
2019,5,29,1,1544,1559,1476,-83
2019,5,29,2,1544,1557,1334,-223
2019,5,29,3,1606,1610,1273,-337
2019,5,29,4,1590,1592,1229,-363
2019,5,29,5,1490,1483,1134,-349
2019,5,29,6,1391,1370,1039,-331
2019,5,29,7,1325,1304,983,-321
2019,5,29,8,1278,1260,1073,-187
2019,5,29,9,1260,1247,1153,-94
2019,5,29,10,1250,1228,1196,-32
2019,5,29,11,1268,1250,1128,-122
2019,5,29,12,1326,1301,1193,-108
2019,5,29,13,1404,1341,1262,-79
2019,5,29,14,1454,1403,1317,-86
2019,5,29,15,1463,1405,996,-409
2019,5,29,16,1470,1385,1022,-363
2019,5,29,17,1465,1390,1016,-374
2019,5,29,18,1464,1403,979,-424
2019,5,29,19,1474,1431,935,-496
2019,5,29,20,1494,1458,905,-553
2019,5,29,21,1504,1485,941,-544
2019,5,29,22,1526,1529,1011,-518
2019,5,29,23,1541,1556,851,-705
2019,5,30,0,1550,1566,875,-691
2019,5,30,1,1556,1549,888,-661
2019,5,30,2,1546,1535,988,-547
2019,5,30,3,1617,1591,1164,-427
2019,5,30,4,1610,1477,1268,-209
2019,5,30,5,1505,1455,1367,-88
2019,5,30,6,1400,1382,1333,-49
2019,5,30,7,1327,1284,1276,-8
2019,5,30,8,1293,1240,1255,15
2019,5,30,9,1274,1228,1273,45
2019,5,30,10,1257,1224,1257,33
2019,5,30,11,1266,1240,1218,-22
2019,5,30,12,1317,1290,1256,-34
2019,5,30,13,1401,1336,1238,-98
2019,5,30,14,1454,1391,1392,1
2019,5,30,15,1466,1413,1503,90
2019,5,30,16,1468,1433,1539,106
2019,5,30,17,1474,1446,1566,120
2019,5,30,18,1495,1479,1506,27
2019,5,30,19,1522,1516,1469,-47
2019,5,30,20,1538,1541,1394,-147
2019,5,30,21,1552,1595,1538,-57
2019,5,30,22,1581,1615,1556,-59
2019,5,30,23,1600,1574,1590,16
2019,5,31,0,1610,1559,1827,268
2019,5,31,1,1600,1550,1838,288
2019,5,31,2,1592,1548,1690,142
2019,5,31,3,1638,1600,1743,143
2019,5,31,4,1626,1585,1852,267
2019,5,31,5,1529,1491,1793,302
2019,5,31,6,1421,1373,1664,291
2019,5,31,7,1345,1295,1564,269
2019,5,31,8,1294,1256,1490,234
2019,5,31,9,1264,1234,1395,161
2019,5,31,10,1241,1232,1307,75
2019,5,31,11,1253,1238,1274,36
2019,5,31,12,1297,1290,1275,-15
2019,5,31,13,1353,1329,1294,-35
2019,5,31,14,1405,1373,1315,-58
2019,5,31,15,1434,1387,1385,-2
2019,5,31,16,1448,1415,1404,-11
2019,5,31,17,1464,1449,1455,6
2019,5,31,18,1479,1477,1511,34
2019,5,31,19,1503,1502,1519,17
2019,5,31,20,1539,1556,1580,24
2019,5,31,21,1567,1591,1687,96
2019,5,31,22,1597,1633,1632,-1
2019,5,31,23,1629,1668,1642,-26
2019,6,1,0,1647,1686,1621,-65
2019,6,1,1,1642,1690,1642,-48
2019,6,1,2,1623,1667,1626,-41
2019,6,1,3,1654,1701,1665,-36
2019,6,1,4,1630,1675,1722,47
2019,6,1,5,1546,1585,1771,186
2019,6,1,6,1437,1458,1735,277
2019,6,1,7,1354,1375,1626,251
2019,6,1,8,1308,1306,1461,155
2019,6,1,9,1285,1260,1313,53
2019,6,1,10,1269,1234,1255,21
2019,6,1,11,1265,1233,1242,9
2019,6,1,12,1279,1248,1235,-13
2019,6,1,13,1298,1251,1211,-40
2019,6,1,14,1332,1296,1238,-58
2019,6,1,15,1384,1353,1254,-99
2019,6,1,16,1420,1409,1284,-125
2019,6,1,17,1457,1470,1357,-113
2019,6,1,18,1486,1535,1428,-107
2019,6,1,19,1514,1615,1625,10
2019,6,1,20,1541,1578,1567,-11
2019,6,1,21,1567,1614,1613,-1
2019,6,1,22,1598,1602,1730,128
2019,6,1,23,1618,1575,1792,217
2019,6,2,0,1644,1595,1782,187
2019,6,2,1,1638,1608,1713,105
2019,6,2,2,1632,1596,1751,155
2019,6,2,3,1651,1606,1724,118
2019,6,2,4,1635,1580,1752,172
2019,6,2,5,1556,1464,1630,166
2019,6,2,6,1442,1388,1523,135
2019,6,2,7,1372,1307,1468,161
2019,6,2,8,1330,1252,1336,84
2019,6,2,9,1290,1219,1295,76
2019,6,2,10,1265,1201,1281,80
2019,6,2,11,1269,1196,1389,193
2019,6,2,12,1279,1205,1398,193
2019,6,2,13,1286,1197,1364,167
2019,6,2,14,1312,1226,1407,181
2019,6,2,15,1366,1285,1366,81
2019,6,2,16,1419,1327,1326,-1
2019,6,2,17,1456,1370,1264,-106
2019,6,2,18,1490,1444,1359,-85
2019,6,2,19,1540,1491,1380,-111
2019,6,2,20,1603,1538,1514,-24
2019,6,2,21,1629,1614,1727,113
2019,6,2,22,1678,1642,1773,131
2019,6,2,23,1712,1623,1744,121
2019,6,3,0,1742,1640,1707,67
2019,6,3,1,1752,1636,1706,70
2019,6,3,2,1726,1636,1776,140
2019,6,3,3,1736,1654,1707,53
2019,6,3,4,1706,1620,1685,65
2019,6,3,5,1609,1513,1715,202
2019,6,3,6,1482,1412,1648,236
2019,6,3,7,1385,1341,1580,239
2019,6,3,8,1327,1276,1469,193
2019,6,3,9,1313,1247,1508,261
2019,6,3,10,1294,1239,1428,189
2019,6,3,11,1297,1252,1357,105
2019,6,3,12,1342,1304,1364,60
2019,6,3,13,1414,1365,1450,85
2019,6,3,14,1474,1402,1397,-5
2019,6,3,15,1515,1456,1451,-5
2019,6,3,16,1551,1505,1510,5
2019,6,3,17,1595,1550,1635,85
2019,6,3,18,1642,1612,1639,27
2019,6,3,19,1705,1665,1635,-30
2019,6,3,20,1762,1730,1684,-46
2019,6,3,21,1820,1803,1924,121
2019,6,3,22,1858,1794,1989,195
2019,6,3,23,1872,1734,1989,255
2019,6,4,0,1856,1703,1977,274
2019,6,4,1,1823,1686,1761,75
2019,6,4,2,1772,1666,1706,40
2019,6,4,3,1774,1697,1908,211
2019,6,4,4,1711,1666,1899,233
2019,6,4,5,1594,1541,1756,215
2019,6,4,6,1469,1424,1772,348
2019,6,4,7,1380,1351,1728,377
2019,6,4,8,1331,1295,1736,441
2019,6,4,9,1304,1262,1698,436
2019,6,4,10,1284,1237,1574,337
2019,6,4,11,1292,1247,1482,235
2019,6,4,12,1338,1299,1460,161
2019,6,4,13,1418,1309,1468,159
2019,6,4,14,1470,1382,1515,133
2019,6,4,15,1512,1435,1616,181
2019,6,4,16,1547,1478,1668,190
2019,6,4,17,1590,1534,1673,139
2019,6,4,18,1644,1594,1569,-25
2019,6,4,19,1700,1652,1517,-135
2019,6,4,20,1750,1732,1712,-20
2019,6,4,21,1805,1756,1724,-32
2019,6,4,22,1833,1737,1642,-95
2019,6,4,23,1825,1668,1664,-4
2019,6,5,0,1812,1593,1765,172
2019,6,5,1,1783,1560,1709,149
2019,6,5,2,1773,1551,1747,196
2019,6,5,3,1771,1604,1697,93
2019,6,5,4,1717,1578,1760,182
2019,6,5,5,1606,1509,1580,71
2019,6,5,6,1486,1366,1467,101
2019,6,5,7,1400,1290,1459,169
2019,6,5,8,1331,1245,1380,135
2019,6,5,9,1304,1198,1370,172
2019,6,5,10,1286,1200,1313,113
2019,6,5,11,1294,1231,1294,63
2019,6,5,12,1345,1282,1308,26
2019,6,5,13,1417,1328,1322,-6
2019,6,5,14,1476,1383,1350,-33
2019,6,5,15,1501,1417,1327,-90
2019,6,5,16,1526,1458,1379,-79
2019,6,5,17,1546,1481,1517,36
2019,6,5,18,1567,1495,1708,213
2019,6,5,19,1585,1523,1694,171
2019,6,5,20,1608,1559,1614,55
2019,6,5,21,1639,1602,1693,91
2019,6,5,22,1652,1627,1678,51
2019,6,5,23,1648,1630,1725,95
2019,6,6,0,1645,1638,1664,26
2019,6,6,1,1641,1619,1624,5
2019,6,6,2,1647,1595,1553,-42
2019,6,6,3,1676,1629,1520,-109
2019,6,6,4,1645,1612,1519,-93
2019,6,6,5,1547,1506,1432,-74
2019,6,6,6,1437,1386,1360,-26
2019,6,6,7,1365,1311,1331,20
2019,6,6,8,1318,1260,1297,37
2019,6,6,9,1292,1233,1282,49
2019,6,6,10,1274,1219,1256,37
2019,6,6,11,1274,1235,1253,18
2019,6,6,12,1313,1280,1328,48
2019,6,6,13,1374,1324,1371,47
2019,6,6,14,1433,1380,1434,54
2019,6,6,15,1475,1405,1470,65
2019,6,6,16,1509,1459,1524,65
2019,6,6,17,1547,1518,1547,29
2019,6,6,18,1584,1564,1620,56
2019,6,6,19,1636,1619,1755,136
2019,6,6,20,1688,1696,1864,168
2019,6,6,21,1740,1772,1879,107
2019,6,6,22,1790,1827,1887,60
2019,6,6,23,1805,1840,1830,-10
2019,6,7,0,1821,1858,1776,-82
2019,6,7,1,1780,1863,1725,-138
2019,6,7,2,1759,1830,1666,-164
2019,6,7,3,1775,1830,1695,-135
2019,6,7,4,1747,1779,1809,30
2019,6,7,5,1651,1649,1784,135
2019,6,7,6,1518,1489,1637,148
2019,6,7,7,1418,1401,1481,80
2019,6,7,8,1361,1349,1313,-36
2019,6,7,9,1326,1301,1335,34
2019,6,7,10,1303,1277,1322,45
2019,6,7,11,1302,1285,1291,6
2019,6,7,12,1342,1319,1371,52
2019,6,7,13,1391,1360,1360,0
2019,6,7,14,1460,1447,1417,-30
2019,6,7,15,1500,1515,1451,-64
2019,6,7,16,1559,1572,1514,-58
2019,6,7,17,1625,1644,1569,-75
2019,6,7,18,1678,1699,1522,-177
2019,6,7,19,1743,1762,1442,-320
2019,6,7,20,1818,1826,1616,-210
2019,6,7,21,1874,1874,1679,-195
2019,6,7,22,1930,1942,1741,-201
2019,6,7,23,1941,1965,1796,-169
2019,6,8,0,1929,1956,1798,-158
2019,6,8,1,1902,1916,1653,-263
2019,6,8,2,1860,1862,1695,-167
2019,6,8,3,1863,1871,1876,5
2019,6,8,4,1821,1827,1981,154
2019,6,8,5,1708,1698,1899,201
2019,6,8,6,1570,1559,1935,376
2019,6,8,7,1477,1465,1830,365
2019,6,8,8,1424,1396,1678,282
2019,6,8,9,1374,1334,1518,184
2019,6,8,10,1340,1300,1377,77
2019,6,8,11,1330,1290,1318,28
2019,6,8,12,1340,1294,1325,31
2019,6,8,13,1342,1287,1296,9
2019,6,8,14,1387,1342,1310,-32
2019,6,8,15,1445,1428,1320,-108
2019,6,8,16,1518,1499,1344,-155
2019,6,8,17,1596,1560,1532,-28
2019,6,8,18,1672,1613,1628,15
2019,6,8,19,1744,1677,1678,1
2019,6,8,20,1805,1738,1747,9
2019,6,8,21,1874,1792,1807,15
2019,6,8,22,1929,1860,1821,-39
2019,6,8,23,1927,1918,1841,-77
2019,6,9,0,1951,1956,1781,-175
2019,6,9,1,1922,1959,1686,-273
2019,6,9,2,1903,1917,1623,-294
2019,6,9,3,1863,1860,1611,-249
2019,6,9,4,1812,1793,1715,-78
2019,6,9,5,1720,1655,1707,52
2019,6,9,6,1601,1507,1561,54
2019,6,9,7,1501,1408,1314,-94
2019,6,9,8,1421,1338,1223,-115
2019,6,9,9,1366,1296,1226,-70
2019,6,9,10,1333,1260,1262,2
2019,6,9,11,1324,1258,1265,7
2019,6,9,12,1326,1256,1275,19
2019,6,9,13,1326,1246,1327,81
2019,6,9,14,1356,1285,1465,180
2019,6,9,15,1420,1345,1587,242
2019,6,9,16,1490,1409,1761,352
2019,6,9,17,1557,1484,1781,297
2019,6,9,18,1624,1549,1767,218
2019,6,9,19,1710,1618,1717,99
2019,6,9,20,1790,1693,1771,78
2019,6,9,21,1845,1773,1799,26
2019,6,9,22,1888,1844,1857,13
2019,6,9,23,1895,1907,1872,-35
2019,6,10,0,1912,1951,1974,23
2019,6,10,1,1889,1922,2032,110
2019,6,10,2,1858,1858,2063,205
2019,6,10,3,1829,1805,1998,193
2019,6,10,4,1782,1740,2029,289
2019,6,10,5,1668,1601,1987,386
2019,6,10,6,1543,1455,1825,370
2019,6,10,7,1453,1361,1664,303
2019,6,10,8,1354,1300,1649,349
2019,6,10,9,1317,1268,1635,367
2019,6,10,10,1302,1254,1597,343
2019,6,10,11,1312,1254,1581,327
2019,6,10,12,1353,1295,1641,346
2019,6,10,13,1427,1332,1576,244
2019,6,10,14,1482,1387,1588,201
2019,6,10,15,1523,1428,1690,262
2019,6,10,16,1547,1474,1713,239
2019,6,10,17,1568,1506,1627,121
2019,6,10,18,1593,1522,1548,26
2019,6,10,19,1621,1540,1553,13
2019,6,10,20,1653,1567,1581,14
2019,6,10,21,1675,1610,1600,-10
2019,6,10,22,1697,1653,1623,-30
2019,6,10,23,1685,1667,1667,0
2019,6,11,0,1684,1650,1609,-41
2019,6,11,1,1674,1627,1508,-119
2019,6,11,2,1677,1604,1458,-146
2019,6,11,3,1704,1641,1573,-68
2019,6,11,4,1678,1612,1751,139
2019,6,11,5,1578,1487,1674,187
2019,6,11,6,1462,1370,1703,333
2019,6,11,7,1381,1309,1583,274
2019,6,11,8,1317,1270,1579,309
2019,6,11,9,1286,1250,1550,300
2019,6,11,10,1269,1238,1533,295
2019,6,11,11,1275,1247,1572,325
2019,6,11,12,1322,1288,1596,308
2019,6,11,13,1389,1321,1558,237
2019,6,11,14,1443,1367,1575,208
2019,6,11,15,1475,1422,1534,112
2019,6,11,16,1510,1466,1588,122
2019,6,11,17,1552,1522,1677,155
2019,6,11,18,1597,1557,1633,76
2019,6,11,19,1656,1624,1821,197
2019,6,11,20,1740,1700,1969,269
2019,6,11,21,1816,1797,2044,247
2019,6,11,22,1881,1874,2109,235
2019,6,11,23,1923,1926,2192,266
2019,6,12,0,1950,1955,2238,283
2019,6,12,1,1920,1947,2185,238
2019,6,12,2,1906,1903,2088,185
2019,6,12,3,1871,1877,1881,4
2019,6,12,4,1822,1804,1760,-44
2019,6,12,5,1706,1636,1948,312
2019,6,12,6,1545,1491,1832,341
2019,6,12,7,1430,1407,1785,378
2019,6,12,8,1375,1377,1821,444
2019,6,12,9,1338,1307,1753,446
2019,6,12,10,1314,1289,1719,430
2019,6,12,11,1313,1292,1721,429
2019,6,12,12,1358,1328,1736,408
2019,6,12,13,1411,1363,1721,358
2019,6,12,14,1475,1419,1796,377
2019,6,12,15,1525,1471,1848,377
2019,6,12,16,1570,1511,1848,337
2019,6,12,17,1612,1553,1879,326
2019,6,12,18,1661,1606,1882,276
2019,6,12,19,1717,1659,1954,295
2019,6,12,20,1780,1725,1931,206
2019,6,12,21,1848,1791,1964,173
2019,6,12,22,1905,1871,1992,121
2019,6,12,23,1919,1927,1954,27
2019,6,13,0,1917,1949,2020,71
2019,6,13,1,1893,1956,2017,61
2019,6,13,2,1859,1886,1994,108
2019,6,13,3,1853,1899,2005,106
2019,6,13,4,1799,1847,1992,145
2019,6,13,5,1670,1688,1891,203
2019,6,13,6,1533,1547,1706,159
2019,6,13,7,1450,1441,1680,239
2019,6,13,8,1405,1363,1570,207
2019,6,13,9,1358,1323,1569,246
2019,6,13,10,1341,1303,1485,182
2019,6,13,11,1339,1339,1555,216
2019,6,13,12,1385,1343,1504,161
2019,6,13,13,1447,1387,1510,123
2019,6,13,14,1513,1456,1606,150
2019,6,13,15,1570,1518,1729,211
2019,6,13,16,1624,1599,1871,272
2019,6,13,17,1705,1668,1996,328
2019,6,13,18,1774,1731,2047,316
2019,6,13,19,1855,1804,2035,231
2019,6,13,20,1943,1890,2065,175
2019,6,13,21,2019,1980,2154,174
2019,6,13,22,2072,2056,2175,119
2019,6,13,23,2101,2079,2397,318
2019,6,14,0,2089,2091,2475,384
2019,6,14,1,2044,2050,2453,403
2019,6,14,2,2006,1975,2334,359
2019,6,14,3,1979,1967,2295,328
2019,6,14,4,1899,1917,2311,394
2019,6,14,5,1764,1759,2189,430
2019,6,14,6,1611,1605,2074,469
2019,6,14,7,1512,1500,1853,353
2019,6,14,8,1448,1417,1825,408
2019,6,14,9,1402,1379,1921,542
2019,6,14,10,1373,1356,1975,619
2019,6,14,11,1367,1356,1958,602
2019,6,14,12,1399,1385,1909,524
2019,6,14,13,1451,1423,1901,478
2019,6,14,14,1507,1495,1943,448
2019,6,14,15,1575,1562,1988,426
2019,6,14,16,1653,1647,2101,454
2019,6,14,17,1729,1724,2199,475
2019,6,14,18,1817,1800,2268,468
2019,6,14,19,1884,1866,2296,430
2019,6,14,20,1982,1922,2289,367
2019,6,14,21,2057,1978,2261,283
2019,6,14,22,2107,2043,2271,228
2019,6,14,23,2124,2085,2306,221
2019,6,15,0,2119,2097,2299,202
2019,6,15,1,2070,2053,2244,191
2019,6,15,2,2014,1988,2114,126
2019,6,15,3,1993,1982,2044,62
2019,6,15,4,1938,1909,2070,161
2019,6,15,5,1816,1761,2078,317
2019,6,15,6,1672,1618,2101,483
2019,6,15,7,1561,1495,1939,444
2019,6,15,8,1474,1425,1863,438
2019,6,15,9,1420,1366,1806,440
2019,6,15,10,1385,1344,1712,368
2019,6,15,11,1365,1316,1597,281
2019,6,15,12,1368,1319,1554,235
2019,6,15,13,1368,1311,1582,271
2019,6,15,14,1409,1351,1545,194
2019,6,15,15,1484,1417,1411,-6
2019,6,15,16,1559,1487,1437,-50
2019,6,15,17,1617,1559,1555,-4
2019,6,15,18,1679,1627,1671,44
2019,6,15,19,1758,1699,1789,90
2019,6,15,20,1830,1795,1902,107
2019,6,15,21,1895,1805,1887,82
2019,6,15,22,1941,1822,1837,15
2019,6,15,23,1937,1836,1962,126
2019,6,16,0,1949,1849,1913,64
2019,6,16,1,1929,1817,1960,143
2019,6,16,2,1886,1758,1858,100
2019,6,16,3,1857,1770,1892,122
2019,6,16,4,1808,1734,1968,234
2019,6,16,5,1707,1627,1842,215
2019,6,16,6,1594,1501,1744,243
2019,6,16,7,1495,1398,1540,142
2019,6,16,8,1412,1337,1507,170
2019,6,16,9,1364,1287,1534,247
2019,6,16,10,1331,1274,1476,202
2019,6,16,11,1323,1254,1466,212
2019,6,16,12,1320,1256,1486,230
2019,6,16,13,1315,1253,1495,242
2019,6,16,14,1346,1296,1474,178
2019,6,16,15,1417,1354,1465,111
2019,6,16,16,1493,1415,1506,91
2019,6,16,17,1561,1482,1562,80
2019,6,16,18,1631,1543,1566,23
2019,6,16,19,1715,1630,1621,-9
2019,6,16,20,1786,1743,1646,-97
2019,6,16,21,1852,1800,1796,-4
2019,6,16,22,1896,1854,1824,-30
2019,6,16,23,1906,1857,1766,-91
2019,6,17,0,1940,1864,1757,-107
2019,6,17,1,1936,1839,1796,-43
2019,6,17,2,1915,1812,1789,-23
2019,6,17,3,1887,1828,1875,47
2019,6,17,4,1832,1789,1901,112
2019,6,17,5,1722,1680,1768,88
2019,6,17,6,1583,1547,1677,130
2019,6,17,7,1478,1453,1591,138
2019,6,17,8,1408,1387,1576,189
2019,6,17,9,1364,1355,1550,195
2019,6,17,10,1339,1330,1551,221
2019,6,17,11,1344,1339,1575,236
2019,6,17,12,1380,1373,1579,206
2019,6,17,13,1446,1420,1593,173
2019,6,17,14,1514,1513,1603,90
2019,6,17,15,1579,1557,1567,10
2019,6,17,16,1646,1646,1611,-35
2019,6,17,17,1714,1715,1722,7
2019,6,17,18,1787,1792,1787,-5
2019,6,17,19,1861,1848,1858,10
2019,6,17,20,1932,1941,1982,41
2019,6,17,21,2002,1993,2130,137
2019,6,17,22,2051,1910,2057,147
2019,6,17,23,2048,1811,2038,227
2019,6,18,0,2050,1773,2182,409
2019,6,18,1,1999,1745,2118,373
2019,6,18,2,1957,1702,2041,339
2019,6,18,3,1946,1739,1890,151
2019,6,18,4,1875,1712,1862,150
2019,6,18,5,1735,1639,1778,139
2019,6,18,6,1599,1460,1572,112
2019,6,18,7,1490,1365,1551,186
2019,6,18,8,1385,1309,1611,302
2019,6,18,9,1349,1290,1670,380
2019,6,18,10,1329,1260,1530,270
2019,6,18,11,1332,1271,1483,212
2019,6,18,12,1370,1315,1515,200
2019,6,18,13,1433,1359,1468,109
2019,6,18,14,1486,1418,1543,125
2019,6,18,15,1537,1453,1542,89
2019,6,18,16,1600,1501,1563,62
2019,6,18,17,1667,1563,1582,19
2019,6,18,18,1731,1626,1699,73
2019,6,18,19,1805,1695,1824,129
2019,6,18,20,1892,1779,1990,211
2019,6,18,21,1968,1856,2187,331
2019,6,18,22,2040,1933,2297,364
2019,6,18,23,2065,1975,2388,413
2019,6,19,0,2073,2007,2329,322
2019,6,19,1,2051,1988,2341,353
2019,6,19,2,2007,1948,2307,359
2019,6,19,3,1968,1938,2291,353
2019,6,19,4,1900,1866,2234,368
2019,6,19,5,1770,1704,2125,421
2019,6,19,6,1613,1552,1888,336
2019,6,19,7,1506,1444,1730,286
2019,6,19,8,1394,1379,1462,83
2019,6,19,9,1362,1339,1344,5
2019,6,19,10,1327,1301,1258,-43
2019,6,19,11,1324,1301,1278,-23
2019,6,19,12,1367,1338,1347,9
2019,6,19,13,1421,1376,1490,114
2019,6,19,14,1488,1455,1483,28
2019,6,19,15,1547,1516,1466,-50
2019,6,19,16,1601,1571,1592,21
2019,6,19,17,1663,1643,1774,131
2019,6,19,18,1733,1717,1863,146
2019,6,19,19,1806,1780,1926,146
2019,6,19,20,1888,1852,1961,109
2019,6,19,21,1959,1932,1986,54
2019,6,19,22,2029,1998,2008,10
2019,6,19,23,2055,2046,2077,31
2019,6,20,0,2070,2076,2109,33
2019,6,20,1,2056,2068,2085,17
2019,6,20,2,2001,2022,1910,-112
2019,6,20,3,1980,2018,1763,-255
2019,6,20,4,1920,1946,1660,-286
2019,6,20,5,1778,1764,1468,-296
2019,6,20,6,1615,1614,1373,-241
2019,6,20,7,1508,1483,1341,-142
2019,6,20,8,1437,1413,1369,-44
2019,6,20,9,1379,1361,1332,-29
2019,6,20,10,1350,1335,1372,37
2019,6,20,11,1349,1334,1441,107
2019,6,20,12,1385,1281,1368,87
2019,6,20,13,1435,1412,1482,70
2019,6,20,14,1494,1491,1514,23
2019,6,20,15,1528,1548,1463,-85
2019,6,20,16,1625,1614,1485,-129
2019,6,20,17,1711,1700,1538,-162
2019,6,20,18,1793,1774,1588,-186
2019,6,20,19,1867,1866,1736,-130
2019,6,20,20,1964,1955,1948,-7
2019,6,20,21,2040,2041,2031,-10
2019,6,20,22,2095,2090,2077,-13
2019,6,20,23,2131,2134,2020,-114
2019,6,21,0,2155,2153,2049,-104
2019,6,21,1,2113,2113,1908,-205
2019,6,21,2,2059,2055,1862,-193
2019,6,21,3,2025,2041,1903,-138
2019,6,21,4,1961,1969,1988,19
2019,6,21,5,1821,1798,1951,153
2019,6,21,6,1663,1624,1831,207
2019,6,21,7,1544,1522,1613,91
2019,6,21,8,1440,1444,1553,109
2019,6,21,9,1389,1381,1462,81
2019,6,21,10,1360,1336,1392,56
2019,6,21,11,1354,1329,1467,138
2019,6,21,12,1383,1356,1404,48
2019,6,21,13,1428,1388,1368,-20
2019,6,21,14,1497,1459,1374,-85
2019,6,21,15,1553,1510,1462,-48
2019,6,21,16,1617,1587,1592,5
2019,6,21,17,1684,1658,1639,-19
2019,6,21,18,1742,1726,1647,-79
2019,6,21,19,1808,1794,1681,-113
2019,6,21,20,1892,1864,1808,-56
2019,6,21,21,1962,1934,1975,41
2019,6,21,22,2021,2003,2061,58
2019,6,21,23,2057,2062,2046,-16
2019,6,22,0,2053,2090,2033,-57
2019,6,22,1,2029,2083,1974,-109
2019,6,22,2,1971,2020,1903,-117
2019,6,22,3,1951,1998,1932,-66
2019,6,22,4,1898,1940,1992,52
2019,6,22,5,1775,1781,1907,126
2019,6,22,6,1634,1622,1743,121
2019,6,22,7,1526,1509,1597,88
2019,6,22,8,1441,1429,1450,21
2019,6,22,9,1388,1383,1514,131
2019,6,22,10,1344,1340,1496,156
2019,6,22,11,1334,1320,1384,64
2019,6,22,12,1341,1325,1322,-3
2019,6,22,13,1344,1316,1217,-99
2019,6,22,14,1383,1365,1283,-82
2019,6,22,15,1446,1428,1316,-112
2019,6,22,16,1508,1496,1315,-181
2019,6,22,17,1556,1567,1389,-178
2019,6,22,18,1604,1632,1394,-238
2019,6,22,19,1664,1681,1418,-263
2019,6,22,20,1717,1738,1554,-184
2019,6,22,21,1767,1788,1639,-149
2019,6,22,22,1805,1833,1781,-52
2019,6,22,23,1813,1855,1747,-108
2019,6,23,0,1824,1873,1730,-143
2019,6,23,1,1805,1823,1650,-173
2019,6,23,2,1783,1754,1571,-183
2019,6,23,3,1780,1755,1781,26
2019,6,23,4,1755,1716,1848,132
2019,6,23,5,1669,1595,1713,118
2019,6,23,6,1553,1491,1581,90
2019,6,23,7,1459,1412,1460,48
2019,6,23,8,1364,1352,1408,56
2019,6,23,9,1321,1315,1371,56
2019,6,23,10,1282,1285,1301,16
2019,6,23,11,1270,1275,1291,16
2019,6,23,12,1273,1272,1412,140
2019,6,23,13,1269,1264,1395,131
2019,6,23,14,1302,1297,1340,43
2019,6,23,15,1349,1346,1313,-33
2019,6,23,16,1404,1400,1320,-80
2019,6,23,17,1446,1441,1341,-100
2019,6,23,18,1492,1477,1494,17
2019,6,23,19,1543,1512,1574,62
2019,6,23,20,1592,1559,1615,56
2019,6,23,21,1637,1609,1725,116
2019,6,23,22,1674,1667,1924,257
2019,6,23,23,1711,1731,1965,234
2019,6,24,0,1746,1791,1991,200
2019,6,24,1,1752,1807,1963,156
2019,6,24,2,1745,1786,1854,68
2019,6,24,3,1759,1752,1719,-33
2019,6,24,4,1728,1722,1755,33
2019,6,24,5,1628,1589,1653,64
2019,6,24,6,1499,1458,1503,45
2019,6,24,7,1406,1369,1386,17
2019,6,24,8,1328,1316,1271,-45
2019,6,24,9,1289,1275,1217,-58
2019,6,24,10,1275,1259,1308,49
2019,6,24,11,1282,1254,1346,92
2019,6,24,12,1321,1282,1365,83
2019,6,24,13,1380,1316,1380,64
2019,6,24,14,1434,1385,1362,-23
2019,6,24,15,1475,1442,1343,-99
2019,6,24,16,1515,1495,1358,-137
2019,6,24,17,1564,1545,1357,-188
2019,6,24,18,1617,1601,1358,-243
2019,6,24,19,1673,1652,1404,-248
2019,6,24,20,1743,1725,1440,-285
2019,6,24,21,1802,1774,1692,-82
2019,6,24,22,1874,1864,1726,-138
2019,6,24,23,1901,1952,1767,-185
2019,6,25,0,1945,1992,1769,-223
2019,6,25,1,1932,2010,1707,-303
2019,6,25,2,1875,1970,1580,-390
2019,6,25,3,1873,1931,1470,-461
2019,6,25,4,1837,1880,1455,-425
2019,6,25,5,1696,1710,1352,-358
2019,6,25,6,1552,1542,1156,-386
2019,6,25,7,1438,1430,1169,-261
2019,6,25,8,1401,1354,1100,-254
2019,6,25,9,1359,1315,1092,-223
2019,6,25,10,1331,1291,1200,-91
2019,6,25,11,1321,1295,1094,-201
2019,6,25,12,1351,1322,1100,-222
2019,6,25,13,1396,1355,1121,-234
2019,6,25,14,1466,1415,1243,-172
2019,6,25,15,1526,1496,1318,-178
2019,6,25,16,1590,1553,1350,-203
2019,6,25,17,1661,1628,1401,-227
2019,6,25,18,1734,1714,1438,-276
2019,6,25,19,1815,1808,1604,-204
2019,6,25,20,1912,1916,1687,-229
2019,6,25,21,1983,1978,1742,-236
2019,6,25,22,2050,2080,1781,-299
2019,6,25,23,2086,2140,1841,-299
2019,6,26,0,2101,2168,1877,-291
2019,6,26,1,2080,2158,1783,-375
2019,6,26,2,2043,2098,1666,-432
2019,6,26,3,2011,2065,1691,-374
2019,6,26,4,1954,1976,1698,-278
2019,6,26,5,1808,1803,1593,-210
2019,6,26,6,1642,1654,1555,-99
2019,6,26,7,1546,1521,1438,-83
2019,6,26,8,1482,1430,1321,-109
2019,6,26,9,1432,1379,1396,17
2019,6,26,10,1395,1346,1401,55
2019,6,26,11,1382,1343,1358,15
2019,6,26,12,1409,1360,1326,-34
2019,6,26,13,1449,1415,1376,-39
2019,6,26,14,1521,1495,1425,-70
2019,6,26,15,1592,1545,1493,-52
2019,6,26,16,1675,1620,1644,24
2019,6,26,17,1754,1730,1780,50
2019,6,26,18,1841,1836,1997,161
2019,6,26,19,1932,1930,2090,160
2019,6,26,20,2032,2030,2169,139
2019,6,26,21,2103,2122,2208,86
2019,6,26,22,2147,2155,2208,53
2019,6,26,23,2154,2136,2294,158
2019,6,27,0,2132,2089,2114,25
2019,6,27,1,2080,2034,1951,-83
2019,6,27,2,2027,2000,2050,50
2019,6,27,3,2005,2032,2088,56
2019,6,27,4,1958,1959,2106,147
2019,6,27,5,1817,1795,1887,92
2019,6,27,6,1664,1653,1698,45
2019,6,27,7,1543,1558,1617,59
2019,6,27,8,1511,1490,1584,94
2019,6,27,9,1460,1423,1545,122
2019,6,27,10,1425,1396,1619,223
2019,6,27,11,1422,1399,1589,190
2019,6,27,12,1450,1424,1533,109
2019,6,27,13,1505,1466,1492,26
2019,6,27,14,1565,1540,1549,9
2019,6,27,15,1637,1627,1569,-58
2019,6,27,16,1722,1710,1718,8
2019,6,27,17,1808,1813,1753,-60
2019,6,27,18,1899,1895,1752,-143
2019,6,27,19,1992,1992,1763,-229
2019,6,27,20,2092,2107,1857,-250
2019,6,27,21,2173,2159,1816,-343
2019,6,27,22,2210,2127,1826,-301
2019,6,27,23,2235,2073,1932,-141
2019,6,28,0,2194,2002,2035,33
2019,6,28,1,2133,1956,2091,135
2019,6,28,2,2081,1940,2030,90
2019,6,28,3,2061,1947,2019,72
2019,6,28,4,2000,1935,1950,15
2019,6,28,5,1854,1786,1728,-58
2019,6,28,6,1697,1623,1534,-89
2019,6,28,7,1572,1518,1423,-95
2019,6,28,8,1499,1445,1334,-111
2019,6,28,9,1452,1414,1259,-155
2019,6,28,10,1422,1369,1222,-147
2019,6,28,11,1408,1366,1239,-127
2019,6,28,12,1435,1392,1267,-125
2019,6,28,13,1487,1425,1341,-84
2019,6,28,14,1541,1491,1546,55
2019,6,28,15,1614,1571,1651,80
2019,6,28,16,1695,1670,1699,29
2019,6,28,17,1785,1765,1715,-50
2019,6,28,18,1885,1857,1769,-88
2019,6,28,19,1979,1957,1882,-75
2019,6,28,20,2078,2065,2022,-43
2019,6,28,21,2166,2157,2148,-9
2019,6,28,22,2207,2204,2277,73
2019,6,28,23,2229,2273,2308,35
2019,6,29,0,2206,2250,2391,141
2019,6,29,1,2134,2198,2333,135
2019,6,29,2,2076,2108,2285,177
2019,6,29,3,2069,2086,2187,101
2019,6,29,4,2000,2027,2169,142
2019,6,29,5,1870,1873,1889,16
2019,6,29,6,1732,1731,1868,137
2019,6,29,7,1624,1616,1546,-70
2019,6,29,8,1521,1538,1470,-68
2019,6,29,9,1461,1483,1633,150
2019,6,29,10,1422,1442,1518,76
2019,6,29,11,1438,1423,1428,5
2019,6,29,12,1445,1428,1411,-17
2019,6,29,13,1423,1425,1412,-13
2019,6,29,14,1457,1486,1480,-6
2019,6,29,15,1555,1585,1521,-64
2019,6,29,16,1655,1687,1605,-82
2019,6,29,17,1746,1806,1693,-113
2019,6,29,18,1839,1918,1753,-165
2019,6,29,19,1926,2016,1877,-139
2019,6,29,20,2009,2101,1994,-107
2019,6,29,21,2085,2158,2092,-66
2019,6,29,22,2128,2179,2122,-57
2019,6,29,23,2106,2218,2123,-95
2019,6,30,0,2129,2226,2163,-63
2019,6,30,1,2079,2199,2135,-64
2019,6,30,2,2038,2143,2183,40
2019,6,30,3,2031,2077,2190,113
2019,6,30,4,1981,2033,2215,182
2019,6,30,5,1878,1892,2059,167
2019,6,30,6,1735,1727,1849,122
2019,6,30,7,1613,1621,1651,30
2019,6,30,8,1512,1541,1592,51
2019,6,30,9,1453,1470,1578,108
2019,6,30,10,1413,1411,1495,84
2019,6,30,11,1427,1387,1459,72
2019,6,30,12,1426,1381,1405,24
2019,6,30,13,1391,1363,1401,38
2019,6,30,14,1423,1420,1467,47
2019,6,30,15,1516,1521,1580,59
2019,6,30,16,1611,1620,1606,-14
2019,6,30,17,1708,1736,1673,-63
2019,6,30,18,1800,1850,1823,-27
2019,6,30,19,1917,1950,1872,-78
2019,6,30,20,1997,2053,1904,-149
2019,6,30,21,2075,2143,1993,-150
2019,6,30,22,2124,2212,2061,-151
2019,6,30,23,2128,2296,2085,-211
2019,7,1,0,2136,2338,2126,-212
2019,7,1,1,2084,2296,2090,-206
2019,7,1,2,2060,2212,2084,-128
2019,7,1,3,2043,2157,2058,-99
2019,7,1,4,2000,2069,1903,-166
2019,7,1,5,1877,1915,1760,-155
2019,7,1,6,1728,1724,1694,-30
2019,7,1,7,1608,1607,1526,-81
2019,7,1,8,1482,1527,1553,26
2019,7,1,9,1433,1477,1628,151
2019,7,1,10,1384,1448,1606,158
2019,7,1,11,1448,1453,1543,90
2019,7,1,12,1467,1476,1506,30
2019,7,1,13,1508,1509,1523,14
2019,7,1,14,1558,1634,1739,105
2019,7,1,15,1633,1706,1795,89
2019,7,1,16,1720,1810,1842,32
2019,7,1,17,1805,1916,2010,94
2019,7,1,18,1890,2022,2038,16
2019,7,1,19,1983,2128,2145,17
2019,7,1,20,2042,2194,2202,8
2019,7,1,21,2108,2233,2303,70
2019,7,1,22,2119,2179,2221,42
2019,7,1,23,2100,2063,2221,158
2019,7,2,0,2078,1988,2151,163
2019,7,2,1,2009,1911,2119,208
2019,7,2,2,1961,1868,2124,256
2019,7,2,3,1945,1896,2151,255
2019,7,2,4,1912,1849,2199,350
2019,7,2,5,1784,1729,2085,356
2019,7,2,6,1639,1587,1893,306
2019,7,2,7,1527,1497,1628,131
2019,7,2,8,1542,1456,1418,-38
2019,7,2,9,1496,1402,1476,74
2019,7,2,10,1461,1374,1460,86
2019,7,2,11,1458,1384,1493,109
2019,7,2,12,1493,1428,1460,32
2019,7,2,13,1545,1472,1437,-35
2019,7,2,14,1622,1534,1498,-36
2019,7,2,15,1700,1587,1525,-62
2019,7,2,16,1800,1689,1547,-142
2019,7,2,17,1905,1772,1677,-95
2019,7,2,18,2026,1887,1864,-23
2019,7,2,19,2137,1940,1894,-46
2019,7,2,20,2243,2059,1923,-136
2019,7,2,21,2324,2147,2072,-75
2019,7,2,22,2361,2210,2041,-169
2019,7,2,23,2343,2221,2104,-117
2019,7,3,0,2306,2222,2211,-11
2019,7,3,1,2251,2197,2107,-90
2019,7,3,2,2205,2127,2108,-19
2019,7,3,3,2192,2099,2144,45
2019,7,3,4,2099,2047,2132,85
2019,7,3,5,1950,1889,1889,0
2019,7,3,6,1766,1723,1632,-91
2019,7,3,7,1634,1595,1666,71
2019,7,3,8,1514,1504,1494,-10
2019,7,3,9,1449,1454,1381,-73
2019,7,3,10,1421,1408,1383,-25
2019,7,3,11,1415,1405,1404,-1
2019,7,3,12,1437,1434,1377,-57
2019,7,3,13,1483,1468,1414,-54
2019,7,3,14,1561,1549,1416,-133
2019,7,3,15,1632,1630,1489,-141
2019,7,3,16,1724,1721,1632,-89
2019,7,3,17,1838,1820,1671,-149
2019,7,3,18,1942,1901,1677,-224
2019,7,3,19,2033,1996,1666,-330
2019,7,3,20,2142,2089,1753,-336
2019,7,3,21,2224,2156,1832,-324
2019,7,3,22,2296,2222,1890,-332
2019,7,3,23,2338,2265,2040,-225
2019,7,4,0,2346,2294,2055,-239
2019,7,4,1,2311,2283,2076,-207
2019,7,4,2,2249,2227,2048,-179
2019,7,4,3,2223,2179,2027,-152
2019,7,4,4,2138,2078,1947,-131
2019,7,4,5,1959,1904,1868,-36
2019,7,4,6,1791,1716,1871,155
2019,7,4,7,1655,1583,1760,177
2019,7,4,8,1598,1499,1567,68
2019,7,4,9,1528,1435,1588,153
2019,7,4,10,1484,1401,1593,192
2019,7,4,11,1450,1387,1686,299
2019,7,4,12,1443,1399,1723,324
2019,7,4,13,1436,1392,1770,378
2019,7,4,14,1478,1431,1800,369
2019,7,4,15,1560,1493,1788,295
2019,7,4,16,1663,1575,1776,201
2019,7,4,17,1775,1687,1831,144
2019,7,4,18,1884,1784,1846,62
2019,7,4,19,1993,1871,1888,17
2019,7,4,20,2099,1942,1967,25
2019,7,4,21,2184,2015,1960,-55
2019,7,4,22,2243,2089,2006,-83
2019,7,4,23,2271,2170,2018,-152
2019,7,5,0,2295,2185,2094,-91
2019,7,5,1,2282,2173,2075,-98
2019,7,5,2,2249,2114,2012,-102
2019,7,5,3,2220,2055,1995,-60
2019,7,5,4,2140,1955,1929,-26
2019,7,5,5,1978,1859,1903,44
2019,7,5,6,1839,1737,1949,212
2019,7,5,7,1709,1636,1826,190
2019,7,5,8,1586,1532,1711,179
2019,7,5,9,1518,1465,1594,129
2019,7,5,10,1477,1419,1560,141
2019,7,5,11,1460,1404,1537,133
2019,7,5,12,1476,1417,1613,196
2019,7,5,13,1505,1435,1706,271
2019,7,5,14,1584,1502,1794,292
2019,7,5,15,1683,1576,1757,181
2019,7,5,16,1775,1665,1794,129
2019,7,5,17,1885,1783,1679,-104
2019,7,5,18,1998,1875,1821,-54
2019,7,5,19,2108,1960,1838,-122
2019,7,5,20,2218,2051,1886,-165
2019,7,5,21,2291,2135,2042,-93
2019,7,5,22,2335,2214,2109,-105
2019,7,5,23,2357,2277,2159,-118
2019,7,6,0,2337,2275,2162,-113
2019,7,6,1,2285,2224,2186,-38
2019,7,6,2,2223,2151,2185,34
2019,7,6,3,2199,2151,2359,208
2019,7,6,4,2146,2088,2276,188
2019,7,6,5,2002,1946,2184,238
2019,7,6,6,1838,1785,2107,322
2019,7,6,7,1709,1669,1832,163
2019,7,6,8,1589,1604,1554,-50
2019,7,6,9,1524,1544,1447,-97
2019,7,6,10,1477,1502,1476,-26
2019,7,6,11,1460,1481,1451,-30
2019,7,6,12,1466,1478,1446,-32
2019,7,6,13,1457,1478,1495,17
2019,7,6,14,1500,1514,1451,-63
2019,7,6,15,1581,1570,1534,-36
2019,7,6,16,1673,1639,1542,-97
2019,7,6,17,1770,1687,1596,-91
2019,7,6,18,1838,1723,1564,-159
2019,7,6,19,1913,1745,1692,-53
2019,7,6,20,1987,1800,1741,-59
2019,7,6,21,2028,1871,1765,-106
2019,7,6,22,2061,1897,1774,-123
2019,7,6,23,2048,1873,1682,-191
2019,7,7,0,2049,1833,1664,-169
2019,7,7,1,1997,1761,1674,-87
2019,7,7,2,1975,1713,1624,-89
2019,7,7,3,1958,1712,1720,8
2019,7,7,4,1912,1690,1788,98
2019,7,7,5,1805,1594,1783,189
2019,7,7,6,1691,1506,1600,94
2019,7,7,7,1582,1456,1398,-58
2019,7,7,8,1513,1394,1273,-121
2019,7,7,9,1454,1357,1270,-87
2019,7,7,10,1414,1329,1197,-132
2019,7,7,11,1397,1322,1259,-63
2019,7,7,12,1393,1336,1261,-75
2019,7,7,13,1380,1343,1234,-109
2019,7,7,14,1416,1370,1234,-136
2019,7,7,15,1485,1433,1142,-291
2019,7,7,16,1560,1485,1182,-303
2019,7,7,17,1651,1543,1221,-322
2019,7,7,18,1731,1621,1314,-307
2019,7,7,19,1818,1692,1389,-303
2019,7,7,20,1899,1758,1524,-234
2019,7,7,21,1949,1851,1608,-243
2019,7,7,22,1993,1862,1725,-137
2019,7,7,23,2004,1851,1678,-173
2019,7,8,0,2008,1842,1757,-85
2019,7,8,1,2006,1844,1695,-149
2019,7,8,2,1976,1806,1595,-211
2019,7,8,3,1961,1809,1636,-173
2019,7,8,4,1911,1764,1658,-106
2019,7,8,5,1797,1643,1600,-43
2019,7,8,6,1666,1517,1447,-70
2019,7,8,7,1552,1441,1419,-22
2019,7,8,8,1466,1383,1288,-95
2019,7,8,9,1416,1355,1193,-162
2019,7,8,10,1390,1319,1294,-25
2019,7,8,11,1386,1340,1325,-15
2019,7,8,12,1418,1390,1341,-49
2019,7,8,13,1469,1437,1360,-77
2019,7,8,14,1540,1510,1455,-55
2019,7,8,15,1602,1578,1537,-41
2019,7,8,16,1681,1654,1672,18
2019,7,8,17,1767,1733,1797,64
2019,7,8,18,1859,1812,1912,100
2019,7,8,19,1952,1899,1989,90
2019,7,8,20,2038,1951,2039,88
2019,7,8,21,2115,2026,2176,150
2019,7,8,22,2166,2095,2234,139
2019,7,8,23,2204,2147,2266,119
2019,7,9,0,2227,2153,2325,172
2019,7,9,1,2200,2146,2253,107
2019,7,9,2,2144,2080,2165,85
2019,7,9,3,2117,2031,2117,86
2019,7,9,4,2038,1957,2043,86
2019,7,9,5,1890,1776,1941,165
2019,7,9,6,1722,1600,1864,264
2019,7,9,7,1609,1488,1873,385
2019,7,9,8,1450,1414,1917,503
2019,7,9,9,1397,1375,1919,544
2019,7,9,10,1364,1345,1896,551
2019,7,9,11,1362,1330,1812,482
2019,7,9,12,1401,1374,1873,499
2019,7,9,13,1453,1417,1926,509
2019,7,9,14,1524,1487,1936,449
2019,7,9,15,1577,1549,1867,318
2019,7,9,16,1646,1608,1889,281
2019,7,9,17,1722,1692,1826,134
2019,7,9,18,1805,1772,1815,43
2019,7,9,19,1883,1878,1863,-15
2019,7,9,20,1968,1963,1908,-55
2019,7,9,21,2049,2031,1983,-48
2019,7,9,22,2118,2118,2025,-93
2019,7,9,23,2152,2182,2070,-112
2019,7,10,0,2186,2225,2065,-160
2019,7,10,1,2179,2227,2039,-188
2019,7,10,2,2118,2183,2014,-169
2019,7,10,3,2078,2140,1998,-142
2019,7,10,4,1998,2024,1874,-150
2019,7,10,5,1854,1836,1790,-46
2019,7,10,6,1692,1648,1820,172
2019,7,10,7,1561,1525,1749,224
2019,7,10,8,1483,1446,1687,241
2019,7,10,9,1420,1396,1667,271
2019,7,10,10,1380,1367,1651,284
2019,7,10,11,1366,1369,1638,269
2019,7,10,12,1401,1405,1674,269
2019,7,10,13,1445,1440,1693,253
2019,7,10,14,1519,1509,1721,212
2019,7,10,15,1598,1559,1759,200
2019,7,10,16,1677,1641,1858,217
2019,7,10,17,1770,1748,1932,184
2019,7,10,18,1883,1868,1995,127
2019,7,10,19,1982,2008,2090,82
2019,7,10,20,2094,2117,2145,28
2019,7,10,21,2168,2219,2271,52
2019,7,10,22,2250,2262,2310,48
2019,7,10,23,2265,2332,2367,35
2019,7,11,0,2278,2364,2446,82
2019,7,11,1,2252,2340,2434,94
2019,7,11,2,2191,2325,2578,253
2019,7,11,3,2154,2293,2555,262
2019,7,11,4,2084,2193,2554,361
2019,7,11,5,1935,1995,2513,518
2019,7,11,6,1745,1822,2328,506
2019,7,11,7,1602,1694,2053,359
2019,7,11,8,1548,1602,1851,249
2019,7,11,9,1499,1549,1712,163
2019,7,11,10,1459,1504,1639,135
2019,7,11,11,1451,1490,1599,109
2019,7,11,12,1483,1524,1667,143
2019,7,11,13,1519,1571,1762,191
2019,7,11,14,1592,1668,1908,240
2019,7,11,15,1660,1801,1968,167
2019,7,11,16,1745,1870,2093,223
2019,7,11,17,1858,1989,2120,131
2019,7,11,18,1965,2081,2219,138
2019,7,11,19,2074,2165,2264,99
2019,7,11,20,2182,2265,2292,27
2019,7,11,21,2259,2349,2317,-32
2019,7,11,22,2315,2377,2319,-58
2019,7,11,23,2335,2363,2338,-25
2019,7,12,0,2321,2284,2448,164
2019,7,12,1,2277,2189,2142,-47
2019,7,12,2,2212,2126,2258,132
2019,7,12,3,2185,2125,2374,249
2019,7,12,4,2100,2039,2410,371
2019,7,12,5,1948,1892,2209,317
2019,7,12,6,1780,1714,2036,322
2019,7,12,7,1651,1609,1487,-122
2019,7,12,8,1567,1531,1224,-307
2019,7,12,9,1512,1477,1216,-261
2019,7,12,10,1482,1437,1254,-183
2019,7,12,11,1468,1431,1264,-167
2019,7,12,12,1496,1460,1365,-95
2019,7,12,13,1534,1507,1499,-8
2019,7,12,14,1604,1579,1566,-13
2019,7,12,15,1677,1666,1661,-5
2019,7,12,16,1762,1751,1890,139
2019,7,12,17,1868,1851,2030,179
2019,7,12,18,1962,1967,2113,146
2019,7,12,19,2070,2061,2162,101
2019,7,12,20,2174,2164,2197,33
2019,7,12,21,2255,2257,2257,0
2019,7,12,22,2302,2312,2309,-3
2019,7,12,23,2302,2359,2331,-28
2019,7,13,0,2283,2365,2329,-36
2019,7,13,1,2244,2310,2257,-53
2019,7,13,2,2173,2245,2200,-45
2019,7,13,3,2166,2221,2224,3
2019,7,13,4,2095,2147,2146,-1
2019,7,13,5,1956,1993,2081,88
2019,7,13,6,1816,1827,1958,131
2019,7,13,7,1682,1692,1837,145
2019,7,13,8,1604,1616,1797,181
2019,7,13,9,1541,1538,1723,185
2019,7,13,10,1490,1499,1643,144
2019,7,13,11,1467,1519,1426,-93
2019,7,13,12,1470,1480,1327,-153
2019,7,13,13,1466,1471,1345,-126
2019,7,13,14,1509,1549,1406,-143
2019,7,13,15,1592,1651,1555,-96
2019,7,13,16,1698,1768,1682,-86
2019,7,13,17,1819,1885,1722,-163
2019,7,13,18,1925,2016,1741,-275
2019,7,13,19,2030,2103,1763,-340
2019,7,13,20,2120,2170,1811,-359
2019,7,13,21,2192,2215,1895,-320
2019,7,13,22,2232,2243,1967,-276
2019,7,13,23,2234,2316,1958,-358
2019,7,14,0,2200,2272,2010,-262
2019,7,14,1,2147,2195,1929,-266
2019,7,14,2,2087,2119,1977,-142
2019,7,14,3,2064,2096,1879,-217
2019,7,14,4,2014,2034,1825,-209
2019,7,14,5,1900,1910,1811,-99
2019,7,14,6,1764,1771,1753,-18
2019,7,14,7,1650,1646,1660,14
2019,7,14,8,1565,1591,1436,-155
2019,7,14,9,1504,1532,1243,-289
2019,7,14,10,1454,1497,1080,-417
2019,7,14,11,1432,1464,1082,-382
2019,7,14,12,1427,1467,1101,-366
2019,7,14,13,1417,1452,1089,-363
2019,7,14,14,1462,1523,1131,-392
2019,7,14,15,1546,1624,1239,-385
2019,7,14,16,1640,1729,1332,-397
2019,7,14,17,1766,1849,1425,-424
2019,7,14,18,1875,1965,1491,-474
2019,7,14,19,1981,2046,1490,-556
2019,7,14,20,2080,2144,1512,-632
2019,7,14,21,2168,2238,1479,-759
2019,7,14,22,2226,2305,1518,-787
2019,7,14,23,2255,2358,1602,-756
2019,7,15,0,2249,2357,1685,-672
2019,7,15,1,2223,2258,1656,-602
2019,7,15,2,2175,2215,1493,-722
2019,7,15,3,2151,2175,1579,-596
2019,7,15,4,2094,2119,1729,-390
2019,7,15,5,1950,1936,1693,-243
2019,7,15,6,1790,1761,1567,-194
2019,7,15,7,1658,1650,1496,-154
2019,7,15,8,1569,1582,1474,-108
2019,7,15,9,1517,1535,1456,-79
2019,7,15,10,1488,1493,1394,-99
2019,7,15,11,1481,1491,1293,-198
2019,7,15,12,1512,1527,1300,-227
2019,7,15,13,1555,1576,1273,-303
2019,7,15,14,1635,1683,1398,-285
2019,7,15,15,1718,1738,1500,-238
2019,7,15,16,1813,1847,1620,-227
2019,7,15,17,1929,1946,1732,-214
2019,7,15,18,2039,2047,1769,-278
2019,7,15,19,2135,2173,1851,-322
2019,7,15,20,2258,2243,1902,-341
2019,7,15,21,2328,2333,2032,-301
2019,7,15,22,2355,2416,2019,-397
2019,7,15,23,2391,2425,1970,-455
2019,7,16,0,2377,2416,2000,-416
2019,7,16,1,2316,2330,1978,-352
2019,7,16,2,2247,2252,2027,-225
2019,7,16,3,2219,2240,2011,-229
2019,7,16,4,2149,2159,2143,-16
2019,7,16,5,1997,1969,1881,-88
2019,7,16,6,1828,1796,1710,-86
2019,7,16,7,1692,1693,1710,17
2019,7,16,8,1611,1622,1595,-27
2019,7,16,9,1562,1571,1546,-25
2019,7,16,10,1518,1533,1533,0
2019,7,16,11,1506,1529,1511,-18
2019,7,16,12,1540,1567,1476,-91
2019,7,16,13,1587,1627,1471,-156
2019,7,16,14,1675,1705,1631,-74
2019,7,16,15,1757,1792,1739,-53
2019,7,16,16,1859,1904,1791,-113
2019,7,16,17,1975,2016,1909,-107
2019,7,16,18,2092,2092,1991,-101
2019,7,16,19,2207,2178,2116,-62
2019,7,16,20,2321,2283,2140,-143
2019,7,16,21,2406,2350,2311,-39
2019,7,16,22,2445,2435,2392,-43
2019,7,16,23,2448,2425,2487,62
2019,7,17,0,2416,2306,2270,-36
2019,7,17,1,2349,2156,2096,-60
2019,7,17,2,2287,2068,2039,-29
2019,7,17,3,2267,2079,2157,78
2019,7,17,4,2186,2010,2050,40
2019,7,17,5,2021,1856,1803,-53
2019,7,17,6,1846,1715,1744,29
2019,7,17,7,1716,1611,1695,84
2019,7,17,8,1598,1555,1657,102
2019,7,17,9,1535,1503,1613,110
2019,7,17,10,1505,1477,1579,102
2019,7,17,11,1501,1486,1558,72
2019,7,17,12,1537,1532,1559,27
2019,7,17,13,1589,1576,1652,76
2019,7,17,14,1668,1664,1771,107
2019,7,17,15,1717,1706,1775,69
2019,7,17,16,1819,1789,1818,29
2019,7,17,17,1920,1879,1912,33
2019,7,17,18,2035,2002,2086,84
2019,7,17,19,2176,2123,2174,51
2019,7,17,20,2245,2182,2229,47
2019,7,17,21,2339,2289,2359,70
2019,7,17,22,2409,2354,2370,16
2019,7,17,23,2439,2350,2247,-103
2019,7,18,0,2445,2357,2282,-75
2019,7,18,1,2395,2343,2255,-88
2019,7,18,2,2336,2277,2204,-73
2019,7,18,3,2315,2246,2094,-152
2019,7,18,4,2234,2160,2120,-40
2019,7,18,5,2064,1964,2085,121
2019,7,18,6,1874,1792,1945,153
2019,7,18,7,1736,1672,1828,156
2019,7,18,8,1622,1594,1736,142
2019,7,18,9,1557,1543,1743,200
2019,7,18,10,1516,1506,1800,294
2019,7,18,11,1507,1504,1821,317
2019,7,18,12,1534,1530,1804,274
2019,7,18,13,1583,1569,1774,205
2019,7,18,14,1663,1644,1754,110
2019,7,18,15,1745,1735,1850,115
2019,7,18,16,1843,1847,1967,120
2019,7,18,17,1960,1964,2008,44
2019,7,18,18,2078,2074,2162,88
2019,7,18,19,2182,2178,2298,120
2019,7,18,20,2291,2284,2311,27
2019,7,18,21,2375,2351,2260,-91
2019,7,18,22,2437,2384,2178,-206
2019,7,18,23,2463,2413,2170,-243
2019,7,19,0,2452,2436,2166,-270
2019,7,19,1,2390,2415,2126,-289
2019,7,19,2,2335,2372,2061,-311
2019,7,19,3,2311,2327,2033,-294
2019,7,19,4,2216,2231,2011,-220
2019,7,19,5,2054,2022,2040,18
2019,7,19,6,1871,1852,2186,334
2019,7,19,7,1734,1731,2111,380
2019,7,19,8,1630,1642,2040,398
2019,7,19,9,1570,1581,1986,405
2019,7,19,10,1531,1546,1924,378
2019,7,19,11,1521,1526,1874,348
2019,7,19,12,1542,1558,1834,276
2019,7,19,13,1590,1573,1782,209
2019,7,19,14,1671,1632,1789,157
2019,7,19,15,1728,1721,1817,96
2019,7,19,16,1831,1851,1833,-18
2019,7,19,17,1945,1959,1850,-109
2019,7,19,18,2072,2073,2015,-58
2019,7,19,19,2209,2174,2055,-119
2019,7,19,20,2281,2273,2110,-163
2019,7,19,21,2371,2396,2198,-198
2019,7,19,22,2421,2446,2367,-79
2019,7,19,23,2448,2478,2468,-10
2019,7,20,0,2457,2437,2472,35
2019,7,20,1,2392,2364,2288,-76
2019,7,20,2,2325,2260,1995,-265
2019,7,20,3,2301,2226,2038,-188
2019,7,20,4,2222,2162,2168,6
2019,7,20,5,2080,2006,2237,231
2019,7,20,6,1904,1848,2173,325
2019,7,20,7,1764,1739,2100,361
2019,7,20,8,1674,1656,2035,379
2019,7,20,9,1613,1589,1911,322
2019,7,20,10,1565,1531,1883,352
2019,7,20,11,1539,1496,1850,354
2019,7,20,12,1529,1473,1944,471
2019,7,20,13,1524,1495,1923,428
2019,7,20,14,1571,1554,1929,375
2019,7,20,15,1672,1658,1887,229
2019,7,20,16,1778,1775,1981,206
2019,7,20,17,1902,1907,2006,99
2019,7,20,18,2019,2025,2002,-23
2019,7,20,19,2133,2135,2013,-122
2019,7,20,20,2244,2237,2065,-172
2019,7,20,21,2332,2321,2112,-209
2019,7,20,22,2356,2388,2182,-206
2019,7,20,23,2374,2402,2172,-230
2019,7,21,0,2349,2389,2153,-236
2019,7,21,1,2292,2323,2249,-74
2019,7,21,2,2255,2243,2162,-81
2019,7,21,3,2223,2226,2087,-139
2019,7,21,4,2147,2151,2313,162
2019,7,21,5,2016,1993,2261,268
2019,7,21,6,1870,1853,2023,170
2019,7,21,7,1732,1755,1932,177
2019,7,21,8,1634,1676,1859,183
2019,7,21,9,1577,1604,1850,246
2019,7,21,10,1530,1556,1787,231
2019,7,21,11,1506,1546,1802,256
2019,7,21,12,1501,1543,1868,325
2019,7,21,13,1494,1525,1864,339
2019,7,21,14,1509,1604,1997,393
2019,7,21,15,1576,1683,1910,227
2019,7,21,16,1700,1817,1829,12
2019,7,21,17,1808,1951,1813,-138
2019,7,21,18,1901,2086,1920,-166
2019,7,21,19,2002,2180,2067,-113
2019,7,21,20,2105,2247,2065,-182
2019,7,21,21,2223,2320,2138,-182
2019,7,21,22,2272,2363,2179,-184
2019,7,21,23,2282,2319,2027,-292
2019,7,22,0,2258,2342,2111,-231
2019,7,22,1,2192,2292,2053,-239
2019,7,22,2,2134,2217,1962,-255
2019,7,22,3,2108,2206,2013,-193
2019,7,22,4,2046,2149,2135,-14
2019,7,22,5,1915,1970,2074,104
2019,7,22,6,1764,1804,1849,45
2019,7,22,7,1654,1707,1580,-127
2019,7,22,8,1565,1611,1622,11
2019,7,22,9,1516,1574,1560,-14
2019,7,22,10,1490,1547,1632,85
2019,7,22,11,1492,1566,1702,136
2019,7,22,12,1525,1597,1734,137
2019,7,22,13,1589,1642,1729,87
2019,7,22,14,1657,1694,1756,62
2019,7,22,15,1730,1789,1785,-4
2019,7,22,16,1808,1873,1773,-100
2019,7,22,17,1885,1966,1796,-170
2019,7,22,18,1958,2034,1923,-111
2019,7,22,19,2027,2122,1882,-240
2019,7,22,20,2106,2193,1907,-286
2019,7,22,21,2178,2249,2015,-234
2019,7,22,22,2219,2281,2068,-213
2019,7,22,23,2211,2290,2051,-239
2019,7,23,0,2189,2267,2015,-252
2019,7,23,1,2115,2204,2022,-182
2019,7,23,2,2056,2124,1972,-152
2019,7,23,3,2047,2117,1944,-173
2019,7,23,4,1985,2037,1853,-184
2019,7,23,5,1852,1852,1677,-175
2019,7,23,6,1697,1709,1646,-63
2019,7,23,7,1599,1605,1544,-61
2019,7,23,8,1530,1553,1452,-101
2019,7,23,9,1481,1494,1446,-48
2019,7,23,10,1448,1475,1433,-42
2019,7,23,11,1462,1475,1344,-131
2019,7,23,12,1503,1517,1357,-160
2019,7,23,13,1572,1560,1358,-202
2019,7,23,14,1626,1645,1381,-264
2019,7,23,15,1687,1713,1417,-296
2019,7,23,16,1753,1783,1454,-329
2019,7,23,17,1822,1851,1471,-380
2019,7,23,18,1892,1912,1636,-276
2019,7,23,19,1957,1983,1718,-265
2019,7,23,20,2024,2054,1766,-288
2019,7,23,21,2099,2109,1843,-266
2019,7,23,22,2153,2172,1921,-251
2019,7,23,23,2165,2195,1884,-311
2019,7,24,0,2154,2222,1892,-330
2019,7,24,1,2100,2201,1794,-407
2019,7,24,2,2060,2152,1726,-426
2019,7,24,3,2054,2130,1738,-392
2019,7,24,4,1982,2058,1811,-247
2019,7,24,5,1843,1892,1683,-209
2019,7,24,6,1694,1740,1551,-189
2019,7,24,7,1598,1644,1502,-142
2019,7,24,8,1533,1559,1426,-133
2019,7,24,9,1484,1515,1382,-133
2019,7,24,10,1460,1488,1319,-169
2019,7,24,11,1459,1483,1303,-180
2019,7,24,12,1503,1519,1354,-165
2019,7,24,13,1565,1563,1402,-161
2019,7,24,14,1630,1634,1457,-177
2019,7,24,15,1696,1715,1535,-180
2019,7,24,16,1766,1800,1616,-184
2019,7,24,17,1870,1865,1567,-298
2019,7,24,18,1941,1946,1545,-401
2019,7,24,19,2034,2048,1684,-364
2019,7,24,20,2117,2139,1758,-381
2019,7,24,21,2204,2221,1814,-407
2019,7,24,22,2250,2296,1965,-331
2019,7,24,23,2271,2334,1972,-362
2019,7,25,0,2239,2304,1905,-399
2019,7,25,1,2188,2246,1858,-388
2019,7,25,2,2128,2181,1825,-356
2019,7,25,3,2132,2196,1884,-312
2019,7,25,4,2066,2104,1890,-214
2019,7,25,5,1913,1933,1838,-95
2019,7,25,6,1757,1764,1686,-78
2019,7,25,7,1646,1640,1522,-118
2019,7,25,8,1585,1549,1461,-88
2019,7,25,9,1532,1515,1443,-72
2019,7,25,10,1491,1490,1458,-32
2019,7,25,11,1494,1494,1495,1
2019,7,25,12,1532,1509,1434,-75
2019,7,25,13,1594,1558,1408,-150
2019,7,25,14,1665,1646,1439,-207
2019,7,25,15,1736,1717,1539,-178
2019,7,25,16,1817,1833,1523,-310
2019,7,25,17,1909,1939,1631,-308
2019,7,25,18,1989,2020,1467,-553
2019,7,25,19,2078,2137,1524,-613
2019,7,25,20,2164,2193,1522,-671
2019,7,25,21,2242,2291,1819,-472
2019,7,25,22,2287,2317,1766,-551
2019,7,25,23,2298,2315,1688,-627
2019,7,26,0,2248,2297,1676,-621
2019,7,26,1,2178,2178,1641,-537
2019,7,26,2,2111,2072,1536,-536
2019,7,26,3,2095,2009,1622,-387
2019,7,26,4,2012,1906,1643,-263
2019,7,26,5,1878,1765,1599,-166
2019,7,26,6,1731,1630,1497,-133
2019,7,26,7,1619,1538,1374,-164
2019,7,26,8,1576,1472,1251,-221
2019,7,26,9,1523,1434,1241,-193
2019,7,26,10,1485,1418,1235,-183
2019,7,26,11,1480,1416,1209,-207
2019,7,26,12,1522,1446,1217,-229
2019,7,26,13,1570,1494,1259,-235
2019,7,26,14,1637,1562,1328,-234
2019,7,26,15,1710,1629,1386,-243
2019,7,26,16,1785,1716,1472,-244
2019,7,26,17,1859,1846,1579,-267
2019,7,26,18,1939,1904,1721,-183
2019,7,26,19,2034,1980,1824,-156
2019,7,26,20,2121,2077,1950,-127
2019,7,26,21,2199,2167,2044,-123
2019,7,26,22,2230,2245,2072,-173
2019,7,26,23,2243,2308,2043,-265
2019,7,27,0,2178,2300,2143,-157
2019,7,27,1,2110,2131,2027,-104
2019,7,27,2,2039,1977,2019,42
2019,7,27,3,2043,1977,2104,127
2019,7,27,4,1982,1922,2035,113
2019,7,27,5,1865,1797,1924,127
2019,7,27,6,1725,1638,1833,195
2019,7,27,7,1621,1578,1646,68
2019,7,27,8,1541,1515,1556,41
2019,7,27,9,1478,1471,1460,-11
2019,7,27,10,1446,1441,1430,-11
2019,7,27,11,1432,1441,1466,25
2019,7,27,12,1430,1455,1461,6
2019,7,27,13,1429,1448,1484,36
2019,7,27,14,1464,1516,1507,-9
2019,7,27,15,1536,1607,1573,-34
2019,7,27,16,1633,1707,1682,-25
2019,7,27,17,1747,1795,1747,-48
2019,7,27,18,1837,1874,1845,-29
2019,7,27,19,1917,1971,1945,-26
2019,7,27,20,2003,2055,2054,-1
2019,7,27,21,2082,2131,2146,15
2019,7,27,22,2128,2213,2170,-43
2019,7,27,23,2132,2203,2181,-22
2019,7,28,0,2113,2131,2112,-19
2019,7,28,1,2054,2083,2166,83
2019,7,28,2,2015,2011,2152,141
2019,7,28,3,1997,1984,2016,32
2019,7,28,4,1949,1923,1969,46
2019,7,28,5,1832,1789,1912,123
2019,7,28,6,1709,1661,1817,156
2019,7,28,7,1597,1576,1632,56
2019,7,28,8,1524,1506,1610,104
2019,7,28,9,1465,1464,1574,110
2019,7,28,10,1430,1429,1606,177
2019,7,28,11,1410,1408,1639,231
2019,7,28,12,1393,1423,1608,185
2019,7,28,13,1385,1419,1607,188
2019,7,28,14,1425,1458,1708,250
2019,7,28,15,1499,1525,1802,277
2019,7,28,16,1600,1628,1806,178
2019,7,28,17,1715,1728,1919,191
2019,7,28,18,1813,1842,1976,134
2019,7,28,19,1914,1946,2029,83
2019,7,28,20,2006,2052,2157,105
2019,7,28,21,2095,2143,2206,63
2019,7,28,22,2159,2218,2169,-49
2019,7,28,23,2189,2249,2161,-88
2019,7,29,0,2205,2287,2213,-74
2019,7,29,1,2181,2275,2349,74
2019,7,29,2,2127,2235,2359,124
2019,7,29,3,2097,2185,2324,139
2019,7,29,4,2027,2094,2218,124
2019,7,29,5,1897,1939,2126,187
2019,7,29,6,1744,1758,2106,348
2019,7,29,7,1655,1655,1983,328
2019,7,29,8,1593,1584,1860,276
2019,7,29,9,1536,1540,1751,211
2019,7,29,10,1508,1517,1673,156
2019,7,29,11,1506,1521,1632,111
2019,7,29,12,1536,1557,1594,37
2019,7,29,13,1587,1602,1574,-28
2019,7,29,14,1659,1682,1618,-64
2019,7,29,15,1734,1767,1671,-96
2019,7,29,16,1832,1847,1706,-141
2019,7,29,17,1942,1926,1701,-225
2019,7,29,18,2038,1966,1768,-198
2019,7,29,19,2132,2025,2009,-16
2019,7,29,20,2223,2135,2152,17
2019,7,29,21,2295,2232,2248,16
2019,7,29,22,2337,2305,2290,-15
2019,7,29,23,2335,2332,2291,-41
2019,7,30,0,2310,2319,2244,-75
2019,7,30,1,2252,2305,2233,-72
2019,7,30,2,2202,2243,2211,-32
2019,7,30,3,2193,2215,2279,64
2019,7,30,4,2117,2130,2213,83
2019,7,30,5,1960,1937,1924,-13
2019,7,30,6,1793,1763,1849,86
2019,7,30,7,1664,1646,1900,254
2019,7,30,8,1599,1564,1689,125
2019,7,30,9,1552,1518,1578,60
2019,7,30,10,1517,1488,1526,38
2019,7,30,11,1511,1486,1497,11
2019,7,30,12,1560,1534,1469,-65
2019,7,30,13,1611,1579,1464,-115
2019,7,30,14,1685,1668,1505,-163
2019,7,30,15,1756,1746,1634,-112
2019,7,30,16,1849,1845,1704,-141
2019,7,30,17,1941,1950,1755,-195
2019,7,30,18,2041,2063,1818,-245
2019,7,30,19,2140,2138,1887,-251
2019,7,30,20,2241,2218,1946,-272
2019,7,30,21,2322,2292,1953,-339
2019,7,30,22,2389,2342,1938,-404
2019,7,30,23,2409,2368,2017,-351
2019,7,31,0,2411,2373,2049,-324
2019,7,31,1,2359,2342,2015,-327
2019,7,31,2,2278,2293,2120,-173
2019,7,31,3,2269,2259,2168,-91
2019,7,31,4,2175,2147,2202,55
2019,7,31,5,2011,1961,2139,178
2019,7,31,6,1836,1807,2000,193
2019,7,31,7,1706,1710,1902,192
2019,7,31,8,1613,1626,1788,162
2019,7,31,9,1563,1571,1728,157
2019,7,31,10,1522,1542,1559,17
2019,7,31,11,1519,1523,1512,-11
2019,7,31,12,1553,1555,1518,-37
2019,7,31,13,1606,1593,1554,-39
2019,7,31,14,1684,1672,1590,-82
2019,7,31,15,1751,1755,1637,-118
2019,7,31,16,1842,1854,1701,-153
2019,7,31,17,1945,1953,1822,-131
2019,7,31,18,2038,2059,1818,-241
2019,7,31,19,2130,2163,1851,-312
2019,7,31,20,2222,2221,1772,-449
2019,7,31,21,2312,2329,1859,-470
2019,7,31,22,2379,2394,2004,-390
2019,7,31,23,2411,2435,2101,-334
2019,8,1,0,2391,2444,2164,-280
2019,8,1,1,2342,2382,2285,-97
2019,8,1,2,2268,2270,2211,-59
2019,8,1,3,2246,2262,2148,-114
2019,8,1,4,2173,2183,2255,72
2019,8,1,5,2014,1989,2120,131
2019,8,1,6,1840,1821,1983,162
2019,8,1,7,1717,1709,1818,109
2019,8,1,8,1621,1632,1533,-99
2019,8,1,9,1565,1574,1233,-341
2019,8,1,10,1591,1533,1127,-406
2019,8,1,11,1521,1523,1142,-381
2019,8,1,12,1561,1557,1117,-440
2019,8,1,13,1621,1604,1107,-497
2019,8,1,14,1694,1682,1228,-454
2019,8,1,15,1758,1769,1437,-332
2019,8,1,16,1852,1866,1502,-364
2019,8,1,17,1957,1984,1572,-412
2019,8,1,18,2042,2108,1618,-490
2019,8,1,19,2131,2218,1666,-552
2019,8,1,20,2221,2299,1774,-525
2019,8,1,21,2307,2338,1854,-484
2019,8,1,22,2368,2396,2048,-348
2019,8,1,23,2386,2425,1981,-444
2019,8,2,0,2359,2389,2035,-354
2019,8,2,1,2287,2340,2008,-332
2019,8,2,2,2216,2279,1913,-366
2019,8,2,3,2191,2216,1883,-333
2019,8,2,4,2122,2112,1829,-283
2019,8,2,5,1974,1954,1740,-214
2019,8,2,6,1817,1802,1684,-118
2019,8,2,7,1703,1686,1597,-89
2019,8,2,8,1605,1636,1267,-369
2019,8,2,9,1553,1546,1196,-350
2019,8,2,10,1515,1512,1204,-308
2019,8,2,11,1515,1511,1199,-312
2019,8,2,12,1544,1548,1257,-291
2019,8,2,13,1600,1592,1262,-330
2019,8,2,14,1672,1661,1295,-366
2019,8,2,15,1738,1760,1375,-385
2019,8,2,16,1827,1857,1409,-448
2019,8,2,17,1924,1968,1502,-466
2019,8,2,18,2019,2058,1592,-466
2019,8,2,19,2108,2146,1653,-493
2019,8,2,20,2185,2239,1762,-477
2019,8,2,21,2268,2310,1954,-356
2019,8,2,22,2320,2328,1865,-463
2019,8,2,23,2337,2364,1770,-594
2019,8,3,0,2302,2314,1795,-519
2019,8,3,1,2238,2189,1775,-414
2019,8,3,2,2163,2111,1788,-323
2019,8,3,3,2154,2082,1713,-369
2019,8,3,4,2091,2005,1636,-369
2019,8,3,5,1965,1883,1614,-269
2019,8,3,6,1816,1760,1510,-250
2019,8,3,7,1701,1651,1373,-278
2019,8,3,8,1628,1575,1230,-345
2019,8,3,9,1560,1539,1199,-340
2019,8,3,10,1528,1494,1146,-348
2019,8,3,11,1512,1479,1142,-337
2019,8,3,12,1518,1482,1124,-358
2019,8,3,13,1519,1481,1139,-342
2019,8,3,14,1565,1560,1232,-328
2019,8,3,15,1638,1646,1346,-300
2019,8,3,16,1740,1758,1411,-347
2019,8,3,17,1850,1870,1417,-453
2019,8,3,18,1933,1974,1503,-471
2019,8,3,19,2016,2078,1605,-473
2019,8,3,20,2089,2158,1672,-486
2019,8,3,21,2157,2208,1691,-517
2019,8,3,22,2195,2242,1719,-523
2019,8,3,23,2196,2140,1726,-414
2019,8,4,0,2171,1994,1808,-186
2019,8,4,1,2107,1916,1794,-122
2019,8,4,2,2051,1867,1721,-146
2019,8,4,3,2025,1889,1576,-313
2019,8,4,4,1976,1849,1588,-261
2019,8,4,5,1867,1755,1424,-331
2019,8,4,6,1745,1638,1404,-234
2019,8,4,7,1643,1566,1333,-233
2019,8,4,8,1584,1490,1313,-177
2019,8,4,9,1529,1458,1204,-254
2019,8,4,10,1493,1420,1034,-386
2019,8,4,11,1480,1422,1062,-360
2019,8,4,12,1476,1411,1061,-350
2019,8,4,13,1479,1438,1098,-340
2019,8,4,14,1511,1469,1098,-371
2019,8,4,15,1586,1565,1162,-403
2019,8,4,16,1680,1635,1186,-449
2019,8,4,17,1782,1731,1264,-467
2019,8,4,18,1871,1817,1386,-431
2019,8,4,19,1959,1895,1501,-394
2019,8,4,20,2038,1981,1566,-415
2019,8,4,21,2115,2066,1555,-511
2019,8,4,22,2170,2154,1565,-589
2019,8,4,23,2197,2187,1623,-564
2019,8,5,0,2210,2197,1650,-547
2019,8,5,1,2154,2149,1553,-596
2019,8,5,2,2108,2091,1398,-693
2019,8,5,3,2080,2101,1357,-744
2019,8,5,4,2025,2004,1445,-559
2019,8,5,5,1899,1865,1458,-407
2019,8,5,6,1751,1707,1396,-311
2019,8,5,7,1648,1602,1247,-355
2019,8,5,8,1582,1544,1174,-370
2019,8,5,9,1528,1502,1140,-362
2019,8,5,10,1504,1474,1111,-363
2019,8,5,11,1499,1473,1101,-372
2019,8,5,12,1538,1514,1095,-419
2019,8,5,13,1594,1569,1117,-452
2019,8,5,14,1669,1651,1162,-489
2019,8,5,15,1743,1734,1301,-433
2019,8,5,16,1831,1804,1346,-458
2019,8,5,17,1935,2103,1657,-446
2019,8,5,18,2027,2056,1622,-434
2019,8,5,19,2119,2157,1682,-475
2019,8,5,20,2199,2265,1676,-589
2019,8,5,21,2285,2353,1755,-598
2019,8,5,22,2337,2435,1843,-592
2019,8,5,23,2357,2463,1757,-706
2019,8,6,0,2331,2498,1787,-711
2019,8,6,1,2300,2463,1828,-635
2019,8,6,2,2224,2382,1680,-702
2019,8,6,3,2204,2349,1583,-766
2019,8,6,4,2142,2231,1595,-636
2019,8,6,5,1969,2026,1450,-576
2019,8,6,6,1815,1851,1415,-436
2019,8,6,7,1698,1737,1399,-338
2019,8,6,8,1623,1660,1334,-326
2019,8,6,9,1570,1597,1327,-270
2019,8,6,10,1538,1558,1259,-299
2019,8,6,11,1531,1542,1229,-313
2019,8,6,12,1565,1593,1278,-315
2019,8,6,13,1630,1658,1416,-242
2019,8,6,14,1704,1711,1467,-244
2019,8,6,15,1778,1792,1448,-344
2019,8,6,16,1869,1899,1487,-412
2019,8,6,17,1981,2009,1473,-536
2019,8,6,18,2080,2117,1519,-598
2019,8,6,19,2175,2178,1699,-479
2019,8,6,20,2258,2229,1815,-414
2019,8,6,21,2339,2254,1975,-279
2019,8,6,22,2397,2263,1834,-429
2019,8,6,23,2407,2282,1899,-383
2019,8,7,0,2353,2141,1927,-214
2019,8,7,1,2285,2041,1828,-213
2019,8,7,2,2207,1940,1789,-151
2019,8,7,3,2189,1965,1830,-135
2019,8,7,4,2122,1893,1793,-100
2019,8,7,5,1968,1763,1621,-142
2019,8,7,6,1803,1635,1446,-189
2019,8,7,7,1692,1557,1308,-249
2019,8,7,8,1624,1500,1026,-474
2019,8,7,9,1566,1474,1091,-383
2019,8,7,10,1532,1456,1176,-280
2019,8,7,11,1533,1454,1183,-271
2019,8,7,12,1572,1508,1249,-259
2019,8,7,13,1629,1551,1279,-272
2019,8,7,14,1697,1604,1294,-310
2019,8,7,15,1765,1651,1379,-272
2019,8,7,16,1847,1668,1391,-277
2019,8,7,17,1995,1825,1594,-231
2019,8,7,18,2055,1934,1722,-212
2019,8,7,19,2147,2023,1861,-162
2019,8,7,20,2249,2066,1959,-107
2019,8,7,21,2342,2182,2052,-130
2019,8,7,22,2410,2310,2059,-251
2019,8,7,23,2452,2338,2100,-238
2019,8,8,0,2403,2325,2199,-126
2019,8,8,1,2362,2260,2153,-107
2019,8,8,2,2279,2184,1895,-289
2019,8,8,3,2262,2173,1864,-309
2019,8,8,4,2168,2069,1761,-308
2019,8,8,5,2014,1903,1636,-267
2019,8,8,6,1857,1760,1667,-93
2019,8,8,7,1734,1654,1584,-70
2019,8,8,8,1589,1579,1438,-141
2019,8,8,9,1541,1534,1389,-145
2019,8,8,10,1512,1508,1390,-118
2019,8,8,11,1501,1514,1354,-160
2019,8,8,12,1538,1565,1341,-224
2019,8,8,13,1596,1623,1358,-265
2019,8,8,14,1658,1683,1393,-290
2019,8,8,15,1725,1765,1453,-312
2019,8,8,16,1811,1856,1427,-429
2019,8,8,17,1930,1921,1443,-478
2019,8,8,18,2022,2033,1564,-469
2019,8,8,19,2102,2133,1642,-491
2019,8,8,20,2202,2238,1704,-534
2019,8,8,21,2279,2316,1833,-483
2019,8,8,22,2349,2405,1834,-571
2019,8,8,23,2385,2426,1859,-567
2019,8,9,0,2367,2407,1872,-535
2019,8,9,1,2315,2381,1980,-401
2019,8,9,2,2234,2286,1877,-409
2019,8,9,3,2211,2236,1829,-407
2019,8,9,4,2142,2128,1912,-216
2019,8,9,5,1986,1980,1810,-170
2019,8,9,6,1822,1803,1516,-287
2019,8,9,7,1700,1686,1422,-264
2019,8,9,8,1626,1622,1372,-250
2019,8,9,9,1571,1570,1320,-250
2019,8,9,10,1533,1544,1272,-272
2019,8,9,11,1537,1557,1290,-267
2019,8,9,12,1571,1599,1295,-304
2019,8,9,13,1621,1681,1311,-370
2019,8,9,14,1693,1726,1294,-432
2019,8,9,15,1760,1800,1366,-434
2019,8,9,16,1842,1863,1439,-424
2019,8,9,17,1937,1889,1489,-400
2019,8,9,18,2012,2050,1693,-357
2019,8,9,19,2095,2107,1741,-366
2019,8,9,20,2178,2183,1850,-333
2019,8,9,21,2260,2234,1911,-323
2019,8,9,22,2328,2265,2056,-209
2019,8,9,23,2337,2311,2221,-90
2019,8,10,0,2264,2286,2139,-147
2019,8,10,1,2193,2210,2153,-57
2019,8,10,2,2110,2110,2101,-9
2019,8,10,3,2095,2090,2173,83
2019,8,10,4,2042,2002,2231,229
2019,8,10,5,1916,1869,2108,239
2019,8,10,6,1783,1740,1963,223
2019,8,10,7,1674,1645,1910,265
2019,8,10,8,1606,1573,1835,262
2019,8,10,9,1551,1517,1783,266
2019,8,10,10,1508,1475,1734,259
2019,8,10,11,1494,1462,1671,209
2019,8,10,12,1506,1479,1686,207
2019,8,10,13,1513,1500,1754,254
2019,8,10,14,1549,1523,1779,256
2019,8,10,15,1627,1579,1802,223
2019,8,10,16,1715,1608,1923,315
2019,8,10,17,1822,1717,1844,127
2019,8,10,18,1905,1756,1795,39
2019,8,10,19,1987,1869,1809,-60
2019,8,10,20,2069,1903,1750,-153
2019,8,10,21,2151,1992,1893,-99
2019,8,10,22,2210,2091,2026,-65
2019,8,10,23,2224,2143,2121,-22
2019,8,11,0,2209,2159,2097,-62
2019,8,11,1,2158,2114,2047,-67
2019,8,11,2,2095,2069,2008,-61
2019,8,11,3,2053,2032,2092,60
2019,8,11,4,1995,1978,2178,200
2019,8,11,5,1884,1835,2084,249
2019,8,11,6,1751,1679,1945,266
2019,8,11,7,1649,1583,1829,246
2019,8,11,8,1568,1519,1746,227
2019,8,11,9,1507,1470,1727,257
2019,8,11,10,1466,1430,1684,254
2019,8,11,11,1458,1418,1623,205
2019,8,11,12,1461,1420,1624,204
2019,8,11,13,1463,1416,1579,163
2019,8,11,14,1488,1442,1544,102
2019,8,11,15,1559,1534,1616,82
2019,8,11,16,1642,1630,1709,79
2019,8,11,17,1748,1740,1789,49
2019,8,11,18,1824,1850,1887,37
2019,8,11,19,1921,1944,1967,23
2019,8,11,20,1999,2017,2148,131
2019,8,11,21,2055,2074,2231,157
2019,8,11,22,2112,2067,2241,174
2019,8,11,23,2100,2019,2126,107
2019,8,12,0,2080,1967,2188,221
2019,8,12,1,2051,1926,2182,256
2019,8,12,2,1994,1879,2134,255
2019,8,12,3,1979,1903,2014,111
2019,8,12,4,1912,1829,1905,76
2019,8,12,5,1804,1693,1776,83
2019,8,12,6,1669,1573,1630,57
2019,8,12,7,1559,1504,1583,79
2019,8,12,8,1495,1458,1578,120
2019,8,12,9,1447,1418,1620,202
2019,8,12,10,1431,1396,1618,222
2019,8,12,11,1440,1399,1647,248
2019,8,12,12,1488,1444,1700,256
2019,8,12,13,1553,1524,1798,274
2019,8,12,14,1614,1575,1809,234
2019,8,12,15,1677,1630,1911,281
2019,8,12,16,1747,1710,1968,258
2019,8,12,17,1844,1791,1973,182
2019,8,12,18,1917,1880,2002,122
2019,8,12,19,2001,1977,1999,22
2019,8,12,20,2079,2077,2049,-28
2019,8,12,21,2177,2181,2190,9
2019,8,12,22,2237,2240,2290,50
2019,8,12,23,2274,2270,2266,-4
2019,8,13,0,2271,2286,2268,-18
2019,8,13,1,2210,2265,2226,-39
2019,8,13,2,2149,2192,2143,-49
2019,8,13,3,2120,2164,2022,-142
2019,8,13,4,2035,2031,1975,-56
2019,8,13,5,1877,1833,1830,-3
2019,8,13,6,1722,1674,1743,69
2019,8,13,7,1614,1562,1694,132
2019,8,13,8,1539,1492,1578,86
2019,8,13,9,1484,1446,1541,95
2019,8,13,10,1454,1418,1504,86
2019,8,13,11,1448,1414,1578,164
2019,8,13,12,1487,1475,1600,125
2019,8,13,13,1558,1538,1628,90
2019,8,13,14,1619,1597,1615,18
2019,8,13,15,1691,1658,1645,-13
2019,8,13,16,1777,1750,1692,-58
2019,8,13,17,1883,1861,1715,-146
2019,8,13,18,1975,1960,1782,-178
2019,8,13,19,2060,2076,1859,-217
2019,8,13,20,2158,2178,2029,-149
2019,8,13,21,2248,2258,2112,-146
2019,8,13,22,2322,2340,2140,-200
2019,8,13,23,2366,2375,2322,-53
2019,8,14,0,2370,2405,2318,-87
2019,8,14,1,2326,2359,2274,-85
2019,8,14,2,2242,2272,2237,-35
2019,8,14,3,2217,2233,2172,-61
2019,8,14,4,2123,2106,2151,45
2019,8,14,5,1968,1916,1974,58
2019,8,14,6,1792,1741,1973,232
2019,8,14,7,1669,1619,1828,209
2019,8,14,8,1598,1564,1695,131
2019,8,14,9,1541,1501,1624,123
2019,8,14,10,1504,1481,1614,133
2019,8,14,11,1509,1476,1621,145
2019,8,14,12,1546,1518,1730,212
2019,8,14,13,1611,1608,1906,298
2019,8,14,14,1668,1663,1959,296
2019,8,14,15,1727,1715,2022,307
2019,8,14,16,1806,1771,1998,227
2019,8,14,17,1923,1892,1978,86
2019,8,14,18,2008,1965,1892,-73
2019,8,14,19,2098,2029,1876,-153
2019,8,14,20,2190,2093,1890,-203
2019,8,14,21,2269,2186,1910,-276
2019,8,14,22,2330,2223,1935,-288
2019,8,14,23,2366,2187,2060,-127
2019,8,15,0,2324,2118,2055,-63
2019,8,15,1,2269,2054,2098,44
2019,8,15,2,2196,2001,2051,50
2019,8,15,3,2158,1994,2086,92
2019,8,15,4,2076,1909,2073,164
2019,8,15,5,1927,1741,1981,240
2019,8,15,6,1762,1592,1897,305
2019,8,15,7,1656,1503,1726,223
2019,8,15,8,1586,1436,1554,118
2019,8,15,9,1538,1397,1458,61
2019,8,15,10,1503,1376,1510,134
2019,8,15,11,1503,1377,1532,155
2019,8,15,12,1543,1432,1555,123
2019,8,15,13,1614,1519,1652,133
2019,8,15,14,1670,1564,1655,91
2019,8,15,15,1724,1610,1763,153
2019,8,15,16,1797,1685,1792,107
2019,8,15,17,1917,1764,1821,57
2019,8,15,18,2007,1818,1812,-6
2019,8,15,19,2104,1933,1982,49
2019,8,15,20,2191,2050,2152,102
2019,8,15,21,2286,2156,2239,83
2019,8,15,22,2355,2236,2381,145
2019,8,15,23,2390,2252,2313,61
2019,8,16,0,2380,2229,2292,63
2019,8,16,1,2325,2169,2362,193
2019,8,16,2,2236,2096,2250,154
2019,8,16,3,2194,2103,2378,275
2019,8,16,4,2104,1982,2232,250
2019,8,16,5,1951,1830,2041,211
2019,8,16,6,1794,1672,1939,267
2019,8,16,7,1676,1551,1810,259
2019,8,16,8,1551,1472,1742,270
2019,8,16,9,1503,1427,1720,293
2019,8,16,10,1472,1404,1748,344
2019,8,16,11,1465,1407,1759,352
2019,8,16,12,1501,1463,1838,375
2019,8,16,13,1555,1525,1872,347
2019,8,16,14,1626,1564,1890,326
2019,8,16,15,1695,1620,1860,240
2019,8,16,16,1765,1686,1870,184
2019,8,16,17,1883,1792,1898,106
2019,8,16,18,1965,1892,1828,-64
2019,8,16,19,2050,1988,1936,-52
2019,8,16,20,2142,2068,2047,-21
2019,8,16,21,2231,2159,2156,-3
2019,8,16,22,2283,2239,2166,-73
2019,8,16,23,2319,2273,2218,-55
2019,8,17,0,2290,2265,2205,-60
2019,8,17,1,2243,2214,2293,79
2019,8,17,2,2159,2177,2252,75
2019,8,17,3,2142,2119,2130,11
2019,8,17,4,2071,2031,2041,10
2019,8,17,5,1937,1870,1862,-8
2019,8,17,6,1786,1716,1731,15
2019,8,17,7,1676,1606,1680,74
2019,8,17,8,1580,1535,1741,206
2019,8,17,9,1521,1469,1722,253
2019,8,17,10,1484,1422,1783,361
2019,8,17,11,1460,1408,1727,319
2019,8,17,12,1463,1419,1717,298
2019,8,17,13,1460,1416,1767,351
2019,8,17,14,1498,1431,1779,348
2019,8,17,15,1572,1517,1864,347
2019,8,17,16,1654,1616,1934,318
2019,8,17,17,1775,1718,1948,230
2019,8,17,18,1872,1831,1942,111
2019,8,17,19,1962,1931,2008,77
2019,8,17,20,2046,2017,2126,109
2019,8,17,21,2133,2103,2215,112
2019,8,17,22,2210,2181,2260,79
2019,8,17,23,2245,2234,2303,69
2019,8,18,0,2249,2262,2280,18
2019,8,18,1,2210,2240,2261,21
2019,8,18,2,2142,2162,2131,-31
2019,8,18,3,2105,2102,2056,-46
2019,8,18,4,2039,1967,2014,47
2019,8,18,5,1902,1830,1932,102
2019,8,18,6,1761,1684,1762,78
2019,8,18,7,1640,1555,1669,114
2019,8,18,8,1557,1499,1623,124
2019,8,18,9,1501,1444,1563,119
2019,8,18,10,1459,1399,1556,157
2019,8,18,11,1427,1373,1574,201
2019,8,18,12,1423,1371,1616,245
2019,8,18,13,1410,1363,1682,319
2019,8,18,14,1442,1391,1778,387
2019,8,18,15,1518,1467,1838,371
2019,8,18,16,1612,1577,1834,257
2019,8,18,17,1732,1692,1818,126
2019,8,18,18,1844,1802,1798,-4
2019,8,18,19,1940,1930,1814,-116
2019,8,18,20,2034,2040,1879,-161
2019,8,18,21,2128,2145,2017,-128
2019,8,18,22,2207,2253,2059,-194
2019,8,18,23,2259,2308,2050,-258
2019,8,19,0,2276,2345,2090,-255
2019,8,19,1,2260,2314,2155,-159
2019,8,19,2,2201,2230,2057,-173
2019,8,19,3,2156,2176,1973,-203
2019,8,19,4,2081,2034,1884,-150
2019,8,19,5,1933,1846,1776,-70
2019,8,19,6,1773,1685,1726,41
2019,8,19,7,1642,1586,1674,88
2019,8,19,8,1578,1512,1667,155
2019,8,19,9,1526,1461,1585,124
2019,8,19,10,1498,1418,1576,158
2019,8,19,11,1492,1417,1530,113
2019,8,19,12,1526,1456,1576,120
2019,8,19,13,1576,1538,1657,119
2019,8,19,14,1640,1591,1645,54
2019,8,19,15,1714,1640,1691,51
2019,8,19,16,1797,1724,1791,67
2019,8,19,17,1919,1833,1801,-32
2019,8,19,18,2025,1946,1838,-108
2019,8,19,19,2116,2037,1976,-61
2019,8,19,20,2232,2168,2169,1
2019,8,19,21,2329,2265,2230,-35
2019,8,19,22,2410,2338,2374,36
2019,8,19,23,2444,2400,2500,100
2019,8,20,0,2438,2415,2481,66
2019,8,20,1,2392,2407,2385,-22
2019,8,20,2,2292,2297,2238,-59
2019,8,20,3,2262,2276,2234,-42
2019,8,20,4,2165,2112,2195,83
2019,8,20,5,2000,1906,2050,144
2019,8,20,6,1832,1727,1902,175
2019,8,20,7,1698,1620,1817,197
2019,8,20,8,1618,1556,1805,249
2019,8,20,9,1557,1506,1765,259
2019,8,20,10,1515,1453,1715,262
2019,8,20,11,1507,1445,1638,193
2019,8,20,12,1561,1491,1652,161
2019,8,20,13,1619,1572,1627,55
2019,8,20,14,1694,1618,1632,14
2019,8,20,15,1760,1685,1679,-6
2019,8,20,16,1850,1777,1812,35
2019,8,20,17,1952,1908,1924,16
2019,8,20,18,2038,2003,1995,-8
2019,8,20,19,2134,2108,2184,76
2019,8,20,20,2230,2213,2332,119
2019,8,20,21,2313,2295,2381,86
2019,8,20,22,2366,2185,2232,47
2019,8,20,23,2378,2426,2292,-134
2019,8,21,0,2321,2402,2233,-169
2019,8,21,1,2264,2309,2192,-117
2019,8,21,2,2174,2221,2087,-134
2019,8,21,3,2148,2216,2049,-167
2019,8,21,4,2063,2066,1998,-68
2019,8,21,5,1923,1861,1819,-42
2019,8,21,6,1756,1700,1715,15
2019,8,21,7,1652,1600,1610,10
2019,8,21,8,1588,1532,1614,82
2019,8,21,9,1531,1482,1591,109
2019,8,21,10,1481,1443,1593,150
2019,8,21,11,1480,1441,1619,178
2019,8,21,12,1532,1486,1642,156
2019,8,21,13,1607,1557,1636,79
2019,8,21,14,1659,1619,1732,113
2019,8,21,15,1719,1689,1730,41
2019,8,21,16,1804,1770,1839,69
2019,8,21,17,1899,1869,1940,71
2019,8,21,18,1987,1972,1938,-34
2019,8,21,19,2073,2051,1999,-52
2019,8,21,20,2164,2159,2102,-57
2019,8,21,21,2268,2261,2170,-91
2019,8,21,22,2324,2342,2166,-176
2019,8,21,23,2324,2368,2384,16
2019,8,22,0,2262,2287,2255,-32
2019,8,22,1,2182,2141,2249,108
2019,8,22,2,2116,2073,2238,165
2019,8,22,3,2087,2048,2136,88
2019,8,22,4,1994,1934,1993,59
2019,8,22,5,1838,1759,1781,22
2019,8,22,6,1686,1609,1651,42
2019,8,22,7,1573,1515,1599,84
2019,8,22,8,1505,1452,1581,129
2019,8,22,9,1460,1403,1535,132
2019,8,22,10,1427,1373,1527,154
2019,8,22,11,1422,1380,1541,161
2019,8,22,12,1465,1431,1541,110
2019,8,22,13,1536,1516,1585,69
2019,8,22,14,1588,1556,1662,106
2019,8,22,15,1643,1623,1663,40
2019,8,22,16,1716,1679,1752,73
2019,8,22,17,1817,1762,1755,-7
2019,8,22,18,1910,1837,1799,-38
2019,8,22,19,1999,1919,1913,-6
2019,8,22,20,2095,2029,2046,17
2019,8,22,21,2201,2113,2086,-27
2019,8,22,22,2284,2192,2061,-131
2019,8,22,23,2318,2258,1970,-288
2019,8,23,0,2321,2284,2038,-246
2019,8,23,1,2273,2202,2014,-188
2019,8,23,2,2211,2122,2142,20
2019,8,23,3,2170,2133,2177,44
2019,8,23,4,2077,2009,2166,157
2019,8,23,5,1910,1851,2067,216
2019,8,23,6,1742,1707,1881,174
2019,8,23,7,1620,1624,1569,-55
2019,8,23,8,1507,1561,1480,-81
2019,8,23,9,1456,1499,1423,-76
2019,8,23,10,1424,1454,1329,-125
2019,8,23,11,1416,1450,1339,-111
2019,8,23,12,1455,1498,1410,-88
2019,8,23,13,1516,1580,1453,-127
2019,8,23,14,1574,1621,1578,-43
2019,8,23,15,1633,1696,1645,-51
2019,8,23,16,1693,1770,1763,-7
2019,8,23,17,1806,1725,1675,-50
2019,8,23,18,1903,1956,1949,-7
2019,8,23,19,1991,2057,2014,-43
2019,8,23,20,2082,2168,1928,-240
2019,8,23,21,2171,2210,2021,-189
2019,8,23,22,2223,2233,2037,-196
2019,8,23,23,2253,2205,2026,-179
2019,8,24,0,2234,2138,2033,-105
2019,8,24,1,2171,2073,2158,85
2019,8,24,2,2100,2018,2081,63
2019,8,24,3,2079,2023,2121,98
2019,8,24,4,1996,1947,2135,188
2019,8,24,5,1860,1798,1881,83
2019,8,24,6,1704,1666,1868,202
2019,8,24,7,1604,1569,1803,234
2019,8,24,8,1544,1483,1746,263
2019,8,24,9,1478,1426,1671,245
2019,8,24,10,1445,1392,1550,158
2019,8,24,11,1416,1379,1588,209
2019,8,24,12,1424,1389,1692,303
2019,8,24,13,1428,1409,1539,130
2019,8,24,14,1452,1444,1608,164
2019,8,24,15,1529,1519,1690,171
2019,8,24,16,1616,1606,1760,154
2019,8,24,17,1723,1710,1803,93
2019,8,24,18,1819,1807,1861,54
2019,8,24,19,1916,1910,1900,-10
2019,8,24,20,2013,2007,2056,49
2019,8,24,21,2113,2096,2198,102
2019,8,24,22,2203,2188,2352,164
2019,8,24,23,2259,2246,2305,59
2019,8,25,0,2285,2275,2263,-12
2019,8,25,1,2245,2241,2176,-65
2019,8,25,2,2163,2163,2095,-68
2019,8,25,3,2122,2116,2020,-96
2019,8,25,4,2036,1988,2074,86
2019,8,25,5,1889,1841,2052,211
2019,8,25,6,1740,1700,1854,154
2019,8,25,7,1629,1593,1837,244
2019,8,25,8,1545,1535,1907,372
2019,8,25,9,1488,1489,1845,356
2019,8,25,10,1450,1437,1755,318
2019,8,25,11,1422,1414,1726,312
2019,8,25,12,1416,1420,1742,322
2019,8,25,13,1400,1416,1763,347
2019,8,25,14,1424,1434,1814,380
2019,8,25,15,1511,1497,1770,273
2019,8,25,16,1595,1602,1855,253
2019,8,25,17,1720,1712,1935,223
2019,8,25,18,1840,1844,2007,163
2019,8,25,19,1956,1967,2101,134
2019,8,25,20,2071,2091,2106,15
2019,8,25,21,2179,2196,2232,36
2019,8,25,22,2277,2297,2313,16
2019,8,25,23,2328,2353,2356,3
2019,8,26,0,2345,2420,2373,-47
2019,8,26,1,2333,2408,2346,-62
2019,8,26,2,2243,2325,2254,-71
2019,8,26,3,2186,2278,2179,-99
2019,8,26,4,2091,2117,2062,-55
2019,8,26,5,1925,1914,2048,134
2019,8,26,6,1769,1733,2014,281
2019,8,26,7,1643,1629,1897,268
2019,8,26,8,1566,1549,1859,310
2019,8,26,9,1497,1497,1754,257
2019,8,26,10,1462,1455,1735,280
2019,8,26,11,1461,1443,1713,270
2019,8,26,12,1500,1495,1704,209
2019,8,26,13,1557,1579,1726,147
2019,8,26,14,1619,1634,1799,165
2019,8,26,15,1696,1721,1834,113
2019,8,26,16,1791,1826,1906,80
2019,8,26,17,1930,1950,1971,21
2019,8,26,18,2045,2076,1917,-159
2019,8,26,19,2160,2197,2004,-193
2019,8,26,20,2273,2289,2130,-159
2019,8,26,21,2374,2403,2173,-230
2019,8,26,22,2442,2498,2214,-284
2019,8,26,23,2498,2574,2188,-386
2019,8,27,0,2505,2587,2194,-393
2019,8,27,1,2452,2529,2260,-269
2019,8,27,2,2351,2457,2205,-252
2019,8,27,3,2299,2400,2174,-226
2019,8,27,4,2176,2206,2193,-13
2019,8,27,5,1992,1982,2133,151
2019,8,27,6,1814,1818,2128,310
2019,8,27,7,1695,1724,2059,335
2019,8,27,8,1617,1655,2024,369
2019,8,27,9,1553,1610,2011,401
2019,8,27,10,1519,1564,2003,439
2019,8,27,11,1512,1550,1915,365
2019,8,27,12,1546,1604,1877,273
2019,8,27,13,1613,1710,1884,174
2019,8,27,14,1659,1747,1932,185
2019,8,27,15,1718,1802,2009,207
2019,8,27,16,1786,1884,2080,196
2019,8,27,17,1879,1982,2134,152
2019,8,27,18,1983,2071,2116,45
2019,8,27,19,2070,2173,2167,-6
2019,8,27,20,2175,2297,2189,-108
2019,8,27,21,2265,2407,2198,-209
2019,8,27,22,2356,2420,2309,-111
2019,8,27,23,2397,2439,2325,-114
2019,8,28,0,2396,2376,2290,-86
2019,8,28,1,2362,2331,2278,-53
2019,8,28,2,2256,2294,2362,68
2019,8,28,3,2220,2271,2322,51
2019,8,28,4,2128,2136,2149,13
2019,8,28,5,1947,1935,2022,87
2019,8,28,6,1774,1772,1870,98
2019,8,28,7,1653,1674,1746,72
2019,8,28,8,1561,1608,1651,43
2019,8,28,9,1510,1552,1648,96
2019,8,28,10,1479,1524,1667,143
2019,8,28,11,1474,1511,1584,73
2019,8,28,12,1519,1566,1622,56
2019,8,28,13,1600,1655,1644,-11
2019,8,28,14,1645,1689,1665,-24
2019,8,28,15,1695,1748,1731,-17
2019,8,28,16,1764,1832,1767,-65
2019,8,28,17,1853,1910,1768,-142
2019,8,28,18,1951,2004,1844,-160
2019,8,28,19,2048,2090,1993,-97
2019,8,28,20,2141,2177,2097,-80
2019,8,28,21,2251,2291,2090,-201
2019,8,28,22,2336,2359,2178,-181
2019,8,28,23,2385,2425,2307,-118
2019,8,29,0,2383,2433,2433,0
2019,8,29,1,2313,2395,2419,24
2019,8,29,2,2232,2317,2352,35
2019,8,29,3,2198,2277,2315,38
2019,8,29,4,2076,2118,2240,122
2019,8,29,5,1898,1915,1967,52
2019,8,29,6,1739,1764,1990,226
2019,8,29,7,1644,1526,1840,314
2019,8,29,8,1559,1601,1987,386
2019,8,29,9,1505,1535,1973,438
2019,8,29,10,1471,1501,1940,439
2019,8,29,11,1465,1493,1863,370
2019,8,29,12,1513,1533,1920,387
2019,8,29,13,1590,1620,1944,324
2019,8,29,14,1643,1658,1876,218
2019,8,29,15,1697,1714,1965,251
2019,8,29,16,1775,1785,1976,191
2019,8,29,17,1867,1859,1932,73
2019,8,29,18,1970,1971,1902,-69
2019,8,29,19,2070,2076,1980,-96
2019,8,29,20,2177,2198,2082,-116
2019,8,29,21,2291,2300,2095,-205
2019,8,29,22,2366,2357,2175,-182
2019,8,29,23,2409,2412,2165,-247
2019,8,30,0,2391,2378,2108,-270
2019,8,30,1,2317,2298,2325,27
2019,8,30,2,2233,2225,2234,9
2019,8,30,3,2205,2200,2312,112
2019,8,30,4,2094,2082,2339,257
2019,8,30,5,1924,1908,2236,328
2019,8,30,6,1757,1739,2033,294
2019,8,30,7,1650,1617,1924,307
2019,8,30,8,1579,1508,1936,428
2019,8,30,9,1526,1455,1905,450
2019,8,30,10,1482,1421,1901,480
2019,8,30,11,1469,1455,1925,470
2019,8,30,12,1503,1509,1934,425
2019,8,30,13,1575,1584,1856,272
2019,8,30,14,1624,1637,1820,183
2019,8,30,15,1693,1720,1861,141
2019,8,30,16,1775,1798,1866,68
2019,8,30,17,1861,1890,1856,-34
2019,8,30,18,1967,1998,1853,-145
2019,8,30,19,2066,2086,1955,-131
2019,8,30,20,2188,2190,1964,-226
2019,8,30,21,2291,2282,1953,-329
2019,8,30,22,2369,2332,1976,-356
2019,8,30,23,2410,2385,2023,-362
2019,8,31,0,2397,2387,2046,-341
2019,8,31,1,2342,2313,2139,-174
2019,8,31,2,2253,2242,2135,-107
2019,8,31,3,2214,2209,2083,-126
2019,8,31,4,2115,2102,2079,-23
2019,8,31,5,1959,1938,1909,-29
2019,8,31,6,1811,1804,1813,9
2019,8,31,7,1678,1674,1733,59
2019,8,31,8,1610,1584,1597,13
2019,8,31,9,1547,1524,1592,68
2019,8,31,10,1502,1489,1610,121
2019,8,31,11,1486,1474,1454,-20
2019,8,31,12,1493,1476,1423,-53
2019,8,31,13,1514,1487,1399,-88
2019,8,31,14,1539,1496,1421,-75
2019,8,31,15,1616,1583,1428,-155
2019,8,31,16,1713,1687,1484,-203
2019,8,31,17,1805,1798,1534,-264
2019,8,31,18,1918,1915,1542,-373
2019,8,31,19,2011,2002,1604,-398
2019,8,31,20,2115,2085,1637,-448
2019,8,31,21,2212,2170,1737,-433
2019,8,31,22,2267,2232,1795,-437
2019,8,31,23,2299,2261,1931,-330
2019,9,1,0,2279,2290,2010,-280
2019,9,1,1,2208,2255,1936,-319
2019,9,1,2,2135,2188,2005,-183
2019,9,1,3,2094,2165,1913,-252
2019,9,1,4,2004,2054,1681,-373
2019,9,1,5,1875,1898,1633,-265
2019,9,1,6,1741,1763,1558,-205
2019,9,1,7,1631,1653,1546,-107
2019,9,1,8,1562,1580,1391,-189
2019,9,1,9,1503,1509,1324,-185
2019,9,1,10,1462,1467,1307,-160
2019,9,1,11,1440,1436,1302,-134
2019,9,1,12,1445,1454,1269,-185
2019,9,1,13,1452,1456,1228,-228
2019,9,1,14,1476,1456,1197,-259
2019,9,1,15,1540,1550,1291,-259
2019,9,1,16,1643,1653,1388,-265
2019,9,1,17,1733,1752,1493,-259
2019,9,1,18,1844,1868,1510,-358
2019,9,1,19,1947,1981,1502,-479
2019,9,1,20,2051,2079,1553,-526
2019,9,1,21,2144,2136,1665,-471
2019,9,1,22,2191,2214,1756,-458
2019,9,1,23,2212,2256,1818,-438
2019,9,2,0,2209,2234,1756,-478
2019,9,2,1,2153,2182,1787,-395
2019,9,2,2,2098,2118,1783,-335
2019,9,2,3,2074,2071,1763,-308
2019,9,2,4,2000,1973,1626,-347
2019,9,2,5,1861,1831,1501,-330
2019,9,2,6,1719,1683,1397,-286
2019,9,2,7,1610,1582,1383,-199
2019,9,2,8,1555,1510,1312,-198
2019,9,2,9,1506,1464,1270,-194
2019,9,2,10,1471,1436,1220,-216
2019,9,2,11,1443,1425,1187,-238
2019,9,2,12,1446,1434,1191,-243
2019,9,2,13,1457,1453,1229,-224
2019,9,2,14,1473,1461,1232,-229
2019,9,2,15,1528,1508,1286,-222
2019,9,2,16,1621,1614,1415,-199
2019,9,2,17,1726,1726,1538,-188
2019,9,2,18,1836,1846,1636,-210
2019,9,2,19,1938,1954,1767,-187
2019,9,2,20,2041,2046,1925,-121
2019,9,2,21,2139,2134,2039,-95
2019,9,2,22,2218,2216,2086,-130
2019,9,2,23,2259,2277,2095,-182
2019,9,3,0,2272,2330,2120,-210
2019,9,3,1,2238,2295,2074,-221
2019,9,3,2,2172,2241,2086,-155
2019,9,3,3,2135,2227,2040,-187
2019,9,3,4,2035,2097,1997,-100
2019,9,3,5,1885,1917,1983,66
2019,9,3,6,1757,1744,1892,148
2019,9,3,7,1643,1633,1782,149
2019,9,3,8,1544,1545,1732,187
2019,9,3,9,1497,1482,1668,186
2019,9,3,10,1465,1450,1659,209
2019,9,3,11,1454,1449,1650,201
2019,9,3,12,1494,1501,1694,193
2019,9,3,13,1574,1586,1786,200
2019,9,3,14,1629,1628,1809,181
2019,9,3,15,1691,1683,1801,118
2019,9,3,16,1766,1771,1871,100
2019,9,3,17,1867,1848,1878,30
2019,9,3,18,1980,1946,1923,-23
2019,9,3,19,2082,2076,1840,-236
2019,9,3,20,2183,2193,1947,-246
2019,9,3,21,2276,2301,2120,-181
2019,9,3,22,2337,2412,2208,-204
2019,9,3,23,2375,2471,2238,-233
2019,9,4,0,2365,2413,2232,-181
2019,9,4,1,2299,2288,2014,-274
2019,9,4,2,2219,2244,2020,-224
2019,9,4,3,2191,2227,2191,-36
2019,9,4,4,2084,2099,2151,52
2019,9,4,5,1910,1920,2059,139
2019,9,4,6,1743,1736,1963,227
2019,9,4,7,1625,1626,1911,285
2019,9,4,8,1611,1554,1782,228
2019,9,4,9,1549,1520,1679,159
2019,9,4,10,1515,1485,1612,127
2019,9,4,11,1510,1485,1590,105
2019,9,4,12,1552,1523,1574,51
2019,9,4,13,1628,1611,1600,-11
2019,9,4,14,1678,1632,1657,25
2019,9,4,15,1728,1707,1750,43
2019,9,4,16,1819,1798,1521,-277
2019,9,4,17,1908,1891,1419,-472
2019,9,4,18,2006,1982,1617,-365
2019,9,4,19,2101,2070,1692,-378
2019,9,4,20,2200,2151,1934,-217
2019,9,4,21,2291,2241,2033,-208
2019,9,4,22,2351,2268,1999,-269
2019,9,4,23,2386,2300,2005,-295
2019,9,5,0,2360,2307,1961,-346
2019,9,5,1,2299,2249,1954,-295
2019,9,5,2,2228,2201,1862,-339
2019,9,5,3,2195,2170,1883,-287
2019,9,5,4,2079,2027,1784,-243
2019,9,5,5,1914,1849,1746,-103
2019,9,5,6,1759,1691,1676,-15
2019,9,5,7,1645,1590,1631,41
2019,9,5,8,1562,1520,1375,-145
2019,9,5,9,1508,1468,1243,-225
2019,9,5,10,1472,1434,1145,-289
2019,9,5,11,1470,1428,1124,-304
2019,9,5,12,1515,1480,1169,-311
2019,9,5,13,1596,1562,1241,-321
2019,9,5,14,1642,1599,1308,-291
2019,9,5,15,1690,1653,1348,-305
2019,9,5,16,1766,1734,1411,-323
2019,9,5,17,1849,1814,1511,-303
2019,9,5,18,1940,1907,1572,-335
2019,9,5,19,2038,1997,1680,-317
2019,9,5,20,2136,2098,1706,-392
2019,9,5,21,2248,2217,1796,-421
2019,9,5,22,2325,2288,1858,-430
2019,9,5,23,2370,2341,1936,-405
2019,9,6,0,2374,2363,1996,-367
2019,9,6,1,2317,2320,1982,-338
2019,9,6,2,2254,2238,1975,-263
2019,9,6,3,2216,2214,2051,-163
2019,9,6,4,2101,2059,1860,-199
2019,9,6,5,1938,1861,1661,-200
2019,9,6,6,1771,1708,1522,-186
2019,9,6,7,1651,1597,1521,-76
2019,9,6,8,1556,1515,1519,4
2019,9,6,9,1501,1466,1448,-18
2019,9,6,10,1468,1441,1354,-87
2019,9,6,11,1458,1441,1320,-121
2019,9,6,12,1496,1486,1314,-172
2019,9,6,13,1569,1576,1353,-223
2019,9,6,14,1614,1595,1362,-233
2019,9,6,15,1672,1664,1437,-227
2019,9,6,16,1756,1742,1426,-316
2019,9,6,17,1852,1814,1521,-293
2019,9,6,18,1952,1930,1617,-313
2019,9,6,19,2043,2038,1742,-296
2019,9,6,20,2138,2145,1858,-287
2019,9,6,21,2241,2250,1947,-303
2019,9,6,22,2306,2342,1944,-398
2019,9,6,23,2345,2404,1974,-430
2019,9,7,0,2335,2385,2017,-368
2019,9,7,1,2270,2316,2001,-315
2019,9,7,2,2199,2245,2024,-221
2019,9,7,3,2172,2202,2080,-122
2019,9,7,4,2077,2085,2035,-50
2019,9,7,5,1940,1925,1885,-40
2019,9,7,6,1790,1778,1798,20
2019,9,7,7,1675,1656,1666,10
2019,9,7,8,1587,1585,1487,-98
2019,9,7,9,1518,1529,1435,-94
2019,9,7,10,1485,1491,1430,-61
2019,9,7,11,1459,1463,1421,-42
2019,9,7,12,1473,1468,1434,-34
2019,9,7,13,1488,1485,1400,-85
2019,9,7,14,1504,1504,1426,-78
2019,9,7,15,1575,1592,1491,-101
2019,9,7,16,1665,1682,1701,19
2019,9,7,17,1762,1779,1806,27
2019,9,7,18,1856,1877,1821,-56
2019,9,7,19,1937,1977,1918,-59
2019,9,7,20,2027,2066,1931,-135
2019,9,7,21,2116,2135,1973,-162
2019,9,7,22,2178,2187,2021,-166
2019,9,7,23,2204,2209,2078,-131
2019,9,8,0,2207,2130,1983,-147
2019,9,8,1,2141,2050,1957,-93
2019,9,8,2,2084,2038,1986,-52
2019,9,8,3,2042,1997,1797,-200
2019,9,8,4,1971,1887,1815,-72
2019,9,8,5,1845,1748,1644,-104
2019,9,8,6,1716,1634,1623,-11
2019,9,8,7,1606,1536,1494,-42
2019,9,8,8,1549,1496,1359,-137
2019,9,8,9,1481,1445,1333,-112
2019,9,8,10,1447,1421,1332,-89
2019,9,8,11,1425,1400,1328,-72
2019,9,8,12,1424,1417,1362,-55
2019,9,8,13,1436,1433,1364,-69
2019,9,8,14,1456,1442,1321,-121
2019,9,8,15,1517,1513,1347,-166
2019,9,8,16,1606,1602,1360,-242
2019,9,8,17,1688,1692,1420,-272
2019,9,8,18,1782,1784,1560,-224
2019,9,8,19,1872,1842,1714,-128
2019,9,8,20,1967,1891,1767,-124
2019,9,8,21,2046,1989,1891,-98
2019,9,8,22,2096,2079,1879,-200
2019,9,8,23,2129,2132,1885,-247
2019,9,9,0,2122,2121,1817,-304
2019,9,9,1,2088,2090,1904,-186
2019,9,9,2,2054,2065,1869,-196
2019,9,9,3,2029,2048,1906,-142
2019,9,9,4,1947,1921,1945,24
2019,9,9,5,1807,1767,1894,127
2019,9,9,6,1662,1653,1823,170
2019,9,9,7,1548,1571,1705,134
2019,9,9,8,1480,1514,1608,94
2019,9,9,9,1429,1478,1631,153
2019,9,9,10,1407,1458,1696,238
2019,9,9,11,1410,1485,1708,223
2019,9,9,12,1447,1474,1609,135
2019,9,9,13,1538,1579,1626,47
2019,9,9,14,1585,1615,1576,-39
2019,9,9,15,1631,1656,1543,-113
2019,9,9,16,1697,1750,1595,-155
2019,9,9,17,1763,1825,1642,-183
2019,9,9,18,1843,1880,1587,-293
2019,9,9,19,1912,1927,1556,-371
2019,9,9,20,1997,1972,1707,-265
2019,9,9,21,2084,2044,1768,-276
2019,9,9,22,2141,2126,1764,-362
2019,9,9,23,2179,2169,1781,-388
2019,9,10,0,2177,2194,1856,-338
2019,9,10,1,2139,2178,1808,-370
2019,9,10,2,2088,2123,1745,-378
2019,9,10,3,2060,2099,1894,-205
2019,9,10,4,1963,1979,2013,34
2019,9,10,5,1798,1809,1997,188
2019,9,10,6,1646,1667,1935,268
2019,9,10,7,1541,1570,1736,166
2019,9,10,8,1479,1514,1646,132
2019,9,10,9,1437,1483,1665,182
2019,9,10,10,1407,1453,1612,159
2019,9,10,11,1408,1450,1614,164
2019,9,10,12,1456,1496,1726,230
2019,9,10,13,1540,1585,1863,278
2019,9,10,14,1588,1607,1953,346
2019,9,10,15,1641,1659,1961,302
2019,9,10,16,1688,1718,1953,235
2019,9,10,17,1752,1774,1987,213
2019,9,10,18,1823,1864,1991,127
2019,9,10,19,1895,1943,2077,134
2019,9,10,20,1971,2029,2207,178
2019,9,10,21,2051,2116,2285,169
2019,9,10,22,2106,2177,2471,294
2019,9,10,23,2131,2169,2418,249
2019,9,11,0,2107,2107,2289,182
2019,9,11,1,2068,2020,2317,297
2019,9,11,2,2038,2003,2220,217
2019,9,11,3,2015,1946,2125,179
2019,9,11,4,1923,1889,2192,303
2019,9,11,5,1780,1728,2071,343
2019,9,11,6,1636,1594,1902,308
2019,9,11,7,1534,1518,1804,286
2019,9,11,8,1489,1469,1807,338
2019,9,11,9,1439,1432,1771,339
2019,9,11,10,1410,1407,1771,364
2019,9,11,11,1410,1401,1728,327
2019,9,11,12,1453,1447,1768,321
2019,9,11,13,1538,1545,1904,359
2019,9,11,14,1584,1578,1869,291
2019,9,11,15,1628,1624,1880,256
2019,9,11,16,1679,1674,1963,289
2019,9,11,17,1737,1737,2038,301
2019,9,11,18,1803,1801,2142,341
2019,9,11,19,1862,1872,2296,424
2019,9,11,20,1936,1921,2259,338
2019,9,11,21,2020,2035,2325,290
2019,9,11,22,2085,2109,2347,238
2019,9,11,23,2122,2149,2365,216
2019,9,12,0,2100,2190,2438,248
2019,9,12,1,2075,2131,2367,236
2019,9,12,2,2035,2100,1965,-135
2019,9,12,3,2013,2072,1925,-147
2019,9,12,4,1922,1960,1868,-92
2019,9,12,5,1778,1799,1714,-85
2019,9,12,6,1632,1627,1629,2
2019,9,12,7,1530,1541,1609,68
2019,9,12,8,1455,1486,1629,143
2019,9,12,9,1408,1414,1611,197
2019,9,12,10,1383,1376,1640,264
2019,9,12,11,1381,1391,1486,95
2019,9,12,12,1425,1437,1481,44
2019,9,12,13,1508,1514,1517,3
2019,9,12,14,1551,1545,1529,-16
2019,9,12,15,1585,1574,1478,-96
2019,9,12,16,1631,1633,1436,-197
2019,9,12,17,1684,1676,1404,-272
2019,9,12,18,1746,1739,1437,-302
2019,9,12,19,1804,1795,1454,-341
2019,9,12,20,1872,1857,1420,-437
2019,9,12,21,1952,1932,1483,-449
2019,9,12,22,2011,2012,1546,-466
2019,9,12,23,2033,2050,1587,-463
2019,9,13,0,2038,2068,1568,-500
2019,9,13,1,2007,2013,1533,-480
2019,9,13,2,1986,1962,1514,-448
2019,9,13,3,1972,1904,1562,-342
2019,9,13,4,1882,1822,1521,-301
2019,9,13,5,1751,1652,1440,-212
2019,9,13,6,1610,1514,1532,18
2019,9,13,7,1499,1422,1423,1
2019,9,13,8,1448,1361,1452,91
2019,9,13,9,1401,1319,1500,181
2019,9,13,10,1375,1297,1465,168
2019,9,13,11,1378,1308,1443,135
2019,9,13,12,1414,1360,1316,-44
2019,9,13,13,1496,1473,1282,-191
2019,9,13,14,1539,1503,1327,-176
2019,9,13,15,1574,1545,1322,-223
2019,9,13,16,1620,1610,1323,-287
2019,9,13,17,1661,1674,1353,-321
2019,9,13,18,1717,1749,1416,-333
2019,9,13,19,1778,1798,1450,-348
2019,9,13,20,1849,1908,1594,-314
2019,9,13,21,1936,1996,1706,-290
2019,9,13,22,2004,2042,1871,-171
2019,9,13,23,2052,2085,2068,-17
2019,9,14,0,2072,2090,2077,-13
2019,9,14,1,2027,2023,2032,9
2019,9,14,2,1981,1992,2047,55
2019,9,14,3,1956,1992,2042,50
2019,9,14,4,1889,1897,2055,158
2019,9,14,5,1768,1766,2019,253
2019,9,14,6,1639,1653,1885,232
2019,9,14,7,1538,1554,1754,200
2019,9,14,8,1486,1481,1690,209
2019,9,14,9,1428,1438,1630,192
2019,9,14,10,1406,1405,1603,198
2019,9,14,11,1385,1390,1566,176
2019,9,14,12,1399,1411,1534,123
2019,9,14,13,1427,1435,1549,114
2019,9,14,14,1448,1445,1558,113
2019,9,14,15,1510,1511,1627,116
2019,9,14,16,1575,1579,1694,115
2019,9,14,17,1640,1671,1721,50
2019,9,14,18,1703,1757,1619,-138
2019,9,14,19,1761,1841,1861,20
2019,9,14,20,1810,1913,1972,59
2019,9,14,21,1873,1941,2068,127
2019,9,14,22,1929,1956,2008,52
2019,9,14,23,1946,1934,2125,191
2019,9,15,0,1962,1877,2058,181
2019,9,15,1,1926,1823,2041,218
2019,9,15,2,1902,1801,2030,229
2019,9,15,3,1880,1750,1951,201
2019,9,15,4,1816,1687,1884,197
2019,9,15,5,1712,1606,1779,173
2019,9,15,6,1600,1518,1653,135
2019,9,15,7,1502,1451,1597,146
2019,9,15,8,1441,1405,1591,186
2019,9,15,9,1395,1369,1578,209
2019,9,15,10,1369,1343,1574,231
2019,9,15,11,1354,1337,1540,203
2019,9,15,12,1364,1349,1547,198
2019,9,15,13,1377,1366,1589,223
2019,9,15,14,1392,1380,1600,220
2019,9,15,15,1452,1416,1634,218
2019,9,15,16,1521,1460,1748,288
2019,9,15,17,1571,1501,1798,297
2019,9,15,18,1630,1529,1668,139
2019,9,15,19,1692,1524,1687,163
2019,9,15,20,1740,1533,1710,177
2019,9,15,21,1801,1546,1853,307
2019,9,15,22,1829,1559,1869,310
2019,9,15,23,1856,1582,1985,403
2019,9,16,0,1894,1578,1886,308
2019,9,16,1,1870,1609,1812,203
2019,9,16,2,1865,1659,1831,172
2019,9,16,3,1842,1674,1790,116
2019,9,16,4,1781,1616,1703,87
2019,9,16,5,1680,1537,1670,133
2019,9,16,6,1557,1429,1634,205
2019,9,16,7,1461,1376,1626,250
2019,9,16,8,1399,1328,1428,100
2019,9,16,9,1354,1304,1310,6
2019,9,16,10,1338,1300,1242,-58
2019,9,16,11,1346,1317,1240,-77
2019,9,16,12,1391,1361,1335,-26
2019,9,16,13,1481,1462,1472,10
2019,9,16,14,1534,1496,1592,96
2019,9,16,15,1572,1531,1718,187
2019,9,16,16,1624,1587,1889,302
2019,9,16,17,1673,1612,2000,388
2019,9,16,18,1711,1640,1927,287
2019,9,16,19,1750,1674,1965,291
2019,9,16,20,1798,1731,1956,225
2019,9,16,21,1858,1786,1970,184
2019,9,16,22,1906,1842,1959,117
2019,9,16,23,1935,1890,1965,75
2019,9,17,0,1950,1907,1936,29
2019,9,17,1,1921,1857,1866,9
2019,9,17,2,1902,1863,1822,-41
2019,9,17,3,1901,1842,1882,40
2019,9,17,4,1818,1714,1993,279
2019,9,17,5,1681,1584,1964,380
2019,9,17,6,1543,1464,2007,543
2019,9,17,7,1442,1378,1863,485
2019,9,17,8,1396,1332,1815,483
2019,9,17,9,1352,1304,1690,386
2019,9,17,10,1339,1285,1640,355
2019,9,17,11,1343,1293,1633,340
2019,9,17,12,1385,1350,1603,253
2019,9,17,13,1468,1459,1672,213
2019,9,17,14,1526,1506,1672,166
2019,9,17,15,1554,1529,1729,200
2019,9,17,16,1595,1568,1801,233
2019,9,17,17,1641,1622,1923,301
2019,9,17,18,1688,1658,1994,336
2019,9,17,19,1739,1714,2111,397
2019,9,17,20,1802,1780,2217,437
2019,9,17,21,1873,1847,2227,380
2019,9,17,22,1943,1910,2218,308
2019,9,17,23,1974,1967,2217,250
2019,9,18,0,1986,2074,2268,194
2019,9,18,1,1954,1931,2075,144
2019,9,18,2,1938,1924,2039,115
2019,9,18,3,1925,1893,2006,113
2019,9,18,4,1833,1758,1897,139
2019,9,18,5,1710,1648,1812,164
2019,9,18,6,1564,1474,1717,243
2019,9,18,7,1470,1383,1692,309
2019,9,18,8,1408,1327,1592,265
2019,9,18,9,1370,1291,1602,311
2019,9,18,10,1345,1276,1584,308
2019,9,18,11,1349,1288,1572,284
2019,9,18,12,1388,1344,1425,81
2019,9,18,13,1464,1438,1435,-3
2019,9,18,14,1518,1474,1487,13
2019,9,18,15,1562,1502,1549,47
2019,9,18,16,1621,1550,1595,45
2019,9,18,17,1669,1610,1653,43
2019,9,18,18,1726,1664,1678,14
2019,9,18,19,1781,1724,1778,54
2019,9,18,20,1847,1802,1939,137
2019,9,18,21,1917,1872,2013,141
2019,9,18,22,1967,1938,2050,112
2019,9,18,23,2006,1989,2117,128
2019,9,19,0,2008,2009,2163,154
2019,9,19,1,1972,1970,2081,111
2019,9,19,2,1941,1932,2046,114
2019,9,19,3,1928,1885,1910,25
2019,9,19,4,1845,1775,1855,80
2019,9,19,5,1719,1617,1739,122
2019,9,19,6,1576,1473,1603,130
2019,9,19,7,1477,1402,1514,112
2019,9,19,8,1428,1346,1395,49
2019,9,19,9,1377,1308,1347,39
2019,9,19,10,1354,1294,1353,59
2019,9,19,11,1355,1310,1418,108
2019,9,19,12,1401,1357,1507,150
2019,9,19,13,1483,1471,1573,102
2019,9,19,14,1540,1498,1628,130
2019,9,19,15,1569,1531,1648,117
2019,9,19,16,1626,1573,1670,97
2019,9,19,17,1674,1633,1694,61
2019,9,19,18,1727,1703,1766,63
2019,9,19,19,1778,1777,1848,71
2019,9,19,20,1836,1871,1936,65
2019,9,19,21,1898,1957,2011,54
2019,9,19,22,1950,2022,2116,94
2019,9,19,23,1954,2043,2221,178
2019,9,20,0,1973,2005,2174,169
2019,9,20,1,1915,1923,2257,334
2019,9,20,2,1883,1913,2364,451
2019,9,20,3,1875,1874,2324,450
2019,9,20,4,1810,1786,2265,479
2019,9,20,5,1683,1630,2009,379
2019,9,20,6,1549,1511,1781,270
2019,9,20,7,1454,1409,1687,278
2019,9,20,8,1404,1357,1701,344
2019,9,20,9,1358,1321,1556,235
2019,9,20,10,1334,1304,1515,211
2019,9,20,11,1333,1315,1481,166
2019,9,20,12,1380,1373,1552,179
2019,9,20,13,1447,1473,1527,54
2019,9,20,14,1505,1517,1536,19
2019,9,20,15,1530,1539,1585,46
2019,9,20,16,1586,1600,1617,17
2019,9,20,17,1635,1657,1652,-5
2019,9,20,18,1682,1710,1726,16
2019,9,20,19,1731,1749,1891,142
2019,9,20,20,1797,1828,2062,234
2019,9,20,21,1856,1875,2152,277
2019,9,20,22,1895,1907,2257,350
2019,9,20,23,1909,1935,2319,384
2019,9,21,0,1933,1925,2350,425
2019,9,21,1,1883,1888,2261,373
2019,9,21,2,1849,1868,2193,325
2019,9,21,3,1858,1840,2253,413
2019,9,21,4,1798,1750,2188,438
2019,9,21,5,1686,1638,2012,374
2019,9,21,6,1554,1522,1828,306
2019,9,21,7,1465,1431,1792,361
2019,9,21,8,1414,1368,1730,362
2019,9,21,9,1369,1324,1607,283
2019,9,21,10,1339,1305,1530,225
2019,9,21,11,1330,1293,1498,205
2019,9,21,12,1344,1306,1461,155
2019,9,21,13,1369,1333,1444,111
2019,9,21,14,1391,1343,1420,77
2019,9,21,15,1437,1393,1484,91
2019,9,21,16,1490,1431,1562,131
2019,9,21,17,1536,1481,1572,91
2019,9,21,18,1585,1538,1615,77
2019,9,21,19,1636,1584,1729,145
2019,9,21,20,1690,1625,1773,148
2019,9,21,21,1748,1693,1985,292
2019,9,21,22,1805,1745,2161,416
2019,9,21,23,1854,1792,2234,442
2019,9,22,0,1873,1795,2298,503
2019,9,22,1,1846,1790,2269,479
2019,9,22,2,1822,1798,2265,467
2019,9,22,3,1801,1774,2339,565
2019,9,22,4,1740,1682,2268,586
2019,9,22,5,1641,1589,2139,550
2019,9,22,6,1533,1482,2078,596
2019,9,22,7,1443,1394,1995,601
2019,9,22,8,1367,1332,1884,552
2019,9,22,9,1317,1291,1883,592
2019,9,22,10,1293,1275,1848,573
2019,9,22,11,1284,1266,1731,465
2019,9,22,12,1297,1276,1674,398
2019,9,22,13,1315,1295,1646,351
2019,9,22,14,1332,1295,1616,321
2019,9,22,15,1367,1335,1592,257
2019,9,22,16,1411,1370,1619,249
2019,9,22,17,1464,1410,1704,294
2019,9,22,18,1520,1452,1842,390
2019,9,22,19,1577,1499,1894,395
2019,9,22,20,1629,1551,1916,365
2019,9,22,21,1687,1606,2027,421
2019,9,22,22,1744,1692,2108,416
2019,9,22,23,1803,1750,2108,358
2019,9,23,0,1837,1804,2077,273
2019,9,23,1,1809,1798,2024,226
2019,9,23,2,1778,1782,1993,211
2019,9,23,3,1771,1728,1949,221
2019,9,23,4,1714,1611,1901,290
2019,9,23,5,1600,1473,1834,361
2019,9,23,6,1469,1345,1815,470
2019,9,23,7,1389,1271,1774,503
2019,9,23,8,1310,1238,1685,447
2019,9,23,9,1274,1218,1687,469
2019,9,23,10,1259,1213,1686,473
2019,9,23,11,1258,1223,1647,424
2019,9,23,12,1299,1280,1646,366
2019,9,23,13,1379,1383,1713,330
2019,9,23,14,1437,1414,1716,302
2019,9,23,15,1473,1437,1724,287
2019,9,23,16,1508,1458,1732,274
2019,9,23,17,1545,1504,1836,332
2019,9,23,18,1578,1540,1901,361
2019,9,23,19,1611,1573,2024,451
2019,9,23,20,1662,1636,2108,472
2019,9,23,21,1708,1637,2091,454
2019,9,23,22,1749,1699,2087,388
2019,9,23,23,1758,1783,2214,431
2019,9,24,0,1767,1738,2173,435
2019,9,24,1,1719,1674,2033,359
2019,9,24,2,1703,1694,2055,361
2019,9,24,3,1718,1677,2011,334
2019,9,24,4,1655,1587,2021,434
2019,9,24,5,1545,1489,2188,699
2019,9,24,6,1430,1396,2098,702
2019,9,24,7,1346,1329,1870,541
2019,9,24,8,1332,1309,1660,351
2019,9,24,9,1303,1338,1629,291
2019,9,24,10,1286,1302,1572,270
2019,9,24,11,1291,1268,1575,307
2019,9,24,12,1342,1328,1611,283
2019,9,24,13,1435,1440,1647,207
2019,9,24,14,1485,1464,1722,258
2019,9,24,15,1509,1482,1732,250
2019,9,24,16,1535,1486,1789,303
2019,9,24,17,1567,1526,1845,319
2019,9,24,18,1611,1556,1859,303
2019,9,24,19,1652,1563,1865,302
2019,9,24,20,1721,1565,1866,301
2019,9,24,21,1780,1601,1902,301
2019,9,24,22,1842,1653,2096,443
2019,9,24,23,1873,1727,2273,546
2019,9,25,0,1888,1841,2422,581
2019,9,25,1,1862,1742,2304,562
2019,9,25,2,1846,1842,2392,550
2019,9,25,3,1807,1712,2186,474
2019,9,25,4,1716,1633,2104,471
2019,9,25,5,1589,1491,1987,496
2019,9,25,6,1466,1380,1889,509
2019,9,25,7,1369,1325,1739,414
2019,9,25,8,1305,1277,1687,410
2019,9,25,9,1274,1262,1676,414
2019,9,25,10,1251,1246,1629,383
2019,9,25,11,1250,1259,1635,376
2019,9,25,12,1300,1311,1663,352
2019,9,25,13,1383,1413,1726,313
2019,9,25,14,1436,1448,1748,300
2019,9,25,15,1460,1466,1715,249
2019,9,25,16,1501,1475,1703,228
2019,9,25,17,1547,1518,1812,294
2019,9,25,18,1602,1554,1967,413
2019,9,25,19,1653,1603,2027,424
2019,9,25,20,1720,1677,2098,421
2019,9,25,21,1793,1764,2176,412
2019,9,25,22,1878,1839,2296,457
2019,9,25,23,1946,1888,2390,502
2019,9,26,0,1943,1918,2226,308
2019,9,26,1,1920,1884,2114,230
2019,9,26,2,1889,1873,2072,199
2019,9,26,3,1877,1832,1949,117
2019,9,26,4,1796,1715,1876,161
2019,9,26,5,1656,1570,1782,212
2019,9,26,6,1531,1457,1635,178
2019,9,26,7,1433,1367,1610,243
2019,9,26,8,1372,1323,1612,289
2019,9,26,9,1328,1277,1549,272
2019,9,26,10,1317,1270,1548,278
2019,9,26,11,1319,1273,1532,259
2019,9,26,12,1361,1328,1556,228
2019,9,26,13,1454,1433,1652,219
2019,9,26,14,1499,1464,1631,167
2019,9,26,15,1531,1489,1648,159
2019,9,26,16,1568,1530,1654,124
2019,9,26,17,1617,1591,1686,95
2019,9,26,18,1663,1653,1780,127
2019,9,26,19,1721,1704,1823,119
2019,9,26,20,1771,1780,1867,87
2019,9,26,21,1835,1850,1934,84
2019,9,26,22,1900,1909,2031,122
2019,9,26,23,1932,1933,2066,133
2019,9,27,0,1952,1928,2013,85
2019,9,27,1,1902,1893,2013,120
2019,9,27,2,1900,1894,2034,140
2019,9,27,3,1858,1839,2022,183
2019,9,27,4,1774,1740,1957,217
2019,9,27,5,1648,1598,1821,223
2019,9,27,6,1525,1479,1729,250
2019,9,27,7,1424,1389,1654,265
2019,9,27,8,1354,1343,1645,302
2019,9,27,9,1313,1311,1628,317
2019,9,27,10,1298,1285,1586,301
2019,9,27,11,1299,1293,1562,269
2019,9,27,12,1344,1341,1637,296
2019,9,27,13,1430,1454,1665,211
2019,9,27,14,1477,1482,1683,201
2019,9,27,15,1497,1493,1694,201
2019,9,27,16,1528,1526,1798,272
2019,9,27,17,1555,1574,1846,272
2019,9,27,18,1586,1621,1855,234
2019,9,27,19,1611,1661,1924,263
2019,9,27,20,1641,1705,2012,307
2019,9,27,21,1690,1757,2120,363
2019,9,27,22,1730,1797,2161,364
2019,9,27,23,1777,1818,2218,400
2019,9,28,0,1798,1796,2154,358
2019,9,28,1,1759,1744,2072,328
2019,9,28,2,1762,1756,2080,324
2019,9,28,3,1760,1739,2061,322
2019,9,28,4,1695,1664,2009,345
2019,9,28,5,1593,1555,1866,311
2019,9,28,6,1475,1451,1815,364
2019,9,28,7,1388,1380,1683,303
2019,9,28,8,1348,1326,1612,286
2019,9,28,9,1305,1287,1634,347
2019,9,28,10,1287,1274,1552,278
2019,9,28,11,1281,1259,1499,240
2019,9,28,12,1295,1283,1549,266
2019,9,28,13,1321,1333,1569,236
2019,9,28,14,1344,1332,1527,195
2019,9,28,15,1376,1399,1549,150
2019,9,28,16,1407,1425,1560,135
2019,9,28,17,1457,1465,1584,119
2019,9,28,18,1503,1507,1592,85
2019,9,28,19,1557,1554,1666,112
2019,9,28,20,1616,1605,1728,123
2019,9,28,21,1673,1656,1913,257
2019,9,28,22,1728,1716,2077,361
2019,9,28,23,1789,1752,2128,376
2019,9,29,0,1824,1770,2126,356
2019,9,29,1,1805,1739,2039,300
2019,9,29,2,1782,1741,2041,300
2019,9,29,3,1762,1714,2043,329
2019,9,29,4,1695,1637,1991,354
2019,9,29,5,1599,1535,1975,440
2019,9,29,6,1487,1457,1977,520
2019,9,29,7,1402,1382,1866,484
2019,9,29,8,1359,1330,1735,405
2019,9,29,9,1317,1288,1610,322
2019,9,29,10,1288,1265,1564,299
2019,9,29,11,1281,1259,1545,286
2019,9,29,12,1288,1270,1521,251
2019,9,29,13,1312,1300,1509,209
2019,9,29,14,1329,1311,1561,250
2019,9,29,15,1362,1355,1595,240
2019,9,29,16,1412,1404,1675,271
2019,9,29,17,1461,1454,1687,233
2019,9,29,18,1519,1505,1779,274
2019,9,29,19,1575,1562,1877,315
2019,9,29,20,1637,1620,1954,334
2019,9,29,21,1701,1674,2072,398
2019,9,29,22,1760,1746,2149,403
2019,9,29,23,1826,1802,2231,429
2019,9,30,0,1865,1834,2196,362
2019,9,30,1,1850,1821,2038,217
2019,9,30,2,1835,1854,2035,181
2019,9,30,3,1805,1800,1990,190
2019,9,30,4,1736,1699,1875,176
2019,9,30,5,1621,1567,1789,222
2019,9,30,6,1491,1438,1718,280
2019,9,30,7,1407,1362,1649,287
2019,9,30,8,1349,1320,1655,335
2019,9,30,9,1315,1288,1623,335
2019,9,30,10,1291,1282,1635,353
2019,9,30,11,1283,1292,1629,337
2019,9,30,12,1296,1343,1582,239
2019,9,30,13,1332,1444,1602,158
2019,9,30,14,1355,1479,1626,147
2019,9,30,15,1403,1500,1635,135
2019,9,30,16,1445,1528,1734,206
2019,9,30,17,1481,1579,1768,189
2019,9,30,18,1540,1652,1761,109
2019,9,30,19,1602,1713,1810,97
2019,9,30,20,1664,1787,1883,96
2019,9,30,21,1732,1855,1903,48
2019,9,30,22,1791,1923,1903,-20
2019,9,30,23,1860,1978,1842,-136
2019,10,1,0,1893,1992,1865,-127
2019,10,1,1,1867,1943,1754,-189
2019,10,1,2,1851,1960,1565,-395
2019,10,1,3,1818,1944,1825,-119
2019,10,1,4,1750,1846,1874,28
2019,10,1,5,1636,1707,1792,85
2019,10,1,6,1501,1578,1737,159
2019,10,1,7,1418,1491,1666,175
2019,10,1,8,1390,1446,1638,192
2019,10,1,9,1350,1396,1629,233
2019,10,1,10,1333,1372,1648,276
2019,10,1,11,1334,1377,1658,281
2019,10,1,12,1385,1436,1641,205
2019,10,1,13,1477,1553,1641,88
2019,10,1,14,1523,1604,1652,48
2019,10,1,15,1552,1619,1752,133
2019,10,1,16,1589,1651,1786,135
2019,10,1,17,1628,1698,1753,55
2019,10,1,18,1672,1738,1672,-66
2019,10,1,19,1713,1741,1782,41
2019,10,1,20,1762,1745,1769,24
2019,10,1,21,1818,1769,1825,56
2019,10,1,22,1866,1766,1874,108
2019,10,1,23,1880,1732,1931,199
2019,10,2,0,1904,1709,1936,227
2019,10,2,1,1861,1709,1953,244
2019,10,2,2,1862,1749,1960,211
2019,10,2,3,1847,1736,1794,58
2019,10,2,4,1748,1668,1595,-73
2019,10,2,5,1622,1539,1570,31
2019,10,2,6,1487,1431,1571,140
2019,10,2,7,1399,1374,1609,235
2019,10,2,8,1383,1332,1452,120
2019,10,2,9,1343,1308,1447,139
2019,10,2,10,1321,1283,1476,193
2019,10,2,11,1325,1293,1475,182
2019,10,2,12,1372,1350,1475,125
2019,10,2,13,1472,1460,1414,-46
2019,10,2,14,1520,1491,1582,91
2019,10,2,15,1534,1497,1524,27
2019,10,2,16,1554,1499,1491,-8
2019,10,2,17,1578,1540,1505,-35
2019,10,2,18,1619,1561,1531,-30
2019,10,2,19,1658,1593,1551,-42
2019,10,2,20,1706,1643,1565,-78
2019,10,2,21,1754,1710,1607,-103
2019,10,2,22,1813,1764,1593,-171
2019,10,2,23,1853,1787,1605,-182
2019,10,3,0,1863,1815,1595,-220
2019,10,3,1,1820,1793,1563,-230
2019,10,3,2,1826,1802,1569,-233
2019,10,3,3,1810,1768,1481,-287
2019,10,3,4,1727,1652,1380,-272
2019,10,3,5,1607,1532,1332,-200
2019,10,3,6,1490,1416,1315,-101
2019,10,3,7,1409,1348,1287,-61
2019,10,3,8,1324,1296,1357,61
2019,10,3,9,1298,1271,1342,71
2019,10,3,10,1279,1252,1216,-36
2019,10,3,11,1285,1278,1162,-116
2019,10,3,12,1341,1340,1196,-144
2019,10,3,13,1439,1463,1159,-304
2019,10,3,14,1490,1497,1187,-310
2019,10,3,15,1508,1485,1345,-140
2019,10,3,16,1525,1483,1520,37
2019,10,3,17,1549,1506,1701,195
2019,10,3,18,1579,1526,1723,197
2019,10,3,19,1594,1564,1734,170
2019,10,3,20,1617,1614,1723,109
2019,10,3,21,1653,1663,1738,75
2019,10,3,22,1701,1711,1694,-17
2019,10,3,23,1732,1772,1616,-156
2019,10,4,0,1734,1774,1551,-223
2019,10,4,1,1704,1739,1395,-344
2019,10,4,2,1720,1751,1351,-400
2019,10,4,3,1710,1717,1301,-416
2019,10,4,4,1646,1622,1222,-400
2019,10,4,5,1539,1527,1067,-460
2019,10,4,6,1433,1418,989,-429
2019,10,4,7,1356,1340,992,-348
2019,10,4,8,1330,1307,898,-409
2019,10,4,9,1293,1280,831,-449
2019,10,4,10,1275,1261,897,-364
2019,10,4,11,1285,1293,940,-353
2019,10,4,12,1329,1345,970,-375
2019,10,4,13,1419,1468,948,-520
2019,10,4,14,1474,1532,1010,-522
2019,10,4,15,1499,1528,1054,-474
2019,10,4,16,1509,1555,1081,-474
2019,10,4,17,1537,1562,1151,-411
2019,10,4,18,1547,1591,1225,-366
2019,10,4,19,1559,1600,1335,-265
2019,10,4,20,1582,1572,1392,-180
2019,10,4,21,1609,1560,1403,-157
2019,10,4,22,1631,1529,1322,-207
2019,10,4,23,1653,1533,1189,-344
2019,10,5,0,1664,1559,1237,-322
2019,10,5,1,1657,1572,1270,-302
2019,10,5,2,1666,1624,1265,-359
2019,10,5,3,1682,1636,1247,-389
2019,10,5,4,1633,1567,1297,-270
2019,10,5,5,1540,1496,1335,-161
2019,10,5,6,1440,1399,1353,-46
2019,10,5,7,1361,1344,1350,6
2019,10,5,8,1325,1304,1367,63
2019,10,5,9,1293,1274,1350,76
2019,10,5,10,1279,1267,1280,13
2019,10,5,11,1275,1273,1287,14
2019,10,5,12,1292,1291,1332,41
2019,10,5,13,1335,1332,1354,22
2019,10,5,14,1362,1346,1376,30
2019,10,5,15,1386,1377,1345,-32
2019,10,5,16,1418,1382,1401,19
2019,10,5,17,1448,1398,1473,75
2019,10,5,18,1473,1421,1532,111
2019,10,5,19,1498,1446,1503,57
2019,10,5,20,1525,1482,1479,-3
2019,10,5,21,1553,1526,1525,-1
2019,10,5,22,1590,1579,1564,-15
2019,10,5,23,1627,1633,1638,5
2019,10,6,0,1652,1651,1672,21
2019,10,6,1,1657,1648,1516,-132
2019,10,6,2,1678,1666,1481,-185
2019,10,6,3,1673,1612,1570,-42
2019,10,6,4,1619,1549,1554,5
2019,10,6,5,1528,1461,1562,101
2019,10,6,6,1436,1373,1573,200
2019,10,6,7,1363,1293,1475,182
2019,10,6,8,1302,1261,1365,104
2019,10,6,9,1269,1229,1373,144
2019,10,6,10,1251,1216,1480,264
2019,10,6,11,1250,1221,1473,252
2019,10,6,12,1258,1239,1479,240
2019,10,6,13,1292,1269,1474,205
2019,10,6,14,1308,1277,1521,244
2019,10,6,15,1324,1312,1509,197
2019,10,6,16,1353,1320,1489,169
2019,10,6,17,1378,1341,1442,101
2019,10,6,18,1409,1370,1471,101
2019,10,6,19,1438,1406,1442,36
2019,10,6,20,1460,1443,1525,82
2019,10,6,21,1491,1503,1632,129
2019,10,6,22,1529,1561,1667,106
2019,10,6,23,1563,1630,1798,168
2019,10,7,0,1601,1652,1928,276
2019,10,7,1,1616,1664,1982,318
2019,10,7,2,1636,1688,1842,154
2019,10,7,3,1636,1660,1784,124
2019,10,7,4,1579,1576,1729,153
2019,10,7,5,1494,1453,1648,195
2019,10,7,6,1402,1347,1532,185
2019,10,7,7,1334,1291,1524,233
2019,10,7,8,1274,1239,1494,255
2019,10,7,9,1253,1228,1323,95
2019,10,7,10,1248,1227,1241,14
2019,10,7,11,1262,1253,1192,-61
2019,10,7,12,1315,1317,1195,-122
2019,10,7,13,1411,1445,1219,-226
2019,10,7,14,1470,1486,1234,-252
2019,10,7,15,1484,1468,1225,-243
2019,10,7,16,1482,1454,1289,-165
2019,10,7,17,1479,1461,1354,-107
2019,10,7,18,1474,1442,1373,-69
2019,10,7,19,1467,1531,1458,-73
2019,10,7,20,1480,1498,1442,-56
2019,10,7,21,1501,1529,1489,-40
2019,10,7,22,1526,1567,1580,13
2019,10,7,23,1561,1613,1630,17
2019,10,8,0,1579,1637,1640,3
2019,10,8,1,1584,1634,1647,13
2019,10,8,2,1623,1692,1707,15
2019,10,8,3,1644,1664,1697,33
2019,10,8,4,1581,1567,1583,16
2019,10,8,5,1488,1449,1469,20
2019,10,8,6,1386,1354,1503,149
2019,10,8,7,1308,1312,1488,176
2019,10,8,8,1287,1264,1386,122
2019,10,8,9,1262,1263,1415,152
2019,10,8,10,1252,1246,1479,233
2019,10,8,11,1262,1246,1552,306
2019,10,8,12,1318,1311,1592,281
2019,10,8,13,1409,1421,1650,229
2019,10,8,14,1469,1481,1681,200
2019,10,8,15,1482,1533,1704,171
2019,10,8,16,1487,1466,1692,226
2019,10,8,17,1490,1464,1728,264
2019,10,8,18,1510,1501,1745,244
2019,10,8,19,1513,1549,1867,318
2019,10,8,20,1536,1596,2047,451
2019,10,8,21,1572,1589,1911,322
2019,10,8,22,1601,1598,1958,360
2019,10,8,23,1633,1595,1885,290
2019,10,9,0,1641,1624,1915,291
2019,10,9,1,1632,1644,1920,276
2019,10,9,2,1656,1700,1970,270
2019,10,9,3,1670,1656,1989,333
2019,10,9,4,1609,1601,1933,332
2019,10,9,5,1498,1489,1865,376
2019,10,9,6,1394,1386,1848,462
2019,10,9,7,1326,1336,1816,480
2019,10,9,8,1292,1298,1706,408
2019,10,9,9,1270,1279,1667,388
2019,10,9,10,1257,1280,1758,478
2019,10,9,11,1269,1287,1749,462
2019,10,9,12,1329,1342,1801,459
2019,10,9,13,1429,1451,1800,349
2019,10,9,14,1484,1483,1783,300
2019,10,9,15,1490,1463,1736,273
2019,10,9,16,1493,1452,1813,361
2019,10,9,17,1507,1478,1885,407
2019,10,9,18,1520,1472,1945,473
2019,10,9,19,1546,1506,2042,536
2019,10,9,20,1551,1537,2053,516
2019,10,9,21,1607,1608,2098,490
2019,10,9,22,1655,1613,2047,434
2019,10,9,23,1692,1654,2111,457
2019,10,10,0,1701,1667,2149,482
2019,10,10,1,1684,1667,2101,434
2019,10,10,2,1711,1735,2121,386
2019,10,10,3,1704,1710,2129,419
2019,10,10,4,1639,1622,2067,445
2019,10,10,5,1514,1519,2003,484
2019,10,10,6,1418,1423,1873,450
2019,10,10,7,1346,1352,1851,499
2019,10,10,8,1280,1309,1776,467
2019,10,10,9,1251,1283,1751,468
2019,10,10,10,1244,1265,1728,463
2019,10,10,11,1254,1276,1718,442
2019,10,10,12,1309,1322,1736,414
2019,10,10,13,1408,1441,1733,292
2019,10,10,14,1475,1473,1826,353
2019,10,10,15,1489,1505,1904,399
2019,10,10,16,1480,1481,1924,443
2019,10,10,17,1477,1489,2028,539
2019,10,10,18,1490,1497,2049,552
2019,10,10,19,1505,1502,2064,562
2019,10,10,20,1508,1511,2109,598
2019,10,10,21,1524,1533,2129,596
2019,10,10,22,1537,1561,2118,557
2019,10,10,23,1557,1593,2089,496
2019,10,11,0,1561,1597,2105,508
2019,10,11,1,1582,1616,2021,405
2019,10,11,2,1602,1668,1978,310
2019,10,11,3,1622,1654,1964,310
2019,10,11,4,1584,1581,1887,306
2019,10,11,5,1500,1509,1788,279
2019,10,11,6,1412,1427,1719,292
2019,10,11,7,1341,1368,1688,320
2019,10,11,8,1337,1345,1683,338
2019,10,11,9,1321,1330,1623,293
2019,10,11,10,1326,1329,1665,336
2019,10,11,11,1344,1341,1587,246
2019,10,11,12,1394,1391,1564,173
2019,10,11,13,1494,1502,1515,13
2019,10,11,14,1576,1552,1504,-48
2019,10,11,15,1566,1547,1503,-44
2019,10,11,16,1536,1513,1506,-7
2019,10,11,17,1514,1475,1487,12
2019,10,11,18,1489,1447,1470,23
2019,10,11,19,1472,1418,1463,45
2019,10,11,20,1454,1409,1476,67
2019,10,11,21,1454,1409,1479,70
2019,10,11,22,1457,1421,1451,30
2019,10,11,23,1476,1443,1449,6
2019,10,12,0,1496,1465,1504,39
2019,10,12,1,1525,1516,1623,107
2019,10,12,2,1582,1580,1749,169
2019,10,12,3,1618,1602,1773,171
2019,10,12,4,1598,1559,1883,324
2019,10,12,5,1532,1506,1851,345
2019,10,12,6,1455,1434,1777,343
2019,10,12,7,1395,1382,1772,390
2019,10,12,8,1366,1352,1724,372
2019,10,12,9,1340,1345,1756,411
2019,10,12,10,1333,1348,1789,441
2019,10,12,11,1337,1360,1839,479
2019,10,12,12,1362,1394,1877,483
2019,10,12,13,1407,1458,1851,393
2019,10,12,14,1431,1491,1855,364
2019,10,12,15,1447,1490,1896,406
2019,10,12,16,1443,1461,1800,339
2019,10,12,17,1423,1430,1798,368
2019,10,12,18,1410,1404,1776,372
2019,10,12,19,1383,1390,1961,571
2019,10,12,20,1377,1379,2000,621
2019,10,12,21,1378,1378,1946,568
2019,10,12,22,1404,1402,1951,549
2019,10,12,23,1435,1436,1932,496
2019,10,13,0,1478,1477,1857,380
2019,10,13,1,1521,1522,1834,312
2019,10,13,2,1567,1592,1972,380
2019,10,13,3,1581,1589,1958,369
2019,10,13,4,1550,1527,1992,465
2019,10,13,5,1489,1470,1986,516
2019,10,13,6,1418,1239,1738,499
2019,10,13,7,1350,1360,1927,567
2019,10,13,8,1307,1315,1868,553
2019,10,13,9,1286,1300,1784,484
2019,10,13,10,1277,1299,1709,410
2019,10,13,11,1280,1295,1669,374
2019,10,13,12,1303,1305,1706,401
2019,10,13,13,1339,1353,1685,332
2019,10,13,14,1359,1370,1715,345
2019,10,13,15,1367,1378,1718,340
2019,10,13,16,1374,1375,1653,278
2019,10,13,17,1366,1353,1695,342
2019,10,13,18,1366,1342,1756,414
2019,10,13,19,1378,1353,1862,509
2019,10,13,20,1387,1360,1891,531
2019,10,13,21,1394,1377,1929,552
2019,10,13,22,1430,1409,1895,486
2019,10,13,23,1456,1463,1858,395
2019,10,14,0,1501,1516,1862,346
2019,10,14,1,1528,1569,1870,301
2019,10,14,2,1578,1617,1880,263
2019,10,14,3,1612,1603,1801,198
2019,10,14,4,1557,1540,1832,292
2019,10,14,5,1466,1457,1903,446
2019,10,14,6,1381,1380,1869,489
2019,10,14,7,1323,1321,1843,522
2019,10,14,8,1290,1281,1804,523
2019,10,14,9,1268,1271,1787,516
2019,10,14,10,1262,1263,1853,590
2019,10,14,11,1274,1268,1861,593
2019,10,14,12,1334,1318,1885,567
2019,10,14,13,1433,1425,1882,457
2019,10,14,14,1499,1486,1796,310
2019,10,14,15,1501,1487,1745,258
2019,10,14,16,1487,1442,1688,246
2019,10,14,17,1489,1453,1762,309
2019,10,14,18,1489,1454,1880,426
2019,10,14,19,1488,1450,1969,519
2019,10,14,20,1490,1475,2019,544
2019,10,14,21,1500,1501,2051,550
2019,10,14,22,1529,1549,2075,526
2019,10,14,23,1544,1576,2059,483
2019,10,15,0,1559,1592,1950,358
2019,10,15,1,1566,1633,1822,189
2019,10,15,2,1619,1700,1810,110
2019,10,15,3,1648,1689,1822,133
2019,10,15,4,1592,1604,1794,190
2019,10,15,5,1499,1488,1764,276
2019,10,15,6,1400,1383,1811,428
2019,10,15,7,1336,1328,1789,461
2019,10,15,8,1302,1295,1680,385
2019,10,15,9,1281,1278,1669,391
2019,10,15,10,1271,1272,1625,353
2019,10,15,11,1284,1282,1607,325
2019,10,15,12,1338,1335,1648,313
2019,10,15,13,1441,1466,1722,256
2019,10,15,14,1507,1518,1777,259
2019,10,15,15,1505,1499,1807,308
2019,10,15,16,1489,1457,1746,289
2019,10,15,17,1481,1441,1829,388
2019,10,15,18,1480,1405,1842,437
2019,10,15,19,1489,1479,1843,364
2019,10,15,20,1497,1487,1795,308
2019,10,15,21,1521,1529,1806,277
2019,10,15,22,1544,1535,1828,293
2019,10,15,23,1562,1562,1845,283
2019,10,16,0,1587,1564,1783,219
2019,10,16,1,1596,1577,1820,243
2019,10,16,2,1637,1622,1914,292
2019,10,16,3,1659,1601,1844,243
2019,10,16,4,1604,1528,1776,248
2019,10,16,5,1503,1430,1695,265
2019,10,16,6,1402,1324,1718,394
2019,10,16,7,1336,1323,1735,412
2019,10,16,8,1292,1242,1614,372
2019,10,16,9,1276,1223,1558,335
2019,10,16,10,1267,1224,1498,274
2019,10,16,11,1274,1248,1473,225
2019,10,16,12,1328,1320,1460,140
2019,10,16,13,1436,1448,1434,-14
2019,10,16,14,1502,1496,1462,-34
2019,10,16,15,1498,1480,1529,49
2019,10,16,16,1478,1447,1574,127
2019,10,16,17,1461,1421,1637,216
2019,10,16,18,1451,1410,1700,290
2019,10,16,19,1449,1425,1736,311
2019,10,16,20,1467,1445,1808,363
2019,10,16,21,1492,1475,1813,338
2019,10,16,22,1516,1515,1701,186
2019,10,16,23,1543,1528,1692,164
2019,10,17,0,1568,1556,1877,321
2019,10,17,1,1580,1586,1880,294
2019,10,17,2,1623,1628,1937,309
2019,10,17,3,1645,1613,1884,271
2019,10,17,4,1587,1534,1872,338
2019,10,17,5,1487,1435,1799,364
2019,10,17,6,1390,1348,1777,429
2019,10,17,7,1325,1301,1743,442
2019,10,17,8,1282,1272,1772,500
2019,10,17,9,1262,1256,1704,448
2019,10,17,10,1254,1246,1712,466
2019,10,17,11,1269,1266,1697,431
2019,10,17,12,1326,1335,1737,402
2019,10,17,13,1424,1475,1775,300
2019,10,17,14,1488,1511,1818,307
2019,10,17,15,1492,1489,1774,285
2019,10,17,16,1473,1473,1680,207
2019,10,17,17,1459,1423,1700,277
2019,10,17,18,1452,1422,1764,342
2019,10,17,19,1463,1441,1916,475
2019,10,17,20,1470,1451,1976,525
2019,10,17,21,1486,1481,2060,579
2019,10,17,22,1510,1512,2065,553
2019,10,17,23,1530,1530,2038,508
2019,10,18,0,1542,1534,2040,506
2019,10,18,1,1559,1580,2045,465
2019,10,18,2,1596,1650,2149,499
2019,10,18,3,1626,1636,2156,520
2019,10,18,4,1576,1568,2106,538
2019,10,18,5,1480,1533,2034,501
2019,10,18,6,1374,1366,1874,508
2019,10,18,7,1306,1317,1903,586
2019,10,18,8,1273,1284,1925,641
2019,10,18,9,1251,1267,1921,654
2019,10,18,10,1243,1258,1832,574
2019,10,18,11,1247,1271,1792,521
2019,10,18,12,1298,1313,1816,503
2019,10,18,13,1394,1426,1880,454
2019,10,18,14,1459,1471,1864,393
2019,10,18,15,1470,1473,1922,449
2019,10,18,16,1460,1477,1994,517
2019,10,18,17,1451,1490,2130,640
2019,10,18,18,1440,1509,2186,677
2019,10,18,19,1449,1538,2209,671
2019,10,18,20,1460,1543,2211,668
2019,10,18,21,1471,1521,2172,651
2019,10,18,22,1488,1534,2198,664
2019,10,18,23,1499,1515,2179,664
2019,10,19,0,1514,1536,2128,592
2019,10,19,1,1530,1564,2166,602
2019,10,19,2,1566,1597,2200,603
2019,10,19,3,1585,1594,2144,550
2019,10,19,4,1548,1549,2172,623
2019,10,19,5,1475,1460,2161,701
2019,10,19,6,1392,1389,2087,698
2019,10,19,7,1331,1348,2054,706
2019,10,19,8,1287,1318,1921,603
2019,10,19,9,1269,1293,1831,538
2019,10,19,10,1255,1280,1741,461
2019,10,19,11,1257,1295,1685,390
2019,10,19,12,1284,1330,1645,315
2019,10,19,13,1335,1389,1625,236
2019,10,19,14,1367,1426,1579,153
2019,10,19,15,1383,1439,1605,166
2019,10,19,16,1378,1410,1593,183
2019,10,19,17,1360,1378,1572,194
2019,10,19,18,1351,1356,1582,226
2019,10,19,19,1351,1340,1678,338
2019,10,19,20,1354,1327,1807,480
2019,10,19,21,1362,1343,1879,536
2019,10,19,22,1385,1369,1945,576
2019,10,19,23,1419,1408,1930,522
2019,10,20,0,1456,1442,1871,429
2019,10,20,1,1497,1501,1875,374
2019,10,20,2,1552,1598,2097,499
2019,10,20,3,1562,1594,2129,535
2019,10,20,4,1517,1557,2099,542
2019,10,20,5,1449,1476,2013,537
2019,10,20,6,1378,1408,1988,580
2019,10,20,7,1322,1374,2004,630
2019,10,20,8,1296,1331,2006,675
2019,10,20,9,1270,1310,1968,658
2019,10,20,10,1266,1296,1960,664
2019,10,20,11,1267,1306,1975,669
2019,10,20,12,1285,1326,1993,667
2019,10,20,13,1319,1374,2065,691
2019,10,20,14,1345,1397,2125,728
2019,10,20,15,1360,1437,2168,731
2019,10,20,16,1377,1447,2193,746
2019,10,20,17,1374,1416,2194,778
2019,10,20,18,1372,1384,2152,768
2019,10,20,19,1384,1407,2144,737
2019,10,20,20,1380,1403,2138,735
2019,10,20,21,1392,1411,2140,729
2019,10,20,22,1411,1438,2167,729
2019,10,20,23,1440,1456,2128,672
2019,10,21,0,1488,1487,2054,567
2019,10,21,1,1549,1573,2078,505
2019,10,21,2,1615,1660,2082,422
2019,10,21,3,1641,1652,2088,436
2019,10,21,4,1597,1588,2018,430
2019,10,21,5,1521,1505,1880,375
2019,10,21,6,1436,1417,1951,534
2019,10,21,7,1381,1354,1911,557
2019,10,21,8,1342,1332,1976,644
2019,10,21,9,1328,1337,1963,626
2019,10,21,10,1324,1324,1865,541
2019,10,21,11,1342,1335,1805,470
2019,10,21,12,1397,1374,1807,433
2019,10,21,13,1504,1569,1953,384
2019,10,21,14,1581,1603,1991,388
2019,10,21,15,1591,1578,2082,504
2019,10,21,16,1544,1519,2092,573
2019,10,21,17,1510,1482,2217,735
2019,10,21,18,1487,1455,2274,819
2019,10,21,19,1478,1432,2185,753
2019,10,21,20,1464,1435,2184,749
2019,10,21,21,1469,1432,2183,751
2019,10,21,22,1484,1432,2180,748
2019,10,21,23,1497,1470,2141,671
2019,10,22,0,1508,1519,2089,570
2019,10,22,1,1538,1605,2034,429
2019,10,22,2,1611,1655,1939,284
2019,10,22,3,1653,1650,1908,258
2019,10,22,4,1614,1580,1894,314
2019,10,22,5,1534,1470,1765,295
2019,10,22,6,1439,1381,1730,349
2019,10,22,7,1375,1331,1707,376
2019,10,22,8,1364,1304,1662,358
2019,10,22,9,1349,1290,1582,292
2019,10,22,10,1343,1293,1589,296
2019,10,22,11,1360,1321,1587,266
2019,10,22,12,1416,1397,1614,217
2019,10,22,13,1528,1538,1669,131
2019,10,22,14,1601,1585,1712,127
2019,10,22,15,1603,1540,1779,239
2019,10,22,16,1559,1494,1859,365
2019,10,22,17,1515,1443,1891,448
2019,10,22,18,1454,1424,1860,436
2019,10,22,19,1465,1407,1809,402
2019,10,22,20,1450,1409,1787,378
2019,10,22,21,1458,1414,1796,382
2019,10,22,22,1478,1424,1820,396
2019,10,22,23,1490,1452,1877,425
2019,10,23,0,1523,1478,1824,346
2019,10,23,1,1560,1556,1841,285
2019,10,23,2,1625,1615,1682,67
2019,10,23,3,1664,1648,1989,341
2019,10,23,4,1624,1582,2072,490
2019,10,23,5,1540,1491,2007,516
2019,10,23,6,1446,1407,2021,614
2019,10,23,7,1383,1360,2010,650
2019,10,23,8,1332,1326,2026,700
2019,10,23,9,1311,1309,2020,711
2019,10,23,10,1308,1306,1968,662
2019,10,23,11,1325,1324,1928,604
2019,10,23,12,1384,1385,1931,546
2019,10,23,13,1511,1516,1955,439
2019,10,23,14,1575,1557,2031,474
2019,10,23,15,1567,1530,1983,453
2019,10,23,16,1527,1494,2016,522
2019,10,23,17,1489,1465,1979,514
2019,10,23,18,1467,1453,1891,438
2019,10,23,19,1462,1434,1870,436
2019,10,23,20,1458,1452,1895,443
2019,10,23,21,1461,1465,1888,423
2019,10,23,22,1473,1487,1889,402
2019,10,23,23,1491,1504,1913,409
2019,10,24,0,1513,1531,1981,450
2019,10,24,1,1550,1602,1995,393
2019,10,24,2,1615,1672,1969,297
2019,10,24,3,1650,1668,2002,334
2019,10,24,4,1602,1584,1945,361
2019,10,24,5,1514,1490,1745,255
2019,10,24,6,1425,1405,1702,297
2019,10,24,7,1361,1363,1784,421
2019,10,24,8,1353,1358,1615,257
2019,10,24,9,1331,1336,1564,228
2019,10,24,10,1326,1321,1379,58
2019,10,24,11,1336,1362,1336,-26
2019,10,24,12,1390,1428,1320,-108
2019,10,24,13,1500,1585,1382,-203
2019,10,24,14,1576,1639,1476,-163
2019,10,24,15,1583,1633,1602,-31
2019,10,24,16,1557,1606,1664,58
2019,10,24,17,1530,1571,1712,141
2019,10,24,18,1513,1556,1780,224
2019,10,24,19,1510,1555,1801,246
2019,10,24,20,1502,1543,1844,301
2019,10,24,21,1503,1521,1795,274
2019,10,24,22,1505,1502,1662,160
2019,10,24,23,1517,1512,1571,59
2019,10,25,0,1547,1539,1485,-54
2019,10,25,1,1598,1627,1481,-146
2019,10,25,2,1677,1678,1470,-208
2019,10,25,3,1724,1676,1499,-177
2019,10,25,4,1691,1629,1448,-181
2019,10,25,5,1622,1544,1291,-253
2019,10,25,6,1537,1458,1291,-167
2019,10,25,7,1474,1412,1262,-150
2019,10,25,8,1445,1378,1236,-142
2019,10,25,9,1427,1375,1210,-165
2019,10,25,10,1427,1384,1225,-159
2019,10,25,11,1442,1425,1260,-165
2019,10,25,12,1496,1499,1252,-247
2019,10,25,13,1613,1623,1131,-492
2019,10,25,14,1699,1691,1135,-556
2019,10,25,15,1687,1645,1192,-453
2019,10,25,16,1634,1600,1227,-373
2019,10,25,17,1582,1535,1262,-273
2019,10,25,18,1533,1486,1379,-107
2019,10,25,19,1506,1456,1359,-97
2019,10,25,20,1478,1426,1328,-98
2019,10,25,21,1471,1421,1319,-102
2019,10,25,22,1464,1421,1320,-101
2019,10,25,23,1477,1437,1345,-92
2019,10,26,0,1499,1482,1318,-164
2019,10,26,1,1551,1558,1309,-249
2019,10,26,2,1628,1611,1268,-343
2019,10,26,3,1662,1622,1261,-361
2019,10,26,4,1639,1586,1369,-217
2019,10,26,5,1581,1521,1457,-64
2019,10,26,6,1508,1449,1483,34
2019,10,26,7,1454,1406,1531,125
2019,10,26,8,1411,1379,1574,195
2019,10,26,9,1393,1390,1453,63
2019,10,26,10,1383,1366,1422,56
2019,10,26,11,1394,1381,1412,31
2019,10,26,12,1427,1427,1442,15
2019,10,26,13,1502,1506,1413,-93
2019,10,26,14,1518,1540,1457,-83
2019,10,26,15,1524,1521,1537,16
2019,10,26,16,1503,1478,1599,121
2019,10,26,17,1460,1441,1630,189
2019,10,26,18,1427,1439,1728,289
2019,10,26,19,1408,1417,1723,306
2019,10,26,20,1392,1382,1731,349
2019,10,26,21,1385,1369,1762,393
2019,10,26,22,1393,1401,1774,373
2019,10,26,23,1419,1424,1803,379
2019,10,27,0,1458,1454,1875,421
2019,10,27,1,1511,1547,1859,312
2019,10,27,2,1584,1612,1881,269
2019,10,27,3,1609,1592,1864,272
2019,10,27,4,1570,1548,1865,317
2019,10,27,5,1511,1485,1861,376
2019,10,27,6,1443,1410,1769,359
2019,10,27,7,1385,1368,1720,352
2019,10,27,8,1343,1336,1726,390
2019,10,27,9,1322,1317,1715,398
2019,10,27,10,1314,1317,1736,419
2019,10,27,11,1328,1324,1747,423
2019,10,27,12,1354,1348,1746,398
2019,10,27,13,1412,1408,1786,378
2019,10,27,14,1429,1454,1901,447
2019,10,27,15,1431,1464,1925,461
2019,10,27,16,1429,1435,1977,542
2019,10,27,17,1403,1406,2047,641
2019,10,27,18,1392,1393,2106,713
2019,10,27,19,1393,1379,2063,684
2019,10,27,20,1389,1370,2061,691
2019,10,27,21,1395,1375,2039,664
2019,10,27,22,1415,1397,1995,598
2019,10,27,23,1438,1444,2036,592
2019,10,28,0,1486,1489,2115,626
2019,10,28,1,1539,1591,2192,601
2019,10,28,2,1611,1641,2182,541
2019,10,28,3,1634,1613,2070,457
2019,10,28,4,1585,1549,2064,515
2019,10,28,5,1503,1460,1989,529
2019,10,28,6,1418,1372,1907,535
2019,10,28,7,1366,1326,1874,548
2019,10,28,8,1343,1302,1827,525
2019,10,28,9,1321,1291,1740,449
2019,10,28,10,1309,1294,1714,420
2019,10,28,11,1330,1310,1743,433
2019,10,28,12,1389,1402,1703,301
2019,10,28,13,1505,1538,1735,197
2019,10,28,14,1583,1615,1675,60
2019,10,28,15,1592,1632,1676,44
2019,10,28,16,1574,1620,1733,113
2019,10,28,17,1553,1611,1706,95
2019,10,28,18,1529,1605,1829,224
2019,10,28,19,1530,1536,1923,387
2019,10,28,20,1520,1484,1916,432
2019,10,28,21,1517,1480,1971,491
2019,10,28,22,1524,1477,1972,495
2019,10,28,23,1533,1501,1957,456
2019,10,29,0,1515,1556,1938,382
2019,10,29,1,1591,1670,2010,340
2019,10,29,2,1648,1722,2053,331
2019,10,29,3,1659,1717,1999,282
2019,10,29,4,1611,1661,2009,348
2019,10,29,5,1545,1562,1896,334
2019,10,29,6,1475,1479,1650,171
2019,10,29,7,1420,1432,1655,223
2019,10,29,8,1408,1411,1682,271
2019,10,29,9,1396,1394,1696,302
2019,10,29,10,1395,1399,1791,392
2019,10,29,11,1412,1427,1810,383
2019,10,29,12,1469,1514,1791,277
2019,10,29,13,1599,1656,1824,168
2019,10,29,14,1687,1712,1849,137
2019,10,29,15,1673,1675,1876,201
2019,10,29,16,1611,1614,1877,263
2019,10,29,17,1556,1557,1804,247
2019,10,29,18,1508,1513,1886,373
2019,10,29,19,1479,1467,1899,432
2019,10,29,20,1457,1457,1965,508
2019,10,29,21,1457,1464,2045,581
2019,10,29,22,1462,1475,2052,577
2019,10,29,23,1487,1500,1982,482
2019,10,30,0,1523,1531,2006,475
2019,10,30,1,1592,1634,2079,445
2019,10,30,2,1656,1688,2123,435
2019,10,30,3,1687,1659,2055,396
2019,10,30,4,1648,1613,1898,285
2019,10,30,5,1560,1518,1841,323
2019,10,30,6,1475,1433,1766,333
2019,10,30,7,1410,1395,1656,261
2019,10,30,8,1437,1379,1558,179
2019,10,30,9,1417,1369,1502,133
2019,10,30,10,1414,1374,1555,181
2019,10,30,11,1434,1420,1585,165
2019,10,30,12,1498,1515,1605,90
2019,10,30,13,1626,1647,1570,-77
2019,10,30,14,1725,1702,1550,-152
2019,10,30,15,1737,1680,1569,-111
2019,10,30,16,1713,1620,1582,-38
2019,10,30,17,1681,1549,1720,171
2019,10,30,18,1655,1533,1629,96
2019,10,30,19,1636,1529,1694,165
2019,10,30,20,1616,1492,1687,195
2019,10,30,21,1605,1488,1714,226
2019,10,30,22,1597,1502,1755,253
2019,10,30,23,1612,1526,1741,215
2019,10,31,0,1643,1594,1757,163
2019,10,31,1,1718,1725,1939,214
2019,10,31,2,1805,1804,1978,174
2019,10,31,3,1846,1815,1898,83
2019,10,31,4,1814,1770,1694,-76
2019,10,31,5,1739,1675,1577,-98
2019,10,31,6,1640,1585,1628,43
2019,10,31,7,1575,1540,1613,73
2019,10,31,8,1526,1499,1687,188
2019,10,31,9,1517,1508,1629,121
2019,10,31,10,1524,1514,1534,20
2019,10,31,11,1547,1552,1577,25
2019,10,31,12,1616,1633,1549,-84
2019,10,31,13,1749,1786,1567,-219
2019,10,31,14,1831,1840,1652,-188
2019,10,31,15,1817,1788,1644,-144
2019,10,31,16,1736,1710,1629,-81
2019,10,31,17,1668,1662,1623,-39
2019,10,31,18,1611,1595,1583,-12
2019,10,31,19,1565,1537,1528,-9
2019,10,31,20,1528,1507,1498,-9
2019,10,31,21,1512,1488,1453,-35
2019,10,31,22,1502,1473,1440,-33
2019,10,31,23,1512,1495,1490,-5
2019,11,1,0,1542,1525,1543,18
2019,11,1,1,1627,1633,1769,136
2019,11,1,2,1727,1681,1790,109
2019,11,1,3,1755,1714,1800,86
2019,11,1,4,1725,1700,1801,101
2019,11,1,5,1653,1627,1896,269
2019,11,1,6,1567,1566,1891,325
2019,11,1,7,1508,1529,1824,295
2019,11,1,8,1488,1495,1709,214
2019,11,1,9,1473,1489,1683,194
2019,11,1,10,1476,1490,1662,172
2019,11,1,11,1496,1520,1723,203
2019,11,1,12,1560,1594,1687,93
2019,11,1,13,1681,1719,1641,-78
2019,11,1,14,1756,1787,1650,-137
2019,11,1,15,1737,1736,1630,-106
2019,11,1,16,1664,1653,1600,-53
2019,11,1,17,1584,1574,1623,49
2019,11,1,18,1531,1527,1577,50
2019,11,1,19,1504,1485,1547,62
2019,11,1,20,1471,1462,1547,85
2019,11,1,21,1451,1450,1555,105
2019,11,1,22,1450,1458,1541,83
2019,11,1,23,1456,1475,1494,19
2019,11,2,0,1490,1529,1545,16
2019,11,2,1,1566,1645,1688,43
2019,11,2,2,1657,1687,1749,62
2019,11,2,3,1685,1688,1800,112
2019,11,2,4,1666,1660,1815,155
2019,11,2,5,1614,1591,1715,124
2019,11,2,6,1543,1506,1676,170
2019,11,2,7,1486,1469,1635,166
2019,11,2,8,1468,1432,1486,54
2019,11,2,9,1451,1423,1413,-10
2019,11,2,10,1448,1416,1361,-55
2019,11,2,11,1464,1431,1303,-128
2019,11,2,12,1500,1498,1245,-253
2019,11,2,13,1574,1574,1234,-340
2019,11,2,14,1606,1631,1284,-347
2019,11,2,15,1601,1618,1453,-165
2019,11,2,16,1579,1563,1518,-45
2019,11,2,17,1543,1499,1610,111
2019,11,2,18,1501,1451,1680,229
2019,11,2,19,1471,1426,1782,356
2019,11,2,20,1436,1399,1915,516
2019,11,2,21,1416,1378,1942,564
2019,11,2,22,1414,1393,1945,552
2019,11,2,23,1425,1432,1820,388
2019,11,3,0,1468,1486,1730,244
2019,11,3,1,1550,1615,1773,158
2019,11,3,2,1631,1663,1802,139
2019,11,3,3,1663,1660,1799,139
2019,11,3,4,1629,1638,1824,186
2019,11,3,5,1574,1553,1868,315
2019,11,3,6,1509,1575,2002,427
2019,11,3,7,1463,1465,1916,451
2019,11,3,8,1425,1426,1808,382
2019,11,3,9,1411,1416,1836,420
2019,11,3,10,1404,1424,1825,401
2019,11,3,11,1415,1427,1848,421
2019,11,3,12,1447,1463,1938,475
2019,11,3,13,1514,1500,1924,424
2019,11,3,14,1531,1544,1921,377
2019,11,3,15,1514,1554,1962,408
2019,11,3,16,1493,1535,1934,399
2019,11,3,17,1464,1484,1909,425
2019,11,3,18,1438,1445,1895,450
2019,11,3,19,1419,1421,1972,551
2019,11,3,20,1404,1419,2101,682
2019,11,3,21,1414,1414,2115,701
2019,11,3,22,1420,1422,2092,670
2019,11,3,23,1469,1457,2055,598
2019,11,4,0,1559,1516,1929,413
2019,11,4,1,1637,1650,1858,208
2019,11,4,2,1666,1702,1823,121
2019,11,4,3,1629,1686,1832,146
2019,11,4,4,1561,1637,1665,28
2019,11,4,5,1523,1587,1795,208
2019,11,4,6,1484,1497,1753,256
2019,11,4,7,1430,1428,1769,341
2019,11,4,8,1388,1396,1760,364
2019,11,4,9,1379,1377,1739,362
2019,11,4,10,1378,1377,1729,352
2019,11,4,11,1400,1389,1737,348
2019,11,4,12,1456,1436,1759,323
2019,11,4,13,1579,1574,1881,307
2019,11,4,14,1654,1635,1824,189
2019,11,4,15,1635,1627,1889,262
2019,11,4,16,1584,1549,1802,253
2019,11,4,17,1548,1504,1744,240
2019,11,4,18,1518,1474,1803,329
2019,11,4,19,1501,1463,1902,439
2019,11,4,20,1477,1467,1987,520
2019,11,4,21,1481,1458,2036,578
2019,11,4,22,1487,1476,2057,581
2019,11,4,23,1526,1507,2060,553
2019,11,5,0,1605,1554,1987,433
2019,11,5,1,1670,1653,1914,261
2019,11,5,2,1695,1692,1884,192
2019,11,5,3,1653,1680,1824,144
2019,11,5,4,1576,1650,1782,132
2019,11,5,5,1533,1562,1717,155
2019,11,5,6,1487,1483,1570,87
2019,11,5,7,1419,1402,1433,31
2019,11,5,8,1407,1353,1218,-135
2019,11,5,9,1381,1347,1214,-133
2019,11,5,10,1381,1354,1252,-102
2019,11,5,11,1390,1348,1150,-198
2019,11,5,12,1454,1405,1139,-266
2019,11,5,13,1542,1493,1152,-341
2019,11,5,14,1641,1604,1120,-484
2019,11,5,15,1655,1605,1179,-426
2019,11,5,16,1600,1543,1127,-416
2019,11,5,17,1542,1491,1129,-362
2019,11,5,18,1510,1463,1268,-195
2019,11,5,19,1489,1449,1442,-7
2019,11,5,20,1491,1438,1512,74
2019,11,5,21,1488,1449,1540,91
2019,11,5,22,1500,1473,1523,50
2019,11,5,23,1523,1495,1516,21
2019,11,6,0,1543,1518,1466,-52
2019,11,6,1,1657,1639,1390,-249
2019,11,6,2,1694,1682,1412,-270
2019,11,6,3,1676,1660,1417,-243
2019,11,6,4,1619,1648,1386,-262
2019,11,6,5,1578,1575,1341,-234
2019,11,6,6,1487,1469,1327,-142
2019,11,6,7,1406,1396,1320,-76
2019,11,6,8,1371,1358,1248,-110
2019,11,6,9,1356,1352,1260,-92
2019,11,6,10,1363,1346,1199,-147
2019,11,6,11,1354,1332,1140,-192
2019,11,6,12,1407,1368,1118,-250
2019,11,6,13,1506,1460,1131,-329
2019,11,6,14,1627,1569,1127,-442
2019,11,6,15,1621,1578,1158,-420
2019,11,6,16,1568,1582,1158,-424
2019,11,6,17,1537,1611,1276,-335
2019,11,6,18,1515,1645,1382,-263
2019,11,6,19,1505,1637,1442,-195
2019,11,6,20,1514,1611,1359,-252
2019,11,6,21,1506,1617,1232,-385
2019,11,6,22,1505,1613,1247,-366
2019,11,6,23,1536,1596,1207,-389
2019,11,7,0,1568,1624,1308,-316
2019,11,7,1,1666,1724,1540,-184
2019,11,7,2,1694,1732,1412,-320
2019,11,7,3,1672,1712,1409,-303
2019,11,7,4,1654,1674,1444,-230
2019,11,7,5,1575,1596,1349,-247
2019,11,7,6,1493,1511,1348,-163
2019,11,7,7,1413,1431,1351,-80
2019,11,7,8,1395,1398,1305,-93
2019,11,7,9,1383,1359,1476,117
2019,11,7,10,1378,1333,1510,177
2019,11,7,11,1379,1334,1420,86
2019,11,7,12,1433,1366,1410,44
2019,11,7,13,1525,1458,1499,41
2019,11,7,14,1640,1574,1431,-143
2019,11,7,15,1658,1608,1439,-169
2019,11,7,16,1632,1618,1465,-153
2019,11,7,17,1578,1622,1476,-146
2019,11,7,18,1554,1606,1378,-228
2019,11,7,19,1530,1591,1318,-273
2019,11,7,20,1519,1569,1277,-292
2019,11,7,21,1517,1566,1200,-366
2019,11,7,22,1523,1568,1176,-392
2019,11,7,23,1525,1572,1167,-405
2019,11,8,0,1556,1622,1179,-443
2019,11,8,1,1660,1729,1249,-480
2019,11,8,2,1705,1761,1273,-488
2019,11,8,3,1693,1738,1279,-459
2019,11,8,4,1695,1716,1268,-448
2019,11,8,5,1630,1656,1233,-423
2019,11,8,6,1531,1558,1193,-365
2019,11,8,7,1445,1438,1143,-295
2019,11,8,8,1431,1391,1175,-216
2019,11,8,9,1411,1354,1275,-79
2019,11,8,10,1398,1362,1329,-33
2019,11,8,11,1384,1374,1416,42
2019,11,8,12,1429,1407,1461,54
2019,11,8,13,1536,1495,1549,54
2019,11,8,14,1641,1600,1551,-49
2019,11,8,15,1631,1629,1609,-20
2019,11,8,16,1594,1617,1705,88
2019,11,8,17,1557,1577,1700,123
2019,11,8,18,1533,1503,1710,207
2019,11,8,19,1514,1445,1713,268
2019,11,8,20,1484,1431,1638,207
2019,11,8,21,1484,1411,1590,179
2019,11,8,22,1492,1412,1537,125
2019,11,8,23,1512,1410,1450,40
2019,11,9,0,1549,1484,1440,-44
2019,11,9,1,1649,1583,1563,-20
2019,11,9,2,1676,1633,1589,-44
2019,11,9,3,1689,1639,1499,-140
2019,11,9,4,1651,1623,1466,-157
2019,11,9,5,1605,1571,1440,-131
2019,11,9,6,1545,1507,1436,-71
2019,11,9,7,1477,1441,1450,9
2019,11,9,8,1446,1393,1362,-31
2019,11,9,9,1417,1349,1376,27
2019,11,9,10,1400,1361,1356,-5
2019,11,9,11,1400,1373,1385,12
2019,11,9,12,1415,1387,1363,-24
2019,11,9,13,1461,1443,1348,-95
2019,11,9,14,1523,1519,1353,-166
2019,11,9,15,1537,1533,1400,-133
2019,11,9,16,1519,1489,1443,-46
2019,11,9,17,1484,1471,1418,-53
2019,11,9,18,1465,1443,1435,-8
2019,11,9,19,1446,1402,1441,39
2019,11,9,20,1412,1386,1425,39
2019,11,9,21,1399,1378,1458,80
2019,11,9,22,1414,1375,1541,166
2019,11,9,23,1437,1414,1559,145
2019,11,10,0,1493,1477,1631,154
2019,11,10,1,1616,1641,1741,100
2019,11,10,2,1663,1665,1736,71
2019,11,10,3,1638,1637,1752,115
2019,11,10,4,1616,1624,1865,241
2019,11,10,5,1578,1579,1871,292
2019,11,10,6,1520,1504,1837,333
2019,11,10,7,1452,1451,1720,269
2019,11,10,8,1413,1411,1682,271
2019,11,10,9,1386,1393,1569,176
2019,11,10,10,1369,1371,1515,144
2019,11,10,11,1370,1371,1545,174
2019,11,10,12,1383,1384,1593,209
2019,11,10,13,1430,1410,1637,227
2019,11,10,14,1473,1471,1693,222
2019,11,10,15,1476,1491,1821,330
2019,11,10,16,1481,1455,1828,373
2019,11,10,17,1459,1441,1799,358
2019,11,10,18,1443,1427,1843,416
2019,11,10,19,1433,1407,1833,426
2019,11,10,20,1419,1382,1835,453
2019,11,10,21,1412,1379,1864,485
2019,11,10,22,1435,1373,1856,483
2019,11,10,23,1472,1387,1825,438
2019,11,11,0,1536,1470,1844,374
2019,11,11,1,1647,1609,1842,233
2019,11,11,2,1695,1638,1722,84
2019,11,11,3,1674,1633,1714,81
2019,11,11,4,1650,1605,1753,148
2019,11,11,5,1594,1542,1778,236
2019,11,11,6,1512,1454,1690,236
2019,11,11,7,1427,1392,1552,160
2019,11,11,8,1399,1372,1455,83
2019,11,11,9,1378,1380,1501,121
2019,11,11,10,1367,1375,1553,178
2019,11,11,11,1381,1369,1585,216
2019,11,11,12,1419,1389,1490,101
2019,11,11,13,1521,1444,1571,127
2019,11,11,14,1627,1536,1683,147
2019,11,11,15,1636,1570,1714,144
2019,11,11,16,1614,1518,1690,172
2019,11,11,17,1595,1514,1733,219
2019,11,11,18,1571,1488,1723,235
2019,11,11,19,1559,1474,1651,177
2019,11,11,20,1535,1471,1598,127
2019,11,11,21,1527,1472,1580,108
2019,11,11,22,1537,1501,1582,81
2019,11,11,23,1557,1532,1571,39
2019,11,12,0,1623,1600,1665,65
2019,11,12,1,1738,1744,1729,-15
2019,11,12,2,1787,1783,1704,-79
2019,11,12,3,1774,1786,1651,-135
2019,11,12,4,1751,1768,1610,-158
2019,11,12,5,1687,1699,1587,-112
2019,11,12,6,1595,1605,1489,-116
2019,11,12,7,1501,1532,1387,-145
2019,11,12,8,1495,1480,1349,-131
2019,11,12,9,1493,1469,1316,-153
2019,11,12,10,1486,1466,1316,-150
2019,11,12,11,1487,1481,1315,-166
2019,11,12,12,1531,1518,1315,-203
2019,11,12,13,1630,1615,1350,-265
2019,11,12,14,1769,1759,1436,-323
2019,11,12,15,1775,1754,1471,-283
2019,11,12,16,1709,1667,1543,-124
2019,11,12,17,1653,1594,1509,-85
2019,11,12,18,1611,1560,1577,17
2019,11,12,19,1577,1533,1663,130
2019,11,12,20,1541,1534,1670,136
2019,11,12,21,1526,1512,1604,92
2019,11,12,22,1528,1523,1655,132
2019,11,12,23,1545,1527,1615,88
2019,11,13,0,1611,1619,1503,-116
2019,11,13,1,1749,1770,1435,-335
2019,11,13,2,1787,1824,1407,-417
2019,11,13,3,1812,1797,1311,-486
2019,11,13,4,1786,1796,1185,-611
2019,11,13,5,1714,1731,1171,-560
2019,11,13,6,1619,1633,1272,-361
2019,11,13,7,1536,1557,1273,-284
2019,11,13,8,1492,1520,1327,-193
2019,11,13,9,1473,1486,1357,-129
2019,11,13,10,1463,1485,1374,-111
2019,11,13,11,1471,1485,1315,-170
2019,11,13,12,1512,1530,1333,-197
2019,11,13,13,1614,1615,1344,-271
2019,11,13,14,1727,1734,1409,-325
2019,11,13,15,1725,1732,1441,-291
2019,11,13,16,1662,1623,1362,-261
2019,11,13,17,1604,1544,1309,-235
2019,11,13,18,1565,1465,1337,-128
2019,11,13,19,1531,1431,1264,-167
2019,11,13,20,1503,1410,1258,-152
2019,11,13,21,1489,1425,1297,-128
2019,11,13,22,1499,1492,1481,-11
2019,11,13,23,1517,1510,1509,-1
2019,11,14,0,1574,1551,1415,-136
2019,11,14,1,1698,1680,1419,-261
2019,11,14,2,1739,1705,1475,-230
2019,11,14,3,1762,1698,1468,-230
2019,11,14,4,1733,1701,1426,-275
2019,11,14,5,1663,1637,1449,-188
2019,11,14,6,1573,1558,1428,-130
2019,11,14,7,1495,1469,1401,-68
2019,11,14,8,1488,1427,1318,-109
2019,11,14,9,1469,1399,1195,-204
2019,11,14,10,1458,1384,1077,-307
2019,11,14,11,1468,1396,968,-428
2019,11,14,12,1507,1432,892,-540
2019,11,14,13,1608,1514,911,-603
2019,11,14,14,1731,1655,946,-709
2019,11,14,15,1725,1657,1013,-644
2019,11,14,16,1659,1590,1188,-402
2019,11,14,17,1603,1542,1219,-323
2019,11,14,18,1567,1493,1210,-283
2019,11,14,19,1542,1467,1160,-307
2019,11,14,20,1521,1439,1148,-291
2019,11,14,21,1503,1458,1123,-335
2019,11,14,22,1508,1466,1134,-332
2019,11,14,23,1525,1496,1101,-395
2019,11,15,0,1590,1557,1197,-360
2019,11,15,1,1708,1664,1277,-387
2019,11,15,2,1775,1699,1233,-466
2019,11,15,3,1768,1692,1203,-489
2019,11,15,4,1758,1686,1271,-415
2019,11,15,5,1701,1636,1272,-364
2019,11,15,6,1611,1549,1212,-337
2019,11,15,7,1528,1487,1266,-221
2019,11,15,8,1464,1459,1296,-163
2019,11,15,9,1439,1444,1260,-184
2019,11,15,10,1431,1432,1272,-160
2019,11,15,11,1434,1437,1223,-214
2019,11,15,12,1476,1479,1240,-239
2019,11,15,13,1564,1570,1296,-274
2019,11,15,14,1656,1681,1368,-313
2019,11,15,15,1659,1678,1399,-279
2019,11,15,16,1609,1653,1465,-188
2019,11,15,17,1558,1603,1548,-55
2019,11,15,18,1520,1553,1670,117
2019,11,15,19,1496,1535,1844,309
2019,11,15,20,1466,1513,1952,439
2019,11,15,21,1454,1514,2001,487
2019,11,15,22,1466,1519,2002,483
2019,11,15,23,1479,1536,1985,449
2019,11,16,0,1534,1574,1870,296
2019,11,16,1,1639,1698,1893,195
2019,11,16,2,1687,1703,1871,168
2019,11,16,3,1689,1689,1851,162
2019,11,16,4,1682,1689,1845,156
2019,11,16,5,1642,1635,1945,310
2019,11,16,6,1572,1569,1749,180
2019,11,16,7,1498,1504,1848,344
2019,11,16,8,1456,1451,1844,393
2019,11,16,9,1429,1426,1822,396
2019,11,16,10,1424,1412,1704,292
2019,11,16,11,1424,1429,1813,384
2019,11,16,12,1441,1428,1714,286
2019,11,16,13,1486,1468,1724,256
2019,11,16,14,1543,1531,1747,216
2019,11,16,15,1555,1548,1872,324
2019,11,16,16,1527,1533,1855,322
2019,11,16,17,1491,1528,1818,290
2019,11,16,18,1458,1513,1802,289
2019,11,16,19,1436,1469,1748,279
2019,11,16,20,1413,1447,1734,287
2019,11,16,21,1405,1419,1794,375
2019,11,16,22,1414,1434,1735,301
2019,11,16,23,1442,1454,1753,299
2019,11,17,0,1508,1507,1795,288
2019,11,17,1,1617,1616,1826,210
2019,11,17,2,1664,1634,1878,244
2019,11,17,3,1650,1625,1785,160
2019,11,17,4,1634,1580,1778,198
2019,11,17,5,1591,1537,1865,328
2019,11,17,6,1530,1513,1921,408
2019,11,17,7,1472,1471,2029,558
2019,11,17,8,1408,1442,2012,570
2019,11,17,9,1387,1423,1970,547
2019,11,17,10,1376,1415,1900,485
2019,11,17,11,1377,1413,1826,413
2019,11,17,12,1391,1425,1743,318
2019,11,17,13,1433,1468,1775,307
2019,11,17,14,1482,1516,1765,249
2019,11,17,15,1491,1514,1777,263
2019,11,17,16,1477,1501,1758,257
2019,11,17,17,1451,1443,1753,310
2019,11,17,18,1434,1414,1639,225
2019,11,17,19,1420,1394,1541,147
2019,11,17,20,1410,1380,1618,238
2019,11,17,21,1408,1382,1727,345
2019,11,17,22,1423,1409,1670,261
2019,11,17,23,1458,1434,1666,232
2019,11,18,0,1530,1499,1705,206
2019,11,18,1,1666,1652,1901,249
2019,11,18,2,1705,1700,1908,208
2019,11,18,3,1692,1683,1955,272
2019,11,18,4,1672,1666,2005,339
2019,11,18,5,1611,1603,1970,367
2019,11,18,6,1530,1518,1976,458
2019,11,18,7,1468,1440,1992,552
2019,11,18,8,1409,1403,1969,566
2019,11,18,9,1393,1380,1953,573
2019,11,18,10,1389,1387,1914,527
2019,11,18,11,1400,1391,1866,475
2019,11,18,12,1446,1411,1842,431
2019,11,18,13,1540,1499,1836,337
2019,11,18,14,1644,1638,1894,256
2019,11,18,15,1644,1660,1974,314
2019,11,18,16,1594,1574,1990,416
2019,11,18,17,1552,1528,1990,462
2019,11,18,18,1514,1485,1913,428
2019,11,18,19,1494,1475,1881,406
2019,11,18,20,1476,1471,1811,340
2019,11,18,21,1473,1474,1702,228
2019,11,18,22,1483,1489,1721,232
2019,11,18,23,1499,1522,1629,107
2019,11,19,0,1556,1573,1540,-33
2019,11,19,1,1648,1685,1612,-73
2019,11,19,2,1682,1710,1633,-77
2019,11,19,3,1672,1684,1663,-21
2019,11,19,4,1647,1659,1711,52
2019,11,19,5,1585,1585,1724,139
2019,11,19,6,1503,1494,1673,179
2019,11,19,7,1441,1422,1557,135
2019,11,19,8,1398,1386,1694,308
2019,11,19,9,1381,1382,1821,439
2019,11,19,10,1374,1368,1956,588
2019,11,19,11,1381,1379,2034,655
2019,11,19,12,1425,1413,1901,488
2019,11,19,13,1524,1508,1873,365
2019,11,19,14,1629,1619,1940,321
2019,11,19,15,1632,1634,1913,279
2019,11,19,16,1587,1579,1860,281
2019,11,19,17,1542,1519,1909,390
2019,11,19,18,1516,1494,1961,467
2019,11,19,19,1494,1499,2089,590
2019,11,19,20,1482,1489,2163,674
2019,11,19,21,1480,1493,2201,708
2019,11,19,22,1497,1496,2156,660
2019,11,19,23,1518,1517,2028,511
2019,11,20,0,1574,1562,1824,262
2019,11,20,1,1692,1692,1897,205
2019,11,20,2,1720,1715,1907,192
2019,11,20,3,1705,1696,1911,215
2019,11,20,4,1683,1663,1939,276
2019,11,20,5,1609,1595,1932,337
2019,11,20,6,1515,1483,1887,404
2019,11,20,7,1434,1393,1821,428
2019,11,20,8,1379,1354,1783,429
2019,11,20,9,1357,1323,1777,454
2019,11,20,10,1353,1310,1824,514
2019,11,20,11,1360,1311,1772,461
2019,11,20,12,1404,1342,1638,296
2019,11,20,13,1494,1430,1636,206
2019,11,20,14,1596,1508,1697,189
2019,11,20,15,1607,1550,1710,160
2019,11,20,16,1581,1527,1639,112
2019,11,20,17,1551,1505,1789,284
2019,11,20,18,1539,1501,1859,358
2019,11,20,19,1529,1485,1895,410
2019,11,20,20,1523,1497,1881,384
2019,11,20,21,1525,1521,1943,422
2019,11,20,22,1540,1541,1950,409
2019,11,20,23,1557,1566,1930,364
2019,11,21,0,1613,1606,1892,286
2019,11,21,1,1719,1728,1885,157
2019,11,21,2,1724,1738,1937,199
2019,11,21,3,1718,1720,1928,208
2019,11,21,4,1690,1693,1868,175
2019,11,21,5,1611,1619,1827,208
2019,11,21,6,1517,1497,1833,336
2019,11,21,7,1441,1398,1752,354
2019,11,21,8,1394,1361,1376,15
2019,11,21,9,1375,1315,1337,22
2019,11,21,10,1364,1312,1391,79
2019,11,21,11,1368,1331,1419,88
2019,11,21,12,1406,1358,1582,224
2019,11,21,13,1496,1434,1601,167
2019,11,21,14,1600,1574,1670,96
2019,11,21,15,1615,1637,1851,214
2019,11,21,16,1599,1648,1845,197
2019,11,21,17,1582,1692,1942,250
2019,11,21,18,1576,1688,1905,217
2019,11,21,19,1561,1682,1638,-44
2019,11,21,20,1555,1676,1631,-45
2019,11,21,21,1551,1667,1640,-27
2019,11,21,22,1558,1674,1616,-58
2019,11,21,23,1579,1712,1586,-126
2019,11,22,0,1641,1739,1600,-139
2019,11,22,1,1766,1878,1706,-172
2019,11,22,2,1786,1830,1642,-188
2019,11,22,3,1765,1784,1659,-125
2019,11,22,4,1748,1769,1642,-127
2019,11,22,5,1674,1690,1637,-53
2019,11,22,6,1578,1590,1595,5
2019,11,22,7,1492,1503,1557,54
2019,11,22,8,1454,1466,1410,-56
2019,11,22,9,1432,1439,1365,-74
2019,11,22,10,1432,1432,1361,-71
2019,11,22,11,1438,1414,1342,-72
2019,11,22,12,1467,1449,1332,-117
2019,11,22,13,1551,1547,1429,-118
2019,11,22,14,1666,1671,1479,-192
2019,11,22,15,1679,1693,1551,-142
2019,11,22,16,1633,1692,1697,5
2019,11,22,17,1598,1649,1850,201
2019,11,22,18,1567,1594,1936,342
2019,11,22,19,1533,1581,1928,347
2019,11,22,20,1517,1584,2088,504
2019,11,22,21,1507,1594,2145,551
2019,11,22,22,1507,1582,2116,534
2019,11,22,23,1537,1577,2139,562
2019,11,23,0,1605,1640,2161,521
2019,11,23,1,1733,1746,2157,411
2019,11,23,2,1764,1757,2128,371
2019,11,23,3,1740,1741,2127,386
2019,11,23,4,1734,1747,2159,412
2019,11,23,5,1685,1698,2188,490
2019,11,23,6,1609,1619,2207,588
2019,11,23,7,1530,1557,2141,584
2019,11,23,8,1508,1491,2057,566
2019,11,23,9,1484,1468,2010,542
2019,11,23,10,1471,1455,2012,557
2019,11,23,11,1468,1457,1948,491
2019,11,23,12,1477,1470,1943,473
2019,11,23,13,1522,1514,1951,437
2019,11,23,14,1587,1568,1956,388
2019,11,23,15,1606,1591,1981,390
2019,11,23,16,1589,1569,1984,415
2019,11,23,17,1565,1551,1928,377
2019,11,23,18,1528,1530,1849,319
2019,11,23,19,1493,1484,1738,254
2019,11,23,20,1463,1442,1697,255
2019,11,23,21,1446,1426,1708,282
2019,11,23,22,1455,1426,1727,301
2019,11,23,23,1489,1463,1728,265
2019,11,24,0,1563,1547,1683,136
2019,11,24,1,1707,1695,1756,61
2019,11,24,2,1757,1736,1817,81
2019,11,24,3,1737,1725,1864,139
2019,11,24,4,1734,1704,1913,209
2019,11,24,5,1692,1686,2011,325
2019,11,24,6,1622,1632,2001,369
2019,11,24,7,1552,1572,1995,423
2019,11,24,8,1522,1509,1987,478
2019,11,24,9,1496,1478,1979,501
2019,11,24,10,1490,1456,1941,485
2019,11,24,11,1479,1450,2014,564
2019,11,24,12,1491,1482,2035,553
2019,11,24,13,1529,1514,2042,528
2019,11,24,14,1587,1565,2028,463
2019,11,24,15,1598,1579,1926,347
2019,11,24,16,1581,1560,2014,454
2019,11,24,17,1551,1528,2043,515
2019,11,24,18,1520,1488,1997,509
2019,11,24,19,1496,1466,1946,480
2019,11,24,20,1475,1444,1958,514
2019,11,24,21,1466,1444,2029,585
2019,11,24,22,1480,1488,2100,612
2019,11,24,23,1512,1491,2066,575
2019,11,25,0,1587,1569,2018,449
2019,11,25,1,1737,1752,2065,313
2019,11,25,2,1796,1795,2063,268
2019,11,25,3,1780,1785,2104,319
2019,11,25,4,1766,1755,2081,326
2019,11,25,5,1711,1694,2091,397
2019,11,25,6,1628,1603,2084,481
2019,11,25,7,1556,1514,2044,530
2019,11,25,8,1505,1474,2055,581
2019,11,25,9,1489,1465,2051,586
2019,11,25,10,1481,1463,1993,530
2019,11,25,11,1494,1477,2033,556
2019,11,25,12,1532,1484,2120,636
2019,11,25,13,1620,1582,2062,480
2019,11,25,14,1744,1694,2099,405
2019,11,25,15,1753,1712,2116,404
2019,11,25,16,1701,1650,2088,438
2019,11,25,17,1662,1604,2132,528
2019,11,25,18,1625,1565,2233,668
2019,11,25,19,1591,1520,2180,660
2019,11,25,20,1563,1504,2050,546
2019,11,25,21,1551,1508,1932,424
2019,11,25,22,1557,1522,1934,412
2019,11,25,23,1581,1562,1886,324
2019,11,26,0,1645,1608,1791,183
2019,11,26,1,1772,1767,1884,117
2019,11,26,2,1813,1796,1840,44
2019,11,26,3,1808,1786,1762,-24
2019,11,26,4,1792,1773,1780,7
2019,11,26,5,1723,1721,1853,132
2019,11,26,6,1625,1627,1845,218
2019,11,26,7,1545,1543,1835,292
2019,11,26,8,1495,1490,1828,338
2019,11,26,9,1475,1479,1822,343
2019,11,26,10,1475,1463,1815,352
2019,11,26,11,1475,1475,1820,345
2019,11,26,12,1514,1515,1839,324
2019,11,26,13,1607,1611,1838,227
2019,11,26,14,1733,1723,1886,163
2019,11,26,15,1763,1761,1962,201
2019,11,26,16,1739,1738,2035,297
2019,11,26,17,1716,1709,2020,311
2019,11,26,18,1697,1692,1941,249
2019,11,26,19,1677,1662,1839,177
2019,11,26,20,1666,1645,1969,324
2019,11,26,21,1667,1656,1927,271
2019,11,26,22,1669,1661,1917,256
2019,11,26,23,1696,1675,1848,173
2019,11,27,0,1755,1744,1886,142
2019,11,27,1,1881,1910,1936,26
2019,11,27,2,1930,1923,1939,16
2019,11,27,3,1918,1913,1833,-80
2019,11,27,4,1903,1894,1810,-84
2019,11,27,5,1833,1844,1801,-43
2019,11,27,6,1730,1734,1785,51
2019,11,27,7,1641,1631,1701,70
2019,11,27,8,1591,1572,1668,96
2019,11,27,9,1568,1548,1563,15
2019,11,27,10,1562,1540,1475,-65
2019,11,27,11,1567,1565,1426,-139
2019,11,27,12,1598,1592,1474,-118
2019,11,27,13,1681,1659,1563,-96
2019,11,27,14,1812,1765,1600,-165
2019,11,27,15,1826,1801,1735,-66
2019,11,27,16,1773,1796,1901,105
2019,11,27,17,1722,1755,1876,121
2019,11,27,18,1686,1730,1915,185
2019,11,27,19,1652,1733,1975,242
2019,11,27,20,1636,1729,1945,216
2019,11,27,21,1628,1733,1969,236
2019,11,27,22,1632,1744,1941,197
2019,11,27,23,1653,1766,1897,131
2019,11,28,0,1713,1798,1967,169
2019,11,28,1,1846,1887,1976,89
2019,11,28,2,1893,1899,1750,-149
2019,11,28,3,1880,1883,1658,-225
2019,11,28,4,1869,1881,1646,-235
2019,11,28,5,1800,1821,1744,-77
2019,11,28,6,1701,1751,1765,14
2019,11,28,7,1608,1671,1747,76
2019,11,28,8,1535,1598,1692,94
2019,11,28,9,1489,1558,1629,71
2019,11,28,10,1464,1531,1534,3
2019,11,28,11,1452,1527,1581,54
2019,11,28,12,1465,1534,1532,-2
2019,11,28,13,1512,1572,1478,-94
2019,11,28,14,1574,1634,1438,-196
2019,11,28,15,1601,1698,1432,-266
2019,11,28,16,1637,1757,1418,-339
2019,11,28,17,1661,1816,1365,-451
2019,11,28,18,1684,1820,1366,-454
2019,11,28,19,1668,1784,1234,-550
2019,11,28,20,1624,1723,1260,-463
2019,11,28,21,1569,1629,1378,-251
2019,11,28,22,1530,1589,1387,-202
2019,11,28,23,1520,1575,1351,-224
2019,11,29,0,1544,1590,1362,-228
2019,11,29,1,1627,1669,1354,-315
2019,11,29,2,1653,1699,1347,-352
2019,11,29,3,1654,1682,1312,-370
2019,11,29,4,1659,1661,1347,-314
2019,11,29,5,1623,1625,1399,-226
2019,11,29,6,1575,1568,1441,-127
2019,11,29,7,1515,1497,1541,44
2019,11,29,8,1459,1450,1517,67
2019,11,29,9,1422,1435,1331,-104
2019,11,29,10,1404,1416,1383,-33
2019,11,29,11,1400,1421,1411,-10
2019,11,29,12,1424,1445,1422,-23
2019,11,29,13,1477,1491,1451,-40
2019,11,29,14,1539,1539,1495,-44
2019,11,29,15,1560,1563,1544,-19
2019,11,29,16,1574,1598,1718,120
2019,11,29,17,1587,1631,1812,181
2019,11,29,18,1587,1620,1755,135
2019,11,29,19,1578,1594,1765,171
2019,11,29,20,1566,1650,1766,116
2019,11,29,21,1557,1664,1770,106
2019,11,29,22,1563,1648,1903,255
2019,11,29,23,1582,1630,1863,233
2019,11,30,0,1661,1675,1893,218
2019,11,30,1,1783,1800,1982,182
2019,11,30,2,1791,1821,1902,81
2019,11,30,3,1774,1812,1931,119
2019,11,30,4,1778,1803,1941,138
2019,11,30,5,1713,1775,1971,196
2019,11,30,6,1655,1708,1987,279
2019,11,30,7,1601,1638,1985,347
2019,11,30,8,1558,1587,1941,354
2019,11,30,9,1535,1552,1905,353
2019,11,30,10,1523,1550,1905,355
2019,11,30,11,1515,1547,1918,371
2019,11,30,12,1520,1558,1895,337
2019,11,30,13,1551,1603,1889,286
2019,11,30,14,1623,1654,1871,217
2019,11,30,15,1662,1667,1968,301
2019,11,30,16,1671,1651,2039,388
2019,11,30,17,1669,1654,2061,407
2019,11,30,18,1650,1635,2066,431
2019,11,30,19,1615,1623,2108,485
2019,11,30,20,1590,1600,2041,441
2019,11,30,21,1563,1580,2045,465
2019,11,30,22,1565,1583,1971,388
2019,11,30,23,1602,1609,1931,322
2019,12,1,0,1685,1693,1952,259
2019,12,1,1,1849,1860,2004,144
2019,12,1,2,1897,1878,2017,139
2019,12,1,3,1872,1881,1947,66
2019,12,1,4,1853,1869,1935,66
2019,12,1,5,1801,1820,1993,173
2019,12,1,6,1726,1725,1936,211
2019,12,1,7,1643,1651,1812,161
2019,12,1,8,1603,1602,1756,154
2019,12,1,9,1584,1573,1765,192
2019,12,1,10,1567,1561,1758,197
2019,12,1,11,1566,1560,1710,150
2019,12,1,12,1576,1572,1695,123
2019,12,1,13,1605,1607,1667,60
2019,12,1,14,1658,1656,1633,-23
2019,12,1,15,1684,1671,1678,7
2019,12,1,16,1672,1647,1785,138
2019,12,1,17,1650,1611,1828,217
2019,12,1,18,1623,1590,1729,139
2019,12,1,19,1592,1573,1740,167
2019,12,1,20,1575,1532,1729,197
2019,12,1,21,1561,1524,1718,194
2019,12,1,22,1564,1530,1698,168
2019,12,1,23,1587,1570,1680,110
2019,12,2,0,1670,1649,1685,36
2019,12,2,1,1827,1810,1806,-4
2019,12,2,2,1893,1865,1837,-28
2019,12,2,3,1883,1862,1848,-14
2019,12,2,4,1867,1835,1802,-33
2019,12,2,5,1812,1770,1770,0
2019,12,2,6,1716,1684,1656,-28
2019,12,2,7,1642,1595,1609,14
2019,12,2,8,1568,1550,1624,74
2019,12,2,9,1551,1537,1653,116
2019,12,2,10,1548,1527,1697,170
2019,12,2,11,1554,1542,1723,181
2019,12,2,12,1589,1577,1709,132
2019,12,2,13,1665,1678,1710,32
2019,12,2,14,1787,1818,1738,-80
2019,12,2,15,1807,1840,1798,-42
2019,12,2,16,1758,1768,1826,58
2019,12,2,17,1715,1700,1766,66
2019,12,2,18,1668,1661,1736,75
2019,12,2,19,1633,1588,1696,108
2019,12,2,20,1607,1583,1619,36
2019,12,2,21,1593,1573,1623,50
2019,12,2,22,1600,1576,1600,24
2019,12,2,23,1623,1570,1503,-67
2019,12,3,0,1694,1683,1533,-150
2019,12,3,1,1835,1824,1689,-135
2019,12,3,2,1887,1867,1808,-59
2019,12,3,3,1878,1859,1773,-86
2019,12,3,4,1868,1844,1842,-2
2019,12,3,5,1799,1779,1890,111
2019,12,3,6,1700,1688,1804,116
2019,12,3,7,1614,1596,1788,192
2019,12,3,8,1553,1535,1772,237
2019,12,3,9,1532,1497,1784,287
2019,12,3,10,1524,1495,1585,90
2019,12,3,11,1533,1504,1704,200
2019,12,3,12,1567,1545,1757,212
2019,12,3,13,1653,1618,1812,194
2019,12,3,14,1780,1744,1832,88
2019,12,3,15,1797,1753,1863,110
2019,12,3,16,1739,1700,1864,164
2019,12,3,17,1680,1645,1803,158
2019,12,3,18,1643,1582,1804,222
2019,12,3,19,1606,1565,1777,212
2019,12,3,20,1582,1515,1658,143
2019,12,3,21,1571,1508,1655,147
2019,12,3,22,1574,1508,1611,103
2019,12,3,23,1599,1546,1511,-35
2019,12,4,0,1665,1616,1472,-144
2019,12,4,1,1810,1759,1537,-222
2019,12,4,2,1853,1797,1535,-262
2019,12,4,3,1848,1797,1592,-205
2019,12,4,4,1838,1801,1640,-161
2019,12,4,5,1773,1727,1696,-31
2019,12,4,6,1676,1632,1724,92
2019,12,4,7,1583,1552,1730,178
2019,12,4,8,1520,1464,1785,321
2019,12,4,9,1491,1431,1713,282
2019,12,4,10,1481,1419,1797,378
2019,12,4,11,1483,1444,1775,331
2019,12,4,12,1521,1480,1749,269
2019,12,4,13,1610,1555,1787,232
2019,12,4,14,1733,1691,1932,241
2019,12,4,15,1762,1721,1863,142
2019,12,4,16,1729,1692,1933,241
2019,12,4,17,1684,1708,1993,285
2019,12,4,18,1666,1689,1953,264
2019,12,4,19,1638,1665,1949,284
2019,12,4,20,1625,1609,1927,318
2019,12,4,21,1623,1585,1953,368
2019,12,4,22,1629,1603,2061,458
2019,12,4,23,1650,1622,1977,355
2019,12,5,0,1709,1670,1927,257
2019,12,5,1,1831,1805,1974,169
2019,12,5,2,1853,1836,2000,164
2019,12,5,3,1846,1831,2001,170
2019,12,5,4,1829,1808,1966,158
2019,12,5,5,1764,1726,1953,227
2019,12,5,6,1668,1629,1956,327
2019,12,5,7,1578,1529,1935,406
2019,12,5,8,1483,1465,1862,397
2019,12,5,9,1453,1435,1872,437
2019,12,5,10,1443,1419,2013,594
2019,12,5,11,1450,1425,2031,606
2019,12,5,12,1483,1453,2018,565
2019,12,5,13,1567,1529,2081,552
2019,12,5,14,1689,1668,2119,451
2019,12,5,15,1712,1715,2115,400
2019,12,5,16,1658,1680,2148,468
2019,12,5,17,1621,1640,2119,479
2019,12,5,18,1594,1617,2194,577
2019,12,5,19,1578,1622,2227,605
2019,12,5,20,1553,1604,2179,575
2019,12,5,21,1562,1598,2176,578
2019,12,5,22,1565,1601,2157,556
2019,12,5,23,1592,1597,2083,486
2019,12,6,0,1681,1663,1927,264
2019,12,6,1,1805,1799,1997,198
2019,12,6,2,1834,1819,2028,209
2019,12,6,3,1822,1798,2070,272
2019,12,6,4,1812,1777,1993,216
2019,12,6,5,1748,1739,1972,233
2019,12,6,6,1650,1674,1803,129
2019,12,6,7,1557,1566,1729,163
2019,12,6,8,1499,1521,1621,100
2019,12,6,9,1478,1493,1572,79
2019,12,6,10,1471,1474,1539,65
2019,12,6,11,1482,1490,1517,27
2019,12,6,12,1512,1536,1457,-79
2019,12,6,13,1592,1606,1444,-162
2019,12,6,14,1722,1733,1537,-196
2019,12,6,15,1745,1763,1576,-187
2019,12,6,16,1696,1640,1473,-167
2019,12,6,17,1659,1676,1525,-151
2019,12,6,18,1627,1627,1553,-74
2019,12,6,19,1595,1614,1605,-9
2019,12,6,20,1575,1570,1579,9
2019,12,6,21,1570,1561,1552,-9
2019,12,6,22,1571,1545,1553,8
2019,12,6,23,1601,1577,1560,-17
2019,12,7,0,1657,1616,1635,19
2019,12,7,1,1782,1762,1800,38
2019,12,7,2,1810,1781,1859,78
2019,12,7,3,1796,1777,1842,65
2019,12,7,4,1795,1779,1831,52
2019,12,7,5,1752,1741,1793,52
2019,12,7,6,1674,1674,1752,78
2019,12,7,7,1586,1598,1696,98
2019,12,7,8,1538,1544,1788,244
2019,12,7,9,1505,1513,1702,189
2019,12,7,10,1491,1501,1653,152
2019,12,7,11,1486,1500,1641,141
2019,12,7,12,1498,1529,1668,139
2019,12,7,13,1537,1586,1620,34
2019,12,7,14,1604,1693,1552,-141
2019,12,7,15,1633,1674,1462,-212
2019,12,7,16,1620,1651,1535,-116
2019,12,7,17,1588,1610,1524,-86
2019,12,7,18,1556,1565,1588,23
2019,12,7,19,1528,1536,1656,120
2019,12,7,20,1502,1513,1661,148
2019,12,7,21,1488,1510,1677,167
2019,12,7,22,1495,1518,1693,175
2019,12,7,23,1518,1560,1711,151
2019,12,8,0,1589,1609,1608,-1
2019,12,8,1,1738,1746,1692,-54
2019,12,8,2,1773,1766,1714,-52
2019,12,8,3,1755,1756,1642,-114
2019,12,8,4,1742,1739,1613,-126
2019,12,8,5,1710,1696,1684,-12
2019,12,8,6,1641,1617,1701,84
2019,12,8,7,1562,1561,1645,84
2019,12,8,8,1506,1482,1623,141
2019,12,8,9,1473,1435,1567,132
2019,12,8,10,1460,1427,1565,138
2019,12,8,11,1452,1409,1583,174
2019,12,8,12,1459,1419,1662,243
2019,12,8,13,1490,1481,1672,191
2019,12,8,14,1549,1526,1659,133
2019,12,8,15,1584,1561,1678,117
2019,12,8,16,1597,1604,1745,141
2019,12,8,17,1578,1634,1823,189
2019,12,8,18,1566,1651,1827,176
2019,12,8,19,1559,1643,1856,213
2019,12,8,20,1550,1630,1885,255
2019,12,8,21,1539,1625,1913,288
2019,12,8,22,1550,1629,1894,265
2019,12,8,23,1589,1656,1898,242
2019,12,9,0,1661,1724,1956,232
2019,12,9,1,1809,1857,2108,251
2019,12,9,2,1833,1871,2075,204
2019,12,9,3,1813,1853,2070,217
2019,12,9,4,1792,1805,1996,191
2019,12,9,5,1734,1680,1865,185
2019,12,9,6,1647,1570,1847,277
2019,12,9,7,1559,1488,1813,325
2019,12,9,8,1488,1441,1790,349
2019,12,9,9,1459,1417,1835,418
2019,12,9,10,1453,1414,1852,438
2019,12,9,11,1460,1419,1793,374
2019,12,9,12,1493,1444,1762,318
2019,12,9,13,1574,1528,1692,164
2019,12,9,14,1696,1640,1652,12
2019,12,9,15,1736,1675,1668,-7
2019,12,9,16,1710,1686,1704,18
2019,12,9,17,1679,1657,1755,98
2019,12,9,18,1662,1630,1774,144
2019,12,9,19,1639,1584,1757,173
2019,12,9,20,1624,1602,1845,243
2019,12,9,21,1617,1582,1869,287
2019,12,9,22,1624,1576,1856,280
2019,12,9,23,1646,1571,1731,160
2019,12,10,0,1708,1648,1770,122
2019,12,10,1,1845,1811,1817,6
2019,12,10,2,1872,1856,1798,-58
2019,12,10,3,1860,1844,1811,-33
2019,12,10,4,1841,1840,1828,-12
2019,12,10,5,1782,1761,1817,56
2019,12,10,6,1684,1651,1701,50
2019,12,10,7,1588,1553,1576,23
2019,12,10,8,1532,1509,1612,103
2019,12,10,9,1497,1487,1649,162
2019,12,10,10,1488,1481,1613,132
2019,12,10,11,1493,1495,1583,88
2019,12,10,12,1529,1533,1532,-1
2019,12,10,13,1625,1642,1518,-124
2019,12,10,14,1762,1787,1553,-234
2019,12,10,15,1786,1809,1606,-203
2019,12,10,16,1751,1742,1704,-38
2019,12,10,17,1701,1673,1801,128
2019,12,10,18,1663,1623,1864,241
2019,12,10,19,1628,1574,1871,297
2019,12,10,20,1603,1531,1755,224
2019,12,10,21,1582,1527,1783,256
2019,12,10,22,1588,1533,1767,234
2019,12,10,23,1625,1597,1790,193
2019,12,11,0,1689,1637,1824,187
2019,12,11,1,1842,1809,1973,164
2019,12,11,2,1884,1867,2022,155
2019,12,11,3,1876,1865,2011,146
2019,12,11,4,1861,1858,2002,144
2019,12,11,5,1743,1795,1993,198
2019,12,11,6,1645,1700,1958,258
2019,12,11,7,1555,1590,1754,164
2019,12,11,8,1518,1525,1592,67
2019,12,11,9,1501,1497,1494,-3
2019,12,11,10,1495,1481,1444,-37
2019,12,11,11,1511,1487,1409,-78
2019,12,11,12,1549,1510,1315,-195
2019,12,11,13,1636,1610,1356,-254
2019,12,11,14,1766,1741,1468,-273
2019,12,11,15,1792,1763,1529,-234
2019,12,11,16,1754,1724,1494,-230
2019,12,11,17,1707,1682,1433,-249
2019,12,11,18,1669,1626,1387,-239
2019,12,11,19,1640,1588,1404,-184
2019,12,11,20,1625,1594,1427,-167
2019,12,11,21,1616,1593,1395,-198
2019,12,11,22,1616,1613,1381,-232
2019,12,11,23,1633,1635,1454,-181
2019,12,12,0,1702,1706,1542,-164
2019,12,12,1,1846,1845,1738,-107
2019,12,12,2,1883,1885,1838,-47
2019,12,12,3,1868,1896,1820,-76
2019,12,12,4,1860,1878,1813,-65
2019,12,12,5,1796,1820,1771,-49
2019,12,12,6,1696,1709,1626,-83
2019,12,12,7,1607,1608,1531,-77
2019,12,12,8,1557,1547,1463,-84
2019,12,12,9,1530,1494,1466,-28
2019,12,12,10,1521,1475,1485,10
2019,12,12,11,1526,1516,1417,-99
2019,12,12,12,1563,1566,1514,-52
2019,12,12,13,1652,1644,1601,-43
2019,12,12,14,1790,1774,1752,-22
2019,12,12,15,1814,1794,1778,-16
2019,12,12,16,1769,1731,1774,43
2019,12,12,17,1711,1674,1692,18
2019,12,12,18,1673,1620,1652,32
2019,12,12,19,1642,1561,1668,107
2019,12,12,20,1612,1522,1711,189
2019,12,12,21,1604,1507,1746,239
2019,12,12,22,1606,1512,1862,350
2019,12,12,23,1629,1541,2009,468
2019,12,13,0,1697,1605,1995,390
2019,12,13,1,1838,1783,2104,321
2019,12,13,2,1879,1819,2119,300
2019,12,13,3,1874,1823,2050,227
2019,12,13,4,1864,1813,2080,267
2019,12,13,5,1804,1745,2045,300
2019,12,13,6,1705,1645,2063,418
2019,12,13,7,1607,1575,1844,269
2019,12,13,8,1533,1509,1955,446
2019,12,13,9,1501,1480,1902,422
2019,12,13,10,1490,1475,1910,435
2019,12,13,11,1497,1490,1917,427
2019,12,13,12,1525,1514,1894,380
2019,12,13,13,1603,1599,1882,283
2019,12,13,14,1732,1726,1951,225
2019,12,13,15,1762,1762,2015,253
2019,12,13,16,1721,1715,2138,423
2019,12,13,17,1680,1648,2236,588
2019,12,13,18,1641,1638,2271,633
2019,12,13,19,1602,1605,2258,653
2019,12,13,20,1581,1563,2166,603
2019,12,13,21,1568,1546,2047,501
2019,12,13,22,1564,1566,2097,531
2019,12,13,23,1585,1584,2033,449
2019,12,14,0,1648,1645,1904,259
2019,12,14,1,1791,1788,1908,120
2019,12,14,2,1816,1793,1840,47
2019,12,14,3,1812,1762,1727,-35
2019,12,14,4,1815,1737,1761,24
2019,12,14,5,1769,1687,1723,36
2019,12,14,6,1685,1616,1790,174
2019,12,14,7,1591,1528,1790,262
2019,12,14,8,1510,1470,1827,357
2019,12,14,9,1477,1442,1849,407
2019,12,14,10,1454,1430,1884,454
2019,12,14,11,1455,1425,1916,491
2019,12,14,12,1462,1450,1951,501
2019,12,14,13,1498,1494,1909,415
2019,12,14,14,1567,1557,1892,335
2019,12,14,15,1600,1590,1938,348
2019,12,14,16,1598,1579,2039,460
2019,12,14,17,1574,1557,2060,503
2019,12,14,18,1551,1540,2072,532
2019,12,14,19,1518,1519,2101,582
2019,12,14,20,1498,1518,2075,557
2019,12,14,21,1488,1516,2112,596
2019,12,14,22,1494,1528,2187,659
2019,12,14,23,1525,1571,2114,543
2019,12,15,0,1594,1591,2020,429
2019,12,15,1,1734,1709,1944,235
2019,12,15,2,1757,1718,1991,273
2019,12,15,3,1749,1714,1926,212
2019,12,15,4,1741,1705,2058,353
2019,12,15,5,1702,1658,2061,403
2019,12,15,6,1631,1564,1995,431
2019,12,15,7,1545,1481,1966,485
2019,12,15,8,1498,1430,1955,525
2019,12,15,9,1458,1425,1966,541
2019,12,15,10,1441,1438,1989,551
2019,12,15,11,1435,1437,2041,604
2019,12,15,12,1441,1457,2093,636
2019,12,15,13,1469,1480,2124,644
2019,12,15,14,1537,1529,2103,574
2019,12,15,15,1576,1557,2115,558
2019,12,15,16,1591,1573,2159,586
2019,12,15,17,1581,1559,2250,691
2019,12,15,18,1574,1509,2221,712
2019,12,15,19,1555,1504,2249,745
2019,12,15,20,1547,1504,2286,782
2019,12,15,21,1549,1491,2273,782
2019,12,15,22,1555,1507,2254,747
2019,12,15,23,1595,1573,2202,629
2019,12,16,0,1676,1638,2109,471
2019,12,16,1,1842,1787,2111,324
2019,12,16,2,1879,1838,2125,287
2019,12,16,3,1862,1828,2151,323
2019,12,16,4,1850,1814,1991,177
2019,12,16,5,1788,1748,1847,99
2019,12,16,6,1699,1639,1837,198
2019,12,16,7,1610,1538,1844,306
2019,12,16,8,1555,1493,1968,475
2019,12,16,9,1529,1473,2011,538
2019,12,16,10,1515,1470,1966,496
2019,12,16,11,1526,1470,1880,410
2019,12,16,12,1557,1512,1853,341
2019,12,16,13,1633,1604,1941,337
2019,12,16,14,1778,1738,2031,293
2019,12,16,15,1834,1785,1983,198
2019,12,16,16,1815,1729,2082,353
2019,12,16,17,1780,1682,2145,463
2019,12,16,18,1766,1654,2126,472
2019,12,16,19,1735,1623,2092,469
2019,12,16,20,1716,1615,2119,504
2019,12,16,21,1706,1620,2149,529
2019,12,16,22,1707,1643,2172,529
2019,12,16,23,1734,1665,2209,544
2019,12,17,0,1793,1754,2257,503
2019,12,17,1,1952,1934,2228,294
2019,12,17,2,1992,1984,2154,170
2019,12,17,3,1986,1965,2022,57
2019,12,17,4,1969,1973,1872,-101
2019,12,17,5,1896,1903,1879,-24
2019,12,17,6,1790,1770,1783,13
2019,12,17,7,1687,1669,1707,38
2019,12,17,8,1624,1620,1653,33
2019,12,17,9,1604,1588,1616,28
2019,12,17,10,1600,1589,1604,15
2019,12,17,11,1604,1597,1616,19
2019,12,17,12,1644,1642,1707,65
2019,12,17,13,1730,1738,1798,60
2019,12,17,14,1883,1875,1822,-53
2019,12,17,15,1916,1907,1886,-21
2019,12,17,16,1867,1843,1909,66
2019,12,17,17,1815,1783,1980,197
2019,12,17,18,1773,1719,1943,224
2019,12,17,19,1728,1681,1942,261
2019,12,17,20,1694,1635,1983,348
2019,12,17,21,1677,1619,1971,352
2019,12,17,22,1675,1622,1967,345
2019,12,17,23,1702,1652,1959,307
2019,12,18,0,1770,1747,1951,204
2019,12,18,1,1934,1918,1982,64
2019,12,18,2,1989,1996,2047,51
2019,12,18,3,1984,2004,2021,17
2019,12,18,4,1973,1994,1904,-90
2019,12,18,5,1897,1928,1771,-157
2019,12,18,6,1791,1812,1598,-214
2019,12,18,7,1697,1711,1565,-146
2019,12,18,8,1657,1664,1560,-104
2019,12,18,9,1635,1641,1550,-91
2019,12,18,10,1626,1640,1564,-76
2019,12,18,11,1637,1648,1593,-55
2019,12,18,12,1672,1688,1620,-68
2019,12,18,13,1766,1784,1652,-132
2019,12,18,14,1906,1910,1720,-190
2019,12,18,15,1930,1936,1698,-238
2019,12,18,16,1864,1857,1719,-138
2019,12,18,17,1802,1787,1669,-118
2019,12,18,18,1747,1722,1665,-57
2019,12,18,19,1691,1647,1722,75
2019,12,18,20,1662,1626,1827,201
2019,12,18,21,2501,1590,1808,218
2019,12,18,22,2502,1606,1797,191
2019,12,18,23,2505,1630,1687,57
2019,12,19,0,2520,1730,1691,-39
2019,12,19,1,2561,1914,1790,-124
2019,12,19,2,2581,1979,1850,-129
2019,12,19,3,2584,1976,1837,-139
2019,12,19,4,2583,1963,1477,-486
2019,12,19,5,2568,1910,1506,-404
2019,12,19,6,2544,1803,1308,-495
2019,12,19,7,2524,1706,1220,-486
2019,12,19,8,2521,1656,1171,-485
2019,12,19,9,2515,1628,1228,-400
2019,12,19,10,2517,1622,1283,-339
2019,12,19,11,2516,1631,1323,-308
2019,12,19,12,2526,1666,1390,-276
2019,12,19,13,2553,1745,1528,-217
2019,12,19,14,2587,1864,1565,-299
2019,12,19,15,2585,1897,1575,-322
2019,12,19,16,2538,1867,1677,-190
2019,12,19,17,2518,1836,1787,-49
2019,12,19,18,2497,1809,1874,65
2019,12,19,19,2481,1771,1908,137
2019,12,19,20,2471,1734,1943,209
2019,12,19,21,2464,1709,1963,254
2019,12,19,22,2464,1675,1918,243
2019,12,19,23,2468,1668,2032,364
2019,12,20,0,2511,1736,1869,133
2019,12,20,1,2556,1919,1965,46
2019,12,20,2,2580,1979,1937,-42
2019,12,20,3,2581,1968,1968,0
2019,12,20,4,2584,1963,1932,-31
2019,12,20,5,2572,1893,1876,-17
2019,12,20,6,2549,1795,1819,24
2019,12,20,7,2533,1714,1756,42
2019,12,20,8,1646,1652,1750,98
2019,12,20,9,1619,1658,1724,66
2019,12,20,10,1612,1607,1592,-15
2019,12,20,11,1621,1620,1609,-11
2019,12,20,12,1649,1663,1714,51
2019,12,20,13,1738,1753,1711,-42
2019,12,20,14,1874,1865,1725,-140
2019,12,20,15,1902,1913,1731,-182
2019,12,20,16,1835,1847,1611,-236
2019,12,20,17,1770,1778,1588,-190
2019,12,20,18,1707,1727,1618,-109
2019,12,20,19,1654,1675,1656,-19
2019,12,20,20,1621,1637,1704,67
2019,12,20,21,1597,1610,1699,89
2019,12,20,22,1593,1610,1610,0
2019,12,20,23,1622,1609,1486,-123
2019,12,21,0,1698,1660,1566,-94
2019,12,21,1,1852,1818,1664,-154
2019,12,21,2,1893,1864,1678,-186
2019,12,21,3,1887,1915,1709,-206
2019,12,21,4,1894,1881,1730,-151
2019,12,21,5,1853,1847,1773,-74
2019,12,21,6,1771,1766,1801,35
2019,12,21,7,1688,1663,1744,81
2019,12,21,8,1625,1631,1632,1
2019,12,21,9,1593,1607,1589,-18
2019,12,21,10,1582,1582,1577,-5
2019,12,21,11,1584,1599,1563,-36
2019,12,21,12,1597,1603,1515,-88
2019,12,21,13,1637,1639,1507,-132
2019,12,21,14,1700,1717,1502,-215
2019,12,21,15,1729,1760,1510,-250
2019,12,21,16,1715,1750,1640,-110
2019,12,21,17,1666,1695,1643,-52
2019,12,21,18,1616,1638,1642,4
2019,12,21,19,1574,1595,1606,11
2019,12,21,20,1535,1546,1580,34
2019,12,21,21,1509,1520,1569,49
2019,12,21,22,1508,1517,1501,-16
2019,12,21,23,1534,1537,1488,-49
2019,12,22,0,1616,1618,1464,-154
2019,12,22,1,1773,1785,1625,-160
2019,12,22,2,1825,1832,1668,-164
2019,12,22,3,1824,1836,1669,-167
2019,12,22,4,1824,1821,1650,-171
2019,12,22,5,1786,1789,1604,-185
2019,12,22,6,1713,1731,1570,-161
2019,12,22,7,1639,1665,1444,-221
2019,12,22,8,1591,1597,1383,-214
2019,12,22,9,1563,1564,1319,-245
2019,12,22,10,1547,1557,1309,-248
2019,12,22,11,1544,1548,1361,-187
2019,12,22,12,1555,1563,1409,-154
2019,12,22,13,1589,1606,1469,-137
2019,12,22,14,1649,1661,1473,-188
2019,12,22,15,1667,1679,1504,-175
2019,12,22,16,1658,1695,1631,-64
2019,12,22,17,1622,1640,1700,60
2019,12,22,18,1586,1554,1612,58
2019,12,22,19,1555,1528,1706,178
2019,12,22,20,1531,1500,1666,166
2019,12,22,21,1513,1485,1617,132
2019,12,22,22,1516,1501,1640,139
2019,12,22,23,1546,1563,1592,29
2019,12,23,0,1631,1634,1610,-24
2019,12,23,1,1800,1813,1800,-13
2019,12,23,2,1859,1860,1893,33
2019,12,23,3,1855,1858,1855,-3
2019,12,23,4,1845,1838,1821,-17
2019,12,23,5,1793,1789,1813,24
2019,12,23,6,1704,1720,1738,18
2019,12,23,7,1624,1624,1654,30
2019,12,23,8,1551,1566,1645,79
2019,12,23,9,1525,1550,1533,-17
2019,12,23,10,1517,1545,1513,-32
2019,12,23,11,1525,1538,1462,-76
2019,12,23,12,1566,1559,1381,-178
2019,12,23,13,1643,1626,1398,-228
2019,12,23,14,1759,1716,1422,-294
2019,12,23,15,1782,1777,1553,-224
2019,12,23,16,1746,1794,1626,-168
2019,12,23,17,1702,1799,1616,-183
2019,12,23,18,1656,1768,1482,-286
2019,12,23,19,1629,1725,1470,-255
2019,12,23,20,1602,1686,1413,-273
2019,12,23,21,1587,1659,1386,-273
2019,12,23,22,1584,1656,1378,-278
2019,12,23,23,1611,1675,1262,-413
2019,12,24,0,1687,1728,1283,-445
2019,12,24,1,1827,1869,1424,-445
2019,12,24,2,1875,1895,1480,-415
2019,12,24,3,1873,1880,1463,-417
2019,12,24,4,1865,1879,1539,-340
2019,12,24,5,1779,1838,1575,-263
2019,12,24,6,1698,1744,1508,-236
2019,12,24,7,1616,1644,1446,-198
2019,12,24,8,1561,1576,1620,44
2019,12,24,9,1515,1542,1658,116
2019,12,24,10,1492,1518,1624,106
2019,12,24,11,1479,1509,1633,124
2019,12,24,12,1496,1520,1530,10
2019,12,24,13,1543,1580,1382,-198
2019,12,24,14,1607,1644,1342,-302
2019,12,24,15,1646,1696,1309,-387
2019,12,24,16,1663,1727,1411,-316
2019,12,24,17,1658,1735,1351,-384
2019,12,24,18,1623,1724,1378,-346
2019,12,24,19,1565,1718,1328,-390
2019,12,24,20,1515,1726,1303,-423
2019,12,24,21,1493,1650,1217,-433
2019,12,24,22,1507,1700,1230,-470
2019,12,24,23,1531,1734,1382,-352
2019,12,25,0,1590,1790,1448,-342
2019,12,25,1,1725,1836,1548,-288
2019,12,25,2,1733,1814,1368,-446
2019,12,25,3,1708,1790,1436,-354
2019,12,25,4,1695,1772,1717,-55
2019,12,25,5,1657,1730,1794,64
2019,12,25,6,1610,1675,1836,161
2019,12,25,7,1561,1604,1825,221
2019,12,25,8,1525,1553,1849,296
2019,12,25,9,1493,1510,1834,324
2019,12,25,10,1476,1488,1858,370
2019,12,25,11,1468,1479,1849,370
2019,12,25,12,1478,1495,1831,336
2019,12,25,13,1512,1529,1799,270
2019,12,25,14,1571,1579,1944,365
2019,12,25,15,1602,1613,2020,407
2019,12,25,16,1606,1632,2088,456
2019,12,25,17,1596,1619,2042,423
2019,12,25,18,1573,1597,2015,418
2019,12,25,19,1547,1581,1983,402
2019,12,25,20,1512,1539,1997,458
2019,12,25,21,1486,1509,1987,478
2019,12,25,22,1472,1478,1869,391
2019,12,25,23,1489,1486,1746,260
2019,12,26,0,1546,1537,1614,77
2019,12,26,1,1695,1671,1623,-48
2019,12,26,2,1741,1714,1576,-138
2019,12,26,3,1745,1711,1513,-198
2019,12,26,4,1748,1718,1540,-178
2019,12,26,5,1698,1687,1631,-56
2019,12,26,6,1647,1613,1657,44
2019,12,26,7,1589,1527,1665,138
2019,12,26,8,1551,1481,1641,160
2019,12,26,9,1529,1466,1668,202
2019,12,26,10,1524,1454,1673,219
2019,12,26,11,1523,1450,1638,188
2019,12,26,12,1561,1486,1602,116
2019,12,26,13,1638,1553,1532,-21
2019,12,26,14,1750,1640,1437,-203
2019,12,26,15,1777,1677,1445,-232
2019,12,26,16,1744,1650,1502,-148
2019,12,26,17,1699,1627,1509,-118
2019,12,26,18,1664,1589,1340,-249
2019,12,26,19,1631,1561,1288,-273
2019,12,26,20,1608,1517,1251,-266
2019,12,26,21,1602,1503,1151,-352
2019,12,26,22,1609,1497,1240,-257
2019,12,26,23,1635,1529,1364,-165
2019,12,27,0,1709,1589,1380,-209
2019,12,27,1,1840,1762,1448,-314
2019,12,27,2,1878,1827,1620,-207
2019,12,27,3,1882,1819,1618,-201
2019,12,27,4,1868,1798,1719,-79
2019,12,27,5,1791,1753,1811,58
2019,12,27,6,1684,1663,1797,134
2019,12,27,7,1586,1587,1808,221
2019,12,27,8,1530,1527,1768,241
2019,12,27,9,1501,1479,1737,258
2019,12,27,10,1490,1452,1811,359
2019,12,27,11,1489,1447,1822,375
2019,12,27,12,1521,1472,1904,432
2019,12,27,13,1601,1531,1827,296
2019,12,27,14,1711,1599,1806,207
2019,12,27,15,1755,1632,1872,240
2019,12,27,16,1738,1631,1942,311
2019,12,27,17,1709,1658,2059,401
2019,12,27,18,1685,1673,2147,474
2019,12,27,19,1659,1677,2226,549
2019,12,27,20,1633,1626,2025,399
2019,12,27,21,1622,1649,1923,274
2019,12,27,22,1619,1667,1902,235
2019,12,27,23,1649,1658,1561,-97
2019,12,28,0,1722,1712,1434,-278
2019,12,28,1,1841,1845,1666,-179
2019,12,28,2,1865,1855,1687,-168
2019,12,28,3,1854,1853,1688,-165
2019,12,28,4,1855,1864,1716,-148
2019,12,28,5,1810,1767,1725,-42
2019,12,28,6,1729,1691,1712,21
2019,12,28,7,1640,1620,1730,110
2019,12,28,8,1601,1551,1673,122
2019,12,28,9,1563,1538,1647,109
2019,12,28,10,1547,1508,1634,126
2019,12,28,11,1545,1496,1644,148
2019,12,28,12,1559,1526,1682,156
2019,12,28,13,1591,1560,1695,135
2019,12,28,14,1653,1636,1702,66
2019,12,28,15,1695,1681,1707,26
2019,12,28,16,1710,1701,1792,91
2019,12,28,17,1707,1707,1840,133
2019,12,28,18,1678,1718,1861,143
2019,12,28,19,1652,1698,1888,190
2019,12,28,20,1633,1665,1873,208
2019,12,28,21,1606,1663,1866,203
2019,12,28,22,1609,1674,1916,242
2019,12,28,23,1643,1703,1857,154
2019,12,29,0,1728,1761,1865,104
2019,12,29,1,1885,1871,1757,-114
2019,12,29,2,1921,1903,1700,-203
2019,12,29,3,1914,1876,1632,-244
2019,12,29,4,1906,1858,1570,-288
2019,12,29,5,1862,1828,1578,-250
2019,12,29,6,1786,1754,1597,-157
2019,12,29,7,1714,1669,1621,-48
2019,12,29,8,1657,1618,1589,-29
2019,12,29,9,1624,1585,1436,-149
2019,12,29,10,1606,1563,1486,-77
2019,12,29,11,1602,1559,1494,-65
2019,12,29,12,1620,1565,1565,0
2019,12,29,13,1650,1595,1607,12
2019,12,29,14,1695,1657,1590,-67
2019,12,29,15,1738,1689,1558,-131
2019,12,29,16,1755,1712,1691,-21
2019,12,29,17,1746,1723,1779,56
2019,12,29,18,1717,1701,1790,89
2019,12,29,19,1700,1678,1800,122
2019,12,29,20,1688,1662,1834,172
2019,12,29,21,1665,1630,1844,214
2019,12,29,22,1670,1627,1825,198
2019,12,29,23,1699,1653,1791,138
2019,12,30,0,1778,1729,1756,27
2019,12,30,1,1947,1919,1852,-67
2019,12,30,2,2004,1984,1802,-182
2019,12,30,3,2006,1961,1755,-206
2019,12,30,4,1991,1945,1696,-249
2019,12,30,5,1931,1881,1709,-172
2019,12,30,6,1836,1800,1725,-75
2019,12,30,7,1765,1713,1648,-65
2019,12,30,8,1680,1661,1539,-122
2019,12,30,9,1654,1636,1464,-172
2019,12,30,10,1646,1651,1500,-151
2019,12,30,11,1651,1614,1416,-198
2019,12,30,12,1690,1642,1429,-213
2019,12,30,13,1751,1708,1504,-204
2019,12,30,14,1874,1796,1533,-263
2019,12,30,15,1922,1850,1526,-324
2019,12,30,16,1882,1876,1476,-400
2019,12,30,17,1836,1787,1450,-337
2019,12,30,18,1774,1741,1449,-292
2019,12,30,19,1733,1696,1432,-264
2019,12,30,20,1698,1658,1467,-191
2019,12,30,21,1672,1626,1378,-248
2019,12,30,22,1665,1621,1313,-308
2019,12,30,23,1689,1647,1242,-405
2019,12,31,0,1767,1723,1278,-445
2019,12,31,1,1941,1913,1365,-548
2019,12,31,2,1988,1946,1415,-531
2019,12,31,3,1985,1953,1410,-543
2019,12,31,4,1988,1943,1343,-600
2019,12,31,5,1920,1875,1315,-560
2019,12,31,6,1820,1769,1293,-476
2019,12,31,7,1728,1678,1318,-360
2019,12,31,8,1667,1624,1260,-364
2019,12,31,9,1636,1598,1271,-327
2019,12,31,10,1618,1596,1270,-326
2019,12,31,11,1616,1591,1340,-251
2019,12,31,12,1653,1619,1323,-296
2019,12,31,13,1726,1649,1312,-337
2019,12,31,14,1859,1764,1379,-385
2019,12,31,15,1895,1822,1484,-338
2019,12,31,16,1849,1837,1492,-345
2019,12,31,17,1805,1812,1482,-330
2019,12,31,18,1757,1757,1469,-288
2019,12,31,19,1718,1685,1445,-240
2019,12,31,20,1690,1633,1430,-203
2019,12,31,21,1666,1590,1423,-167
2019,12,31,22,1665,1569,1429,-140
2019,12,31,23,1687,1602,1372,-230
2020,1,1,0,1755,1685,1295,-390
2020,1,1,1,1920,1840,1414,-426
2020,1,1,2,1968,1885,1453,-432
2020,1,1,3,1976,1871,1519,-352
2020,1,1,4,1970,1844,1698,-146
2020,1,1,5,1882,1808,1735,-73
2020,1,1,6,1805,1763,1739,-24
2020,1,1,7,1730,1715,1658,-57
2020,1,1,8,1671,1676,1671,-5
2020,1,1,9,1641,1634,1690,56
2020,1,1,10,1630,1622,1742,120
2020,1,1,11,1620,1609,1723,114
2020,1,1,12,1643,1621,1691,70
2020,1,1,13,1682,1651,1674,23
2020,1,1,14,1736,1714,1690,-24
2020,1,1,15,1766,1715,1747,32
2020,1,1,16,1761,1693,1752,59
2020,1,1,17,1734,1646,1885,239
2020,1,1,18,1698,1607,1908,301
2020,1,1,19,1663,1619,1961,342
2020,1,1,20,1648,1557,1954,397
2020,1,1,21,1629,1533,1888,355
2020,1,1,22,1631,1544,1881,337
2020,1,1,23,1645,1577,1925,348
2020,1,2,0,1716,1678,1962,284
2020,1,2,1,1866,1841,2000,159
2020,1,2,2,1935,1859,2042,183
2020,1,2,3,1940,1847,2038,191
2020,1,2,4,1926,1830,2035,205
2020,1,2,5,1843,1773,1975,202
2020,1,2,6,1761,1669,1785,116
2020,1,2,7,1686,1575,1772,197
2020,1,2,8,1596,1531,1770,239
2020,1,2,9,1572,1509,1738,229
2020,1,2,10,1561,1493,1665,172
2020,1,2,11,1565,1492,1640,148
2020,1,2,12,1608,1521,1590,69
2020,1,2,13,1687,1587,1643,56
2020,1,2,14,1798,1687,1706,19
2020,1,2,15,1843,1755,1754,-1
2020,1,2,16,1830,1801,1925,124
2020,1,2,17,1801,1788,2006,218
2020,1,2,18,1767,1805,1931,126
2020,1,2,19,1741,1827,1986,159
2020,1,2,20,1715,1808,1871,63
2020,1,2,21,1703,1775,1825,50
2020,1,2,22,1702,1788,1827,39
2020,1,2,23,1724,1791,1913,122
2020,1,3,0,1791,1826,1843,17
2020,1,3,1,1931,1943,1795,-148
2020,1,3,2,1979,1971,1684,-287
2020,1,3,3,1978,1952,1576,-376
2020,1,3,4,1961,1926,1581,-345
2020,1,3,5,1886,1860,1631,-229
2020,1,3,6,1782,1744,1651,-93
2020,1,3,7,1693,1674,1706,32
2020,1,3,8,1630,1621,1748,127
2020,1,3,9,1604,1590,1816,226
2020,1,3,10,1595,1586,1800,214
2020,1,3,11,1601,1582,1823,241
2020,1,3,12,1635,1617,1849,232
2020,1,3,13,1713,1683,1868,185
2020,1,3,14,1842,1788,1845,57
2020,1,3,15,1878,1848,1818,-30
2020,1,3,16,1838,1820,1859,39
2020,1,3,17,1791,1766,1821,55
2020,1,3,18,1736,1710,1749,39
2020,1,3,19,1695,1643,1780,137
2020,1,3,20,1657,1611,1853,242
2020,1,3,21,1638,1577,1854,277
2020,1,3,22,1631,1574,1929,355
2020,1,3,23,1650,1591,1932,341
2020,1,4,0,1731,1656,1921,265
2020,1,4,1,1878,1810,1968,158
2020,1,4,2,1917,1881,1943,62
2020,1,4,3,1906,1883,1957,74
2020,1,4,4,1902,1878,1913,35
2020,1,4,5,1856,1833,1945,112
2020,1,4,6,1771,1741,1839,98
2020,1,4,7,1684,1663,1821,158
2020,1,4,8,1625,1597,1843,246
2020,1,4,9,1596,1564,1859,295
2020,1,4,10,1582,1563,1787,224
2020,1,4,11,1579,1559,1764,205
2020,1,4,12,1592,1575,1735,160
2020,1,4,13,1630,1608,1759,151
2020,1,4,14,1686,1663,1705,42
2020,1,4,15,1721,1705,1703,-2
2020,1,4,16,1718,1692,1767,75
2020,1,4,17,1691,1638,1699,61
2020,1,4,18,1644,1605,1768,163
2020,1,4,19,1604,1548,1808,260
2020,1,4,20,1562,1520,1861,341
2020,1,4,21,1540,1517,1684,167
2020,1,4,22,1537,1536,1841,305
2020,1,4,23,1565,1565,1958,393
2020,1,5,0,1638,1618,1875,257
2020,1,5,1,1795,1764,1911,147
2020,1,5,2,1843,1819,1938,119
2020,1,5,3,1838,1833,1931,98
2020,1,5,4,1826,1817,1929,112
2020,1,5,5,1786,1774,1894,120
2020,1,5,6,1715,1700,1895,195
2020,1,5,7,1642,1627,1889,262
2020,1,5,8,1584,1569,1900,331
2020,1,5,9,1554,1538,1802,264
2020,1,5,10,1538,1530,1731,201
2020,1,5,11,1531,1517,1741,224
2020,1,5,12,1548,1518,1729,211
2020,1,5,13,1586,1556,1664,108
2020,1,5,14,1634,1612,1588,-24
2020,1,5,15,1662,1646,1660,14
2020,1,5,16,1659,1642,1709,67
2020,1,5,17,1624,1605,1606,1
2020,1,5,18,1583,1550,1619,69
2020,1,5,19,1560,1509,1609,100
2020,1,5,20,1547,1481,1684,203
2020,1,5,21,1528,1452,1659,207
2020,1,5,22,1537,1456,1699,243
2020,1,5,23,1566,1488,1681,193
2020,1,6,0,1644,1556,1721,165
2020,1,6,1,1804,1723,1780,57
2020,1,6,2,1864,1786,1841,55
2020,1,6,3,1855,1820,1871,51
2020,1,6,4,1835,1793,1908,115
2020,1,6,5,1786,1728,1934,206
2020,1,6,6,1699,1640,1906,266
2020,1,6,7,1621,1569,1887,318
2020,1,6,8,1564,1522,1892,370
2020,1,6,9,1538,1499,1817,318
2020,1,6,10,1528,1484,1795,311
2020,1,6,11,1536,1502,1742,240
2020,1,6,12,1572,1554,1811,257
2020,1,6,13,1653,1611,1927,316
2020,1,6,14,1776,1749,1875,126
2020,1,6,15,1821,1797,1986,189
2020,1,6,16,1796,1754,2091,337
2020,1,6,17,1757,1695,2037,342
2020,1,6,18,1709,1663,2056,393
2020,1,6,19,1681,1622,2084,462
2020,1,6,20,1653,1591,2009,418
2020,1,6,21,1643,1577,1866,289
2020,1,6,22,1650,1570,1808,238
2020,1,6,23,1676,1596,1717,121
2020,1,7,0,1746,1657,1646,-11
2020,1,7,1,1894,1820,1620,-200
2020,1,7,2,1947,1899,1761,-138
2020,1,7,3,1957,1890,1854,-36
2020,1,7,4,1949,1879,1805,-74
2020,1,7,5,1888,1816,1744,-72
2020,1,7,6,1788,1701,1824,123
2020,1,7,7,1695,1619,1848,229
2020,1,7,8,1611,1584,1830,246
2020,1,7,9,1584,1559,1784,225
2020,1,7,10,1577,1557,1747,190
2020,1,7,11,1579,1576,1772,196
2020,1,7,12,1620,1620,1770,150
2020,1,7,13,1703,1696,1807,111
2020,1,7,14,1833,1828,1848,20
2020,1,7,15,1867,1871,1856,-15
2020,1,7,16,1817,1796,1899,103
2020,1,7,17,1757,1705,1938,233
2020,1,7,18,1698,1669,1921,252
2020,1,7,19,1649,1593,1844,251
2020,1,7,20,1616,1551,1747,196
2020,1,7,21,1597,1530,1675,145
2020,1,7,22,1592,1519,1702,183
2020,1,7,23,1611,1538,1692,154
2020,1,8,0,1683,1613,1642,29
2020,1,8,1,1845,1792,1758,-34
2020,1,8,2,1906,1875,1864,-11
2020,1,8,3,1908,1867,1810,-57
2020,1,8,4,1905,1860,1787,-73
2020,1,8,5,1851,1796,1706,-90
2020,1,8,6,1754,1544,1489,-55
2020,1,8,7,1660,1616,1712,96
2020,1,8,8,1595,1576,1767,191
2020,1,8,9,1571,1562,1756,194
2020,1,8,10,1560,1553,1749,196
2020,1,8,11,1569,1557,1769,212
2020,1,8,12,1606,1589,1797,208
2020,1,8,13,1691,1691,1797,106
2020,1,8,14,1818,1820,1797,-23
2020,1,8,15,1851,1849,1830,-19
2020,1,8,16,1804,1792,1917,125
2020,1,8,17,1745,1703,1826,123
2020,1,8,18,1695,1658,1828,170
2020,1,8,19,1655,1611,1889,278
2020,1,8,20,1621,1590,1886,296
2020,1,8,21,1603,1641,1913,272
2020,1,8,22,1605,1613,1896,283
2020,1,8,23,1625,1638,1850,212
2020,1,9,0,1697,1678,1830,152
2020,1,9,1,1851,1819,1810,-9
2020,1,9,2,1907,1876,1860,-16
2020,1,9,3,1909,1875,1874,-1
2020,1,9,4,1897,1861,1889,28
2020,1,9,5,1840,1789,1879,90
2020,1,9,6,1736,1699,1838,139
2020,1,9,7,1642,1659,1912,253
2020,1,9,8,1580,1572,1892,320
2020,1,9,9,1554,1556,1870,314
2020,1,9,10,1547,1531,1875,344
2020,1,9,11,1548,1541,1870,329
2020,1,9,12,1587,1577,1870,293
2020,1,9,13,1671,1667,1883,216
2020,1,9,14,1796,1787,1869,82
2020,1,9,15,1828,1822,1943,121
2020,1,9,16,1784,1774,1997,223
2020,1,9,17,1727,1746,1944,198
2020,1,9,18,1688,1744,2033,289
2020,1,9,19,1649,1732,2096,364
2020,1,9,20,1614,1708,2141,433
2020,1,9,21,1602,1675,2032,357
2020,1,9,22,1598,1675,2052,377
2020,1,9,23,1614,1705,2013,308
2020,1,10,0,1680,1735,1880,145
2020,1,10,1,1833,1867,1748,-119
2020,1,10,2,1901,1889,1648,-241
2020,1,10,3,1904,1877,1547,-330
2020,1,10,4,1894,1856,1508,-348
2020,1,10,5,1833,1801,1528,-273
2020,1,10,6,1732,1678,1507,-171
2020,1,10,7,1638,1594,1509,-85
2020,1,10,8,1572,1545,1561,16
2020,1,10,9,1546,1516,1563,47
2020,1,10,10,1538,1492,1493,1
2020,1,10,11,1545,1501,1461,-40
2020,1,10,12,1573,1528,1591,63
2020,1,10,13,1656,1613,1637,24
2020,1,10,14,1780,1752,1677,-75
2020,1,10,15,1832,1802,1796,-6
2020,1,10,16,1809,1857,1800,-57
2020,1,10,17,1777,1775,1878,103
2020,1,10,18,1744,1723,1949,226
2020,1,10,19,1713,1671,1942,271
2020,1,10,20,1692,1630,2011,381
2020,1,10,21,1670,1646,2006,360
2020,1,10,22,1674,1638,1905,267
2020,1,10,23,1698,1666,1830,164
2020,1,11,0,1755,1724,1918,194
2020,1,11,1,1897,1855,1779,-76
2020,1,11,2,1940,1911,1745,-166
2020,1,11,3,1932,1888,1665,-223
2020,1,11,4,1927,1898,1656,-242
2020,1,11,5,1879,1857,1693,-164
2020,1,11,6,1794,1766,1703,-63
2020,1,11,7,1702,1686,1689,3
2020,1,11,8,1646,1627,1720,93
2020,1,11,9,1619,1607,1669,62
2020,1,11,10,1602,1593,1543,-50
2020,1,11,11,1605,1598,1591,-7
2020,1,11,12,1619,1610,1704,94
2020,1,11,13,1654,1650,1789,139
2020,1,11,14,1712,1721,1835,114
2020,1,11,15,1758,1767,1869,102
2020,1,11,16,1756,1758,1991,233
2020,1,11,17,1733,1725,2092,367
2020,1,11,18,1704,1683,2197,514
2020,1,11,19,1663,1651,2062,411
2020,1,11,20,1630,1604,2026,422
2020,1,11,21,1599,1569,1964,395
2020,1,11,22,1593,1557,1969,412
2020,1,11,23,1624,1586,1929,343
2020,1,12,0,1686,1647,2028,381
2020,1,12,1,1839,1784,1955,171
2020,1,12,2,1889,1850,1916,66
2020,1,12,3,1880,1844,1834,-10
2020,1,12,4,1868,1824,1817,-7
2020,1,12,5,1822,1782,1866,84
2020,1,12,6,1745,1712,1869,157
2020,1,12,7,1671,1643,1885,242
2020,1,12,8,1624,1602,1915,313
2020,1,12,9,1594,1562,1889,327
2020,1,12,10,1577,1544,1857,313
2020,1,12,11,1568,1546,1839,293
2020,1,12,12,1578,1560,1868,308
2020,1,12,13,1608,1602,1932,330
2020,1,12,14,1665,1654,1970,316
2020,1,12,15,1706,1678,1982,304
2020,1,12,16,1700,1677,2060,383
2020,1,12,17,1681,1627,2085,458
2020,1,12,18,1660,1587,2109,522
2020,1,12,19,1632,1542,2044,502
2020,1,12,20,1615,1518,2050,532
2020,1,12,21,1594,1502,2026,524
2020,1,12,22,1603,1462,1984,522
2020,1,12,23,1632,1540,2005,465
2020,1,13,0,1709,1599,1966,367
2020,1,13,1,1869,1742,1968,226
2020,1,13,2,1935,1832,1946,114
2020,1,13,3,1929,1848,1917,69
2020,1,13,4,1917,1834,2005,171
2020,1,13,5,1859,1775,1948,173
2020,1,13,6,1764,1666,1863,197
2020,1,13,7,1685,1597,1855,258
2020,1,13,8,1568,1559,1820,261
2020,1,13,9,1542,1532,1799,267
2020,1,13,10,1526,1525,1745,220
2020,1,13,11,1533,1535,1761,226
2020,1,13,12,1562,1562,1800,238
2020,1,13,13,1632,1648,1789,141
2020,1,13,14,1758,1780,1854,74
2020,1,13,15,1799,1814,1993,179
2020,1,13,16,1747,1749,1997,248
2020,1,13,17,1697,1697,2051,354
2020,1,13,18,1652,1650,2127,477
2020,1,13,19,1608,1616,2158,542
2020,1,13,20,1569,1586,2209,623
2020,1,13,21,1545,1569,2172,603
2020,1,13,22,1550,1550,2108,558
2020,1,13,23,1577,1569,2037,468
2020,1,14,0,1654,1611,1970,359
2020,1,14,1,1821,1719,1976,257
2020,1,14,2,1878,1780,2039,259
2020,1,14,3,1870,1777,2002,225
2020,1,14,4,1863,1771,2054,283
2020,1,14,5,1807,1718,2042,324
2020,1,14,6,1709,1641,2029,388
2020,1,14,7,1613,1556,1882,326
2020,1,14,8,1557,1510,1903,393
2020,1,14,9,1531,1485,1882,397
2020,1,14,10,1520,1479,1834,355
2020,1,14,11,1528,1492,1728,236
2020,1,14,12,1564,1545,1703,158
2020,1,14,13,1653,1628,1693,65
2020,1,14,14,1786,1766,1691,-75
2020,1,14,15,1820,1806,1726,-80
2020,1,14,16,1777,1734,1729,-5
2020,1,14,17,1722,1660,1729,69
2020,1,14,18,1679,1610,1844,234
2020,1,14,19,1641,1547,1902,355
2020,1,14,20,1612,1507,1838,331
2020,1,14,21,1597,1497,1855,358
2020,1,14,22,1600,1506,1927,421
2020,1,14,23,1621,1531,1972,441
2020,1,15,0,1686,1574,1901,327
2020,1,15,1,1835,1710,1832,122
2020,1,15,2,1889,1781,1801,20
2020,1,15,3,1891,1775,1799,24
2020,1,15,4,1873,1759,1805,46
2020,1,15,5,1808,1693,1875,182
2020,1,15,6,1702,1588,1849,261
2020,1,15,7,1607,1506,1904,398
2020,1,15,8,1530,1467,1756,289
2020,1,15,9,1502,1447,1726,279
2020,1,15,10,1492,1431,1733,302
2020,1,15,11,1500,1439,1727,288
2020,1,15,12,1534,1485,1676,191
2020,1,15,13,1622,1574,1669,95
2020,1,15,14,1737,1699,1661,-38
2020,1,15,15,1764,1731,1664,-67
2020,1,15,16,1711,1699,1606,-93
2020,1,15,17,1655,1644,1528,-116
2020,1,15,18,1614,1572,1443,-129
2020,1,15,19,1580,1530,1425,-105
2020,1,15,20,1549,1498,1467,-31
2020,1,15,21,1540,1474,1439,-35
2020,1,15,22,1546,1467,1440,-27
2020,1,15,23,1567,1498,1413,-85
2020,1,16,0,1624,1557,1397,-160
2020,1,16,1,1754,1671,1567,-104
2020,1,16,2,1805,1728,1625,-103
2020,1,16,3,1804,1710,1717,7
2020,1,16,4,1787,1712,1696,-16
2020,1,16,5,1722,1658,1647,-11
2020,1,16,6,1626,1562,1678,116
2020,1,16,7,1540,1473,1679,206
2020,1,16,8,1478,1424,1389,-35
2020,1,16,9,1448,1402,1443,41
2020,1,16,10,1439,1420,1326,-94
2020,1,16,11,1444,1420,1408,-12
2020,1,16,12,1488,1435,1519,84
2020,1,16,13,1582,1523,1569,46
2020,1,16,14,1705,1661,1545,-116
2020,1,16,15,1752,1718,1512,-206
2020,1,16,16,1745,1733,1412,-321
2020,1,16,17,1729,1756,1333,-423
2020,1,16,18,1716,1806,1303,-503
2020,1,16,19,1693,1803,1295,-508
2020,1,16,20,1678,1814,1279,-535
2020,1,16,21,1682,1803,1325,-478
2020,1,16,22,1687,1802,1315,-487
2020,1,16,23,1702,1829,1266,-563
2020,1,17,0,1744,1863,1347,-516
2020,1,17,1,1856,1948,1440,-508
2020,1,17,2,1890,1971,1456,-515
2020,1,17,3,1875,1922,1433,-489
2020,1,17,4,1845,1889,1455,-434
2020,1,17,5,1765,1779,1525,-254
2020,1,17,6,1657,1691,1506,-185
2020,1,17,7,1567,1603,1559,-44
2020,1,17,8,1506,1524,1513,-11
2020,1,17,9,1477,1493,1573,80
2020,1,17,10,1466,1473,1612,139
2020,1,17,11,1472,1475,1602,127
2020,1,17,12,1524,1498,1613,115
2020,1,17,13,1607,1560,1693,133
2020,1,17,14,1726,1638,1809,171
2020,1,17,15,1766,1703,1853,150
2020,1,17,16,1739,1723,1987,264
2020,1,17,17,1712,1718,1995,277
2020,1,17,18,1671,1719,1975,256
2020,1,17,19,1629,1687,1968,281
2020,1,17,20,1609,1641,2002,361
2020,1,17,21,1599,1588,2020,432
2020,1,17,22,1584,1551,1995,444
2020,1,17,23,1601,1564,1986,422
2020,1,18,0,1656,1607,1902,295
2020,1,18,1,1783,1724,1974,250
2020,1,18,2,1823,1794,1963,169
2020,1,18,3,1801,1778,1990,212
2020,1,18,4,1792,1786,2003,217
2020,1,18,5,1752,1743,1977,234
2020,1,18,6,1671,1655,1955,300
2020,1,18,7,1589,1587,1912,325
2020,1,18,8,1569,1538,1794,256
2020,1,18,9,1541,1509,1714,205
2020,1,18,10,1527,1500,1693,193
2020,1,18,11,1527,1505,1635,130
2020,1,18,12,1543,1522,1660,138
2020,1,18,13,1582,1573,1613,40
2020,1,18,14,1658,1650,1614,-36
2020,1,18,15,1699,1688,1618,-70
2020,1,18,16,1692,1685,1713,28
2020,1,18,17,1660,1647,1663,16
2020,1,18,18,1625,1593,1645,52
2020,1,18,19,1590,1546,1596,50
2020,1,18,20,1556,1508,1580,72
2020,1,18,21,1529,1479,1554,75
2020,1,18,22,1531,1465,1550,85
2020,1,18,23,1563,1480,1534,54
2020,1,19,0,1627,1542,1519,-23
2020,1,19,1,1768,1674,1605,-69
2020,1,19,2,1824,1767,1697,-70
2020,1,19,3,1809,1763,1676,-87
2020,1,19,4,1797,1748,1633,-115
2020,1,19,5,1759,1708,1652,-56
2020,1,19,6,1683,1651,1622,-29
2020,1,19,7,1612,1606,1648,42
2020,1,19,8,1576,1563,1670,107
2020,1,19,9,1552,1537,1708,171
2020,1,19,10,1538,1534,1655,121
2020,1,19,11,1535,1522,1617,95
2020,1,19,12,1545,1531,1640,109
2020,1,19,13,1582,1562,1679,117
2020,1,19,14,1638,1620,1627,7
2020,1,19,15,1679,1646,1508,-138
2020,1,19,16,1665,1663,1577,-86
2020,1,19,17,1632,1621,1635,14
2020,1,19,18,1602,1582,1604,22
2020,1,19,19,1571,1528,1591,63
2020,1,19,20,1550,1497,1576,79
2020,1,19,21,1533,1485,1573,88
2020,1,19,22,1531,1494,1544,50
2020,1,19,23,1571,1513,1485,-28
2020,1,20,0,1636,1572,1483,-89
2020,1,20,1,1790,1704,1547,-157
2020,1,20,2,1857,1778,1566,-212
2020,1,20,3,1845,1767,1552,-215
2020,1,20,4,1818,1776,1518,-258
2020,1,20,5,1761,1704,1479,-225
2020,1,20,6,1671,1635,1464,-171
2020,1,20,7,1596,1553,1394,-159
2020,1,20,8,1534,1516,1453,-63
2020,1,20,9,1507,1488,1464,-24
2020,1,20,10,1506,1489,1387,-102
2020,1,20,11,1522,1490,1358,-132
2020,1,20,12,1561,1509,1305,-204
2020,1,20,13,1651,1601,1406,-195
2020,1,20,14,1770,1681,1457,-224
2020,1,20,15,1806,1726,1460,-266
2020,1,20,16,1773,1708,1476,-232
2020,1,20,17,1734,1667,1488,-179
2020,1,20,18,1696,1630,1471,-159
2020,1,20,19,1664,1594,1384,-210
2020,1,20,20,1638,1581,1479,-102
2020,1,20,21,1622,1542,1508,-34
2020,1,20,22,1616,1544,1529,-15
2020,1,20,23,1635,1575,1549,-26
2020,1,21,0,1700,1639,1607,-32
2020,1,21,1,1826,1780,1664,-116
2020,1,21,2,1880,1831,1701,-130
2020,1,21,3,1874,1800,1567,-233
2020,1,21,4,1850,1781,1590,-191
2020,1,21,5,1773,1699,1539,-160
2020,1,21,6,1673,1590,1474,-116
2020,1,21,7,1588,1496,1444,-52
2020,1,21,8,1517,1458,1458,0
2020,1,21,9,1487,1437,1495,58
2020,1,21,10,1470,1434,1500,66
2020,1,21,11,1476,1425,1470,45
2020,1,21,12,1523,1454,1433,-21
2020,1,21,13,1617,1548,1507,-41
2020,1,21,14,1739,1682,1518,-164
2020,1,21,15,1775,1744,1501,-243
2020,1,21,16,1746,1733,1452,-281
2020,1,21,17,1707,1705,1497,-208
2020,1,21,18,1672,1720,1594,-126
2020,1,21,19,1642,1725,1594,-131
2020,1,21,20,1618,1763,1554,-209
2020,1,21,21,1610,1758,1572,-186
2020,1,21,22,1608,1747,1593,-154
2020,1,21,23,1629,1756,1633,-123
2020,1,22,0,1686,1769,1687,-82
2020,1,22,1,1807,1843,1755,-88
2020,1,22,2,1850,1883,1756,-127
2020,1,22,3,1843,1853,1785,-68
2020,1,22,4,1818,1812,1889,77
2020,1,22,5,1742,1733,1966,233
2020,1,22,6,1641,1620,1931,311
2020,1,22,7,1553,1522,1852,330
2020,1,22,8,1514,1472,1785,313
2020,1,22,9,1485,1444,1850,406
2020,1,22,10,1476,1434,1862,428
2020,1,22,11,1483,1428,1828,400
2020,1,22,12,1514,1470,1884,414
2020,1,22,13,1605,1552,1829,277
2020,1,22,14,1724,1678,1855,177
2020,1,22,15,1766,1710,1886,176
2020,1,22,16,1743,1708,2001,293
2020,1,22,17,1699,1740,2126,386
2020,1,22,18,1664,1645,2074,429
2020,1,22,19,1636,1594,2081,487
2020,1,22,20,1613,1581,2061,480
2020,1,22,21,1594,1545,2035,490
2020,1,22,22,1597,1529,2002,473
2020,1,22,23,1613,1542,1960,418
2020,1,23,0,1672,1600,1907,307
2020,1,23,1,1815,1719,1928,209
2020,1,23,2,1860,1814,2027,213
2020,1,23,3,1842,1796,1991,195
2020,1,23,4,1825,1783,2007,224
2020,1,23,5,1754,1715,2002,287
2020,1,23,6,1655,1613,1939,326
2020,1,23,7,1566,1529,1880,351
2020,1,23,8,1522,1487,1788,301
2020,1,23,9,1498,1468,1809,341
2020,1,23,10,1493,1469,1870,401
2020,1,23,11,1498,1507,1950,443
2020,1,23,12,1533,1553,1956,403
2020,1,23,13,1626,1641,1876,235
2020,1,23,14,1758,1775,1807,32
2020,1,23,15,1791,1799,1757,-42
2020,1,23,16,1749,1733,1723,-10
2020,1,23,17,1698,1640,1701,61
2020,1,23,18,1657,1555,1635,80
2020,1,23,19,1628,1535,1660,125
2020,1,23,20,1607,1496,1679,183
2020,1,23,21,1592,1500,1735,235
2020,1,23,22,1585,1486,1673,187
2020,1,23,23,1605,1503,1669,166
2020,1,24,0,1659,1573,1667,94
2020,1,24,1,1796,1686,1577,-109
2020,1,24,2,1855,1774,1660,-114
2020,1,24,3,1840,1773,1621,-152
2020,1,24,4,1824,1768,1625,-143
2020,1,24,5,1763,1713,1624,-89
2020,1,24,6,1663,1613,1654,41
2020,1,24,7,1570,1525,1710,185
2020,1,24,8,1541,1491,1706,215
2020,1,24,9,1517,1447,1711,264
2020,1,24,10,1513,1445,1670,225
2020,1,24,11,1525,1456,1652,196
2020,1,24,12,1556,1502,1655,153
2020,1,24,13,1648,1599,1671,72
2020,1,24,14,1767,1738,1686,-52
2020,1,24,15,1800,1774,1654,-120
2020,1,24,16,1767,1710,1699,-11
2020,1,24,17,1718,1635,1627,-8
2020,1,24,18,1669,1582,1590,8
2020,1,24,19,1630,1531,1536,5
2020,1,24,20,1600,1487,1560,73
2020,1,24,21,1574,1470,1566,96
2020,1,24,22,1561,1463,1611,148
2020,1,24,23,1580,1476,1659,183
2020,1,25,0,1633,1536,1627,91
2020,1,25,1,1747,1647,1668,21
2020,1,25,2,1802,1728,1706,-22
2020,1,25,3,1794,1703,1787,84
2020,1,25,4,1788,1707,1815,108
2020,1,25,5,1738,1680,1858,178
2020,1,25,6,1657,1626,1875,249
2020,1,25,7,1580,1561,1932,371
2020,1,25,8,1545,1511,1886,375
2020,1,25,9,1512,1484,1791,307
2020,1,25,10,1500,1465,1772,307
2020,1,25,11,1503,1469,1741,272
2020,1,25,12,1513,1498,1802,304
2020,1,25,13,1548,1540,1844,304
2020,1,25,14,1621,1598,1811,213
2020,1,25,15,1662,1618,1872,254
2020,1,25,16,1656,1604,2005,401
2020,1,25,17,1613,1553,2033,480
2020,1,25,18,1581,1513,2027,514
2020,1,25,19,1540,1475,2004,529
2020,1,25,20,1504,1432,1925,493
2020,1,25,21,1491,1418,1942,524
2020,1,25,22,1481,1415,1915,500
2020,1,25,23,1507,1438,1870,432
2020,1,26,0,1569,1490,1824,334
2020,1,26,1,1701,1616,1804,188
2020,1,26,2,1759,1698,1811,113
2020,1,26,3,1747,1679,1704,25
2020,1,26,4,1738,1673,1674,1
2020,1,26,5,1702,1620,1685,65
2020,1,26,6,1630,1573,1829,256
2020,1,26,7,1561,1507,1830,323
2020,1,26,8,1535,1468,1813,345
2020,1,26,9,1508,1439,1787,348
2020,1,26,10,1493,1430,1720,290
2020,1,26,11,1491,1433,1711,278
2020,1,26,12,1499,1439,1712,273
2020,1,26,13,1533,1487,1772,285
2020,1,26,14,1598,1549,1772,223
2020,1,26,15,1631,1568,1771,203
2020,1,26,16,1628,1582,1889,307
2020,1,26,17,1593,1550,1920,370
2020,1,26,18,1562,1522,1856,334
2020,1,26,19,1533,1476,1738,262
2020,1,26,20,1515,1450,1741,291
2020,1,26,21,1495,1429,1783,354
2020,1,26,22,1493,1423,1743,320
2020,1,26,23,1522,1433,1655,222
2020,1,27,0,1591,1477,1667,190
2020,1,27,1,1726,1622,1657,35
2020,1,27,2,1798,1727,1685,-42
2020,1,27,3,1788,1725,1736,11
2020,1,27,4,1773,1713,1779,66
2020,1,27,5,1714,1630,1731,101
2020,1,27,6,1618,1571,1706,135
2020,1,27,7,1546,1500,1729,229
2020,1,27,8,1503,1461,1746,285
2020,1,27,9,1472,1423,1708,285
2020,1,27,10,1467,1428,1738,310
2020,1,27,11,1477,1432,1730,298
2020,1,27,12,1512,1471,1777,306
2020,1,27,13,1598,1562,1773,211
2020,1,27,14,1725,1714,1839,125
2020,1,27,15,1768,1761,1950,189
2020,1,27,16,1742,1733,1998,265
2020,1,27,17,1704,1728,2089,361
2020,1,27,18,1668,1699,2102,403
2020,1,27,19,1640,1675,1975,300
2020,1,27,20,1610,1670,1969,299
2020,1,27,21,1598,1674,2020,346
2020,1,27,22,1591,1647,2006,359
2020,1,27,23,1607,1670,1984,314
2020,1,28,0,1672,1697,1908,211
2020,1,28,1,1790,1774,1890,116
2020,1,28,2,1850,1865,2062,197
2020,1,28,3,1837,1860,2106,246
2020,1,28,4,1824,1826,2066,240
2020,1,28,5,1756,1731,2048,317
2020,1,28,6,1659,1647,2080,433
2020,1,28,7,1570,1576,2036,460
2020,1,28,8,1532,1530,1984,454
2020,1,28,9,1501,1500,1977,477
2020,1,28,10,1497,1500,1976,476
2020,1,28,11,1507,1511,1986,475
2020,1,28,12,1545,1545,1904,359
2020,1,28,13,1639,1616,1924,308
2020,1,28,14,1771,1748,2004,256
2020,1,28,15,1802,1796,1969,173
2020,1,28,16,1764,1742,1976,234
2020,1,28,17,1712,1690,2045,355
2020,1,28,18,1664,1628,2032,404
2020,1,28,19,1620,1576,2000,424
2020,1,28,20,1589,1543,1948,405
2020,1,28,21,1564,1506,1838,332
2020,1,28,22,1551,1477,1590,113
2020,1,28,23,1570,1465,1491,26
2020,1,29,0,1628,1492,1599,107
2020,1,29,1,1769,1596,1719,123
2020,1,29,2,1841,1745,1748,3
2020,1,29,3,1840,1760,1656,-104
2020,1,29,4,1833,1752,1697,-55
2020,1,29,5,1766,1697,1706,9
2020,1,29,6,1672,1599,1572,-27
2020,1,29,7,1583,1526,1547,21
2020,1,29,8,1546,1489,1474,-15
2020,1,29,9,1522,1479,1414,-65
2020,1,29,10,1518,1477,1414,-63
2020,1,29,11,1529,1489,1435,-54
2020,1,29,12,1565,1524,1382,-142
2020,1,29,13,1659,1613,1340,-273
2020,1,29,14,1789,1754,1414,-340
2020,1,29,15,1821,1789,1364,-425
2020,1,29,16,1776,1718,1369,-349
2020,1,29,17,1722,1647,1420,-227
2020,1,29,18,1675,1590,1347,-243
2020,1,29,19,1639,1543,1326,-217
2020,1,29,20,1608,1526,1319,-207
2020,1,29,21,1593,1518,1263,-255
2020,1,29,22,1590,1507,1261,-246
2020,1,29,23,1605,1533,1303,-230
2020,1,30,0,1656,1581,1449,-132
2020,1,30,1,1773,1686,1480,-206
2020,1,30,2,1850,1777,1544,-233
2020,1,30,3,1845,1777,1496,-281
2020,1,30,4,1832,1771,1474,-297
2020,1,30,5,1760,1698,1431,-267
2020,1,30,6,1669,1592,1482,-110
2020,1,30,7,1587,1502,1444,-58
2020,1,30,8,1546,1454,1295,-159
2020,1,30,9,1523,1440,1160,-280
2020,1,30,10,1524,1435,1078,-357
2020,1,30,11,1516,1444,1058,-386
2020,1,30,12,1564,1484,1061,-423
2020,1,30,13,1655,1576,1126,-450
2020,1,30,14,1782,1723,1174,-549
2020,1,30,15,1821,1771,1213,-558
2020,1,30,16,1772,1684,1277,-407
2020,1,30,17,1718,1614,1327,-287
2020,1,30,18,1677,1574,1387,-187
2020,1,30,19,1636,1541,1579,38
2020,1,30,20,1607,1514,1695,181
2020,1,30,21,1590,1483,1674,191
2020,1,30,22,1571,1478,1680,202
2020,1,30,23,1565,1497,1685,188
2020,1,31,0,1618,1558,1571,13
2020,1,31,1,1726,1678,1514,-164
2020,1,31,2,1824,1768,1641,-127
2020,1,31,3,1827,1765,1641,-124
2020,1,31,4,1822,1763,1644,-119
2020,1,31,5,1757,1707,1593,-114
2020,1,31,6,1658,1635,1565,-70
2020,1,31,7,1579,1556,1671,115
2020,1,31,8,1538,1524,1702,178
2020,1,31,9,1511,1496,1664,168
2020,1,31,10,1513,1482,1629,147
2020,1,31,11,1523,1482,1523,41
2020,1,31,12,1555,1515,1411,-104
2020,1,31,13,1642,1586,1366,-220
2020,1,31,14,1774,1713,1349,-364
2020,1,31,15,1808,1749,1387,-362
2020,1,31,16,1766,1671,1445,-226
2020,1,31,17,1710,1611,1508,-103
2020,1,31,18,1665,1556,1539,-17
2020,1,31,19,1616,1497,1590,93
2020,1,31,20,1587,1480,1631,151
2020,1,31,21,1558,1454,1660,206
2020,1,31,22,1539,1448,1675,227
2020,1,31,23,1556,1480,1697,217
2020,2,1,0,1606,1530,1604,74
2020,2,1,1,1725,1627,1578,-49
2020,2,1,2,1801,1741,1583,-158
2020,2,1,3,1794,1737,1567,-170
2020,2,1,4,1794,1751,1653,-98
2020,2,1,5,1748,1710,1602,-108
2020,2,1,6,1663,1642,1553,-89
2020,2,1,7,1585,1545,1555,10
2020,2,1,8,1557,1509,1477,-32
2020,2,1,9,1524,1476,1506,30
2020,2,1,10,1516,1468,1462,-6
2020,2,1,11,1515,1461,1412,-49
2020,2,1,12,1528,1479,1347,-132
2020,2,1,13,1567,1523,1379,-144
2020,2,1,14,1636,1582,1447,-135
2020,2,1,15,1669,1611,1533,-78
2020,2,1,16,1641,1588,1593,5
2020,2,1,17,1593,1542,1612,70
2020,2,1,18,1552,1496,1623,127
2020,2,1,19,1508,1453,1628,175
2020,2,1,20,1477,1417,1629,212
2020,2,1,21,1452,1390,1619,229
2020,2,1,22,1440,1390,1625,235
2020,2,1,23,1459,1401,1591,190
2020,2,2,0,1518,1441,1518,77
2020,2,2,1,1642,1552,1486,-66
2020,2,2,2,1725,1678,1499,-179
2020,2,2,3,1714,1671,1440,-231
2020,2,2,4,1710,1659,1465,-194
2020,2,2,5,1671,1612,1489,-123
2020,2,2,6,1606,1554,1480,-74
2020,2,2,7,1541,1489,1467,-22
2020,2,2,8,1509,1441,1429,-12
2020,2,2,9,1483,1423,1384,-39
2020,2,2,10,1470,1417,1344,-73
2020,2,2,11,1470,1412,1320,-92
2020,2,2,12,1482,1434,1338,-96
2020,2,2,13,1510,1472,1341,-131
2020,2,2,14,1570,1529,1422,-107
2020,2,2,15,1604,1555,1451,-104
2020,2,2,16,1585,1543,1322,-221
2020,2,2,17,1540,1516,1305,-211
2020,2,2,18,1502,1469,1296,-173
2020,2,2,19,1467,1441,1247,-194
2020,2,2,20,1455,1424,1311,-113
2020,2,2,21,1438,1415,1340,-75
2020,2,2,22,1436,1419,1335,-84
2020,2,2,23,1457,1432,1380,-52
2020,2,3,0,1523,1478,1434,-44
2020,2,3,1,1648,1547,1378,-169
2020,2,3,2,1731,1656,1428,-228
2020,2,3,3,1724,1664,1451,-213
2020,2,3,4,1712,1647,1517,-130
2020,2,3,5,1656,1630,1566,-64
2020,2,3,6,1572,1567,1542,-25
2020,2,3,7,1501,1488,1448,-40
2020,2,3,8,1468,1434,1490,56
2020,2,3,9,1437,1425,1401,-24
2020,2,3,10,1435,1412,1391,-21
2020,2,3,11,1443,1435,1407,-28
2020,2,3,12,1480,1462,1407,-55
2020,2,3,13,1570,1546,1467,-79
2020,2,3,14,1694,1674,1517,-157
2020,2,3,15,1731,1703,1602,-101
2020,2,3,16,1692,1639,1568,-71
2020,2,3,17,1648,1600,1566,-34
2020,2,3,18,1606,1605,1638,33
2020,2,3,19,1584,1586,1545,-41
2020,2,3,20,1554,1515,1503,-12
2020,2,3,21,1536,1486,1542,56
2020,2,3,22,1531,1480,1532,52
2020,2,3,23,1550,1506,1494,-12
2020,2,4,0,1613,1545,1452,-93
2020,2,4,1,1737,1656,1455,-201
2020,2,4,2,1802,1745,1457,-288
2020,2,4,3,1798,1720,1418,-302
2020,2,4,4,1788,1691,1511,-180
2020,2,4,5,1724,1628,1456,-172
2020,2,4,6,1630,1533,1447,-86
2020,2,4,7,1544,1451,1410,-41
2020,2,4,8,1498,1416,1398,-18
2020,2,4,9,1475,1377,1326,-51
2020,2,4,10,1470,1378,1274,-104
2020,2,4,11,1481,1387,1186,-201
2020,2,4,12,1518,1421,1081,-340
2020,2,4,13,1604,1510,1155,-355
2020,2,4,14,1743,1659,1360,-299
2020,2,4,15,1792,1733,1396,-337
2020,2,4,16,1754,1747,1503,-244
2020,2,4,17,1733,1770,1647,-123
2020,2,4,18,1702,1760,1681,-79
2020,2,4,19,1670,1749,1520,-229
2020,2,4,20,1649,1727,1463,-264
2020,2,4,21,1639,1711,1401,-310
2020,2,4,22,1630,1699,1307,-392
2020,2,4,23,1649,1707,1293,-414
2020,2,5,0,1704,1716,1402,-314
2020,2,5,1,1818,1809,1372,-437
2020,2,5,2,1910,1916,1418,-498
2020,2,5,3,1907,1916,1485,-431
2020,2,5,4,1901,1900,1560,-340
2020,2,5,5,1837,1842,1555,-287
2020,2,5,6,1740,1735,1501,-234
2020,2,5,7,1651,1655,1338,-317
2020,2,5,8,1601,1606,1328,-278
2020,2,5,9,1582,1546,1276,-270
2020,2,5,10,1581,1546,1253,-293
2020,2,5,11,1592,1549,1207,-342
2020,2,5,12,1634,1618,1219,-399
2020,2,5,13,1722,1712,1248,-464
2020,2,5,14,1858,1859,1271,-588
2020,2,5,15,1896,1883,1291,-592
2020,2,5,16,1841,1872,1355,-517
2020,2,5,17,1788,1823,1337,-486
2020,2,5,18,1747,1776,1335,-441
2020,2,5,19,1707,1711,1352,-359
2020,2,5,20,1658,1702,1327,-375
2020,2,5,21,1632,1671,1361,-310
2020,2,5,22,1617,1680,1419,-261
2020,2,5,23,1635,1677,1394,-283
2020,2,6,0,1693,1710,1342,-368
2020,2,6,1,1824,1817,1383,-434
2020,2,6,2,1918,1949,1475,-474
2020,2,6,3,1918,1946,1526,-420
2020,2,6,4,1910,1932,1588,-344
2020,2,6,5,1830,1849,1617,-232
2020,2,6,6,1737,1750,1567,-183
2020,2,6,7,1657,1667,1585,-82
2020,2,6,8,1625,1625,1583,-42
2020,2,6,9,1599,1605,1575,-30
2020,2,6,10,1589,1595,1532,-63
2020,2,6,11,1601,1606,1586,-20
2020,2,6,12,1638,1643,1582,-61
2020,2,6,13,1732,1734,1521,-213
2020,2,6,14,1847,1858,1593,-265
2020,2,6,15,1866,1888,1657,-231
2020,2,6,16,1803,1814,1807,-7
2020,2,6,17,1729,1757,1867,110
2020,2,6,18,1673,1710,1887,177
2020,2,6,19,1621,1658,1868,210
2020,2,6,20,1576,1621,1839,218
2020,2,6,21,1557,1623,1826,203
2020,2,6,22,1544,1617,1767,150
2020,2,6,23,1553,1619,1692,73
2020,2,7,0,1600,1649,1639,-10
2020,2,7,1,1714,1739,1596,-143
2020,2,7,2,1816,1829,1642,-187
2020,2,7,3,1823,1824,1507,-317
2020,2,7,4,1811,1807,1610,-197
2020,2,7,5,1754,1721,1696,-25
2020,2,7,6,1669,1632,1510,-122
2020,2,7,7,1587,1541,1559,18
2020,2,7,8,1528,1485,1524,39
2020,2,7,9,1502,1467,1508,41
2020,2,7,10,1493,1451,1471,20
2020,2,7,11,1505,1457,1439,-18
2020,2,7,12,1543,1485,1565,80
2020,2,7,13,1630,1573,1597,24
2020,2,7,14,1756,1687,1665,-22
2020,2,7,15,1778,1762,1759,-3
2020,2,7,16,1733,1658,1580,-78
2020,2,7,17,1676,1612,1715,103
2020,2,7,18,1621,1582,1716,134
2020,2,7,19,1578,1519,1757,238
2020,2,7,20,1545,1474,1832,358
2020,2,7,21,1527,1448,1848,400
2020,2,7,22,1517,1439,1841,402
2020,2,7,23,1530,1465,1732,267
2020,2,8,0,1571,1494,1803,309
2020,2,8,1,1682,1561,1792,231
2020,2,8,2,1754,1677,1762,85
2020,2,8,3,1749,1674,1724,50
2020,2,8,4,1744,1672,1753,81
2020,2,8,5,1699,1636,1778,142
2020,2,8,6,1624,1558,1721,163
2020,2,8,7,1546,1484,1550,66
2020,2,8,8,1487,1442,1438,-4
2020,2,8,9,1460,1422,1385,-37
2020,2,8,10,1449,1416,1349,-67
2020,2,8,11,1454,1414,1336,-78
2020,2,8,12,1470,1440,1329,-111
2020,2,8,13,1509,1485,1320,-165
2020,2,8,14,1587,1544,1457,-87
2020,2,8,15,1616,1565,1575,10
2020,2,8,16,1596,1533,1670,137
2020,2,8,17,1563,1507,1781,274
2020,2,8,18,1522,1463,1898,435
2020,2,8,19,1482,1416,1915,499
2020,2,8,20,1454,1386,1937,551
2020,2,8,21,1439,1366,1963,597
2020,2,8,22,1437,1368,1864,496
2020,2,8,23,1457,1379,1757,378
2020,2,9,0,1502,1433,1902,469
2020,2,9,1,1602,1512,1898,386
2020,2,9,2,1686,1625,1942,317
2020,2,9,3,1685,1617,1937,320
2020,2,9,4,1667,1609,1906,297
2020,2,9,5,1621,1561,1871,310
2020,2,9,6,1550,1510,1830,320
2020,2,9,7,1480,1451,1904,453
2020,2,9,8,1443,1413,1836,423
2020,2,9,9,1412,1380,1830,450
2020,2,9,10,1397,1368,1846,478
2020,2,9,11,1402,1365,1841,476
2020,2,9,12,1413,1389,1933,544
2020,2,9,13,1449,1432,1910,478
2020,2,9,14,1511,1499,1896,397
2020,2,9,15,1542,1501,1855,354
2020,2,9,16,1531,1513,1948,435
2020,2,9,17,1506,1494,1945,451
2020,2,9,18,1480,1459,1908,449
2020,2,9,19,1457,1428,1883,455
2020,2,9,20,1446,1401,1764,363
2020,2,9,21,1438,1396,1636,240
2020,2,9,22,1443,1409,1547,138
2020,2,9,23,1465,1441,1539,98
2020,2,10,0,1513,1499,1653,154
2020,2,10,1,1613,1619,1838,219
2020,2,10,2,1702,1691,1878,187
2020,2,10,3,1694,1710,1921,211
2020,2,10,4,1677,1691,1957,266
2020,2,10,5,1622,1638,1996,358
2020,2,10,6,1538,1542,1871,329
2020,2,10,7,1461,1444,1699,255
2020,2,10,8,1413,1394,1546,152
2020,2,10,9,1391,1366,1489,123
2020,2,10,10,1386,1360,1475,115
2020,2,10,11,1397,1363,1446,83
2020,2,10,12,1435,1393,1336,-57
2020,2,10,13,1529,1495,1339,-156
2020,2,10,14,1658,1629,1454,-175
2020,2,10,15,1696,1684,1596,-88
2020,2,10,16,1673,1669,1604,-65
2020,2,10,17,1657,1689,1618,-71
2020,2,10,18,1629,1666,1680,14
2020,2,10,19,1597,1630,1721,91
2020,2,10,20,1574,1593,1765,172
2020,2,10,21,1561,1573,1847,274
2020,2,10,22,1560,1543,1792,249
2020,2,10,23,1573,1550,1804,254
2020,2,11,0,1608,1577,1815,238
2020,2,11,1,1706,1672,1751,79
2020,2,11,2,1778,1753,1745,-8
2020,2,11,3,1772,1752,1670,-82
2020,2,11,4,1749,1730,1652,-78
2020,2,11,5,1675,1664,1786,122
2020,2,11,6,1574,1520,1819,299
2020,2,11,7,1486,1532,1953,421
2020,2,11,8,1474,1507,1938,431
2020,2,11,9,1449,1497,1938,441
2020,2,11,10,1443,1476,1906,430
2020,2,11,11,1448,1467,1905,438
2020,2,11,12,1488,1519,1929,410
2020,2,11,13,1578,1590,1965,375
2020,2,11,14,1710,1719,1984,265
2020,2,11,15,1758,1763,2007,244
2020,2,11,16,1749,1768,2005,237
2020,2,11,17,1736,1759,2038,279
2020,2,11,18,1718,1765,2068,303
2020,2,11,19,1698,1756,1994,238
2020,2,11,20,1677,1745,1962,217
2020,2,11,21,1680,1718,1944,226
2020,2,11,22,1675,1742,1712,-30
2020,2,11,23,1693,1784,1696,-88
2020,2,12,0,1730,1817,1729,-88
2020,2,12,1,1832,1893,1673,-220
2020,2,12,2,1917,1951,1650,-301
2020,2,12,3,1909,1934,1617,-317
2020,2,12,4,1887,1905,1580,-325
2020,2,12,5,1807,1806,1542,-264
2020,2,12,6,1704,1686,1519,-167
2020,2,12,7,1609,1589,1537,-52
2020,2,12,8,1571,1547,1510,-37
2020,2,12,9,1544,1521,1569,48
2020,2,12,10,1536,1502,1710,208
2020,2,12,11,1543,1508,1753,245
2020,2,12,12,1583,1544,1753,209
2020,2,12,13,1671,1628,1800,172
2020,2,12,14,1810,1760,1847,87
2020,2,12,15,1847,1794,1871,77
2020,2,12,16,1794,1770,1967,197
2020,2,12,17,1751,1706,1941,235
2020,2,12,18,1709,1642,1901,259
2020,2,12,19,1661,1612,1908,296
2020,2,12,20,1622,1586,1861,275
2020,2,12,21,1594,1555,1811,256
2020,2,12,22,1584,1517,1709,192
2020,2,12,23,1598,1520,1675,155
2020,2,13,0,1649,1557,1589,32
2020,2,13,1,1766,1677,1567,-110
2020,2,13,2,1869,1799,1681,-118
2020,2,13,3,1867,1797,1694,-103
2020,2,13,4,1853,1795,1663,-132
2020,2,13,5,1790,1731,1622,-109
2020,2,13,6,1691,1633,1607,-26
2020,2,13,7,1618,1546,1535,-11
2020,2,13,8,1566,1516,1512,-4
2020,2,13,9,1535,1500,1486,-14
2020,2,13,10,1532,1498,1513,15
2020,2,13,11,1545,1510,1482,-28
2020,2,13,12,1585,1549,1506,-43
2020,2,13,13,1672,1648,1540,-108
2020,2,13,14,1813,1777,1695,-82
2020,2,13,15,1837,1783,1737,-46
2020,2,13,16,1772,1714,1780,66
2020,2,13,17,1712,1651,1967,316
2020,2,13,18,1662,1603,2039,436
2020,2,13,19,1620,1561,2025,464
2020,2,13,20,1584,1520,1978,458
2020,2,13,21,1564,1490,1979,489
2020,2,13,22,1577,1482,1920,438
2020,2,13,23,1587,1494,1910,416
2020,2,14,0,1632,1527,1922,395
2020,2,14,1,1754,1613,1856,243
2020,2,14,2,1850,1746,1974,228
2020,2,14,3,1847,1761,1895,134
2020,2,14,4,1836,1792,1646,-146
2020,2,14,5,1776,1706,1520,-186
2020,2,14,6,1682,1635,1406,-229
2020,2,14,7,1599,1544,1416,-128
2020,2,14,8,1539,1496,1364,-132
2020,2,14,9,1516,1473,1332,-141
2020,2,14,10,1510,1460,1263,-197
2020,2,14,11,1518,1473,1255,-218
2020,2,14,12,1557,1512,1273,-239
2020,2,14,13,1644,1606,1254,-352
2020,2,14,14,1775,1723,1442,-281
2020,2,14,15,1797,1736,1605,-131
2020,2,14,16,1749,1665,1652,-13
2020,2,14,17,1694,1604,1682,78
2020,2,14,18,1635,1572,1587,15
2020,2,14,19,1596,1531,1502,-29
2020,2,14,20,1555,1469,1388,-81
2020,2,14,21,1510,1470,1331,-139
2020,2,14,22,1482,1455,1409,-46
2020,2,14,23,1494,1441,1409,-32
2020,2,15,0,1533,1466,1455,-11
2020,2,15,1,1664,1532,1430,-102
2020,2,15,2,1763,1667,1753,86
2020,2,15,3,1756,1680,1818,138
2020,2,15,4,1755,1683,1832,149
2020,2,15,5,1720,1657,1839,182
2020,2,15,6,1641,1592,1877,285
2020,2,15,7,1565,1541,1876,335
2020,2,15,8,1519,1489,1788,299
2020,2,15,9,1494,1465,1682,217
2020,2,15,10,1485,1496,1692,196
2020,2,15,11,1483,1450,1615,165
2020,2,15,12,1499,1464,1631,167
2020,2,15,13,1538,1517,1632,115
2020,2,15,14,1612,1562,1699,137
2020,2,15,15,1643,1600,1731,131
2020,2,15,16,1628,1540,1708,168
2020,2,15,17,1590,1496,1707,211
2020,2,15,18,1552,1480,1526,46
2020,2,15,19,1514,1420,1415,-5
2020,2,15,20,1479,1382,1446,64
2020,2,15,21,1454,1360,1425,65
2020,2,15,22,1440,1351,1396,45
2020,2,15,23,1458,1372,1431,59
2020,2,16,0,1514,1414,1480,66
2020,2,16,1,1619,1512,1515,3
2020,2,16,2,1714,1626,1653,27
2020,2,16,3,1712,1627,1690,63
2020,2,16,4,1707,1619,1703,84
2020,2,16,5,1663,1580,1705,125
2020,2,16,6,1596,1532,1608,76
2020,2,16,7,1531,1474,1635,161
2020,2,16,8,1490,1437,1561,124
2020,2,16,9,1460,1404,1548,144
2020,2,16,10,1446,1406,1559,153
2020,2,16,11,1443,1402,1561,159
2020,2,16,12,1462,1412,1533,121
2020,2,16,13,1497,1500,1673,173
2020,2,16,14,1564,1505,1623,118
2020,2,16,15,1587,1524,1616,92
2020,2,16,16,1570,1486,1718,232
2020,2,16,17,1538,1462,1720,258
2020,2,16,18,1502,1429,1773,344
2020,2,16,19,1480,1399,1835,436
2020,2,16,20,1459,1358,1809,451
2020,2,16,21,1443,1363,1819,456
2020,2,16,22,1441,1387,1821,434
2020,2,16,23,1463,1403,1792,389
2020,2,17,0,1515,1495,1778,283
2020,2,17,1,1624,1574,1622,48
2020,2,17,2,1720,1656,1636,-20
2020,2,17,3,1723,1653,1714,61
2020,2,17,4,1709,1673,1777,104
2020,2,17,5,1656,1601,1725,124
2020,2,17,6,1560,1534,1644,110
2020,2,17,7,1490,1436,1624,188
2020,2,17,8,1449,1411,1585,174
2020,2,17,9,1429,1395,1624,229
2020,2,17,10,1422,1378,1655,277
2020,2,17,11,1432,1373,1657,284
2020,2,17,12,1468,1406,1703,297
2020,2,17,13,1554,1480,1751,271
2020,2,17,14,1684,1568,1815,247
2020,2,17,15,1712,1595,1798,203
2020,2,17,16,1673,1540,1601,61
2020,2,17,17,1637,1489,1358,-131
2020,2,17,18,1588,1468,1418,-50
2020,2,17,19,1560,1443,1408,-35
2020,2,17,20,1531,1419,1320,-99
2020,2,17,21,1514,1427,1289,-138
2020,2,17,22,1514,1443,1367,-76
2020,2,17,23,1532,1476,1380,-96
2020,2,18,0,1586,1507,1214,-293
2020,2,18,1,1691,1568,1191,-377
2020,2,18,2,1776,1662,1272,-390
2020,2,18,3,1773,1666,1247,-419
2020,2,18,4,1762,1656,1217,-439
2020,2,18,5,1696,1581,1226,-355
2020,2,18,6,1597,1484,1100,-384
2020,2,18,7,1509,1421,1104,-317
2020,2,18,8,1431,1376,1061,-315
2020,2,18,9,1404,1356,1095,-261
2020,2,18,10,1389,1344,1120,-224
2020,2,18,11,1398,1345,1241,-104
2020,2,18,12,1436,1401,1318,-83
2020,2,18,13,1522,1487,1315,-172
2020,2,18,14,1645,1624,1359,-265
2020,2,18,15,1671,1638,1334,-304
2020,2,18,16,1634,1578,1362,-216
2020,2,18,17,1599,1526,1284,-242
2020,2,18,18,1559,1499,1240,-259
2020,2,18,19,1533,1465,1255,-210
2020,2,18,20,1514,1435,1227,-208
2020,2,18,21,1507,1422,1179,-243
2020,2,18,22,1508,1417,1164,-253
2020,2,18,23,1523,1441,1143,-298
2020,2,19,0,1568,1480,1148,-332
2020,2,19,1,1659,1545,1184,-361
2020,2,19,2,1731,1669,1327,-342
2020,2,19,3,1734,1672,1239,-433
2020,2,19,4,1727,1671,1211,-460
2020,2,19,5,1661,1608,1178,-430
2020,2,19,6,1561,1504,1213,-291
2020,2,19,7,1474,1445,1162,-283
2020,2,19,8,1417,1396,1211,-185
2020,2,19,9,1395,1373,1177,-196
2020,2,19,10,1388,1368,1072,-296
2020,2,19,11,1399,1378,1019,-359
2020,2,19,12,1444,1404,1034,-370
2020,2,19,13,1532,1498,1058,-440
2020,2,19,14,1653,1638,1052,-586
2020,2,19,15,1674,1658,1082,-576
2020,2,19,16,1631,1645,1123,-522
2020,2,19,17,1581,1632,1147,-485
2020,2,19,18,1545,1574,1086,-488
2020,2,19,19,1520,1551,1176,-375
2020,2,19,20,1499,1510,1189,-321
2020,2,19,21,1486,1476,1219,-257
2020,2,19,22,1492,1444,1235,-209
2020,2,19,23,1506,1441,1209,-232
2020,2,20,0,1551,1473,1073,-400
2020,2,20,1,1639,1547,1046,-501
2020,2,20,2,1719,1652,1184,-468
2020,2,20,3,1718,1679,1148,-531
2020,2,20,4,1704,1678,1124,-554
2020,2,20,5,1636,1611,1177,-434
2020,2,20,6,1545,1519,1191,-328
2020,2,20,7,1460,1437,1257,-180
2020,2,20,8,1446,1401,1255,-146
2020,2,20,9,1425,1391,1326,-65
2020,2,20,10,1426,1398,1373,-25
2020,2,20,11,1429,1400,1368,-32
2020,2,20,12,1466,1426,1268,-158
2020,2,20,13,1551,1521,1169,-352
2020,2,20,14,1688,1670,1110,-560
2020,2,20,15,1719,1695,1091,-604
2020,2,20,16,1678,1651,1114,-537
2020,2,20,17,1657,1612,1100,-512
2020,2,20,18,1628,1581,1074,-507
2020,2,20,19,1601,1541,1073,-468
2020,2,20,20,1574,1511,1068,-443
2020,2,20,21,1559,1486,1038,-448
2020,2,20,22,1554,1481,1059,-422
2020,2,20,23,1568,1489,1093,-396
2020,2,21,0,1606,1520,1123,-397
2020,2,21,1,1694,1592,1129,-463
2020,2,21,2,1786,1725,1199,-526
2020,2,21,3,1786,1748,1201,-547
2020,2,21,4,1779,1744,1178,-566
2020,2,21,5,1717,1684,1121,-563
2020,2,21,6,1628,1594,1086,-508
2020,2,21,7,1542,1522,1096,-426
2020,2,21,8,1485,1483,1117,-366
2020,2,21,9,1468,1466,1106,-360
2020,2,21,10,1463,1460,1084,-376
2020,2,21,11,1473,1471,1074,-397
2020,2,21,12,1513,1506,1067,-439
2020,2,21,13,1594,1579,1082,-497
2020,2,21,14,1716,1716,1102,-614
2020,2,21,15,1722,1736,1125,-611
2020,2,21,16,1680,1705,1180,-525
2020,2,21,17,1635,1694,1272,-422
2020,2,21,18,1589,1647,1377,-270
2020,2,21,19,1551,1595,1490,-105
2020,2,21,20,1517,1600,1581,-19
2020,2,21,21,1492,1578,1627,49
2020,2,21,22,1480,1538,1608,70
2020,2,21,23,1489,1540,1622,82
2020,2,22,0,1526,1585,1568,-17
2020,2,22,1,1599,1644,1469,-175
2020,2,22,2,1683,1727,1515,-212
2020,2,22,3,1693,1711,1547,-164
2020,2,22,4,1700,1704,1630,-74
2020,2,22,5,1654,1659,1638,-21
2020,2,22,6,1584,1586,1577,-9
2020,2,22,7,1510,1510,1666,156
2020,2,22,8,1464,1460,1702,242
2020,2,22,9,1436,1437,1652,215
2020,2,22,10,1422,1423,1577,154
2020,2,22,11,1417,1415,1586,171
2020,2,22,12,1434,1423,1620,197
2020,2,22,13,1475,1461,1600,139
2020,2,22,14,1548,1503,1638,135
2020,2,22,15,1580,1532,1715,183
2020,2,22,16,1579,1543,1581,38
2020,2,22,17,1564,1542,1474,-68
2020,2,22,18,1538,1504,1472,-32
2020,2,22,19,1508,1528,1533,5
2020,2,22,20,1482,1530,1519,-11
2020,2,22,21,1464,1531,1496,-35
2020,2,22,22,1465,1547,1513,-34
2020,2,22,23,1478,1559,1453,-106
2020,2,23,0,1519,1596,1391,-205
2020,2,23,1,1588,1629,1412,-217
2020,2,23,2,1669,1703,1474,-229
2020,2,23,3,1666,1682,1488,-194
2020,2,23,4,1658,1646,1577,-69
2020,2,23,5,1609,1606,1622,16
2020,2,23,6,1540,1535,1635,100
2020,2,23,7,1470,1472,1696,224
2020,2,23,8,1415,1426,1691,265
2020,2,23,9,1392,1385,1692,307
2020,2,23,10,1381,1380,1704,324
2020,2,23,11,1378,1366,1521,155
2020,2,23,12,1391,1367,1485,118
2020,2,23,13,1425,1401,1528,127
2020,2,23,14,1484,1461,1404,-57
2020,2,23,15,1514,1501,1405,-96
2020,2,23,16,1517,1498,1408,-90
2020,2,23,17,1509,1563,1775,212
2020,2,23,18,1492,1566,1799,233
2020,2,23,19,1472,1577,1886,309
2020,2,23,20,1451,1602,1980,378
2020,2,23,21,1443,1582,1976,394
2020,2,23,22,1449,1566,1950,384
2020,2,23,23,1471,1592,1923,331
2020,2,24,0,1522,1609,1913,304
2020,2,24,1,1624,1693,1925,232
2020,2,24,2,1708,1785,1866,81
2020,2,24,3,1707,1794,1899,105
2020,2,24,4,1691,1773,1790,17
2020,2,24,5,1628,1692,1697,5
2020,2,24,6,1541,1583,1658,75
2020,2,24,7,1471,1509,1594,85
2020,2,24,8,1447,1466,1591,125
2020,2,24,9,1427,1428,1648,220
2020,2,24,10,1421,1423,1679,256
2020,2,24,11,1431,1429,1703,274
2020,2,24,12,1470,1494,1711,217
2020,2,24,13,1552,1553,1588,35
2020,2,24,14,1680,1683,1652,-31
2020,2,24,15,1704,1686,1729,43
2020,2,24,16,1658,1602,1838,236
2020,2,24,17,1618,1550,1918,368
2020,2,24,18,1570,1525,1983,458
2020,2,24,19,1532,1498,2054,556
2020,2,24,20,1505,1469,2084,615
2020,2,24,21,1489,1461,2121,660
2020,2,24,22,1487,1478,2115,637
2020,2,24,23,1503,1500,2128,628
2020,2,25,0,1547,1509,2042,533
2020,2,25,1,1644,1615,1949,334
2020,2,25,2,1729,1752,1938,186
2020,2,25,3,1727,1768,1854,86
2020,2,25,4,1710,1753,1805,52
2020,2,25,5,1660,1692,1851,159
2020,2,25,6,1569,1606,1860,254
2020,2,25,7,1482,1524,1846,322
2020,2,25,8,1488,1480,1810,330
2020,2,25,9,1463,1459,1719,260
2020,2,25,10,1462,1450,1712,262
2020,2,25,11,1471,1485,1426,-59
2020,2,25,12,1510,1503,1462,-41
2020,2,25,13,1598,1596,1470,-126
2020,2,25,14,1741,1741,1456,-285
2020,2,25,15,1768,1742,1443,-299
2020,2,25,16,1733,1700,1404,-296
2020,2,25,17,1702,1641,1317,-324
2020,2,25,18,1666,1610,1285,-325
2020,2,25,19,1631,1614,1285,-329
2020,2,25,20,1604,1614,1304,-310
2020,2,25,21,1588,1585,1331,-254
2020,2,25,22,1573,1570,1434,-136
2020,2,25,23,1587,1578,1555,-23
2020,2,26,0,1621,1628,1676,48
2020,2,26,1,1713,1705,1748,43
2020,2,26,2,1828,1841,1750,-91
2020,2,26,3,1839,1860,1867,7
2020,2,26,4,1830,1849,1871,22
2020,2,26,5,1766,1793,1818,25
2020,2,26,6,1667,1700,1744,44
2020,2,26,7,1587,1618,1673,55
2020,2,26,8,1581,1578,1451,-127
2020,2,26,9,1556,1555,1388,-167
2020,2,26,10,1551,1557,1357,-200
2020,2,26,11,1566,1567,1349,-218
2020,2,26,12,1608,1602,1370,-232
2020,2,26,13,1687,1703,1415,-288
2020,2,26,14,1817,1823,1471,-352
2020,2,26,15,1835,1819,1510,-309
2020,2,26,16,1778,1728,1551,-177
2020,2,26,17,1720,1667,1588,-79
2020,2,26,18,1674,1607,1705,98
2020,2,26,19,1631,1561,1712,151
2020,2,26,20,1589,1522,1754,232
2020,2,26,21,1568,1498,1769,271
2020,2,26,22,1558,1487,1676,189
2020,2,26,23,1566,1489,1654,165
2020,2,27,0,1604,1525,1671,146
2020,2,27,1,1696,1612,1654,42
2020,2,27,2,1813,1751,1689,-62
2020,2,27,3,1829,1776,1689,-87
2020,2,27,4,1824,1789,1788,-1
2020,2,27,5,1763,1739,1909,170
2020,2,27,6,1673,1647,1809,162
2020,2,27,7,1588,1574,1851,277
2020,2,27,8,1548,1527,1964,437
2020,2,27,9,1525,1511,1836,325
2020,2,27,10,1521,1503,1764,261
2020,2,27,11,1525,1505,1718,213
2020,2,27,12,1565,1552,1686,134
2020,2,27,13,1656,1640,1643,3
2020,2,27,14,1784,1763,1716,-47
2020,2,27,15,1787,1755,1697,-58
2020,2,27,16,1717,1663,1674,11
2020,2,27,17,1652,1598,1696,98
2020,2,27,18,1603,1548,1717,169
2020,2,27,19,1563,1498,1680,182
2020,2,27,20,1531,1471,1651,180
2020,2,27,21,1509,1462,1588,126
2020,2,27,22,1503,1453,1627,174
2020,2,27,23,1507,1459,1612,153
2020,2,28,0,1546,1486,1639,153
2020,2,28,1,1630,1567,1516,-51
2020,2,28,2,1742,1686,1615,-71
2020,2,28,3,1758,1711,1754,43
2020,2,28,4,1752,1738,1759,21
2020,2,28,5,1693,1650,1647,-3
2020,2,28,6,1608,1571,1598,27
2020,2,28,7,1528,1504,1568,64
2020,2,28,8,1495,1455,1566,111
2020,2,28,9,1473,1439,1507,68
2020,2,28,10,1467,1437,1450,13
2020,2,28,11,1476,1439,1468,29
2020,2,28,12,1513,1482,1481,-1
2020,2,28,13,1603,1570,1538,-32
2020,2,28,14,1724,1693,1575,-118
2020,2,28,15,1732,1705,1535,-170
2020,2,28,16,1671,1633,1480,-153
2020,2,28,17,1621,1563,1401,-162
2020,2,28,18,1576,1549,1445,-104
2020,2,28,19,1539,1496,1432,-64
2020,2,28,20,1507,1468,1428,-40
2020,2,28,21,1488,1456,1320,-136
2020,2,28,22,1473,1437,1320,-117
2020,2,28,23,1482,1449,1329,-120
2020,2,29,0,1511,1479,1322,-157
2020,2,29,1,1582,1547,1360,-187
2020,2,29,2,1688,1629,1469,-160
2020,2,29,3,1704,1639,1425,-214
2020,2,29,4,1705,1663,1443,-220
2020,2,29,5,1665,1629,1479,-150
2020,2,29,6,1588,1567,1486,-81
2020,2,29,7,1504,1503,1451,-52
2020,2,29,8,1452,1456,1449,-7
2020,2,29,9,1426,1434,1483,49
2020,2,29,10,1416,1411,1496,85
2020,2,29,11,1416,1407,1435,28
2020,2,29,12,1437,1413,1356,-57
2020,2,29,13,1478,1467,1448,-19
2020,2,29,14,1542,1513,1561,48
2020,2,29,15,1555,1524,1604,80
2020,2,29,16,1536,1509,1704,195
2020,2,29,17,1504,1480,1694,214
2020,2,29,18,1475,1442,1715,273
2020,2,29,19,1444,1404,1613,209
2020,2,29,20,1424,1373,1670,297
2020,2,29,21,1403,1377,1709,332
2020,2,29,22,1408,1374,1697,323
2020,2,29,23,1425,1395,1722,327
2020,3,1,0,1463,1440,1723,283
2020,3,1,1,1547,1496,1655,159
2020,3,1,2,1642,1614,1651,37
2020,3,1,3,1650,1625,1559,-66
2020,3,1,4,1629,1611,1508,-103
2020,3,1,5,1594,1579,1526,-53
2020,3,1,6,1531,1522,1500,-22
2020,3,1,7,1461,1461,1571,110
2020,3,1,8,1414,1431,1534,103
2020,3,1,9,1388,1403,1589,186
2020,3,1,10,1373,1385,1603,218
2020,3,1,11,1366,1396,1648,252
2020,3,1,12,1376,1404,1599,195
2020,3,1,13,1413,1434,1654,220
2020,3,1,14,1466,1481,1620,139
2020,3,1,15,1480,1478,1613,135
2020,3,1,16,1472,1492,1729,237
2020,3,1,17,1451,1456,1813,357
2020,3,1,18,1434,1414,1823,409
2020,3,1,19,1427,1381,1723,342
2020,3,1,20,1416,1425,1732,307
2020,3,1,21,1409,1399,1696,297
2020,3,1,22,1415,1403,1669,266
2020,3,1,23,1440,1424,1655,231
2020,3,2,0,1489,1474,1689,215
2020,3,2,1,1579,1543,1585,42
2020,3,2,2,1672,1659,1558,-101
2020,3,2,3,1677,1681,1619,-62
2020,3,2,4,1658,1667,1694,27
2020,3,2,5,1599,1607,1816,209
2020,3,2,6,1514,1523,1743,220
2020,3,2,7,1440,1438,1626,188
2020,3,2,8,1402,1407,1654,247
2020,3,2,9,1383,1369,1629,260
2020,3,2,10,1374,1362,1616,254
2020,3,2,11,1386,1356,1523,167
2020,3,2,12,1418,1400,1503,103
2020,3,2,13,1511,1509,1551,42
2020,3,2,14,1630,1648,1561,-87
2020,3,2,15,1646,1631,1512,-119
2020,3,2,16,1615,1569,1411,-158
2020,3,2,17,1597,1515,1434,-81
2020,3,2,18,1572,1465,1415,-50
2020,3,2,19,1552,1446,1489,43
2020,3,2,20,1531,1444,1555,111
2020,3,2,21,1514,1427,1619,192
2020,3,2,22,1514,1422,1669,247
2020,3,2,23,1523,1452,1679,227
2020,3,3,0,1562,1488,1654,166
2020,3,3,1,1652,1542,1515,-27
2020,3,3,2,1745,1662,1568,-94
2020,3,3,3,1753,1686,1571,-115
2020,3,3,4,1735,1674,1578,-96
2020,3,3,5,1670,1610,1550,-60
2020,3,3,6,1571,1529,1500,-29
2020,3,3,7,1491,1431,1459,28
2020,3,3,8,1429,1407,1350,-57
2020,3,3,9,1409,1390,1384,-6
2020,3,3,10,1391,1381,1471,90
2020,3,3,11,1401,1392,1483,91
2020,3,3,12,1446,1442,1461,19
2020,3,3,13,1542,1539,1321,-218
2020,3,3,14,1662,1664,1357,-307
2020,3,3,15,1669,1646,1549,-97
2020,3,3,16,1622,1636,1764,128
2020,3,3,17,1574,1538,1696,158
2020,3,3,18,1538,1481,1606,125
2020,3,3,19,1512,1440,1562,122
2020,3,3,20,1496,1439,1438,-1
2020,3,3,21,1487,1461,1369,-92
2020,3,3,22,1489,1485,1387,-98
2020,3,3,23,1501,1467,1337,-130
2020,3,4,0,1533,1509,1273,-236
2020,3,4,1,1614,1581,1236,-345
2020,3,4,2,1712,1679,1342,-337
2020,3,4,3,1720,1702,1365,-337
2020,3,4,4,1710,1688,1387,-301
2020,3,4,5,1648,1607,1527,-80
2020,3,4,6,1553,1517,1483,-34
2020,3,4,7,1469,1451,1533,82
2020,3,4,8,1435,1401,1605,204
2020,3,4,9,1414,1401,1660,259
2020,3,4,10,1400,1400,1738,338
2020,3,4,11,1413,1413,1853,440
2020,3,4,12,1451,1457,1886,429
2020,3,4,13,1544,1550,1935,385
2020,3,4,14,1668,1656,2049,393
2020,3,4,15,1665,1633,1982,349
2020,3,4,16,1607,1556,1852,296
2020,3,4,17,1565,1485,1811,326
2020,3,4,18,1528,1457,1712,255
2020,3,4,19,1501,1384,1586,202
2020,3,4,20,1485,1363,1508,145
2020,3,4,21,1472,1363,1473,110
2020,3,4,22,1468,1388,1460,72
2020,3,4,23,1484,1416,1404,-12
2020,3,5,0,1526,1443,1478,35
2020,3,5,1,1589,1477,1525,48
2020,3,5,2,1689,1588,1736,148
2020,3,5,3,1707,1651,1917,266
2020,3,5,4,1698,1687,2133,446
2020,3,5,5,1638,1616,2092,476
2020,3,5,6,1547,1526,2032,506
2020,3,5,7,1460,1445,1939,494
2020,3,5,8,1416,1421,1919,498
2020,3,5,9,1402,1400,1774,374
2020,3,5,10,1393,1385,1720,335
2020,3,5,11,1400,1396,1706,310
2020,3,5,12,1448,1431,1666,235
2020,3,5,13,1543,1515,1686,171
2020,3,5,14,1658,1632,1681,49
2020,3,5,15,1658,1621,1687,66
2020,3,5,16,1607,1550,1611,61
2020,3,5,17,1563,1527,1657,130
2020,3,5,18,1518,1469,1788,319
2020,3,5,19,1485,1433,1901,468
2020,3,5,20,1479,1415,1964,549
2020,3,5,21,1472,1406,1968,562
2020,3,5,22,1475,1403,1953,550
2020,3,5,23,1468,1419,1940,521
2020,3,6,0,1519,1450,1835,385
2020,3,6,1,1578,1500,1745,245
2020,3,6,2,1673,1598,1792,194
2020,3,6,3,1685,1627,1785,158
2020,3,6,4,1673,1627,1863,236
2020,3,6,5,1615,1564,1943,379
2020,3,6,6,1524,1477,1869,392
2020,3,6,7,1445,1408,1750,342
2020,3,6,8,1407,1361,1622,261
2020,3,6,9,1390,1342,1575,233
2020,3,6,10,1377,1328,1552,224
2020,3,6,11,1387,1343,1500,157
2020,3,6,12,1420,1377,1423,46
2020,3,6,13,1500,1476,1439,-37
2020,3,6,14,1606,1588,1483,-105
2020,3,6,15,1598,1597,1542,-55
2020,3,6,16,1544,1531,1542,11
2020,3,6,17,1508,1520,1640,120
2020,3,6,18,1474,1482,1709,227
2020,3,6,19,1430,1444,1739,295
2020,3,6,20,1413,1430,1788,358
2020,3,6,21,1399,1427,1823,396
2020,3,6,22,1420,1430,1871,441
2020,3,6,23,1445,1447,1931,484
2020,3,7,0,1478,1482,1915,433
2020,3,7,1,1518,1519,1793,274
2020,3,7,2,1613,1629,1818,189
2020,3,7,3,1637,1635,1752,117
2020,3,7,4,1650,1641,1745,104
2020,3,7,5,1612,1591,1784,193
2020,3,7,6,1528,1530,1698,168
2020,3,7,7,1452,1455,1606,151
2020,3,7,8,1397,1406,1462,56
2020,3,7,9,1371,1378,1422,44
2020,3,7,10,1357,1379,1364,-15
2020,3,7,11,1358,1351,1218,-133
2020,3,7,12,1375,1371,1200,-171
2020,3,7,13,1411,1419,1186,-233
2020,3,7,14,1473,1462,1244,-218
2020,3,7,15,1478,1478,1296,-182
2020,3,7,16,1459,1443,1348,-95
2020,3,7,17,1436,1414,1472,58
2020,3,7,18,1412,1394,1514,120
2020,3,7,19,1389,1368,1498,130
2020,3,7,20,1385,1357,1516,159
2020,3,7,21,1394,1350,1543,193
2020,3,7,22,1404,1356,1600,244
2020,3,7,23,1431,1386,1617,231
2020,3,8,0,1467,1444,1646,202
2020,3,8,1,1529,1506,1618,112
2020,3,8,2,1602,1602,1778,176
2020,3,8,3,1609,1617,1772,155
2020,3,8,4,1601,1602,1759,157
2020,3,8,5,1551,1542,1771,229
2020,3,8,6,1476,1465,1664,199
2020,3,8,7,1408,1395,1588,193
2020,3,8,8,1381,1364,1468,104
2020,3,8,9,1354,1321,1491,170
2020,3,8,10,1341,1316,1556,240
2020,3,8,11,1340,1310,1536,226
2020,3,8,12,1351,1314,1496,182
2020,3,8,13,1391,1358,1455,97
2020,3,8,14,1445,1402,1408,6
2020,3,8,15,1464,1418,1445,27
2020,3,8,16,1460,1420,1428,8
2020,3,8,17,1453,1449,1515,66
2020,3,8,18,1444,1430,1475,45
2020,3,8,19,1434,1447,1557,110
2020,3,8,20,1435,1436,1552,116
2020,3,8,21,1430,1474,1543,69
2020,3,8,22,1433,1474,1454,-20
2020,3,8,23,1443,1485,1460,-25
2020,3,9,0,1472,1527,1546,19
2020,3,9,1,1537,1572,1597,25
2020,3,9,2,1626,1663,1585,-78
2020,3,9,3,1692,1681,1603,-78
2020,3,9,4,1676,1635,1631,-4
2020,3,9,5,1586,1544,1646,102
2020,3,9,6,1493,1465,1624,159
2020,3,9,7,1639,1418,1660,242
2020,3,9,8,1395,1331,1599,268
2020,3,9,9,1374,1286,1614,328
2020,3,9,10,1366,1302,1611,309
2020,3,9,11,1385,1319,1578,259
2020,3,9,12,1422,1404,1689,285
2020,3,9,13,1520,1537,1725,188
2020,3,9,14,1626,1603,1660,57
2020,3,9,15,1630,1570,1654,84
2020,3,9,16,1580,1508,1700,192
2020,3,9,17,1560,1449,1645,196
2020,3,9,18,1525,1430,1617,187
2020,3,9,19,1495,1391,1631,240
2020,3,9,20,1481,1383,1626,243
2020,3,9,21,1466,1378,1581,203
2020,3,9,22,1473,1355,1537,182
2020,3,9,23,1480,1401,1514,113
2020,3,10,0,1501,1416,1412,-4
2020,3,10,1,1542,1470,1417,-53
2020,3,10,2,1604,1604,1589,-15
2020,3,10,3,1685,1660,1688,28
2020,3,10,4,1694,1612,1683,71
2020,3,10,5,1597,1519,1626,107
2020,3,10,6,1491,1418,1505,87
2020,3,10,7,1417,1345,1467,122
2020,3,10,8,1384,1309,1349,40
2020,3,10,9,1364,1298,1409,111
2020,3,10,10,1366,1303,1459,156
2020,3,10,11,1381,1325,1465,140
2020,3,10,12,1434,1406,1357,-49
2020,3,10,13,1537,1524,1378,-146
2020,3,10,14,1630,1591,1408,-183
2020,3,10,15,1625,1541,1388,-153
2020,3,10,16,1580,1495,1415,-80
2020,3,10,17,1549,1484,1534,50
2020,3,10,18,1498,1457,1647,190
2020,3,10,19,1477,1442,1710,268
2020,3,10,20,1463,1444,1816,372
2020,3,10,21,1478,1456,1811,355
2020,3,10,22,1491,1475,1858,383
2020,3,10,23,1506,1485,1815,330
2020,3,11,0,1540,1499,1690,191
2020,3,11,1,1595,1535,1633,98
2020,3,11,2,1661,1608,1662,54
2020,3,11,3,1692,1627,1655,28
2020,3,11,4,1667,1563,1629,66
2020,3,11,5,1585,1475,1526,51
2020,3,11,6,1490,1389,1491,102
2020,3,11,7,1426,1346,1403,57
2020,3,11,8,1307,1317,1461,144
2020,3,11,9,1269,1309,1361,52
2020,3,11,10,1270,1301,1255,-46
2020,3,11,11,1289,1318,1220,-98
2020,3,11,12,1350,1384,1203,-181
2020,3,11,13,1453,1511,1237,-274
2020,3,11,14,1545,1577,1318,-259
2020,3,11,15,1555,1552,1246,-306
2020,3,11,16,1519,1521,1215,-306
2020,3,11,17,1489,1468,1364,-104
2020,3,11,18,1477,1440,1567,127
2020,3,11,19,1459,1413,1704,291
2020,3,11,20,1452,1443,1791,348
2020,3,11,21,1452,1477,1778,301
2020,3,11,22,1456,1507,1794,287
2020,3,11,23,1471,1508,1691,183
2020,3,12,0,1495,1522,1632,110
2020,3,12,1,1545,1558,1594,36
2020,3,12,2,1626,1635,1627,-8
2020,3,12,3,1664,1638,1456,-182
2020,3,12,4,1642,1587,1498,-89
2020,3,12,5,1561,1493,1521,28
2020,3,12,6,1465,1391,1541,150
2020,3,12,7,1387,1334,1496,162
2020,3,12,8,1331,1315,1525,210
2020,3,12,9,1312,1306,1547,241
2020,3,12,10,1306,1299,1558,259
2020,3,12,11,1326,1322,1597,275
2020,3,12,12,1387,1391,1573,182
2020,3,12,13,1491,1495,1600,105
2020,3,12,14,1582,1560,1481,-79
2020,3,12,15,1566,1536,1495,-41
2020,3,12,16,1535,1508,1551,43
2020,3,12,17,1511,1476,1561,85
2020,3,12,18,1484,1454,1558,104
2020,3,12,19,1461,1460,1616,156
2020,3,12,20,1459,1471,1571,100
2020,3,12,21,1466,1493,1474,-19
2020,3,12,22,1471,1471,1260,-211
2020,3,12,23,1491,1476,1131,-345
2020,3,13,0,1516,1497,1065,-432
2020,3,13,1,1564,1515,1096,-419
2020,3,13,2,1628,1592,1245,-347
2020,3,13,3,1648,1615,1408,-207
2020,3,13,4,1617,1568,1497,-71
2020,3,13,5,1537,1466,1459,-7
2020,3,13,6,1452,1370,1387,17
2020,3,13,7,1393,1315,1191,-124
2020,3,13,8,1327,1284,1180,-104
2020,3,13,9,1310,1271,1219,-52
2020,3,13,10,1342,1281,1192,-89
2020,3,13,11,1332,1303,1239,-64
2020,3,13,12,1381,1380,1316,-64
2020,3,13,13,1489,1488,1388,-100
2020,3,13,14,1578,1554,1378,-176
2020,3,13,15,1579,1552,1358,-194
2020,3,13,16,1573,1571,1411,-160
2020,3,13,17,1531,1553,1428,-125
2020,3,13,18,1495,1549,1432,-117
2020,3,13,19,1469,1525,1294,-231
2020,3,13,20,1475,1496,1340,-156
2020,3,13,21,1486,1473,1333,-140
2020,3,13,22,1481,1498,1344,-154
2020,3,13,23,1464,1501,1377,-124
2020,3,14,0,1482,1533,1490,-43
2020,3,14,1,1531,1529,1417,-112
2020,3,14,2,1618,1597,1431,-166
2020,3,14,3,1633,1627,1504,-123
2020,3,14,4,1608,1593,1596,3
2020,3,14,5,1552,1510,1554,44
2020,3,14,6,1456,1434,1505,71
2020,3,14,7,1406,1373,1417,44
2020,3,14,8,1348,1338,1301,-37
2020,3,14,9,1340,1332,1284,-48
2020,3,14,10,1358,1321,1306,-15
2020,3,14,11,1370,1335,1386,51
2020,3,14,12,1408,1366,1415,49
2020,3,14,13,1454,1420,1430,10
2020,3,14,14,1509,1461,1453,-8
2020,3,14,15,1518,1451,1380,-71
2020,3,14,16,1488,1430,1420,-10
2020,3,14,17,1446,1408,1501,93
2020,3,14,18,1393,1386,1562,176
2020,3,14,19,1381,1385,1546,161
2020,3,14,20,1383,1364,1506,142
2020,3,14,21,1387,1348,1506,158
2020,3,14,22,1364,1341,1501,160
2020,3,14,23,1392,1386,1470,84
2020,3,15,0,1441,1412,1573,161
2020,3,15,1,1484,1456,1540,84
2020,3,15,2,1582,1537,1550,13
2020,3,15,3,1608,1565,1588,23
2020,3,15,4,1585,1537,1567,30
2020,3,15,5,1525,1468,1535,67
2020,3,15,6,1453,1405,1474,69
2020,3,15,7,1398,1359,1496,137
2020,3,15,8,1337,1321,1445,124
2020,3,15,9,1328,1307,1402,95
2020,3,15,10,1336,1297,1347,50
2020,3,15,11,1347,1317,1343,26
2020,3,15,12,1380,1344,1364,20
2020,3,15,13,1410,1390,1365,-25
2020,3,15,14,1447,1420,1375,-45
2020,3,15,15,1443,1431,1472,41
2020,3,15,16,1414,1422,1565,143
2020,3,15,17,1387,1414,1533,119
2020,3,15,18,1347,1381,1665,284
2020,3,15,19,1350,1382,1606,224
2020,3,15,20,1363,1407,1586,179
2020,3,15,21,1365,1418,1597,179
2020,3,15,22,1356,1396,1645,249
2020,3,15,23,1395,1384,1568,184
2020,3,16,0,1456,1419,1609,190
2020,3,16,1,1520,1464,1642,178
2020,3,16,2,1617,1540,1671,131
2020,3,16,3,1640,1575,1691,116
2020,3,16,4,1609,1528,1709,181
2020,3,16,5,1521,1453,1640,187
2020,3,16,6,1429,1369,1554,185
2020,3,16,7,1360,1320,1399,79
2020,3,16,8,1329,1295,1448,153
2020,3,16,9,1320,1284,1413,129
2020,3,16,10,1319,1298,1374,76
2020,3,16,11,1339,1323,1355,32
2020,3,16,12,1395,1390,1197,-193
2020,3,16,13,1505,1502,1282,-220
2020,3,16,14,1582,1557,1337,-220
2020,3,16,15,1566,1519,1407,-112
2020,3,16,16,1512,1447,1479,32
2020,3,16,17,1483,1413,1457,44
2020,3,16,18,1443,1398,1508,110
2020,3,16,19,1433,1379,1569,190
2020,3,16,20,1432,1358,1649,291
2020,3,16,21,1437,1354,1709,355
2020,3,16,22,1439,1353,1780,427
2020,3,16,23,1475,1373,1743,370
2020,3,17,0,1515,1430,1730,300
2020,3,17,1,1560,1429,1653,224
2020,3,17,2,1633,1511,1714,203
2020,3,17,3,1650,1533,1790,257
2020,3,17,4,1619,1493,1669,176
2020,3,17,5,1531,1422,1713,291
2020,3,17,6,1437,1322,1617,295
2020,3,17,7,1366,1269,1496,227
2020,3,17,8,1327,1235,1449,214
2020,3,17,9,1308,1219,1490,271
2020,3,17,10,1306,1214,1432,218
2020,3,17,11,1329,1242,1510,268
2020,3,17,12,1386,1310,1425,115
2020,3,17,13,1499,1399,1353,-46
2020,3,17,14,1579,1460,1351,-109
2020,3,17,15,1567,1470,1421,-49
2020,3,17,16,1527,1489,1537,48
2020,3,17,17,1498,1469,1547,78
2020,3,17,18,1465,1464,1539,75
2020,3,17,19,1450,1449,1504,55
2020,3,17,20,1456,1446,1472,26
2020,3,17,21,1465,1417,1666,249
2020,3,17,22,1471,1401,1750,349
2020,3,17,23,1479,1413,1677,264
2020,3,18,0,1505,1417,1748,331
2020,3,18,1,1540,1441,1770,329
2020,3,18,2,1616,1512,1747,235
2020,3,18,3,1624,1542,1807,265
2020,3,18,4,1604,1490,1818,328
2020,3,18,5,1522,1412,1809,397
2020,3,18,6,1425,1346,1810,464
2020,3,18,7,1361,1302,1805,503
2020,3,18,8,1337,1269,1857,588
2020,3,18,9,1317,1252,1777,525
2020,3,18,10,1313,1254,1670,416
2020,3,18,11,1332,1271,1599,328
2020,3,18,12,1390,1323,1556,233
2020,3,18,13,1488,1430,1679,249
2020,3,18,14,1568,1468,1696,228
2020,3,18,15,1563,1461,1578,117
2020,3,18,16,1492,1453,1439,-14
2020,3,18,17,1466,1437,1568,131
2020,3,18,18,1454,1450,1725,275
2020,3,18,19,1437,1435,1745,310
2020,3,18,20,1425,1479,1819,340
2020,3,18,21,1427,1490,1859,369
2020,3,18,22,1427,1509,1808,299
2020,3,18,23,1445,1526,1574,48
2020,3,19,0,1467,1519,1235,-284
2020,3,19,1,1507,1562,1331,-231
2020,3,19,2,1568,1612,1357,-255
2020,3,19,3,1603,1629,1362,-267
2020,3,19,4,1586,1561,1366,-195
2020,3,19,5,1507,1478,1438,-40
2020,3,19,6,1414,1418,1502,84
2020,3,19,7,1344,1379,1656,277
2020,3,19,8,1335,1361,1829,468
2020,3,19,9,1313,1341,1920,579
2020,3,19,10,1318,1334,1897,563
2020,3,19,11,1333,1365,1908,543
2020,3,19,12,1387,1424,1908,484
2020,3,19,13,1475,1511,1936,425
2020,3,19,14,1555,1557,1927,370
2020,3,19,15,1560,1524,1621,97
2020,3,19,16,1535,1522,1629,107
2020,3,19,17,1521,1538,1828,290
2020,3,19,18,1479,1548,1959,411
2020,3,19,19,1456,1524,1962,438
2020,3,19,20,1442,1490,1875,385
2020,3,19,21,1435,1462,1851,389
2020,3,19,22,1425,1448,1882,434
2020,3,19,23,1436,1447,1886,439
2020,3,20,0,1449,1472,1770,298
2020,3,20,1,1475,1509,1653,144
2020,3,20,2,1555,1602,1786,184
2020,3,20,3,1606,1632,1826,194
2020,3,20,4,1593,1583,1812,229
2020,3,20,5,1523,1493,1655,162
2020,3,20,6,1439,1419,1553,134
2020,3,20,7,1378,1369,1379,10
2020,3,20,8,1345,1345,1390,45
2020,3,20,9,1328,1340,1511,171
2020,3,20,10,1331,1336,1562,226
2020,3,20,11,1353,1360,1577,217
2020,3,20,12,1407,1414,1596,182
2020,3,20,13,1514,1508,1579,71
2020,3,20,14,1593,1543,1564,21
2020,3,20,15,1591,1529,1520,-9
2020,3,20,16,1556,1472,1487,15
2020,3,20,17,1520,1422,1586,164
2020,3,20,18,1488,1378,1544,166
2020,3,20,19,1450,1368,1487,119
2020,3,20,20,1441,1359,1412,53
2020,3,20,21,1435,1362,1417,55
2020,3,20,22,1423,1352,1417,65
2020,3,20,23,1432,1379,1352,-27
2020,3,21,0,1445,1425,1481,56
2020,3,21,1,1485,1462,1410,-52
2020,3,21,2,1566,1532,1599,67
2020,3,21,3,1592,1560,1652,92
2020,3,21,4,1573,1524,1698,174
2020,3,21,5,1515,1499,1681,182
2020,3,21,6,1453,1432,1551,119
2020,3,21,7,1401,1382,1298,-84
2020,3,21,8,1359,1342,1107,-235
2020,3,21,9,1336,1326,1039,-287
2020,3,21,10,1323,1327,1046,-281
2020,3,21,11,1331,1337,1049,-288
2020,3,21,12,1359,1370,1060,-310
2020,3,21,13,1413,1419,1062,-357
2020,3,21,14,1447,1448,1033,-415
2020,3,21,15,1444,1453,1041,-412
2020,3,21,16,1439,1425,1096,-329
2020,3,21,17,1430,1392,1174,-218
2020,3,21,18,1410,1368,1137,-231
2020,3,21,19,1379,1353,1143,-210
2020,3,21,20,1361,1325,1150,-175
2020,3,21,21,1350,1333,1215,-118
2020,3,21,22,1350,1407,1354,-53
2020,3,21,23,1371,1387,1239,-148
2020,3,22,0,1423,1417,1220,-197
2020,3,22,1,1441,1451,1148,-303
2020,3,22,2,1530,1524,1201,-323
2020,3,22,3,1554,1551,1205,-346
2020,3,22,4,1529,1505,1150,-355
2020,3,22,5,1463,1437,1192,-245
2020,3,22,6,1404,1378,1175,-203
2020,3,22,7,1355,1343,1197,-146
2020,3,22,8,1321,1324,1326,2
2020,3,22,9,1301,1302,1282,-20
2020,3,22,10,1297,1302,1248,-54
2020,3,22,11,1299,1311,1226,-85
2020,3,22,12,1328,1338,1255,-83
2020,3,22,13,1376,1390,1275,-115
2020,3,22,14,1411,1407,1294,-113
2020,3,22,15,1407,1409,1353,-56
2020,3,22,16,1406,1407,1462,55
2020,3,22,17,1391,1379,1440,61
2020,3,22,18,1367,1347,1446,99
2020,3,22,19,1349,1332,1417,85
2020,3,22,20,1342,1340,1443,103
2020,3,22,21,1338,1348,1476,128
2020,3,22,22,1337,1358,1479,121
2020,3,22,23,1361,1397,1498,101
2020,3,23,0,1408,1441,1462,21
2020,3,23,1,1455,1467,1265,-202
2020,3,23,2,1541,1543,1134,-409
2020,3,23,3,1570,1568,1147,-421
2020,3,23,4,1549,1503,1105,-398
2020,3,23,5,1517,1421,1101,-320
2020,3,23,6,1434,1336,1127,-209
2020,3,23,7,1376,1286,1241,-45
2020,3,23,8,1335,1267,1355,88
2020,3,23,9,1321,1255,1325,70
2020,3,23,10,1324,1259,1294,35
2020,3,23,11,1341,1271,1267,-4
2020,3,23,12,1400,1342,1219,-123
2020,3,23,13,1508,1457,1207,-250
2020,3,23,14,1589,1488,1224,-264
2020,3,23,15,1579,1499,1230,-269
2020,3,23,16,1550,1448,1216,-232
2020,3,23,17,1530,1386,1059,-327
2020,3,23,18,1509,1340,1186,-154
2020,3,23,19,1482,1330,1308,-22
2020,3,23,20,1470,1322,1380,58
2020,3,23,21,1466,1330,1462,132
2020,3,23,22,1470,1340,1450,110
2020,3,23,23,1484,1371,1441,70
2020,3,24,0,1516,1410,1426,16
2020,3,24,1,1532,1417,1360,-57
2020,3,24,2,1608,1460,1466,6
2020,3,24,3,1636,1555,1528,-27
2020,3,24,4,1609,1518,1589,71
2020,3,24,5,1520,1438,1593,155
2020,3,24,6,1434,1360,1590,230
2020,3,24,7,1372,1313,1561,248
2020,3,24,8,1303,1279,1535,256
2020,3,24,9,1307,1268,1500,232
2020,3,24,10,1308,1266,1495,229
2020,3,24,11,1323,1278,1515,237
2020,3,24,12,1389,1338,1446,108
2020,3,24,13,1504,1419,1366,-53
2020,3,24,14,1576,1443,1464,21
2020,3,24,15,1566,1420,1481,61
2020,3,24,16,1531,1373,1451,78
2020,3,24,17,1504,1335,1455,120
2020,3,24,18,1473,1313,1473,160
2020,3,24,19,1458,1295,1461,166
2020,3,24,20,1449,1284,1442,158
2020,3,24,21,1453,1277,1459,182
2020,3,24,22,1458,1283,1456,173
2020,3,24,23,1470,1299,1472,173
2020,3,25,0,1494,1347,1438,91
2020,3,25,1,1513,1381,1392,11
2020,3,25,2,1582,1450,1407,-43
2020,3,25,3,1621,1524,1529,5
2020,3,25,4,1579,1490,1520,30
2020,3,25,5,1487,1409,1501,92
2020,3,25,6,1393,1328,1448,120
2020,3,25,7,1339,1276,1424,148
2020,3,25,8,1318,1246,1403,157
2020,3,25,9,1301,1232,1387,155
2020,3,25,10,1299,1233,1360,127
2020,3,25,11,1315,1260,1356,96
2020,3,25,12,1385,1321,1348,27
2020,3,25,13,1487,1405,1372,-33
2020,3,25,14,1553,1421,1479,58
2020,3,25,15,1544,1413,1565,152
2020,3,25,16,1512,1382,1586,204
2020,3,25,17,1476,1343,1490,147
2020,3,25,18,1435,1341,1531,190
2020,3,25,19,1426,1348,1557,209
2020,3,25,20,1426,1377,1643,266
2020,3,25,21,1435,1403,1657,254
2020,3,25,22,1454,1406,1608,202
2020,3,25,23,1471,1424,1603,179
2020,3,26,0,1484,1453,1479,26
2020,3,26,1,1494,1474,1460,-14
2020,3,26,2,1540,1520,1438,-82
2020,3,26,3,1588,1542,1530,-12
2020,3,26,4,1557,1487,1488,1
2020,3,26,5,1470,1405,1479,74
2020,3,26,6,1381,1323,1499,176
2020,3,26,7,1315,1264,1484,220
2020,3,26,8,1277,1239,1518,279
2020,3,26,9,1250,1234,1494,260
2020,3,26,10,1246,1219,1437,218
2020,3,26,11,1257,1227,1381,154
2020,3,26,12,1315,1277,1430,153
2020,3,26,13,1404,1353,1475,122
2020,3,26,14,1477,1406,1485,79
2020,3,26,15,1479,1420,1527,107
2020,3,26,16,1463,1430,1393,-37
2020,3,26,17,1449,1430,1459,29
2020,3,26,18,1455,1456,1430,-26
2020,3,26,19,1459,1495,1510,15
2020,3,26,20,1463,1499,1527,28
2020,3,26,21,1477,1486,1449,-37
2020,3,26,22,1479,1454,1402,-52
2020,3,26,23,1489,1477,1422,-55
2020,3,27,0,1502,1497,1432,-65
2020,3,27,1,1518,1492,1529,37
2020,3,27,2,1550,1526,1491,-35
2020,3,27,3,1591,1520,1497,-23
2020,3,27,4,1562,1451,1452,1
2020,3,27,5,1471,1374,1434,60
2020,3,27,6,1382,1307,1411,104
2020,3,27,7,1314,1263,1327,64
2020,3,27,8,1266,1242,1446,204
2020,3,27,9,1247,1218,1522,304
2020,3,27,10,1248,1217,1519,302
2020,3,27,11,1264,1241,1555,314
2020,3,27,12,1317,1298,1568,270
2020,3,27,13,1412,1390,1554,164
2020,3,27,14,1471,1409,1453,44
2020,3,27,15,1475,1435,1572,137
2020,3,27,16,1463,1452,1514,62
2020,3,27,17,1455,1431,1496,65
2020,3,27,18,1442,1411,1431,20
2020,3,27,19,1432,1408,1469,61
2020,3,27,20,1432,1370,1460,90
2020,3,27,21,1434,1324,1323,-1
2020,3,27,22,1435,1330,1227,-103
2020,3,27,23,1443,1326,1188,-138
2020,3,28,0,1473,1362,1276,-86
2020,3,28,1,1500,1422,1544,122
2020,3,28,2,1556,1514,1576,62
2020,3,28,3,1585,1581,1586,5
2020,3,28,4,1563,1555,1589,34
2020,3,28,5,1492,1533,1624,91
2020,3,28,6,1425,1470,1636,166
2020,3,28,7,1368,1432,1633,201
2020,3,28,8,1345,1402,1535,133
2020,3,28,9,1327,1389,1581,192
2020,3,28,10,1326,1392,1601,209
2020,3,28,11,1331,1396,1592,196
2020,3,28,12,1355,1430,1599,169
2020,3,28,13,1400,1478,1555,77
2020,3,28,14,1440,1488,1481,-7
2020,3,28,15,1457,1488,1603,115
2020,3,28,16,1442,1471,1563,92
2020,3,28,17,1429,1443,1583,140
2020,3,28,18,1394,1404,1487,83
2020,3,28,19,1367,1373,1484,111
2020,3,28,20,1349,1347,1460,113
2020,3,28,21,1338,1320,1461,141
2020,3,28,22,1339,1304,1437,133
2020,3,28,23,1357,1318,1208,-110
2020,3,29,0,1392,1359,1200,-159
2020,3,29,1,1435,1416,1495,79
2020,3,29,2,1514,1509,1533,24
2020,3,29,3,1544,1562,1579,17
2020,3,29,4,1526,1521,1535,14
2020,3,29,5,1473,1456,1505,49
2020,3,29,6,1415,1400,1290,-110
2020,3,29,7,1366,1373,1097,-276
2020,3,29,8,1348,1351,1003,-348
2020,3,29,9,1325,1341,979,-362
2020,3,29,10,1328,1334,970,-364
2020,3,29,11,1326,1357,1017,-340
2020,3,29,12,1354,1376,1014,-362
2020,3,29,13,1397,1413,1072,-341
2020,3,29,14,1421,1428,1091,-337
2020,3,29,15,1418,1449,1151,-298
2020,3,29,16,1403,1457,1332,-125
2020,3,29,17,1372,1399,1303,-96
2020,3,29,18,1347,1306,1350,44
2020,3,29,19,1330,1322,1537,215
2020,3,29,20,1325,1298,1529,231
2020,3,29,21,1319,1285,1498,213
2020,3,29,22,1325,1302,1562,260
2020,3,29,23,1346,1348,1549,201
2020,3,30,0,1386,1419,1604,185
2020,3,30,1,1427,1472,1505,33
2020,3,30,2,1496,1540,1473,-67
2020,3,30,3,1535,1560,1400,-160
2020,3,30,4,1508,1508,1357,-151
2020,3,30,5,1477,1432,1416,-16
2020,3,30,6,1400,1374,1588,214
2020,3,30,7,1362,1326,1597,271
2020,3,30,8,1330,1303,1516,213
2020,3,30,9,1317,1289,1429,140
2020,3,30,10,1320,1286,1395,109
2020,3,30,11,1335,1293,1280,-13
2020,3,30,12,1392,1336,1357,21
2020,3,30,13,1498,1422,1347,-75
2020,3,30,14,1568,1455,1449,-6
2020,3,30,15,1564,1425,1523,98
2020,3,30,16,1532,1417,1613,196
2020,3,30,17,1500,1392,1648,256
2020,3,30,18,1473,1364,1528,164
2020,3,30,19,1458,1357,1507,150
2020,3,30,20,1449,1399,1561,162
2020,3,30,21,1440,1370,1497,127
2020,3,30,22,1443,1350,1505,155
2020,3,30,23,1452,1359,1514,155
2020,3,31,0,1475,1397,1461,64
2020,3,31,1,1497,1439,1582,143
2020,3,31,2,1571,1484,1520,36
2020,3,31,3,1620,1555,1559,4
2020,3,31,4,1597,1496,1545,49
2020,3,31,5,1517,1403,1551,148
2020,3,31,6,1435,1327,1571,244
2020,3,31,7,1388,1289,1482,193
2020,3,31,8,1349,1262,1452,190
2020,3,31,9,1332,1252,1401,149
2020,3,31,10,1329,1251,1483,232
2020,3,31,11,1346,1269,1488,219
2020,3,31,12,1407,1339,1485,146
2020,3,31,13,1510,1418,1449,31
2020,3,31,14,1572,1439,1441,2
2020,3,31,15,1565,1415,1442,27
2020,3,31,16,1530,1358,1322,-36
2020,3,31,17,1494,1320,1440,120
2020,3,31,18,1461,1295,1416,121
2020,3,31,19,1454,1280,1398,118
2020,3,31,20,1442,1280,1419,139
2020,3,31,21,1448,1292,1436,144
2020,3,31,22,1459,1291,1341,50
2020,3,31,23,1476,1320,1274,-46
2020,4,1,0,1499,1363,1127,-236
2020,4,1,1,1520,1392,1190,-202
2020,4,1,2,1575,1481,1224,-257
2020,4,1,3,1617,1533,1362,-171
2020,4,1,4,1581,1485,1326,-159
2020,4,1,5,1499,1413,1274,-139
2020,4,1,6,1408,1337,1270,-67
2020,4,1,7,1350,1283,1286,3
2020,4,1,8,1310,1243,1180,-63
2020,4,1,9,1290,1225,1161,-64
2020,4,1,10,1282,1228,1174,-54
2020,4,1,11,1295,1272,1185,-87
2020,4,1,12,1352,1309,1162,-147
2020,4,1,13,1443,1372,1206,-166
2020,4,1,14,1511,1388,1204,-184
2020,4,1,15,1497,1310,1044,-266
2020,4,1,16,1475,1296,1059,-237
2020,4,1,17,1457,1299,1121,-178
2020,4,1,18,1426,1293,1058,-235
2020,4,1,19,1422,1316,1323,7
2020,4,1,20,1438,1357,1120,-237
2020,4,1,21,1441,1385,1420,35
2020,4,1,22,1444,1389,1465,76
2020,4,1,23,1458,1397,1441,44
2020,4,2,0,1473,1416,1395,-21
2020,4,2,1,1503,1410,1306,-104
2020,4,2,2,1548,1429,1141,-288
2020,4,2,3,1587,1498,1210,-288
2020,4,2,4,1556,1446,1236,-210
2020,4,2,5,1468,1359,1195,-164
2020,4,2,6,1384,1284,1203,-81
2020,4,2,7,1324,1239,1174,-65
2020,4,2,8,1277,1215,1187,-28
2020,4,2,9,1248,1223,1254,31
2020,4,2,10,1239,1235,1279,44
2020,4,2,11,1259,1251,1279,28
2020,4,2,12,1318,1315,1312,-3
2020,4,2,13,1407,1364,1277,-87
2020,4,2,14,1463,1377,1248,-129
2020,4,2,15,1461,1353,1261,-92
2020,4,2,16,1450,1329,1312,-17
2020,4,2,17,1439,1326,1279,-47
2020,4,2,18,1433,1320,1333,13
2020,4,2,19,1432,1313,1326,13
2020,4,2,20,1444,1321,1333,12
2020,4,2,21,1465,1328,1330,2
2020,4,2,22,1472,1336,1286,-50
2020,4,2,23,1487,1358,1297,-61
2020,4,3,0,1508,1401,1304,-97
2020,4,3,1,1508,1428,1293,-135
2020,4,3,2,1546,1454,1171,-283
2020,4,3,3,1583,1511,1185,-326
2020,4,3,4,1546,1476,1378,-98
2020,4,3,5,1462,1404,1444,40
2020,4,3,6,1375,1334,1426,92
2020,4,3,7,1313,1275,1392,117
2020,4,3,8,1246,1248,1308,60
2020,4,3,9,1238,1231,1250,19
2020,4,3,10,1237,1229,1278,49
2020,4,3,11,1251,1249,1397,148
2020,4,3,12,1310,1288,1424,136
2020,4,3,13,1400,1359,1349,-10
2020,4,3,14,1456,1369,1347,-22
2020,4,3,15,1436,1364,1468,104
2020,4,3,16,1421,1335,1416,81
2020,4,3,17,1417,1296,1271,-25
2020,4,3,18,1401,1275,1168,-107
2020,4,3,19,1398,1270,1145,-125
2020,4,3,20,1403,1264,1106,-158
2020,4,3,21,1397,1276,1093,-183
2020,4,3,22,1397,1310,1154,-156
2020,4,3,23,1414,1321,1227,-94
2020,4,4,0,1438,1350,1428,78
2020,4,4,1,1456,1382,1398,16
2020,4,4,2,1495,1439,1418,-21
2020,4,4,3,1532,1495,1481,-14
2020,4,4,4,1508,1454,1442,-12
2020,4,4,5,1437,1426,1424,-2
2020,4,4,6,1364,1366,1497,131
2020,4,4,7,1312,1313,1464,151
2020,4,4,8,1274,1286,1413,127
2020,4,4,9,1253,1265,1340,75
2020,4,4,10,1246,1257,1293,36
2020,4,4,11,1249,1266,1326,60
2020,4,4,12,1272,1296,1245,-51
2020,4,4,13,1307,1343,1149,-194
2020,4,4,14,1329,1341,1165,-176
2020,4,4,15,1336,1331,1177,-154
2020,4,4,16,1343,1315,1211,-104
2020,4,4,17,1340,1304,1172,-132
2020,4,4,18,1326,1293,1081,-212
2020,4,4,19,1324,1277,1107,-170
2020,4,4,20,1320,1268,1205,-63
2020,4,4,21,1315,1261,1237,-24
2020,4,4,22,1331,1261,1333,72
2020,4,4,23,1362,1291,1380,89
2020,4,5,0,1402,1346,1540,194
2020,4,5,1,1439,1403,1647,244
2020,4,5,2,1476,1453,1728,275
2020,4,5,3,1507,1502,1749,247
2020,4,5,4,1479,1456,1745,289
2020,4,5,5,1411,1382,1697,315
2020,4,5,6,1348,1326,1726,400
2020,4,5,7,1300,1275,1770,495
2020,4,5,8,1267,1246,1724,478
2020,4,5,9,1243,1227,1596,369
2020,4,5,10,1233,1228,1497,269
2020,4,5,11,1235,1225,1446,221
2020,4,5,12,1249,1248,1427,179
2020,4,5,13,1269,1283,1359,76
2020,4,5,14,1281,1273,1398,125
2020,4,5,15,1286,1258,1429,171
2020,4,5,16,1300,1252,1262,10
2020,4,5,17,1305,1240,1204,-36
2020,4,5,18,1311,1249,1240,-9
2020,4,5,19,1317,1249,1342,93
2020,4,5,20,1332,1238,1318,80
2020,4,5,21,1340,1252,1411,159
2020,4,5,22,1354,1283,1597,314
2020,4,5,23,1392,1331,1625,294
2020,4,6,0,1438,1379,1670,291
2020,4,6,1,1481,1424,1757,333
2020,4,6,2,1516,1460,1709,249
2020,4,6,3,1546,1521,1820,299
2020,4,6,4,1504,1485,1814,329
2020,4,6,5,1457,1407,1766,359
2020,4,6,6,1384,1333,1795,462
2020,4,6,7,1327,1280,1716,436
2020,4,6,8,1291,1247,1647,400
2020,4,6,9,1275,1227,1550,323
2020,4,6,10,1268,1224,1420,196
2020,4,6,11,1285,1222,1411,189
2020,4,6,12,1336,1277,1327,50
2020,4,6,13,1417,1342,1305,-37
2020,4,6,14,1469,1349,1331,-18
2020,4,6,15,1472,1327,1355,28
2020,4,6,16,1459,1314,1294,-20
2020,4,6,17,1458,1313,1290,-23
2020,4,6,18,1450,1305,1396,91
2020,4,6,19,1450,1308,1513,205
2020,4,6,20,1458,1314,1598,284
2020,4,6,21,1460,1329,1623,294
2020,4,6,22,1471,1340,1639,299
2020,4,6,23,1492,1362,1611,249
2020,4,7,0,1524,1387,1540,153
2020,4,7,1,1547,1413,1634,221
2020,4,7,2,1577,1462,1691,229
2020,4,7,3,1611,1526,1846,320
2020,4,7,4,1569,1472,1806,334
2020,4,7,5,1474,1396,1772,376
2020,4,7,6,1385,1323,1638,315
2020,4,7,7,1328,1274,1520,246
2020,4,7,8,1278,1230,1477,247
2020,4,7,9,1266,1196,1489,293
2020,4,7,10,1269,1196,1406,210
2020,4,7,11,1278,1210,1394,184
2020,4,7,12,1336,1249,1322,73
2020,4,7,13,1417,1312,1360,48
2020,4,7,14,1466,1304,1433,129
2020,4,7,15,1458,1284,1359,75
2020,4,7,16,1443,1269,1479,210
2020,4,7,17,1431,1253,1503,250
2020,4,7,18,1428,1251,1584,333
2020,4,7,19,1420,1253,1610,357
2020,4,7,20,1427,1261,1613,352
2020,4,7,21,1442,1267,1602,335
2020,4,7,22,1463,1303,1634,331
2020,4,7,23,1486,1353,1616,263
2020,4,8,0,1508,1398,1573,175
2020,4,8,1,1536,1413,1471,58
2020,4,8,2,1543,1427,1420,-7
2020,4,8,3,1602,1488,1465,-23
2020,4,8,4,1568,1444,1523,79
2020,4,8,5,1486,1363,1580,217
2020,4,8,6,1399,1278,1492,214
2020,4,8,7,1336,1224,1433,209
2020,4,8,8,1302,1195,1427,232
2020,4,8,9,1280,1177,1316,139
2020,4,8,10,1275,1172,1330,158
2020,4,8,11,1287,1196,1277,81
2020,4,8,12,1338,1251,1295,44
2020,4,8,13,1406,1301,1318,17
2020,4,8,14,1438,1306,1312,6
2020,4,8,15,1428,1292,1274,-18
2020,4,8,16,1412,1271,1284,13
2020,4,8,17,1401,1265,1231,-34
2020,4,8,18,1390,1274,1245,-29
2020,4,8,19,1394,1279,1220,-59
2020,4,8,20,1409,1277,1224,-53
2020,4,8,21,1427,1291,1246,-45
2020,4,8,22,1439,1306,1244,-62
2020,4,8,23,1466,1341,1276,-65
2020,4,9,0,1495,1380,1292,-88
2020,4,9,1,1510,1404,1317,-87
2020,4,9,2,1535,1418,1376,-42
2020,4,9,3,1583,1475,1505,30
2020,4,9,4,1554,1417,1565,148
2020,4,9,5,1463,1348,1605,257
2020,4,9,6,1385,1274,1533,259
2020,4,9,7,1319,1233,1390,157
2020,4,9,8,1240,1178,1252,74
2020,4,9,9,1217,1149,1109,-40
2020,4,9,10,1211,1142,1120,-22
2020,4,9,11,1223,1153,1052,-101
2020,4,9,12,1275,1197,1023,-174
2020,4,9,13,1347,1263,1117,-146
2020,4,9,14,1389,1281,1145,-136
2020,4,9,15,1392,1284,1165,-119
2020,4,9,16,1391,1276,1311,35
2020,4,9,17,1380,1268,1351,83
2020,4,9,18,1382,1256,1324,68
2020,4,9,19,1385,1260,1346,86
2020,4,9,20,1387,1276,1426,150
2020,4,9,21,1391,1277,1461,184
2020,4,9,22,1394,1290,1497,207
2020,4,9,23,1416,1334,1519,185
2020,4,10,0,1440,1384,1536,152
2020,4,10,1,1460,1411,1506,95
2020,4,10,2,1482,1425,1535,110
2020,4,10,3,1539,1496,1672,176
2020,4,10,4,1513,1452,1700,248
2020,4,10,5,1427,1369,1623,254
2020,4,10,6,1336,1276,1472,196
2020,4,10,7,1275,1229,1445,216
2020,4,10,8,1226,1193,1314,121
2020,4,10,9,1206,1184,1250,66
2020,4,10,10,1205,1178,1255,77
2020,4,10,11,1215,1172,1215,43
2020,4,10,12,1273,1205,1209,4
2020,4,10,13,1344,1253,1198,-55
2020,4,10,14,1390,1262,1279,17
2020,4,10,15,1387,1247,1318,71
2020,4,10,16,1368,1240,1320,80
2020,4,10,17,1348,1219,1228,9
2020,4,10,18,1343,1222,1195,-27
2020,4,10,19,1351,1225,1165,-60
2020,4,10,20,1347,1219,1168,-51
2020,4,10,21,1348,1226,1194,-32
2020,4,10,22,1348,1247,1396,149
2020,4,10,23,1373,1290,1526,236
2020,4,11,0,1402,1358,1550,192
2020,4,11,1,1420,1374,1633,259
2020,4,11,2,1459,1379,1549,170
2020,4,11,3,1500,1452,1623,171
2020,4,11,4,1477,1412,1541,129
2020,4,11,5,1413,1355,1598,243
2020,4,11,6,1344,1287,1555,268
2020,4,11,7,1286,1251,1459,208
2020,4,11,8,1251,1233,1322,89
2020,4,11,9,1225,1220,1337,117
2020,4,11,10,1221,1200,1379,179
2020,4,11,11,1222,1198,1336,138
2020,4,11,12,1238,1233,1262,29
2020,4,11,13,1264,1261,1145,-116
2020,4,11,14,1285,1268,1189,-79
2020,4,11,15,1298,1257,1180,-77
2020,4,11,16,1299,1233,1192,-41
2020,4,11,17,1284,1211,1150,-61
2020,4,11,18,1280,1210,1170,-40
2020,4,11,19,1281,1211,1214,3
2020,4,11,20,1280,1216,1341,125
2020,4,11,21,1277,1243,1514,271
2020,4,11,22,1284,1269,1546,277
2020,4,11,23,1302,1322,1552,230
2020,4,12,0,1345,1361,1541,180
2020,4,12,1,1377,1403,1674,271
2020,4,12,2,1415,1437,1770,333
2020,4,12,3,1472,1481,1799,318
2020,4,12,4,1466,1435,1736,301
2020,4,12,5,1410,1380,1691,311
2020,4,12,6,1348,1311,1656,345
2020,4,12,7,1301,1252,1523,271
2020,4,12,8,1260,1216,1583,367
2020,4,12,9,1239,1189,1519,330
2020,4,12,10,1230,1183,1539,356
2020,4,12,11,1229,1197,1537,340
2020,4,12,12,1242,1205,1540,335
2020,4,12,13,1264,1240,1511,271
2020,4,12,14,1277,1236,1556,320
2020,4,12,15,1291,1273,1608,335
2020,4,12,16,1305,1275,1414,139
2020,4,12,17,1297,1312,1405,93
2020,4,12,18,1291,1297,1404,107
2020,4,12,19,1287,1312,1414,102
2020,4,12,20,1291,1286,1438,152
2020,4,12,21,1290,1268,1319,51
2020,4,12,22,1293,1276,1296,20
2020,4,12,23,1323,1298,1303,5
2020,4,13,0,1372,1331,1445,114
2020,4,13,1,1433,1350,1523,173
2020,4,13,2,1477,1404,1665,261
2020,4,13,3,1525,1453,1717,264
2020,4,13,4,1503,1412,1637,225
2020,4,13,5,1432,1350,1653,303
2020,4,13,6,1358,1279,1617,338
2020,4,13,7,1308,1244,1532,288
2020,4,13,8,1303,1205,1440,235
2020,4,13,9,1283,1197,1405,208
2020,4,13,10,1276,1199,1442,243
2020,4,13,11,1290,1203,1406,203
2020,4,13,12,1342,1253,1339,86
2020,4,13,13,1421,1340,1302,-38
2020,4,13,14,1481,1393,1337,-56
2020,4,13,15,1482,1440,1392,-48
2020,4,13,16,1469,1469,1439,-30
2020,4,13,17,1446,1501,1439,-62
2020,4,13,18,1426,1535,1374,-161
2020,4,13,19,1409,1526,1344,-182
2020,4,13,20,1401,1530,1292,-238
2020,4,13,21,1393,1506,1151,-355
2020,4,13,22,1384,1491,1149,-342
2020,4,13,23,1394,1480,1190,-290
2020,4,14,0,1429,1493,1146,-347
2020,4,14,1,1461,1514,1205,-309
2020,4,14,2,1523,1543,1317,-226
2020,4,14,3,1587,1590,1286,-304
2020,4,14,4,1567,1527,1262,-265
2020,4,14,5,1495,1438,1287,-151
2020,4,14,6,1417,1357,1316,-41
2020,4,14,7,1363,1308,1345,37
2020,4,14,8,1340,1281,1355,74
2020,4,14,9,1329,1274,1292,18
2020,4,14,10,1332,1281,1199,-82
2020,4,14,11,1345,1300,1152,-148
2020,4,14,12,1398,1361,1163,-198
2020,4,14,13,1487,1434,1179,-255
2020,4,14,14,1541,1450,1200,-250
2020,4,14,15,1523,1435,1219,-216
2020,4,14,16,1480,1402,1225,-177
2020,4,14,17,1447,1371,1202,-169
2020,4,14,18,1407,1342,1259,-83
2020,4,14,19,1381,1328,1231,-97
2020,4,14,20,1360,1305,1165,-140
2020,4,14,21,1351,1280,1162,-118
2020,4,14,22,1342,1271,1259,-12
2020,4,14,23,1358,1281,1446,165
2020,4,15,0,1392,1322,1521,199
2020,4,15,1,1428,1350,1588,238
2020,4,15,2,1505,1410,1440,30
2020,4,15,3,1577,1506,1437,-69
2020,4,15,4,1559,1472,1362,-110
2020,4,15,5,1493,1406,1311,-95
2020,4,15,6,1414,1343,1296,-47
2020,4,15,7,1366,1307,1264,-43
2020,4,15,8,1339,1298,1246,-52
2020,4,15,9,1322,1296,1221,-75
2020,4,15,10,1328,1303,1310,7
2020,4,15,11,1347,1329,1357,28
2020,4,15,12,1405,1376,1327,-49
2020,4,15,13,1504,1445,1317,-128
2020,4,15,14,1544,1457,1381,-76
2020,4,15,15,1514,1424,1354,-70
2020,4,15,16,1458,1369,1342,-27
2020,4,15,17,1415,1340,1345,5
2020,4,15,18,1378,1322,1455,133
2020,4,15,19,1356,1311,1469,158
2020,4,15,20,1338,1287,1486,199
2020,4,15,21,1330,1288,1496,208
2020,4,15,22,1323,1298,1479,181
2020,4,15,23,1334,1318,1502,184
2020,4,16,0,1363,1357,1502,145
2020,4,16,1,1388,1393,1629,236
2020,4,16,2,1462,1408,1527,119
2020,4,16,3,1540,1476,1542,66
2020,4,16,4,1523,1450,1506,56
2020,4,16,5,1456,1404,1515,111
2020,4,16,6,1383,1322,1361,39
2020,4,16,7,1335,1272,1328,56
2020,4,16,8,1276,1247,1316,69
2020,4,16,9,1264,1230,1273,43
2020,4,16,10,1264,1227,1195,-32
2020,4,16,11,1287,1253,1326,73
2020,4,16,12,1342,1314,1414,100
2020,4,16,13,1429,1380,1463,83
2020,4,16,14,1458,1369,1529,160
2020,4,16,15,1438,1330,1587,257
2020,4,16,16,1400,1303,1514,211
2020,4,16,17,1370,1293,1436,143
2020,4,16,18,1350,1301,1406,105
2020,4,16,19,1345,1304,1419,115
2020,4,16,20,1335,1303,1397,94
2020,4,16,21,1338,1297,1525,228
2020,4,16,22,1340,1310,1561,251
2020,4,16,23,1353,1336,1559,223
2020,4,17,0,1380,1384,1502,118
2020,4,17,1,1386,1401,1638,237
2020,4,17,2,1432,1394,1443,49
2020,4,17,3,1502,1457,1394,-63
2020,4,17,4,1487,1424,1351,-73
2020,4,17,5,1420,1356,1338,-18
2020,4,17,6,1338,1299,1417,118
2020,4,17,7,1289,1245,1393,148
2020,4,17,8,1253,1221,1386,165
2020,4,17,9,1241,1211,1396,185
2020,4,17,10,1238,1215,1356,141
2020,4,17,11,1253,1222,1279,57
2020,4,17,12,1301,1269,1280,11
2020,4,17,13,1376,1322,1242,-80
2020,4,17,14,1415,1338,1291,-47
2020,4,17,15,1406,1313,1257,-56
2020,4,17,16,1384,1279,1183,-96
2020,4,17,17,1362,1256,1146,-110
2020,4,17,18,1347,1247,1172,-75
2020,4,17,19,1333,1247,1209,-38
2020,4,17,20,1331,1240,1284,44
2020,4,17,21,1331,1244,1303,59
2020,4,17,22,1335,1250,1361,111
2020,4,17,23,1356,1277,1326,49
2020,4,18,0,1379,1316,1230,-86
2020,4,18,1,1395,1349,1204,-145
2020,4,18,2,1428,1382,1294,-88
2020,4,18,3,1489,1469,1409,-60
2020,4,18,4,1474,1437,1403,-34
2020,4,18,5,1419,1400,1481,81
2020,4,18,6,1349,1333,1446,113
2020,4,18,7,1295,1273,1330,57
2020,4,18,8,1244,1203,1281,78
2020,4,18,9,1222,1182,1229,47
2020,4,18,10,1213,1175,1220,45
2020,4,18,11,1218,1177,1193,16
2020,4,18,12,1230,1204,1198,-6
2020,4,18,13,1251,1225,1228,3
2020,4,18,14,1256,1224,1295,71
2020,4,18,15,1269,1224,1290,66
2020,4,18,16,1273,1222,1380,158
2020,4,18,17,1271,1214,1341,127
2020,4,18,18,1268,1231,1320,89
2020,4,18,19,1266,1270,1364,94
2020,4,18,20,1260,1275,1398,123
2020,4,18,21,1265,1249,1376,127
2020,4,18,22,1273,1278,1433,155
2020,4,18,23,1301,1319,1504,185
2020,4,19,0,1345,1350,1541,191
2020,4,19,1,1375,1362,1381,19
2020,4,19,2,1411,1390,1466,76
2020,4,19,3,1462,1458,1592,134
2020,4,19,4,1448,1401,1603,202
2020,4,19,5,1392,1336,1597,261
2020,4,19,6,1325,1282,1674,392
2020,4,19,7,1280,1257,1720,463
2020,4,19,8,1239,1228,1733,505
2020,4,19,9,1221,1188,1765,577
2020,4,19,10,1207,1163,1729,566
2020,4,19,11,1208,1170,1650,480
2020,4,19,12,1223,1195,1636,441
2020,4,19,13,1239,1216,1644,428
2020,4,19,14,1249,1211,1679,468
2020,4,19,15,1251,1209,1714,505
2020,4,19,16,1262,1191,1538,347
2020,4,19,17,1264,1188,1448,260
2020,4,19,18,1261,1195,1471,276
2020,4,19,19,1262,1211,1491,280
2020,4,19,20,1261,1209,1501,292
2020,4,19,21,1271,1212,1532,320
2020,4,19,22,1284,1234,1556,322
2020,4,19,23,1325,1274,1611,337
2020,4,20,0,1376,1331,1736,405
2020,4,20,1,1404,1369,1833,464
2020,4,20,2,1442,1410,1748,338
2020,4,20,3,1490,1480,1691,211
2020,4,20,4,1466,1430,1516,86
2020,4,20,5,1394,1345,1473,128
2020,4,20,6,1317,1259,1519,260
2020,4,20,7,1262,1195,1523,328
2020,4,20,8,1228,1170,1506,336
2020,4,20,9,1205,1154,1537,383
2020,4,20,10,1204,1152,1591,439
2020,4,20,11,1212,1159,1510,351
2020,4,20,12,1259,1209,1474,265
2020,4,20,13,1328,1259,1475,216
2020,4,20,14,1358,1287,1451,164
2020,4,20,15,1356,1293,1469,176
2020,4,20,16,1346,1280,1447,167
2020,4,20,17,1348,1281,1351,70
2020,4,20,18,1341,1279,1376,97
2020,4,20,19,1346,1290,1469,179
2020,4,20,20,1352,1294,1467,173
2020,4,20,21,1360,1312,1518,206
2020,4,20,22,1374,1340,1335,-5
2020,4,20,23,1405,1344,1441,97
2020,4,21,0,1447,1388,1515,127
2020,4,21,1,1455,1384,1239,-145
2020,4,21,2,1476,1399,1100,-299
2020,4,21,3,1540,1482,1161,-321
2020,4,21,4,1511,1434,1126,-308
2020,4,21,5,1421,1352,1136,-216
2020,4,21,6,1336,1269,1138,-131
2020,4,21,7,1282,1216,1169,-47
2020,4,21,8,1241,1177,1168,-9
2020,4,21,9,1218,1164,1269,105
2020,4,21,10,1215,1162,1285,123
2020,4,21,11,1225,1166,1270,104
2020,4,21,12,1267,1217,1274,57
2020,4,21,13,1336,1261,1222,-39
2020,4,21,14,1366,1276,1260,-16
2020,4,21,15,1360,1264,1324,60
2020,4,21,16,1345,1255,1432,177
2020,4,21,17,1340,1269,1426,157
2020,4,21,18,1341,1277,1531,254
2020,4,21,19,1350,1286,1648,362
2020,4,21,20,1359,1283,1669,386
2020,4,21,21,1373,1297,1625,328
2020,4,21,22,1386,1332,1536,204
2020,4,21,23,1419,1358,1535,177
2020,4,22,0,1451,1382,1485,103
2020,4,22,1,1463,1391,1573,182
2020,4,22,2,1484,1412,1558,146
2020,4,22,3,1542,1476,1526,50
2020,4,22,4,1517,1421,1603,182
2020,4,22,5,1426,1347,1578,231
2020,4,22,6,1339,1272,1577,305
2020,4,22,7,1280,1221,1591,370
2020,4,22,8,1232,1188,1503,315
2020,4,22,9,1213,1188,1550,362
2020,4,22,10,1205,1172,1523,351
2020,4,22,11,1217,1186,1617,431
2020,4,22,12,1259,1228,1585,357
2020,4,22,13,1321,1277,1503,226
2020,4,22,14,1350,1289,1581,292
2020,4,22,15,1344,1283,1805,522
2020,4,22,16,1339,1274,1655,381
2020,4,22,17,1335,1252,1562,310
2020,4,22,18,1337,1265,1600,335
2020,4,22,19,1346,1264,1486,222
2020,4,22,20,1356,1302,1467,165
2020,4,22,21,1378,1315,1520,205
2020,4,22,22,1391,1328,1628,300
2020,4,22,23,1412,1357,1625,268
2020,4,23,0,1451,1384,1448,64
2020,4,23,1,1459,1399,1434,35
2020,4,23,2,1480,1407,1440,33
2020,4,23,3,1535,1476,1629,153
2020,4,23,4,1509,1425,1670,245
2020,4,23,5,1423,1340,1458,118
2020,4,23,6,1337,1260,1332,72
2020,4,23,7,1281,1211,1356,145
2020,4,23,8,1228,1178,1314,136
2020,4,23,9,1209,1158,1279,121
2020,4,23,10,1196,1154,1268,114
2020,4,23,11,1212,1169,1228,59
2020,4,23,12,1256,1223,1381,158
2020,4,23,13,1325,1271,1378,107
2020,4,23,14,1360,1292,1479,187
2020,4,23,15,1339,1277,1661,384
2020,4,23,16,1329,1266,1790,524
2020,4,23,17,1333,1259,1752,493
2020,4,23,18,1344,1257,1690,433
2020,4,23,19,1362,1262,1648,386
2020,4,23,20,1380,1295,1692,397
2020,4,23,21,1393,1336,1830,494
2020,4,23,22,1412,1340,1817,477
2020,4,23,23,1456,1339,1848,509
2020,4,24,0,1478,1366,1884,518
2020,4,24,1,1488,1395,1885,490
2020,4,24,2,1492,1408,1946,538
2020,4,24,3,1546,1486,1881,395
2020,4,24,4,1514,1502,1795,293
2020,4,24,5,1431,1348,1562,214
2020,4,24,6,1347,1276,1569,293
2020,4,24,7,1279,1215,1544,329
2020,4,24,8,1225,1194,1601,407
2020,4,24,9,1205,1172,1581,409
2020,4,24,10,1189,1157,1540,383
2020,4,24,11,1201,1162,1595,433
2020,4,24,12,1239,1232,1413,181
2020,4,24,13,1301,1277,1269,-8
2020,4,24,14,1339,1303,1227,-76
2020,4,24,15,1344,1286,1318,32
2020,4,24,16,1341,1253,1319,66
2020,4,24,17,1340,1250,1194,-56
2020,4,24,18,1347,1255,1122,-133
2020,4,24,19,1357,1256,897,-359
2020,4,24,20,1379,1264,1123,-141
2020,4,24,21,1386,1281,1232,-49
2020,4,24,22,1393,1293,1289,-4
2020,4,24,23,1427,1329,1383,54
2020,4,25,0,1451,1379,1548,169
2020,4,25,1,1452,1407,1605,198
2020,4,25,2,1460,1424,1422,-2
2020,4,25,3,1511,1505,1410,-95
2020,4,25,4,1492,1462,1377,-85
2020,4,25,5,1423,1379,1222,-157
2020,4,25,6,1346,1300,1264,-36
2020,4,25,7,1284,1230,1269,39
2020,4,25,8,1222,1185,1278,93
2020,4,25,9,1200,1158,1259,101
2020,4,25,10,1189,1139,1251,112
2020,4,25,11,1191,1142,1141,-1
2020,4,25,12,1208,1167,1073,-94
2020,4,25,13,1223,1175,1080,-95
2020,4,25,14,1240,1183,1003,-180
2020,4,25,15,1255,1189,1053,-136
2020,4,25,16,1267,1213,1115,-98
2020,4,25,17,1268,1205,1128,-77
2020,4,25,18,1271,1198,1122,-76
2020,4,25,19,1282,1208,1142,-66
2020,4,25,20,1297,1222,1147,-75
2020,4,25,21,1314,1238,1220,-18
2020,4,25,22,1350,1269,1293,24
2020,4,25,23,1413,1317,1351,34
2020,4,26,0,1444,1376,1347,-29
2020,4,26,1,1466,1420,1373,-47
2020,4,26,2,1476,1434,1256,-178
2020,4,26,3,1496,1496,1297,-199
2020,4,26,4,1475,1447,1349,-98
2020,4,26,5,1400,1375,1267,-108
2020,4,26,6,1319,1292,1240,-52
2020,4,26,7,1268,1241,1258,17
2020,4,26,8,1225,1200,1382,182
2020,4,26,9,1196,1170,1361,191
2020,4,26,10,1181,1161,1359,198
2020,4,26,11,1182,1153,1348,195
2020,4,26,12,1196,1176,1255,79
2020,4,26,13,1201,1179,1186,7
2020,4,26,14,1211,1185,1195,10
2020,4,26,15,1232,1206,1257,51
2020,4,26,16,1251,1220,1253,33
2020,4,26,17,1267,1229,1292,63
2020,4,26,18,1293,1238,1373,135
2020,4,26,19,1317,1265,1476,211
2020,4,26,20,1360,1289,1565,276
2020,4,26,21,1400,1322,1618,296
2020,4,26,22,1446,1369,1748,379
2020,4,26,23,1509,1437,1846,409
2020,4,27,0,1577,1517,1782,265
2020,4,27,1,1599,1544,1616,72
2020,4,27,2,1585,1551,1663,112
2020,4,27,3,1613,1594,1752,158
2020,4,27,4,1576,1538,1682,144
2020,4,27,5,1471,1437,1581,144
2020,4,27,6,1385,1339,1464,125
2020,4,27,7,1310,1266,1523,257
2020,4,27,8,1242,1243,1602,359
2020,4,27,9,1226,1208,1511,303
2020,4,27,10,1206,1180,1377,197
2020,4,27,11,1207,1167,1312,145
2020,4,27,12,1250,1214,1319,105
2020,4,27,13,1309,1256,1239,-17
2020,4,27,14,1361,1283,1291,8
2020,4,27,15,1393,1303,1428,125
2020,4,27,16,1427,1305,1431,126
2020,4,27,17,1463,1317,1402,85
2020,4,27,18,1513,1358,1396,38
2020,4,27,19,1555,1394,1462,68
2020,4,27,20,1612,1435,1532,97
2020,4,27,21,1667,1458,1632,174
2020,4,27,22,1711,1495,1672,177
2020,4,27,23,1749,1556,1710,154
2020,4,28,0,1782,1589,1624,35
2020,4,28,1,1771,1585,1597,12
2020,4,28,2,1733,1567,1669,102
2020,4,28,3,1728,1615,1753,138
2020,4,28,4,1662,1547,1704,157
2020,4,28,5,1531,1446,1607,161
2020,4,28,6,1415,1345,1559,214
2020,4,28,7,1339,1281,1457,176
2020,4,28,8,1280,1259,1600,341
2020,4,28,9,1243,1227,1660,433
2020,4,28,10,1223,1212,1669,457
2020,4,28,11,1224,1219,1714,495
2020,4,28,12,1261,1257,1727,470
2020,4,28,13,1329,1281,1643,362
2020,4,28,14,1376,1295,1615,320
2020,4,28,15,1400,1296,1612,316
2020,4,28,16,1422,1323,1718,395
2020,4,28,17,1455,1361,1897,536
2020,4,28,18,1504,1398,1944,546
2020,4,28,19,1550,1430,1923,493
2020,4,28,20,1610,1483,1913,430
2020,4,28,21,1651,1518,1996,478
2020,4,28,22,1694,1552,2046,494
2020,4,28,23,1735,1588,2079,491
2020,4,29,0,1749,1632,2141,509
2020,4,29,1,1736,1637,2016,379
2020,4,29,2,1722,1606,1900,294
2020,4,29,3,1720,1660,1945,285
2020,4,29,4,1677,1591,1962,371
2020,4,29,5,1553,1471,1885,414
2020,4,29,6,1427,1368,1872,504
2020,4,29,7,1344,1313,1820,507
2020,4,29,8,1280,1266,1826,560
2020,4,29,9,1247,1212,1766,554
2020,4,29,10,1228,1191,1758,567
2020,4,29,11,1234,1193,1741,548
2020,4,29,12,1278,1223,1792,569
2020,4,29,13,1348,1248,1737,489
2020,4,29,14,1361,1256,1601,345
2020,4,29,15,1396,1264,1701,437
2020,4,29,16,1399,1271,1736,465
2020,4,29,17,1412,1279,1707,428
2020,4,29,18,1441,1304,1687,383
2020,4,29,19,1466,1343,1690,347
2020,4,29,20,1507,1383,1683,300
2020,4,29,21,1539,1440,1628,188
2020,4,29,22,1570,1486,1618,132
2020,4,29,23,1624,1535,1657,122
2020,4,30,0,1660,1586,1676,90
2020,4,30,1,1664,1617,1578,-39
2020,4,30,2,1661,1582,1667,85
2020,4,30,3,1678,1619,1750,131
2020,4,30,4,1625,1548,1803,255
2020,4,30,5,1526,1432,1775,343
2020,4,30,6,1413,1323,1625,302
2020,4,30,7,1343,1245,1509,264
2020,4,30,8,1278,1204,1580,376
2020,4,30,9,1251,1181,1641,460
2020,4,30,10,1234,1174,1639,465
2020,4,30,11,1238,1187,1675,488
2020,4,30,12,1279,1218,1712,494
2020,4,30,13,1338,1247,1726,479
2020,4,30,14,1389,1271,1690,419
2020,4,30,15,1400,1295,1877,582
2020,4,30,16,1430,1327,2017,690
2020,4,30,17,1469,1352,1994,642
2020,4,30,18,1522,1389,2025,636
2020,4,30,19,1576,1438,1988,550
2020,4,30,20,1649,1495,1895,400
2020,4,30,21,1709,1570,1962,392
2020,4,30,22,1773,1642,2110,468
2020,4,30,23,1814,1681,2033,352
2020,5,1,0,1848,1722,2043,321
2020,5,1,1,1847,1688,2023,335
2020,5,1,2,1832,1653,1966,313
2020,5,1,3,1827,1700,1984,284
2020,5,1,4,1756,1635,1959,324
2020,5,1,5,1632,1530,1948,418
2020,5,1,6,1511,1411,1758,347
2020,5,1,7,1418,1338,1682,344
2020,5,1,8,1335,1274,1614,340
2020,5,1,9,1297,1232,1522,290
2020,5,1,10,1277,1212,1504,292
2020,5,1,11,1274,1202,1445,243
2020,5,1,12,1303,1230,1341,111
2020,5,1,13,1359,1239,1169,-70
2020,5,1,14,1408,1260,1200,-60
2020,5,1,15,1432,1287,1262,-25
2020,5,1,16,1465,1326,1322,-4
2020,5,1,17,1518,1375,1465,90
2020,5,1,18,1565,1443,1546,103
2020,5,1,19,1618,1501,1596,95
2020,5,1,20,1688,1561,1636,75
2020,5,1,21,1730,1613,1549,-64
2020,5,1,22,1796,1665,1594,-71
2020,5,1,23,1843,1725,1671,-54
2020,5,2,0,1853,1725,1695,-30
2020,5,2,1,1844,1697,1498,-199
2020,5,2,2,1810,1652,1261,-391
2020,5,2,3,1806,1653,1212,-441
2020,5,2,4,1743,1597,1377,-220
2020,5,2,5,1627,1456,1430,-26
2020,5,2,6,1502,1365,1481,116
2020,5,2,7,1419,1300,1535,235
2020,5,2,8,1346,1283,1502,219
2020,5,2,9,1299,1249,1525,276
2020,5,2,10,1273,1226,1616,390
2020,5,2,11,1258,1212,1595,383
2020,5,2,12,1263,1222,1594,372
2020,5,2,13,1263,1201,1530,329
2020,5,2,14,1283,1199,1515,316
2020,5,2,15,1320,1215,1498,283
2020,5,2,16,1364,1258,1579,321
2020,5,2,17,1406,1298,1649,351
2020,5,2,18,1457,1347,1811,464
2020,5,2,19,1516,1405,1947,542
2020,5,2,20,1575,1452,2079,627
2020,5,2,21,1620,1512,2126,614
2020,5,2,22,1674,1587,2134,547
2020,5,2,23,1728,1664,2152,488
2020,5,3,0,1760,1718,2116,398
2020,5,3,1,1752,1720,2065,345
2020,5,3,2,1744,1691,1860,169
2020,5,3,3,1722,1678,1896,218
2020,5,3,4,1658,1588,1831,243
2020,5,3,5,1567,1468,1586,118
2020,5,3,6,1476,1366,1492,126
2020,5,3,7,1387,1296,1408,112
2020,5,3,8,1317,1231,1319,88
2020,5,3,9,1275,1188,1245,57
2020,5,3,10,1251,1172,1141,-31
2020,5,3,11,1240,1163,1093,-70
2020,5,3,12,1242,1176,1042,-134
2020,5,3,13,1240,1154,992,-162
2020,5,3,14,1249,1153,1089,-64
2020,5,3,15,1278,1182,1181,-1
2020,5,3,16,1314,1216,1385,169
2020,5,3,17,1359,1260,1442,182
2020,5,3,18,1411,1319,1360,41
2020,5,3,19,1471,1378,1579,201
2020,5,3,20,1524,1440,1657,217
2020,5,3,21,1579,1504,1752,248
2020,5,3,22,1645,1579,1854,275
2020,5,3,23,1711,1660,1923,263
2020,5,4,0,1769,1726,1960,234
2020,5,4,1,1783,1753,1847,94
2020,5,4,2,1786,1725,1775,50
2020,5,4,3,1766,1717,1820,103
2020,5,4,4,1690,1643,1799,156
2020,5,4,5,1569,1506,1613,107
2020,5,4,6,1465,1390,1531,141
2020,5,4,7,1373,1330,1464,134
2020,5,4,8,1299,1274,1414,140
2020,5,4,9,1270,1232,1454,222
2020,5,4,10,1248,1220,1398,178
2020,5,4,11,1247,1216,1399,183
2020,5,4,12,1284,1234,1383,149
2020,5,4,13,1339,1262,1402,140
2020,5,4,14,1386,1298,1511,213
2020,5,4,15,1417,1330,1609,279
2020,5,4,16,1437,1338,1566,228
2020,5,4,17,1475,1363,1639,276
2020,5,4,18,1522,1411,1709,298
2020,5,4,19,1569,1458,1722,264
2020,5,4,20,1635,1519,1730,211
2020,5,4,21,1689,1590,1782,192
2020,5,4,22,1751,1650,1823,173
2020,5,4,23,1805,1698,1866,168
2020,5,5,0,1845,1739,1822,83
2020,5,5,1,1836,1731,1680,-51
2020,5,5,2,1810,1671,1584,-87
2020,5,5,3,1799,1676,1612,-64
2020,5,5,4,1723,1609,1700,91
2020,5,5,5,1594,1506,1625,119
2020,5,5,6,1469,1395,1536,141
2020,5,5,7,1376,1323,1577,254
2020,5,5,8,1279,1264,1585,321
2020,5,5,9,1246,1233,1474,241
2020,5,5,10,1225,1206,1408,202
2020,5,5,11,1229,1195,1441,246
2020,5,5,12,1273,1224,1395,171
2020,5,5,13,1340,1245,1326,81
2020,5,5,14,1374,1262,1113,-149
2020,5,5,15,1378,1304,1031,-273
2020,5,5,16,1381,1276,1029,-247
2020,5,5,17,1391,1301,1024,-277
2020,5,5,18,1409,1328,1044,-284
2020,5,5,19,1438,1360,1100,-260
2020,5,5,20,1471,1397,1170,-227
2020,5,5,21,1503,1457,1214,-243
2020,5,5,22,1532,1521,1169,-352
2020,5,5,23,1591,1580,1213,-367
2020,5,6,0,1620,1622,1230,-392
2020,5,6,1,1623,1630,1139,-491
2020,5,6,2,1639,1596,1179,-417
2020,5,6,3,1660,1658,1270,-388
2020,5,6,4,1612,1606,1371,-235
2020,5,6,5,1499,1484,1394,-90
2020,5,6,6,1386,1368,1287,-81
2020,5,6,7,1319,1284,1140,-144
2020,5,6,8,1270,1233,1010,-223
2020,5,6,9,1242,1201,1033,-168
2020,5,6,10,1224,1167,1057,-110
2020,5,6,11,1224,1162,940,-222
2020,5,6,12,1263,1205,854,-351
2020,5,6,13,1314,1224,826,-398
2020,5,6,14,1348,1250,860,-390
2020,5,6,15,1360,1264,938,-326
2020,5,6,16,1377,1280,931,-349
2020,5,6,17,1412,1314,831,-483
2020,5,6,18,1449,1358,829,-529
2020,5,6,19,1497,1408,901,-507
2020,5,6,20,1554,1462,963,-499
2020,5,6,21,1619,1521,1070,-451
2020,5,6,22,1685,1585,1177,-408
2020,5,6,23,1742,1566,1213,-353
2020,5,7,0,1783,1717,1316,-401
2020,5,7,1,1786,1732,1246,-486
2020,5,7,2,1764,1699,1186,-513
2020,5,7,3,1770,1732,1374,-358
2020,5,7,4,1711,1652,1392,-260
2020,5,7,5,1589,1536,1311,-225
2020,5,7,6,1472,1447,1183,-264
2020,5,7,7,1376,1327,1114,-213
2020,5,7,8,1301,1279,1153,-126
2020,5,7,9,1276,1250,1144,-106
2020,5,7,10,1247,1226,1169,-57
2020,5,7,11,1241,1213,1182,-31
2020,5,7,12,1276,1233,1212,-21
2020,5,7,13,1324,1251,1180,-71
2020,5,7,14,1366,1282,1199,-83
2020,5,7,15,1386,1318,1305,-13
2020,5,7,16,1411,1360,1294,-66
2020,5,7,17,1452,1415,1314,-101
2020,5,7,18,1508,1477,1376,-101
2020,5,7,19,1568,1552,1477,-75
2020,5,7,20,1630,1626,1543,-83
2020,5,7,21,1691,1681,1624,-57
2020,5,7,22,1741,1734,1681,-53
2020,5,7,23,1784,1787,1716,-71
2020,5,8,0,1798,1795,1720,-75
2020,5,8,1,1765,1770,1588,-182
2020,5,8,2,1736,1717,1571,-146
2020,5,8,3,1740,1710,1557,-153
2020,5,8,4,1680,1632,1568,-64
2020,5,8,5,1566,1495,1571,76
2020,5,8,6,1449,1376,1424,48
2020,5,8,7,1372,1304,1391,87
2020,5,8,8,1275,1253,1296,43
2020,5,8,9,1235,1238,1312,74
2020,5,8,10,1218,1225,1321,96
2020,5,8,11,1223,1218,1349,131
2020,5,8,12,1265,1249,1341,92
2020,5,8,13,1316,1262,1330,68
2020,5,8,14,1351,1287,1383,96
2020,5,8,15,1367,1299,1521,222
2020,5,8,16,1372,1306,1557,251
2020,5,8,17,1368,1315,1656,341
2020,5,8,18,1372,1328,1662,334
2020,5,8,19,1386,1328,1621,293
2020,5,8,20,1405,1326,1541,215
2020,5,8,21,1423,1337,1453,116
2020,5,8,22,1437,1362,1384,22
2020,5,8,23,1465,1420,1357,-63
2020,5,9,0,1497,1454,1414,-40
2020,5,9,1,1495,1471,1340,-131
2020,5,9,2,1501,1459,1327,-132
2020,5,9,3,1561,1515,1376,-139
2020,5,9,4,1528,1484,1394,-90
2020,5,9,5,1449,1404,1317,-87
2020,5,9,6,1365,1316,1339,23
2020,5,9,7,1300,1268,1291,23
2020,5,9,8,1244,1221,1135,-86
2020,5,9,9,1211,1204,1080,-124
2020,5,9,10,1192,1178,998,-180
2020,5,9,11,1189,1165,975,-190
2020,5,9,12,1202,1184,1020,-164
2020,5,9,13,1212,1178,1099,-79
2020,5,9,14,1222,1192,1173,-19
2020,5,9,15,1242,1203,1279,76
2020,5,9,16,1250,1223,1371,148
2020,5,9,17,1266,1236,1324,88
2020,5,9,18,1291,1257,1277,20
2020,5,9,19,1305,1298,1265,-33
2020,5,9,20,1343,1347,1355,8
2020,5,9,21,1388,1399,1368,-31
2020,5,9,22,1440,1476,1397,-79
2020,5,9,23,1494,1543,1446,-97
2020,5,10,0,1554,1593,1403,-190
2020,5,10,1,1571,1589,1425,-164
2020,5,10,2,1573,1561,1438,-123
2020,5,10,3,1577,1582,1461,-121
2020,5,10,4,1541,1539,1537,-2
2020,5,10,5,1461,1453,1521,68
2020,5,10,6,1380,1377,1400,23
2020,5,10,7,1309,1296,1383,87
2020,5,10,8,1253,1242,1388,146
2020,5,10,9,1217,1204,1357,153
2020,5,10,10,1201,1205,1367,162
2020,5,10,11,1190,1192,1371,179
2020,5,10,12,1194,1180,1262,82
2020,5,10,13,1196,1149,1211,62
2020,5,10,14,1203,1170,1325,155
2020,5,10,15,1225,1194,1486,292
2020,5,10,16,1238,1214,1396,182
2020,5,10,17,1259,1245,1416,171
2020,5,10,18,1285,1282,1435,153
2020,5,10,19,1314,1325,1447,122
2020,5,10,20,1343,1354,1497,143
2020,5,10,21,1378,1406,1593,187
2020,5,10,22,1416,1454,1640,186
2020,5,10,23,1471,1486,1591,105
2020,5,11,0,1507,1507,1608,101
2020,5,11,1,1527,1515,1548,33
2020,5,11,2,1541,1519,1554,35
2020,5,11,3,1574,1547,1505,-42
2020,5,11,4,1538,1517,1516,-1
2020,5,11,5,1447,1431,1550,119
2020,5,11,6,1351,1330,1426,96
2020,5,11,7,1280,1260,1483,223
2020,5,11,8,1247,1212,1558,346
2020,5,11,9,1219,1193,1566,373
2020,5,11,10,1204,1192,1581,389
2020,5,11,11,1209,1195,1520,325
2020,5,11,12,1248,1220,1429,209
2020,5,11,13,1305,1238,1355,117
2020,5,11,14,1346,1282,1289,7
2020,5,11,15,1355,1311,1345,34
2020,5,11,16,1356,1343,1496,153
2020,5,11,17,1363,1345,1562,217
2020,5,11,18,1377,1369,1455,86
2020,5,11,19,1390,1413,1525,112
2020,5,11,20,1411,1435,1720,285
2020,5,11,21,1423,1446,1827,381
2020,5,11,22,1433,1459,1900,441
2020,5,11,23,1458,1485,1799,314
2020,5,12,0,1481,1504,1760,256
2020,5,12,1,1489,1526,1767,241
2020,5,12,2,1504,1485,1670,185
2020,5,12,3,1569,1529,1658,129
2020,5,12,4,1539,1491,1576,85
2020,5,12,5,1448,1395,1477,82
2020,5,12,6,1349,1298,1331,33
2020,5,12,7,1283,1232,1229,-3
2020,5,12,8,1240,1204,1238,34
2020,5,12,9,1214,1175,1337,162
2020,5,12,10,1197,1156,1331,175
2020,5,12,11,1204,1159,1336,177
2020,5,12,12,1240,1196,1350,154
2020,5,12,13,1287,1225,1276,51
2020,5,12,14,1325,1257,1362,105
2020,5,12,15,1330,1270,1445,175
2020,5,12,16,1335,1282,1564,282
2020,5,12,17,1354,1304,1667,363
2020,5,12,18,1388,1334,1627,293
2020,5,12,19,1424,1383,1770,387
2020,5,12,20,1468,1434,1934,500
2020,5,12,21,1523,1476,1976,500
2020,5,12,22,1576,1544,2047,503
2020,5,12,23,1622,1599,2085,486
2020,5,13,0,1653,1600,2012,412
2020,5,13,1,1652,1576,1910,334
2020,5,13,2,1640,1561,1850,289
2020,5,13,3,1684,1600,1854,254
2020,5,13,4,1636,1563,1863,300
2020,5,13,5,1522,1458,1744,286
2020,5,13,6,1404,1351,1665,314
2020,5,13,7,1322,1278,1697,419
2020,5,13,8,1264,1236,1714,478
2020,5,13,9,1226,1201,1651,450
2020,5,13,10,1203,1187,1597,410
2020,5,13,11,1204,1188,1528,340
2020,5,13,12,1240,1229,1421,192
2020,5,13,13,1287,1246,1385,139
2020,5,13,14,1325,1274,1472,198
2020,5,13,15,1333,1271,1585,314
2020,5,13,16,1346,1298,1799,501
2020,5,13,17,1367,1334,1879,545
2020,5,13,18,1388,1387,1963,576
2020,5,13,19,1429,1417,1999,582
2020,5,13,20,1467,1465,2051,586
2020,5,13,21,1514,1517,2073,556
2020,5,13,22,1563,1573,2063,490
2020,5,13,23,1611,1615,2133,518
2020,5,14,0,1647,1671,2130,459
2020,5,14,1,1641,1682,2134,452
2020,5,14,2,1619,1625,2006,381
2020,5,14,3,1660,1643,1939,296
2020,5,14,4,1618,1593,2019,426
2020,5,14,5,1516,1478,1897,419
2020,5,14,6,1404,1363,1821,458
2020,5,14,7,1324,1301,1732,431
2020,5,14,8,1269,1248,1733,485
2020,5,14,9,1234,1206,1654,448
2020,5,14,10,1210,1193,1604,411
2020,5,14,11,1209,1181,1585,404
2020,5,14,12,1249,1218,1491,273
2020,5,14,13,1295,1234,1455,221
2020,5,14,14,1330,1275,1492,217
2020,5,14,15,1331,1288,1679,391
2020,5,14,16,1339,1304,1717,413
2020,5,14,17,1354,1347,1782,435
2020,5,14,18,1376,1384,1850,466
2020,5,14,19,1407,1420,1890,470
2020,5,14,20,1441,1469,1884,415
2020,5,14,21,1477,1519,1881,362
2020,5,14,22,1524,1573,1969,396
2020,5,14,23,1574,1632,2059,427
2020,5,15,0,1606,1668,2056,388
2020,5,15,1,1607,1669,1970,301
2020,5,15,2,1600,1633,1716,83
2020,5,15,3,1644,1650,1767,117
2020,5,15,4,1614,1602,1851,249
2020,5,15,5,1513,1478,1818,340
2020,5,15,6,1400,1363,1687,324
2020,5,15,7,1316,1285,1626,341
2020,5,15,8,1277,1230,1482,252
2020,5,15,9,1244,1204,1504,300
2020,5,15,10,1222,1191,1552,361
2020,5,15,11,1216,1179,1498,319
2020,5,15,12,1247,1229,1479,250
2020,5,15,13,1282,1260,1553,293
2020,5,15,14,1317,1275,1641,366
2020,5,15,15,1333,1297,1668,371
2020,5,15,16,1344,1323,1573,250
2020,5,15,17,1360,1340,1535,195
2020,5,15,18,1395,1387,1586,199
2020,5,15,19,1430,1437,1522,85
2020,5,15,20,1471,1484,1498,14
2020,5,15,21,1510,1540,1536,-4
2020,5,15,22,1552,1600,1555,-45
2020,5,15,23,1602,1651,1609,-42
2020,5,16,0,1631,1694,1687,-7
2020,5,16,1,1634,1672,1713,41
2020,5,16,2,1612,1642,1558,-84
2020,5,16,3,1644,1659,1532,-127
2020,5,16,4,1617,1595,1538,-57
2020,5,16,5,1534,1484,1547,63
2020,5,16,6,1431,1371,1518,147
2020,5,16,7,1357,1301,1492,191
2020,5,16,8,1304,1247,1438,191
2020,5,16,9,1262,1219,1508,289
2020,5,16,10,1235,1190,1512,322
2020,5,16,11,1222,1181,1357,176
2020,5,16,12,1224,1188,1328,140
2020,5,16,13,1211,1179,1388,209
2020,5,16,14,1219,1206,1426,220
2020,5,16,15,1247,1238,1485,247
2020,5,16,16,1273,1254,1532,278
2020,5,16,17,1305,1300,1548,248
2020,5,16,18,1350,1352,1526,174
2020,5,16,19,1402,1425,1523,98
2020,5,16,20,1463,1483,1526,43
2020,5,16,21,1509,1552,1591,39
2020,5,16,22,1571,1623,1618,-5
2020,5,16,23,1633,1689,1671,-18
2020,5,17,0,1681,1767,1673,-94
2020,5,17,1,1693,1766,1560,-206
2020,5,17,2,1667,1725,1501,-224
2020,5,17,3,1679,1701,1531,-170
2020,5,17,4,1636,1619,1535,-84
2020,5,17,5,1546,1501,1590,89
2020,5,17,6,1450,1381,1561,180
2020,5,17,7,1359,1298,1676,378
2020,5,17,8,1322,1246,1585,339
2020,5,17,9,1283,1218,1481,263
2020,5,17,10,1255,1194,1498,304
2020,5,17,11,1235,1189,1509,320
2020,5,17,12,1235,1186,1499,313
2020,5,17,13,1217,1163,1415,252
2020,5,17,14,1231,1200,1485,285
2020,5,17,15,1264,1243,1570,327
2020,5,17,16,1302,1283,1578,295
2020,5,17,17,1349,1342,1503,161
2020,5,17,18,1396,1408,1511,103
2020,5,17,19,1463,1480,1548,68
2020,5,17,20,1531,1565,1583,18
2020,5,17,21,1595,1650,1585,-65
2020,5,17,22,1654,1719,1590,-129
2020,5,17,23,1720,1783,1560,-223
2020,5,18,0,1770,1842,1565,-277
2020,5,18,1,1780,1851,1422,-429
2020,5,18,2,1760,1813,1342,-471
2020,5,18,3,1758,1787,1367,-420
2020,5,18,4,1702,1721,1497,-224
2020,5,18,5,1591,1593,1527,-66
2020,5,18,6,1473,1465,1465,0
2020,5,18,7,1385,1372,1553,181
2020,5,18,8,1339,1315,1642,327
2020,5,18,9,1297,1271,1625,354
2020,5,18,10,1276,1237,1540,303
2020,5,18,11,1259,1214,1463,249
2020,5,18,12,1284,1246,1422,176
2020,5,18,13,1329,1271,1398,127
2020,5,18,14,1382,1315,1369,54
2020,5,18,15,1411,1358,1379,21
2020,5,18,16,1447,1424,1431,7
2020,5,18,17,1527,1488,1575,87
2020,5,18,18,1583,1578,1676,98
2020,5,18,19,1648,1648,1716,68
2020,5,18,20,1743,1736,1821,85
2020,5,18,21,1796,1822,1865,43
2020,5,18,22,1869,1906,1996,90
2020,5,18,23,1931,1962,2103,141
2020,5,19,0,1984,2013,2108,95
2020,5,19,1,1972,1995,2085,90
2020,5,19,2,1901,1914,1942,28
2020,5,19,3,1910,1904,1985,81
2020,5,19,4,1836,1795,1950,155
2020,5,19,5,1701,1635,1869,234
2020,5,19,6,1558,1492,1814,322
2020,5,19,7,1459,1385,1633,248
2020,5,19,8,1403,1315,1533,218
2020,5,19,9,1355,1267,1443,176
2020,5,19,10,1322,1237,1392,155
2020,5,19,11,1305,1241,1305,64
2020,5,19,12,1331,1261,1228,-33
2020,5,19,13,1376,1275,1196,-79
2020,5,19,14,1422,1321,1243,-78
2020,5,19,15,1453,1362,1324,-38
2020,5,19,16,1485,1436,1364,-72
2020,5,19,17,1539,1510,1488,-22
2020,5,19,18,1608,1599,1601,2
2020,5,19,19,1685,1671,1678,7
2020,5,19,20,1757,1734,1728,-6
2020,5,19,21,1829,1791,1886,95
2020,5,19,22,1894,1853,1911,58
2020,5,19,23,1942,1899,1864,-35
2020,5,20,0,1966,1916,1932,16
2020,5,20,1,1943,1873,1883,10
2020,5,20,2,1914,1796,1768,-28
2020,5,20,3,1891,1797,1979,182
2020,5,20,4,1814,1723,1919,196
2020,5,20,5,1676,1592,1898,306
2020,5,20,6,1538,1444,1749,305
2020,5,20,7,1444,1361,1698,337
2020,5,20,8,1338,1293,1532,239
2020,5,20,9,1293,1259,1578,319
2020,5,20,10,1259,1236,1606,370
2020,5,20,11,1259,1221,1511,290
2020,5,20,12,1289,1249,1461,212
2020,5,20,13,1340,1265,1449,184
2020,5,20,14,1375,1305,1533,228
2020,5,20,15,1390,1317,1617,300
2020,5,20,16,1409,1350,1679,329
2020,5,20,17,1440,1389,1727,338
2020,5,20,18,1488,1429,1859,430
2020,5,20,19,1540,1474,1926,452
2020,5,20,20,1585,1538,1970,432
2020,5,20,21,1651,1604,2019,415
2020,5,20,22,1715,1667,2028,361
2020,5,20,23,1765,1723,2017,294
2020,5,21,0,1791,1769,2010,241
2020,5,21,1,1767,1761,1950,189
2020,5,21,2,1748,1720,1912,192
2020,5,21,3,1748,1716,1941,225
2020,5,21,4,1685,1629,1930,301
2020,5,21,5,1562,1502,1873,371
2020,5,21,6,1442,1388,1783,395
2020,5,21,7,1354,1305,1665,360
2020,5,21,8,1258,1239,1647,408
2020,5,21,9,1226,1203,1598,395
2020,5,21,10,1205,1186,1595,409
2020,5,21,11,1214,1170,1572,402
2020,5,21,12,1246,1193,1494,301
2020,5,21,13,1304,1215,1452,237
2020,5,21,14,1331,1251,1475,224
2020,5,21,15,1332,1254,1423,169
2020,5,21,16,1339,1277,1369,92
2020,5,21,17,1353,1317,1525,208
2020,5,21,18,1375,1357,1662,305
2020,5,21,19,1407,1389,1712,323
2020,5,21,20,1439,1434,1793,359
2020,5,21,21,1479,1465,1941,476
2020,5,21,22,1518,1540,1960,420
2020,5,21,23,1558,1612,2018,406
2020,5,22,0,1609,1647,1903,256
2020,5,22,1,1617,1649,1743,94
2020,5,22,2,1603,1596,1711,115
2020,5,22,3,1637,1619,1695,76
2020,5,22,4,1586,1573,1764,191
2020,5,22,5,1488,1466,1804,338
2020,5,22,6,1382,1354,1621,267
2020,5,22,7,1297,1271,1516,245
2020,5,22,8,1256,1223,1458,235
2020,5,22,9,1232,1180,1485,305
2020,5,22,10,1209,1157,1406,249
2020,5,22,11,1208,1170,1338,168
2020,5,22,12,1243,1207,1321,114
2020,5,22,13,1273,1222,1319,97
2020,5,22,14,1302,1253,1370,117
2020,5,22,15,1301,1269,1305,36
2020,5,22,16,1310,1289,1242,-47
2020,5,22,17,1332,1319,1296,-23
2020,5,22,18,1362,1364,1386,22
2020,5,22,19,1403,1387,1379,-8
2020,5,22,20,1457,1435,1442,7
2020,5,22,21,1496,1486,1656,170
2020,5,22,22,1556,1533,1772,239
2020,5,22,23,1605,1607,1877,270
2020,5,23,0,1650,1650,1861,211
2020,5,23,1,1655,1637,1775,138
2020,5,23,2,1623,1594,1793,199
2020,5,23,3,1657,1628,1787,159
2020,5,23,4,1610,1587,1808,221
2020,5,23,5,1517,1495,1755,260
2020,5,23,6,1405,1398,1792,394
2020,5,23,7,1323,1315,1726,411
2020,5,23,8,1241,1261,1709,448
2020,5,23,9,1206,1222,1620,398
2020,5,23,10,1177,1194,1607,413
2020,5,23,11,1163,1185,1646,461
2020,5,23,12,1170,1182,1569,387
2020,5,23,13,1166,1170,1547,377
2020,5,23,14,1172,1199,1577,378
2020,5,23,15,1204,1222,1478,256
2020,5,23,16,1236,1258,1416,158
2020,5,23,17,1264,1293,1536,243
2020,5,23,18,1295,1326,1579,253
2020,5,23,19,1323,1378,1725,347
2020,5,23,20,1366,1427,1823,396
2020,5,23,21,1414,1489,1921,432
2020,5,23,22,1478,1577,1966,389
2020,5,23,23,1545,1649,2018,369
2020,5,24,0,1595,1701,1953,252
2020,5,24,1,1612,1676,1887,211
2020,5,24,2,1582,1626,1806,180
2020,5,24,3,1606,1646,1773,127
2020,5,24,4,1579,1593,1792,199
2020,5,24,5,1490,1484,1745,261
2020,5,24,6,1401,1389,1700,311
2020,5,24,7,1307,1319,1685,366
2020,5,24,8,1269,1272,1639,367
2020,5,24,9,1226,1235,1550,315
2020,5,24,10,1201,1214,1529,315
2020,5,24,11,1189,1203,1463,260
2020,5,24,12,1180,1204,1403,199
2020,5,24,13,1163,1182,1402,220
2020,5,24,14,1171,1195,1426,231
2020,5,24,15,1200,1203,1411,208
2020,5,24,16,1232,1237,1426,189
2020,5,24,17,1272,1282,1456,174
2020,5,24,18,1313,1330,1651,321
2020,5,24,19,1343,1375,1649,274
2020,5,24,20,1383,1420,1697,277
2020,5,24,21,1421,1460,1777,317
2020,5,24,22,1466,1516,1790,274
2020,5,24,23,1512,1578,1817,239
2020,5,25,0,1561,1625,1766,141
2020,5,25,1,1580,1638,1721,83
2020,5,25,2,1571,1605,1703,98
2020,5,25,3,1602,1596,1699,103
2020,5,25,4,1573,1544,1674,130
2020,5,25,5,1472,1441,1722,281
2020,5,25,6,1381,1344,1752,408
2020,5,25,7,1303,1275,1713,438
2020,5,25,8,1260,1241,1685,444
2020,5,25,9,1223,1216,1744,528
2020,5,25,10,1199,1188,1743,555
2020,5,25,11,1183,1190,1703,513
2020,5,25,12,1177,1208,1688,480
2020,5,25,13,1162,1204,1672,468
2020,5,25,14,1173,1211,1660,449
2020,5,25,15,1197,1219,1646,427
2020,5,25,16,1221,1247,1749,502
2020,5,25,17,1244,1269,1831,562
2020,5,25,18,1276,1299,1810,511
2020,5,25,19,1314,1320,1663,343
2020,5,25,20,1346,1342,1603,261
2020,5,25,21,1382,1364,1593,229
2020,5,25,22,1424,1412,1650,238
2020,5,25,23,1475,1480,1659,179
2020,5,26,0,1540,1543,1620,77
2020,5,26,1,1575,1560,1492,-68
2020,5,26,2,1564,1538,1427,-111
2020,5,26,3,1574,1559,1446,-113
2020,5,26,4,1539,1528,1509,-19
2020,5,26,5,1449,1434,1341,-93
2020,5,26,6,1366,1329,1290,-39
2020,5,26,7,1294,1259,1219,-40
2020,5,26,8,1229,1219,1180,-39
2020,5,26,9,1200,1182,1207,25
2020,5,26,10,1186,1165,1150,-15
2020,5,26,11,1182,1171,1102,-69
2020,5,26,12,1214,1205,1080,-125
2020,5,26,13,1257,1221,1079,-142
2020,5,26,14,1291,1254,1198,-56
2020,5,26,15,1300,1268,1333,65
2020,5,26,16,1303,1284,1358,74
2020,5,26,17,1323,1329,1156,-173
2020,5,26,18,1347,1352,1193,-159
2020,5,26,19,1381,1392,1269,-123
2020,5,26,20,1423,1451,1225,-226
2020,5,26,21,1457,1519,1334,-185
2020,5,26,22,1508,1590,1465,-125
2020,5,26,23,1560,1667,1456,-211
2020,5,27,0,1606,1744,1446,-298
2020,5,27,1,1623,1751,1462,-289
2020,5,27,2,1596,1690,1364,-326
2020,5,27,3,1636,1691,1281,-410
2020,5,27,4,1599,1631,1289,-342
2020,5,27,5,1494,1502,1222,-280
2020,5,27,6,1385,1387,1293,-94
2020,5,27,7,1296,1297,1276,-21
2020,5,27,8,1268,1234,1223,-11
2020,5,27,9,1231,1208,1181,-27
2020,5,27,10,1212,1189,1188,-1
2020,5,27,11,1212,1185,1222,37
2020,5,27,12,1241,1210,1272,62
2020,5,27,13,1279,1235,1193,-42
2020,5,27,14,1319,1275,1180,-95
2020,5,27,15,1336,1317,1134,-183
2020,5,27,16,1363,1372,1156,-216
2020,5,27,17,1403,1435,1198,-237
2020,5,27,18,1459,1500,1234,-266
2020,5,27,19,1524,1590,1274,-316
2020,5,27,20,1591,1672,1292,-380
2020,5,27,21,1656,1779,1319,-460
2020,5,27,22,1732,1859,1456,-403
2020,5,27,23,1786,1914,1454,-460
2020,5,28,0,1819,1918,1376,-542
2020,5,28,1,1808,1879,1298,-581
2020,5,28,2,1765,1812,1205,-607
2020,5,28,3,1784,1831,1284,-547
2020,5,28,4,1721,1771,1403,-368
2020,5,28,5,1602,1628,1287,-341
2020,5,28,6,1480,1489,1254,-235
2020,5,28,7,1384,1394,1277,-117
2020,5,28,8,1332,1329,1459,130
2020,5,28,9,1287,1285,1549,264
2020,5,28,10,1268,1258,1535,277
2020,5,28,11,1257,1246,1540,294
2020,5,28,12,1293,1265,1467,202
2020,5,28,13,1321,1313,1405,92
2020,5,28,14,1373,1353,1331,-22
2020,5,28,15,1405,1402,1436,34
2020,5,28,16,1448,1471,1468,-3
2020,5,28,17,1501,1545,1509,-36
2020,5,28,18,1563,1635,1553,-82
2020,5,28,19,1626,1717,1622,-95
2020,5,28,20,1706,1815,1702,-113
2020,5,28,21,1771,1909,1737,-172
2020,5,28,22,1849,1975,1837,-138
2020,5,28,23,1888,2017,1882,-135
2020,5,29,0,1909,2032,1837,-195
2020,5,29,1,1870,1980,1754,-226
2020,5,29,2,1807,1897,1658,-239
2020,5,29,3,1800,1900,1708,-192
2020,5,29,4,1757,1811,1804,-7
2020,5,29,5,1642,1677,1747,70
2020,5,29,6,1510,1546,1815,269
2020,5,29,7,1427,1451,1877,426
2020,5,29,8,1374,1379,1716,337
2020,5,29,9,1315,1328,1589,261
2020,5,29,10,1281,1295,1473,178
2020,5,29,11,1268,1282,1379,97
2020,5,29,12,1293,1305,1340,35
2020,5,29,13,1343,1324,1318,-6
2020,5,29,14,1387,1374,1432,58
2020,5,29,15,1430,1421,1437,16
2020,5,29,16,1481,1479,1501,22
2020,5,29,17,1541,1560,1565,5
2020,5,29,18,1625,1635,1608,-27
2020,5,29,19,1696,1729,1708,-21
2020,5,29,20,1776,1813,1685,-128
2020,5,29,21,1853,1899,1717,-182
2020,5,29,22,1928,1983,1789,-194
2020,5,29,23,1972,2036,1946,-90
2020,5,30,0,1974,1999,2005,6
2020,5,30,1,1934,1918,1863,-55
2020,5,30,2,1874,1850,1805,-45
2020,5,30,3,1867,1884,1944,60
2020,5,30,4,1807,1833,1979,146
2020,5,30,5,1695,1717,1909,192
2020,5,30,6,1568,1581,1702,121
2020,5,30,7,1474,1484,1654,170
2020,5,30,8,1422,1423,1702,279
2020,5,30,9,1373,1369,1554,185
2020,5,30,10,1331,1330,1537,207
2020,5,30,11,1303,1309,1563,254
2020,5,30,12,1315,1307,1650,343
2020,5,30,13,1307,1296,1646,350
2020,5,30,14,1335,1348,1686,338
2020,5,30,15,1387,1410,1704,294
2020,5,30,16,1465,1485,1705,220
2020,5,30,17,1548,1566,1723,157
2020,5,30,18,1643,1666,1721,55
2020,5,30,19,1731,1747,1713,-34
2020,5,30,20,1816,1846,1775,-71
2020,5,30,21,1894,1928,1880,-48
2020,5,30,22,1982,2013,2021,8
2020,5,30,23,1998,2059,2094,35
2020,5,31,0,2035,2052,1976,-76
2020,5,31,1,1976,1983,1887,-96
2020,5,31,2,1945,1864,1684,-180
2020,5,31,3,1897,1802,1634,-168
2020,5,31,4,1832,1724,1635,-89
2020,5,31,5,1727,1629,1585,-44
2020,5,31,6,1598,1518,1477,-41
2020,5,31,7,1502,1427,1517,90
2020,5,31,8,1423,1365,1517,152
2020,5,31,9,1365,1315,1475,160
2020,5,31,10,1329,1288,1446,158
2020,5,31,11,1294,1271,1383,112
2020,5,31,12,1303,1260,1301,41
2020,5,31,13,1285,1236,1259,23
2020,5,31,14,1309,1282,1355,73
2020,5,31,15,1353,1330,1334,4
2020,5,31,16,1427,1408,1367,-41
2020,5,31,17,1515,1457,1449,-8
2020,5,31,18,1611,1517,1491,-26
2020,5,31,19,1703,1580,1474,-106
2020,5,31,20,1796,1649,1523,-126
2020,5,31,21,1873,1716,1682,-34
2020,5,31,22,1953,1779,1714,-65
2020,5,31,23,2002,1834,1706,-128
2020,6,1,0,2039,1866,1796,-70
2020,6,1,1,2020,1840,1860,20
2020,6,1,2,1977,1797,1867,70
2020,6,1,3,1948,1818,1966,148
2020,6,1,4,1859,1775,1962,187
2020,6,1,5,1738,1647,1839,192
2020,6,1,6,1600,1521,1719,198
2020,6,1,7,1491,1425,1604,179
2020,6,1,8,1404,1357,1479,122
2020,6,1,9,1352,1308,1369,61
2020,6,1,10,1319,1275,1368,93
2020,6,1,11,1313,1271,1345,74
2020,6,1,12,1348,1292,1326,34
2020,6,1,13,1399,1315,1345,30
2020,6,1,14,1440,1395,1479,84
2020,6,1,15,1474,1449,1557,108
2020,6,1,16,1533,1507,1460,-47
2020,6,1,17,1606,1587,1268,-319
2020,6,1,18,1691,1683,1414,-269
2020,6,1,19,1776,1778,1459,-319
2020,6,1,20,1864,1852,1574,-278
2020,6,1,21,1931,1923,1623,-300
2020,6,1,22,2016,2000,1731,-269
2020,6,1,23,2069,2048,1927,-121
2020,6,2,0,2100,2005,1804,-201
2020,6,2,1,2062,1863,1586,-277
2020,6,2,2,2008,1752,1387,-365
2020,6,2,3,1972,1740,1438,-302
2020,6,2,4,1896,1681,1639,-42
2020,6,2,5,1753,1566,1607,41
2020,6,2,6,1606,1448,1447,-1
2020,6,2,7,1492,1363,1335,-28
2020,6,2,8,1403,1319,1143,-176
2020,6,2,9,1356,1287,989,-298
2020,6,2,10,1332,1265,1003,-262
2020,6,2,11,1324,1262,990,-272
2020,6,2,12,1341,1281,1005,-276
2020,6,2,13,1394,1315,1016,-299
2020,6,2,14,1437,1366,1164,-202
2020,6,2,15,1469,1406,1223,-183
2020,6,2,16,1517,1454,1406,-48
2020,6,2,17,1578,1509,1451,-58
2020,6,2,18,1655,1595,1416,-179
2020,6,2,19,1736,1680,1433,-247
2020,6,2,20,1828,1767,1469,-298
2020,6,2,21,1909,1870,1605,-265
2020,6,2,22,1984,1960,1712,-248
2020,6,2,23,2037,2015,1679,-336
2020,6,3,0,2055,2029,1628,-401
2020,6,3,1,2007,1952,1527,-425
2020,6,3,2,1958,1837,1482,-355
2020,6,3,3,1942,1821,1703,-118
2020,6,3,4,1866,1769,1531,-238
2020,6,3,5,1729,1642,1359,-283
2020,6,3,6,1595,1520,1179,-341
2020,6,3,7,1489,1408,1156,-252
2020,6,3,8,1383,1342,976,-366
2020,6,3,9,1334,1299,907,-392
2020,6,3,10,1306,1276,887,-389
2020,6,3,11,1296,1272,896,-376
2020,6,3,12,1326,1289,905,-384
2020,6,3,13,1363,1306,926,-380
2020,6,3,14,1417,1372,1071,-301
2020,6,3,15,1458,1427,1189,-238
2020,6,3,16,1513,1493,1210,-283
2020,6,3,17,1585,1582,1232,-350
2020,6,3,18,1674,1684,1265,-419
2020,6,3,19,1771,1790,1414,-376
2020,6,3,20,1867,1900,1546,-354
2020,6,3,21,1958,1997,1602,-395
2020,6,3,22,2041,2064,1554,-510
2020,6,3,23,2109,2122,1535,-587
2020,6,4,0,2141,2144,1686,-458
2020,6,4,1,2096,2104,1410,-694
2020,6,4,2,2023,2015,1256,-759
2020,6,4,3,2008,1991,1307,-684
2020,6,4,4,1927,1898,1216,-682
2020,6,4,5,1787,1727,1225,-502
2020,6,4,6,1639,1584,1124,-460
2020,6,4,7,1527,1466,1095,-371
2020,6,4,8,1453,1385,1177,-208
2020,6,4,9,1393,1325,1142,-183
2020,6,4,10,1368,1291,1162,-129
2020,6,4,11,1348,1284,1127,-157
2020,6,4,12,1366,1312,1123,-189
2020,6,4,13,1407,1333,1101,-232
2020,6,4,14,1462,1402,1163,-239
2020,6,4,15,1503,1481,1328,-153
2020,6,4,16,1572,1571,1408,-163
2020,6,4,17,1684,1685,1479,-206
2020,6,4,18,1785,1798,1622,-176
2020,6,4,19,1897,1904,1809,-95
2020,6,4,20,2016,2015,1934,-81
2020,6,4,21,2109,2142,1967,-175
2020,6,4,22,2188,2160,1906,-254
2020,6,4,23,2276,2178,1897,-281
2020,6,5,0,2301,2192,1803,-389
2020,6,5,1,2246,2189,1768,-421
2020,6,5,2,2169,2151,1760,-391
2020,6,5,3,2131,2071,1779,-292
2020,6,5,4,2040,1966,1732,-234
2020,6,5,5,1880,1800,1571,-229
2020,6,5,6,1728,1634,1491,-143
2020,6,5,7,1596,1510,1409,-101
2020,6,5,8,1513,1433,1428,-5
2020,6,5,9,1441,1380,1360,-20
2020,6,5,10,1405,1332,1393,61
2020,6,5,11,1389,1314,1514,200
2020,6,5,12,1407,1329,1517,188
2020,6,5,13,1431,1353,1493,140
2020,6,5,14,1492,1407,1438,31
2020,6,5,15,1564,1466,1508,42
2020,6,5,16,1656,1564,1614,50
2020,6,5,17,1758,1684,1745,61
2020,6,5,18,1879,1807,1822,15
2020,6,5,19,1982,1951,1958,7
2020,6,5,20,2101,2065,2087,22
2020,6,5,21,2198,2179,2111,-68
2020,6,5,22,2260,2212,2100,-112
2020,6,5,23,2330,2246,2111,-135
2020,6,6,0,2338,2222,2194,-28
2020,6,6,1,2266,2192,2187,-5
2020,6,6,2,2172,2107,2072,-35
2020,6,6,3,2125,2088,2103,15
2020,6,6,4,2063,2005,2065,60
2020,6,6,5,1923,1875,1991,116
2020,6,6,6,1774,1734,2028,294
2020,6,6,7,1644,1638,1960,322
2020,6,6,8,1546,1550,1917,367
2020,6,6,9,1481,1465,1668,203
2020,6,6,10,1434,1417,1545,128
2020,6,6,11,1401,1392,1569,177
2020,6,6,12,1388,1386,1581,195
2020,6,6,13,1381,1380,1588,208
2020,6,6,14,1412,1396,1628,232
2020,6,6,15,1472,1453,1609,156
2020,6,6,16,1556,1516,1717,201
2020,6,6,17,1648,1602,1796,194
2020,6,6,18,1751,1681,1965,284
2020,6,6,19,1847,1767,2152,385
2020,6,6,20,1930,1852,2226,374
2020,6,6,21,2015,1917,2106,189
2020,6,6,22,2094,1976,2226,250
2020,6,6,23,2143,2029,2258,229
2020,6,7,0,2154,2083,2328,245
2020,6,7,1,2103,2087,2237,150
2020,6,7,2,2030,2030,2123,93
2020,6,7,3,2003,1943,2000,57
2020,6,7,4,1929,1846,1933,87
2020,6,7,5,1808,1684,1919,235
2020,6,7,6,1686,1556,1884,328
2020,6,7,7,1567,1450,1874,424
2020,6,7,8,1454,1371,1763,392
2020,6,7,9,1395,1314,1582,268
2020,6,7,10,1357,1270,1520,250
2020,6,7,11,1316,1250,1487,237
2020,6,7,12,1307,1246,1500,254
2020,6,7,13,1291,1226,1530,304
2020,6,7,14,1309,1249,1586,337
2020,6,7,15,1351,1304,1600,296
2020,6,7,16,1423,1358,1822,464
2020,6,7,17,1505,1431,1937,506
2020,6,7,18,1589,1511,2026,515
2020,6,7,19,1692,1590,2082,492
2020,6,7,20,1788,1671,2114,443
2020,6,7,21,1886,1758,2154,396
2020,6,7,22,1993,1857,2200,343
2020,6,7,23,2069,1951,2203,252
2020,6,8,0,2124,2026,2170,144
2020,6,8,1,2100,2054,2167,113
2020,6,8,2,2042,2015,2039,24
2020,6,8,3,1999,1946,1958,12
2020,6,8,4,1917,1862,1951,89
2020,6,8,5,1784,1713,1843,130
2020,6,8,6,1642,1571,1834,263
2020,6,8,7,1529,1455,1857,402
2020,6,8,8,1393,1384,1774,390
2020,6,8,9,1356,1336,1761,425
2020,6,8,10,1324,1309,1663,354
2020,6,8,11,1314,1291,1565,274
2020,6,8,12,1342,1294,1585,291
2020,6,8,13,1391,1311,1688,377
2020,6,8,14,1431,1366,1787,421
2020,6,8,15,1464,1427,1939,512
2020,6,8,16,1494,1476,1981,505
2020,6,8,17,1540,1546,2046,500
2020,6,8,18,1598,1600,2120,520
2020,6,8,19,1656,1663,2136,473
2020,6,8,20,1735,1732,2138,406
2020,6,8,21,1807,1820,2068,248
2020,6,8,22,1890,1902,2178,276
2020,6,8,23,1944,1959,2227,268
2020,6,9,0,1956,1998,2197,199
2020,6,9,1,1917,1959,2082,123
2020,6,9,2,1869,1861,1919,58
2020,6,9,3,1858,1792,1913,121
2020,6,9,4,1798,1692,1915,223
2020,6,9,5,1666,1542,1881,339
2020,6,9,6,1534,1414,1867,453
2020,6,9,7,1431,1331,1835,504
2020,6,9,8,1262,1259,1679,420
2020,6,9,9,1231,1219,1753,534
2020,6,9,10,1211,1185,1724,539
2020,6,9,11,1213,1197,1711,514
2020,6,9,12,1249,1249,1763,514
2020,6,9,13,1309,1270,1738,468
2020,6,9,14,1341,1308,1834,526
2020,6,9,15,1352,1305,1864,559
2020,6,9,16,1355,1323,1900,577
2020,6,9,17,1367,1319,1927,608
2020,6,9,18,1393,1346,1921,575
2020,6,9,19,1426,1361,1964,603
2020,6,9,20,1455,1376,1966,590
2020,6,9,21,1504,1397,1922,525
2020,6,9,22,1541,1427,1935,508
2020,6,9,23,1583,1493,1912,419
2020,6,10,0,1627,1546,1927,381
2020,6,10,1,1621,1576,1861,285
2020,6,10,2,1590,1564,1784,220
2020,6,10,3,1631,1573,1709,136
2020,6,10,4,1595,1555,1699,144
2020,6,10,5,1507,1450,1658,208
2020,6,10,6,1391,1344,1634,290
2020,6,10,7,1315,1267,1636,369
2020,6,10,8,1260,1221,1726,505
2020,6,10,9,1223,1190,1714,524
2020,6,10,10,1200,1175,1580,405
2020,6,10,11,1203,1187,1544,357
2020,6,10,12,1233,1221,1454,233
2020,6,10,13,1270,1247,1461,214
2020,6,10,14,1310,1280,1442,162
2020,6,10,15,1319,1320,1523,203
2020,6,10,16,1342,1335,1521,186
2020,6,10,17,1373,1381,1509,128
2020,6,10,18,1421,1427,1552,125
2020,6,10,19,1464,1490,1572,82
2020,6,10,20,1520,1550,1621,71
2020,6,10,21,1593,1633,1682,49
2020,6,10,22,1659,1714,1707,-7
2020,6,10,23,1733,1788,1833,45
2020,6,11,0,1764,1860,1836,-24
2020,6,11,1,1764,1870,1805,-65
2020,6,11,2,1711,1851,1653,-198
2020,6,11,3,1715,1814,1578,-236
2020,6,11,4,1692,1749,1613,-136
2020,6,11,5,1585,1614,1670,56
2020,6,11,6,1463,1472,1673,201
2020,6,11,7,1366,1369,1590,221
2020,6,11,8,1310,1311,1531,220
2020,6,11,9,1270,1254,1512,258
2020,6,11,10,1233,1232,1537,305
2020,6,11,11,1237,1234,1520,286
2020,6,11,12,1254,1268,1422,154
2020,6,11,13,1281,1274,1453,179
2020,6,11,14,1329,1328,1513,185
2020,6,11,15,1356,1365,1596,231
2020,6,11,16,1395,1423,1662,239
2020,6,11,17,1447,1499,1760,261
2020,6,11,18,1526,1577,1732,155
2020,6,11,19,1607,1678,1755,77
2020,6,11,20,1707,1779,1768,-11
2020,6,11,21,1765,1875,1843,-32
2020,6,11,22,1825,1951,1860,-91
2020,6,11,23,1870,2030,1908,-122
2020,6,12,0,1886,2063,1952,-111
2020,6,12,1,1837,2050,2056,6
2020,6,12,2,1755,1965,1953,-12
2020,6,12,3,1760,1915,1879,-36
2020,6,12,4,1718,1843,1817,-26
2020,6,12,5,1611,1694,1651,-43
2020,6,12,6,1500,1554,1657,103
2020,6,12,7,1407,1445,1645,200
2020,6,12,8,1348,1366,1492,126
2020,6,12,9,1304,1314,1479,165
2020,6,12,10,1284,1279,1484,205
2020,6,12,11,1273,1268,1449,181
2020,6,12,12,1304,1283,1366,83
2020,6,12,13,1330,1309,1339,30
2020,6,12,14,1380,1371,1307,-64
2020,6,12,15,1412,1454,1509,55
2020,6,12,16,1468,1532,1641,109
2020,6,12,17,1509,1608,1691,83
2020,6,12,18,1587,1687,1667,-20
2020,6,12,19,1661,1788,1685,-103
2020,6,12,20,1736,1888,1820,-68
2020,6,12,21,1782,1983,1939,-44
2020,6,12,22,1837,2053,2081,28
2020,6,12,23,1846,2057,2117,60
2020,6,13,0,1846,2025,2110,85
2020,6,13,1,1800,1930,1969,39
2020,6,13,2,1731,1854,1924,70
2020,6,13,3,1724,1815,1759,-56
2020,6,13,4,1700,1788,1623,-165
2020,6,13,5,1607,1672,1552,-120
2020,6,13,6,1503,1541,1539,-2
2020,6,13,7,1427,1424,1556,132
2020,6,13,8,1391,1372,1683,311
2020,6,13,9,1335,1323,1707,384
2020,6,13,10,1298,1284,1533,249
2020,6,13,11,1279,1276,1428,152
2020,6,13,12,1272,1279,1362,83
2020,6,13,13,1266,1263,1317,54
2020,6,13,14,1303,1298,1379,81
2020,6,13,15,1352,1375,1553,178
2020,6,13,16,1419,1450,1672,222
2020,6,13,17,1496,1524,1740,216
2020,6,13,18,1587,1610,1784,174
2020,6,13,19,1667,1701,1853,152
2020,6,13,20,1751,1784,1922,138
2020,6,13,21,1828,1884,2000,116
2020,6,13,22,1892,1933,2085,152
2020,6,13,23,1925,1863,2103,240
2020,6,14,0,1959,1793,2017,224
2020,6,14,1,1905,1742,1914,172
2020,6,14,2,1859,1684,1741,57
2020,6,14,3,1837,1682,1662,-20
2020,6,14,4,1779,1619,1767,148
2020,6,14,5,1665,1540,1875,335
2020,6,14,6,1559,1428,1675,247
2020,6,14,7,1456,1346,1653,307
2020,6,14,8,1398,1288,1484,196
2020,6,14,9,1344,1255,1510,255
2020,6,14,10,1305,1234,1587,353
2020,6,14,11,1277,1229,1568,339
2020,6,14,12,1272,1236,1497,261
2020,6,14,13,1257,1223,1456,233
2020,6,14,14,1278,1248,1572,324
2020,6,14,15,1333,1330,1861,531
2020,6,14,16,1405,1410,1907,497
2020,6,14,17,1493,1488,1942,454
2020,6,14,18,1588,1563,1982,419
2020,6,14,19,1673,1649,1908,259
2020,6,14,20,1776,1729,1935,206
2020,6,14,21,1850,1813,1938,125
2020,6,14,22,1912,1890,2030,140
2020,6,14,23,1928,1900,2019,119
2020,6,15,0,1954,1865,2009,144
2020,6,15,1,1908,1829,1939,110
2020,6,15,2,1868,1808,1880,72
2020,6,15,3,1861,1809,1837,28
2020,6,15,4,1800,1784,1945,161
2020,6,15,5,1681,1661,1839,178
2020,6,15,6,1549,1536,1669,133
2020,6,15,7,1441,1438,1467,29
2020,6,15,8,1362,1378,1426,48
2020,6,15,9,1316,1345,1408,63
2020,6,15,10,1292,1310,1304,-6
2020,6,15,11,1288,1293,1342,49
2020,6,15,12,1313,1317,1370,53
2020,6,15,13,1350,1340,1507,167
2020,6,15,14,1402,1403,1622,219
2020,6,15,15,1446,1479,1690,211
2020,6,15,16,1501,1549,1724,175
2020,6,15,17,1574,1646,1697,51
2020,6,15,18,1644,1741,1665,-76
2020,6,15,19,1732,1826,1659,-167
2020,6,15,20,1825,1912,1794,-118
2020,6,15,21,1899,1996,2047,51
2020,6,15,22,1961,2071,2160,89
2020,6,15,23,1999,2102,2225,123
2020,6,16,0,2020,2096,2213,117
2020,6,16,1,1978,1980,1960,-20
2020,6,16,2,1926,1859,1892,33
2020,6,16,3,1897,1849,1916,67
2020,6,16,4,1833,1791,1848,57
2020,6,16,5,1696,1670,1652,-18
2020,6,16,6,1563,1524,1451,-73
2020,6,16,7,1458,1424,1406,-18
2020,6,16,8,1413,1363,1335,-28
2020,6,16,9,1369,1321,1314,-7
2020,6,16,10,1336,1296,1330,34
2020,6,16,11,1326,1290,1347,57
2020,6,16,12,1351,1308,1427,119
2020,6,16,13,1392,1327,1455,128
2020,6,16,14,1443,1388,1516,128
2020,6,16,15,1487,1436,1598,162
2020,6,16,16,1546,1507,1726,219
2020,6,16,17,1623,1588,1845,257
2020,6,16,18,1708,1691,1867,176
2020,6,16,19,1802,1765,1793,28
2020,6,16,20,1900,1855,1903,48
2020,6,16,21,1998,1968,1885,-83
2020,6,16,22,2066,2003,1956,-47
2020,6,16,23,2102,2020,2021,1
2020,6,17,0,2094,2012,1997,-15
2020,6,17,1,2047,2008,2074,66
2020,6,17,2,2001,1963,1960,-3
2020,6,17,3,1970,1921,1669,-252
2020,6,17,4,1900,1863,1617,-246
2020,6,17,5,1761,1712,1566,-146
2020,6,17,6,1619,1562,1585,23
2020,6,17,7,1508,1454,1520,66
2020,6,17,8,1433,1387,1513,126
2020,6,17,9,1378,1359,1523,164
2020,6,17,10,1340,1330,1581,251
2020,6,17,11,1325,1319,1541,222
2020,6,17,12,1349,1327,1569,242
2020,6,17,13,1388,1344,1665,321
2020,6,17,14,1441,1422,1683,261
2020,6,17,15,1492,1480,1692,212
2020,6,17,16,1555,1558,1793,235
2020,6,17,17,1647,1641,1885,244
2020,6,17,18,1745,1727,2021,294
2020,6,17,19,1849,1820,2206,386
2020,6,17,20,1953,1900,2232,332
2020,6,17,21,2056,1985,2177,192
2020,6,17,22,2141,2066,2277,211
2020,6,17,23,2199,2139,2272,133
2020,6,18,0,2219,2185,2267,82
2020,6,18,1,2176,2183,2256,73
2020,6,18,2,2104,2113,2097,-16
2020,6,18,3,2067,2027,2011,-16
2020,6,18,4,1983,1922,1987,65
2020,6,18,5,1833,1762,1935,173
2020,6,18,6,1675,1592,1778,186
2020,6,18,7,1543,1468,1706,238
2020,6,18,8,1443,1398,1728,330
2020,6,18,9,1384,1347,1800,453
2020,6,18,10,1353,1308,1792,484
2020,6,18,11,1336,1293,1749,456
2020,6,18,12,1357,1321,1695,374
2020,6,18,13,1394,1346,1620,274
2020,6,18,14,1436,1385,1583,198
2020,6,18,15,1458,1422,1630,208
2020,6,18,16,1516,1485,1711,226
2020,6,18,17,1591,1554,1652,98
2020,6,18,18,1673,1624,1587,-37
2020,6,18,19,1761,1714,1670,-44
2020,6,18,20,1856,1804,1765,-39
2020,6,18,21,1960,1898,1773,-125
2020,6,18,22,2037,1993,1827,-166
2020,6,18,23,2103,2061,1918,-143
2020,6,19,0,2130,2110,1950,-160
2020,6,19,1,2093,2099,1919,-180
2020,6,19,2,2041,2026,1877,-149
2020,6,19,3,1997,1952,1769,-183
2020,6,19,4,1923,1862,1721,-141
2020,6,19,5,1789,1706,1764,58
2020,6,19,6,1642,1569,1653,84
2020,6,19,7,1524,1456,1557,101
2020,6,19,8,1424,1382,1635,253
2020,6,19,9,1369,1335,1579,244
2020,6,19,10,1333,1303,1598,295
2020,6,19,11,1319,1278,1547,269
2020,6,19,12,1344,1301,1594,293
2020,6,19,13,1375,1321,1679,358
2020,6,19,14,1425,1374,1812,438
2020,6,19,15,1461,1428,1911,483
2020,6,19,16,1515,1494,1832,338
2020,6,19,17,1586,1582,1714,132
2020,6,19,18,1665,1667,1719,52
2020,6,19,19,1744,1749,1745,-4
2020,6,19,20,1830,1828,1834,6
2020,6,19,21,1916,1893,1909,16
2020,6,19,22,1989,1978,1992,14
2020,6,19,23,2043,2047,2061,14
2020,6,20,0,2054,2080,2060,-20
2020,6,20,1,2022,2070,1919,-151
2020,6,20,2,1968,2015,1751,-264
2020,6,20,3,1939,1943,1704,-239
2020,6,20,4,1884,1862,1724,-138
2020,6,20,5,1764,1726,1689,-37
2020,6,20,6,1633,1578,1612,34
2020,6,20,7,1526,1478,1769,291
2020,6,20,8,1439,1395,1823,428
2020,6,20,9,1378,1332,1735,403
2020,6,20,10,1341,1298,1729,431
2020,6,20,11,1309,1279,1697,418
2020,6,20,12,1302,1277,1665,388
2020,6,20,13,1290,1263,1630,367
2020,6,20,14,1315,1314,1596,282
2020,6,20,15,1369,1373,1645,272
2020,6,20,16,1432,1356,1612,256
2020,6,20,17,1514,1526,1677,151
2020,6,20,18,1599,1607,1660,53
2020,6,20,19,1688,1698,1694,-4
2020,6,20,20,1780,1774,1800,26
2020,6,20,21,1879,1849,1881,32
2020,6,20,22,1968,1934,2037,103
2020,6,20,23,2033,1998,2102,104
2020,6,21,0,2068,2060,2124,64
2020,6,21,1,2055,2063,1986,-77
2020,6,21,2,1993,2014,1821,-193
2020,6,21,3,1945,1937,1717,-220
2020,6,21,4,1881,1851,1775,-76
2020,6,21,5,1759,1717,1698,-19
2020,6,21,6,1644,1575,1578,3
2020,6,21,7,1531,1465,1590,125
2020,6,21,8,1444,1379,1476,97
2020,6,21,9,1379,1308,1435,127
2020,6,21,10,1333,1270,1408,138
2020,6,21,11,1303,1252,1395,143
2020,6,21,12,1289,1249,1393,144
2020,6,21,13,1259,1232,1468,236
2020,6,21,14,1280,1273,1568,295
2020,6,21,15,1348,1328,1589,261
2020,6,21,16,1424,1402,1656,254
2020,6,21,17,1526,1503,1674,171
2020,6,21,18,1632,1608,1787,179
2020,6,21,19,1744,1722,1918,196
2020,6,21,20,1850,1815,1955,140
2020,6,21,21,1955,1940,2120,180
2020,6,21,22,2047,2036,2166,130
2020,6,21,23,2115,2108,2312,204
2020,6,22,0,2162,2145,2278,133
2020,6,22,1,2161,2131,2219,88
2020,6,22,2,2098,2076,2114,38
2020,6,22,3,2044,2008,1953,-55
2020,6,22,4,1965,1907,2024,117
2020,6,22,5,1819,1753,1974,221
2020,6,22,6,1671,1587,1842,255
2020,6,22,7,1544,1505,1681,176
2020,6,22,8,1467,1429,1527,98
2020,6,22,9,1406,1383,1543,160
2020,6,22,10,1368,1345,1686,341
2020,6,22,11,1346,1327,1762,435
2020,6,22,12,1362,1336,1765,429
2020,6,22,13,1383,1344,1726,382
2020,6,22,14,1453,1422,1750,328
2020,6,22,15,1519,1499,1771,272
2020,6,22,16,1607,1604,1774,170
2020,6,22,17,1717,1768,1767,-1
2020,6,22,18,1816,1850,1736,-114
2020,6,22,19,1929,1988,1906,-82
2020,6,22,20,2047,2116,1989,-127
2020,6,22,21,2163,2207,2129,-78
2020,6,22,22,2235,2276,2228,-48
2020,6,22,23,2279,2331,2307,-24
2020,6,23,0,2309,2362,2326,-36
2020,6,23,1,2283,2320,2288,-32
2020,6,23,2,2209,2267,2242,-25
2020,6,23,3,2164,2199,2082,-117
2020,6,23,4,2079,2099,2152,53
2020,6,23,5,1917,1920,1994,74
2020,6,23,6,1746,1728,1957,229
2020,6,23,7,1620,1584,1850,266
2020,6,23,8,1496,1513,1826,313
2020,6,23,9,1429,1448,1750,302
2020,6,23,10,1390,1410,1665,255
2020,6,23,11,1375,1402,1623,221
2020,6,23,12,1395,1427,1565,138
2020,6,23,13,1436,1444,1543,99
2020,6,23,14,1494,1524,1634,110
2020,6,23,15,1544,1617,1676,59
2020,6,23,16,1608,1702,1744,42
2020,6,23,17,1680,1806,1840,34
2020,6,23,18,1771,1926,1957,31
2020,6,23,19,1861,2028,2005,-23
2020,6,23,20,1946,2134,2062,-72
2020,6,23,21,2040,2218,1969,-249
2020,6,23,22,2100,2196,2038,-158
2020,6,23,23,2133,2077,2053,-24
2020,6,24,0,2120,2084,2091,7
2020,6,24,1,2090,2064,2168,104
2020,6,24,2,2048,1985,2198,213
2020,6,24,3,2007,1940,1922,-18
2020,6,24,4,1923,1887,1691,-196
2020,6,24,5,1786,1748,1579,-169
2020,6,24,6,1638,1610,1503,-107
2020,6,24,7,1526,1491,1403,-88
2020,6,24,8,1446,1426,1437,11
2020,6,24,9,1395,1368,1462,94
2020,6,24,10,1357,1336,1397,61
2020,6,24,11,1354,1334,1354,20
2020,6,24,12,1375,1355,1329,-26
2020,6,24,13,1412,1385,1319,-66
2020,6,24,14,1467,1454,1450,-4
2020,6,24,15,1514,1525,1541,16
2020,6,24,16,1579,1603,1605,2
2020,6,24,17,1658,1694,1768,74
2020,6,24,18,1749,1785,1856,71
2020,6,24,19,1851,1900,1880,-20
2020,6,24,20,1949,2012,1998,-14
2020,6,24,21,2059,2106,2124,18
2020,6,24,22,2144,2183,2227,44
2020,6,24,23,2203,2253,2420,167
2020,6,25,0,2229,2198,2476,278
2020,6,25,1,2195,2169,2328,159
2020,6,25,2,2137,2091,2225,134
2020,6,25,3,2086,2054,2192,138
2020,6,25,4,2000,1989,2138,149
2020,6,25,5,1843,1832,1860,28
2020,6,25,6,1687,1661,1703,42
2020,6,25,7,1563,1549,1623,74
2020,6,25,8,1478,1482,1565,83
2020,6,25,9,1421,1419,1494,75
2020,6,25,10,1387,1386,1521,135
2020,6,25,11,1376,1366,1508,142
2020,6,25,12,1396,1384,1526,142
2020,6,25,13,1435,1409,1418,9
2020,6,25,14,1493,1476,1549,73
2020,6,25,15,1532,1549,1678,129
2020,6,25,16,1610,1648,1926,278
2020,6,25,17,1715,1702,2013,311
2020,6,25,18,1816,1847,1990,143
2020,6,25,19,1923,1963,2075,112
2020,6,25,20,2042,2087,2172,85
2020,6,25,21,2146,2191,2243,52
2020,6,25,22,2232,2195,2290,95
2020,6,25,23,2280,2258,2286,28
2020,6,26,0,2313,2255,2284,29
2020,6,26,1,2274,2224,2144,-80
2020,6,26,2,2210,2195,2141,-54
2020,6,26,3,2162,2134,2173,39
2020,6,26,4,2054,2057,2231,174
2020,6,26,5,1895,1921,2163,242
2020,6,26,6,1736,1777,2008,231
2020,6,26,7,1602,1617,1969,352
2020,6,26,8,1514,1536,1907,371
2020,6,26,9,1447,1466,1872,406
2020,6,26,10,1404,1411,1843,432
2020,6,26,11,1386,1402,1817,415
2020,6,26,12,1401,1414,1820,406
2020,6,26,13,1427,1424,1760,336
2020,6,26,14,1490,1498,1895,397
2020,6,26,15,1558,1580,1939,359
2020,6,26,16,1651,1657,1961,304
2020,6,26,17,1756,1734,1851,117
2020,6,26,18,1867,1778,1700,-78
2020,6,26,19,1983,1837,1800,-37
2020,6,26,20,2094,1975,1961,-14
2020,6,26,21,2194,1973,2091,118
2020,6,26,22,2257,2020,2276,256
2020,6,26,23,2309,2069,2338,269
2020,6,27,0,2311,2075,2127,52
2020,6,27,1,2258,2051,2238,187
2020,6,27,2,2197,1989,2137,148
2020,6,27,3,2152,1970,2039,69
2020,6,27,4,2075,1887,1960,73
2020,6,27,5,1929,1765,1753,-12
2020,6,27,6,1776,1630,1754,124
2020,6,27,7,1655,1526,1741,215
2020,6,27,8,1533,1456,1795,339
2020,6,27,9,1471,1408,1808,400
2020,6,27,10,1418,1374,1877,503
2020,6,27,11,1386,1357,1888,531
2020,6,27,12,1369,1355,1838,483
2020,6,27,13,1352,1340,1812,472
2020,6,27,14,1380,1384,1863,479
2020,6,27,15,1454,1466,1920,454
2020,6,27,16,1539,1548,1991,443
2020,6,27,17,1644,1654,2061,407
2020,6,27,18,1766,1760,2144,384
2020,6,27,19,1868,1847,2139,292
2020,6,27,20,1960,1930,2152,222
2020,6,27,21,2058,1983,2154,171
2020,6,27,22,2140,2059,2068,9
2020,6,27,23,2161,2127,2127,0
2020,6,28,0,2159,2170,2143,-27
2020,6,28,1,2128,2149,2126,-23
2020,6,28,2,2069,2091,2131,40
2020,6,28,3,2017,2015,2087,72
2020,6,28,4,1955,1944,2093,149
2020,6,28,5,1819,1801,1997,196
2020,6,28,6,1696,1658,1928,270
2020,6,28,7,1571,1540,1846,306
2020,6,28,8,1490,1459,1831,372
2020,6,28,9,1433,1419,1906,487
2020,6,28,10,1388,1372,1854,482
2020,6,28,11,1366,1351,1853,502
2020,6,28,12,1345,1345,1707,362
2020,6,28,13,1321,1320,1620,300
2020,6,28,14,1334,1349,1524,175
2020,6,28,15,1407,1391,1586,195
2020,6,28,16,1490,1480,1732,252
2020,6,28,17,1587,1587,1782,195
2020,6,28,18,1688,1682,1773,91
2020,6,28,19,1792,1770,1749,-21
2020,6,28,20,1891,1889,1714,-175
2020,6,28,21,1986,1989,1741,-248
2020,6,28,22,2078,2078,1883,-195
2020,6,28,23,2115,2160,1942,-218
2020,6,29,0,2143,2208,1965,-243
2020,6,29,1,2129,2203,1940,-263
2020,6,29,2,2084,2139,1938,-201
2020,6,29,3,2033,2079,1983,-96
2020,6,29,4,1956,2013,1988,-25
2020,6,29,5,1815,1863,1848,-15
2020,6,29,6,1677,1676,1741,65
2020,6,29,7,1543,1567,1721,154
2020,6,29,8,1449,1494,1588,94
2020,6,29,9,1396,1434,1568,134
2020,6,29,10,1365,1399,1534,135
2020,6,29,11,1356,1377,1497,120
2020,6,29,12,1373,1399,1483,84
2020,6,29,13,1416,1419,1450,31
2020,6,29,14,1469,1471,1474,3
2020,6,29,15,1514,1546,1707,161
2020,6,29,16,1582,1635,1825,190
2020,6,29,17,1666,1717,1880,163
2020,6,29,18,1749,1802,1944,142
2020,6,29,19,1844,1895,1945,50
2020,6,29,20,1946,2000,1967,-33
2020,6,29,21,2030,2080,1997,-83
2020,6,29,22,2100,2139,2082,-57
2020,6,29,23,2152,2195,2087,-108
2020,6,30,0,2182,2215,2165,-50
2020,6,30,1,2145,2202,2107,-95
2020,6,30,2,2112,2125,1905,-220
2020,6,30,3,2066,2088,1853,-235
2020,6,30,4,1980,1989,1834,-155
2020,6,30,5,1835,1820,1808,-12
2020,6,30,6,1678,1658,1664,6
2020,6,30,7,1549,1559,1639,80
2020,6,30,8,1451,1488,1582,94
2020,6,30,9,1396,1417,1532,115
2020,6,30,10,1363,1384,1525,141
2020,6,30,11,1349,1374,1480,106
2020,6,30,12,1377,1391,1502,111
2020,6,30,13,1423,1405,1514,109
2020,6,30,14,1464,1476,1694,218
2020,6,30,15,1506,1563,1845,282
2020,6,30,16,1559,1616,1901,285
2020,6,30,17,1617,1674,1943,269
2020,6,30,18,1683,1737,1936,199
2020,6,30,19,1759,1787,1934,147
2020,6,30,20,1837,1858,1866,8
2020,6,30,21,1911,1935,1894,-41
2020,6,30,22,1982,2017,1985,-32
2020,6,30,23,2018,2068,2029,-39
2020,7,1,0,2047,2117,2051,-66
2020,7,1,1,2006,2109,1968,-141
2020,7,1,2,1976,2037,1751,-286
2020,7,1,3,1943,1958,1534,-424
2020,7,1,4,1867,1872,1461,-411
2020,7,1,5,1741,1720,1378,-342
2020,7,1,6,1576,1551,1266,-285
2020,7,1,7,1475,1434,1208,-226
2020,7,1,8,1401,1360,1294,-66
2020,7,1,9,1349,1310,1314,4
2020,7,1,10,1313,1282,1300,18
2020,7,1,11,1306,1277,1304,27
2020,7,1,12,1343,1313,1382,69
2020,7,1,13,1386,1336,1380,44
2020,7,1,14,1429,1416,1406,-10
2020,7,1,15,1472,1479,1543,64
2020,7,1,16,1524,1552,1581,29
2020,7,1,17,1603,1628,1505,-123
2020,7,1,18,1674,1712,1434,-278
2020,7,1,19,1756,1811,1481,-330
2020,7,1,20,1856,1915,1502,-413
2020,7,1,21,1942,1995,1585,-410
2020,7,1,22,2021,2070,1660,-410
2020,7,1,23,2060,2136,1731,-405
2020,7,2,0,2086,2184,1750,-434
2020,7,2,1,2066,2176,1678,-498
2020,7,2,2,2021,2129,1561,-568
2020,7,2,3,1988,2044,1505,-539
2020,7,2,4,1903,1944,1540,-404
2020,7,2,5,1764,1786,1551,-235
2020,7,2,6,1612,1640,1478,-162
2020,7,2,7,1500,1537,1449,-88
2020,7,2,8,1446,1466,1441,-25
2020,7,2,9,1391,1413,1469,56
2020,7,2,10,1351,1370,1475,105
2020,7,2,11,1339,1366,1388,22
2020,7,2,12,1362,1389,1440,51
2020,7,2,13,1405,1403,1440,37
2020,7,2,14,1452,1468,1424,-44
2020,7,2,15,1501,1553,1416,-137
2020,7,2,16,1563,1634,1420,-214
2020,7,2,17,1643,1731,1440,-291
2020,7,2,18,1728,1862,1490,-372
2020,7,2,19,1815,1972,1569,-403
2020,7,2,20,1912,2087,1514,-573
2020,7,2,21,1999,2178,1574,-604
2020,7,2,22,2059,2248,1668,-580
2020,7,2,23,2105,2288,1736,-552
2020,7,3,0,2125,2293,1847,-446
2020,7,3,1,2107,2273,1764,-509
2020,7,3,2,2055,2197,1563,-634
2020,7,3,3,2008,2112,1507,-605
2020,7,3,4,1934,2039,1494,-545
2020,7,3,5,1795,1903,1444,-459
2020,7,3,6,1661,1750,1291,-459
2020,7,3,7,1549,1632,1264,-368
2020,7,3,8,1529,1552,1229,-323
2020,7,3,9,1480,1493,1173,-320
2020,7,3,10,1442,1459,1140,-319
2020,7,3,11,1409,1447,1109,-338
2020,7,3,12,1400,1449,1084,-365
2020,7,3,13,1394,1453,1142,-311
2020,7,3,14,1411,1512,1298,-214
2020,7,3,15,1471,1613,1401,-212
2020,7,3,16,1556,1730,1396,-334
2020,7,3,17,1655,1831,1500,-331
2020,7,3,18,1750,1948,1585,-363
2020,7,3,19,1845,2055,1669,-386
2020,7,3,20,1950,2144,1819,-325
2020,7,3,21,2027,2209,1841,-368
2020,7,3,22,2094,2282,1969,-313
2020,7,3,23,2150,2322,2060,-262
2020,7,4,0,2179,2320,2083,-237
2020,7,4,1,2164,2265,2020,-245
2020,7,4,2,2121,2176,2135,-41
2020,7,4,3,2063,2134,2238,104
2020,7,4,4,1995,2069,2290,221
2020,7,4,5,1851,1908,2143,235
2020,7,4,6,1728,1754,2036,282
2020,7,4,7,1615,1636,1737,101
2020,7,4,8,1544,1567,1553,-14
2020,7,4,9,1494,1506,1633,127
2020,7,4,10,1439,1453,1630,177
2020,7,4,11,1391,1426,1534,108
2020,7,4,12,1386,1424,1652,228
2020,7,4,13,1368,1410,1623,213
2020,7,4,14,1403,1454,1633,179
2020,7,4,15,1474,1539,1716,177
2020,7,4,16,1555,1651,1654,3
2020,7,4,17,1652,1763,1704,-59
2020,7,4,18,1763,1882,1680,-202
2020,7,4,19,1861,1971,1724,-247
2020,7,4,20,1949,2079,1808,-271
2020,7,4,21,2038,2132,1876,-256
2020,7,4,22,2120,2188,1875,-313
2020,7,4,23,2167,2215,2026,-189
2020,7,5,0,2199,2209,2007,-202
2020,7,5,1,2177,2185,2007,-178
2020,7,5,2,2133,2111,2008,-103
2020,7,5,3,2075,2030,1841,-189
2020,7,5,4,2019,1918,1826,-92
2020,7,5,5,1872,1853,1807,-46
2020,7,5,6,1733,1719,1824,105
2020,7,5,7,1620,1607,1793,186
2020,7,5,8,1516,1520,1703,183
2020,7,5,9,1459,1460,1649,189
2020,7,5,10,1407,1417,1614,197
2020,7,5,11,1380,1396,1517,121
2020,7,5,12,1370,1385,1458,73
2020,7,5,13,1343,1366,1432,66
2020,7,5,14,1377,1405,1499,94
2020,7,5,15,1437,1495,1576,81
2020,7,5,16,1532,1589,1644,55
2020,7,5,17,1638,1696,1764,68
2020,7,5,18,1752,1836,1777,-59
2020,7,5,19,1858,1963,1886,-77
2020,7,5,20,1963,2061,2019,-42
2020,7,5,21,2060,2153,1984,-169
2020,7,5,22,2144,2207,2113,-94
2020,7,5,23,2184,2219,2151,-68
2020,7,6,0,2219,2253,2235,-18
2020,7,6,1,2204,2254,2174,-80
2020,7,6,2,2160,2214,2111,-103
2020,7,6,3,2104,2141,2020,-121
2020,7,6,4,2029,2068,1912,-156
2020,7,6,5,1871,1925,1782,-143
2020,7,6,6,1739,1754,1717,-37
2020,7,6,7,1605,1644,1508,-136
2020,7,6,8,1516,1551,1199,-352
2020,7,6,9,1457,1490,1143,-347
2020,7,6,10,1415,1460,1188,-272
2020,7,6,11,1403,1428,1289,-139
2020,7,6,12,1418,1454,1359,-95
2020,7,6,13,1448,1479,1418,-61
2020,7,6,14,1522,1553,1578,25
2020,7,6,15,1591,1655,1661,6
2020,7,6,16,1674,1753,1713,-40
2020,7,6,17,1783,1878,1723,-155
2020,7,6,18,1883,1989,1725,-264
2020,7,6,19,1994,2117,1748,-369
2020,7,6,20,2103,2235,1667,-568
2020,7,6,21,2189,2332,1683,-649
2020,7,6,22,2260,2356,1748,-608
2020,7,6,23,2312,2383,1858,-525
2020,7,7,0,2332,2367,1830,-537
2020,7,7,1,2307,2343,1762,-581
2020,7,7,2,2240,2274,1548,-726
2020,7,7,3,2190,2200,1399,-801
2020,7,7,4,2096,2085,1437,-648
2020,7,7,5,1922,1936,1333,-603
2020,7,7,6,1763,1756,1299,-457
2020,7,7,7,1626,1642,1227,-415
2020,7,7,8,1569,1569,1080,-489
2020,7,7,9,1506,1500,1016,-484
2020,7,7,10,1462,1454,979,-475
2020,7,7,11,1443,1436,984,-452
2020,7,7,12,1460,1458,1044,-414
2020,7,7,13,1495,1485,1111,-374
2020,7,7,14,1565,1573,1228,-345
2020,7,7,15,1638,1655,1274,-381
2020,7,7,16,1723,1756,1360,-396
2020,7,7,17,1827,1864,1441,-423
2020,7,7,18,1942,1970,1454,-516
2020,7,7,19,2048,2084,1599,-485
2020,7,7,20,2160,2243,1682,-561
2020,7,7,21,2257,2274,1682,-592
2020,7,7,22,2328,2368,1734,-634
2020,7,7,23,2372,2426,1771,-655
2020,7,8,0,2402,2454,1809,-645
2020,7,8,1,2374,2413,1798,-615
2020,7,8,2,2329,2346,1676,-670
2020,7,8,3,2262,2272,1787,-485
2020,7,8,4,2172,2152,1788,-364
2020,7,8,5,1998,1976,1700,-276
2020,7,8,6,1823,1779,1630,-149
2020,7,8,7,1690,1658,1605,-53
2020,7,8,8,1599,1550,1572,22
2020,7,8,9,1531,1515,1658,143
2020,7,8,10,1481,1449,1719,270
2020,7,8,11,1468,1432,1695,263
2020,7,8,12,1481,1443,1646,203
2020,7,8,13,1509,1455,1668,213
2020,7,8,14,1573,1530,1718,188
2020,7,8,15,1650,1630,1805,175
2020,7,8,16,1734,1749,1892,143
2020,7,8,17,1839,1865,2028,163
2020,7,8,18,1960,2005,2138,133
2020,7,8,19,2070,2121,2206,85
2020,7,8,20,2184,2256,2143,-113
2020,7,8,21,2284,2348,2323,-25
2020,7,8,22,2346,2421,2365,-56
2020,7,8,23,2398,2474,2344,-130
2020,7,9,0,2418,2475,2349,-126
2020,7,9,1,2392,2446,2306,-140
2020,7,9,2,2337,2375,2176,-199
2020,7,9,3,2283,2282,2059,-223
2020,7,9,4,2193,2179,2003,-176
2020,7,9,5,2024,1981,1937,-44
2020,7,9,6,1855,1815,1825,10
2020,7,9,7,1715,1671,1765,94
2020,7,9,8,1607,1599,1814,215
2020,7,9,9,1544,1526,1847,321
2020,7,9,10,1500,1476,1876,400
2020,7,9,11,1476,1470,1941,471
2020,7,9,12,1491,1473,1953,480
2020,7,9,13,1514,1504,1958,454
2020,7,9,14,1587,1573,2001,428
2020,7,9,15,1644,1686,2068,382
2020,7,9,16,1738,1799,2124,325
2020,7,9,17,1850,1940,2165,225
2020,7,9,18,1976,2071,2149,78
2020,7,9,19,2099,2191,2156,-35
2020,7,9,20,2221,2312,2201,-111
2020,7,9,21,2308,2400,2327,-73
2020,7,9,22,2364,2476,2425,-51
2020,7,9,23,2428,2535,2443,-92
2020,7,10,0,2455,2537,2370,-167
2020,7,10,1,2413,2515,2309,-206
2020,7,10,2,2351,2445,2081,-364
2020,7,10,3,2295,2353,2051,-302
2020,7,10,4,2203,2227,1895,-332
2020,7,10,5,2033,2029,1683,-346
2020,7,10,6,1862,1844,1620,-224
2020,7,10,7,1722,1711,1675,-36
2020,7,10,8,1624,1622,1695,73
2020,7,10,9,1557,1565,1713,148
2020,7,10,10,1508,1512,1734,222
2020,7,10,11,1482,1483,1660,177
2020,7,10,12,1491,1496,1657,161
2020,7,10,13,1499,1514,1625,111
2020,7,10,14,1578,1581,1739,158
2020,7,10,15,1665,1697,1866,169
2020,7,10,16,1775,1820,1881,61
2020,7,10,17,1903,1952,1932,-20
2020,7,10,18,2037,2102,1933,-169
2020,7,10,19,2163,2244,1980,-264
2020,7,10,20,2285,2389,2107,-282
2020,7,10,21,2381,2491,2220,-271
2020,7,10,22,2423,2553,2318,-235
2020,7,10,23,2486,2598,2314,-284
2020,7,11,0,2493,2612,2287,-325
2020,7,11,1,2464,2580,2252,-328
2020,7,11,2,2397,2505,2071,-434
2020,7,11,3,2335,2421,1983,-438
2020,7,11,4,2261,2278,1976,-302
2020,7,11,5,2103,2104,1865,-239
2020,7,11,6,1933,1919,1655,-264
2020,7,11,7,1793,1777,1525,-252
2020,7,11,8,1690,1670,1500,-170
2020,7,11,9,1611,1587,1518,-69
2020,7,11,10,1550,1534,1551,17
2020,7,11,11,1507,1491,1597,106
2020,7,11,12,1484,1461,1624,163
2020,7,11,13,1466,1443,1752,309
2020,7,11,14,1525,1493,1974,481
2020,7,11,15,1636,1596,1977,381
2020,7,11,16,1750,1730,1976,246
2020,7,11,17,1881,1874,1944,70
2020,7,11,18,2025,2043,1915,-128
2020,7,11,19,2144,2204,1957,-247
2020,7,11,20,2279,2333,1984,-349
2020,7,11,21,2378,2420,2045,-375
2020,7,11,22,2440,2489,2063,-426
2020,7,11,23,2513,2549,2265,-284
2020,7,12,0,2525,2573,2421,-152
2020,7,12,1,2508,2549,2404,-145
2020,7,12,2,2430,2488,2309,-179
2020,7,12,3,2338,2400,2190,-210
2020,7,12,4,2267,2272,2273,1
2020,7,12,5,2093,2101,2047,-54
2020,7,12,6,1927,1940,1827,-113
2020,7,12,7,1793,1790,1789,-1
2020,7,12,8,1701,1678,1758,80
2020,7,12,9,1633,1592,1736,144
2020,7,12,10,1569,1539,1707,168
2020,7,12,11,1531,1506,1623,117
2020,7,12,12,1501,1487,1642,155
2020,7,12,13,1471,1470,1592,122
2020,7,12,14,1511,1524,1613,89
2020,7,12,15,1611,1609,1668,59
2020,7,12,16,1728,1730,1773,43
2020,7,12,17,1854,1862,1824,-38
2020,7,12,18,1998,2031,1896,-135
2020,7,12,19,2123,2173,2014,-159
2020,7,12,20,2263,2308,2149,-159
2020,7,12,21,2349,2384,2232,-152
2020,7,12,22,2407,2465,2348,-117
2020,7,12,23,2455,2473,2302,-171
2020,7,13,0,2462,2478,2357,-121
2020,7,13,1,2415,2472,2248,-224
2020,7,13,2,2352,2400,2264,-136
2020,7,13,3,2286,2331,2187,-144
2020,7,13,4,2206,2233,2202,-31
2020,7,13,5,2048,2069,2072,3
2020,7,13,6,1888,1930,1874,-56
2020,7,13,7,1753,1798,1773,-25
2020,7,13,8,1652,1714,1717,3
2020,7,13,9,1590,1661,1660,-1
2020,7,13,10,1550,1628,1639,11
2020,7,13,11,1524,1614,1668,54
2020,7,13,12,1532,1635,1657,22
2020,7,13,13,1559,1662,1685,23
2020,7,13,14,1645,1727,1760,33
2020,7,13,15,1723,1833,1913,80
2020,7,13,16,1833,1947,1851,-96
2020,7,13,17,1959,2052,1687,-365
2020,7,13,18,2102,2216,1830,-386
2020,7,13,19,2230,2360,1980,-380
2020,7,13,20,2348,2474,2056,-418
2020,7,13,21,2444,2499,1997,-502
2020,7,13,22,2501,2432,1887,-545
2020,7,13,23,2524,2398,2048,-350
2020,7,14,0,2520,2284,2074,-210
2020,7,14,1,2463,2156,2080,-76
2020,7,14,2,2391,2082,2014,-68
2020,7,14,3,2321,2072,1942,-130
2020,7,14,4,2241,2005,1836,-169
2020,7,14,5,2069,1849,1830,-19
2020,7,14,6,1905,1707,1832,125
2020,7,14,7,1770,1591,1786,195
2020,7,14,8,1659,1516,1611,95
2020,7,14,9,1602,1475,1550,75
2020,7,14,10,1561,1438,1514,76
2020,7,14,11,1540,1423,1468,45
2020,7,14,12,1553,1451,1482,31
2020,7,14,13,1586,1496,1544,48
2020,7,14,14,1662,1561,1524,-37
2020,7,14,15,1742,1653,1632,-21
2020,7,14,16,1840,1746,1682,-64
2020,7,14,17,1960,1851,1688,-163
2020,7,14,18,2090,1993,1769,-224
2020,7,14,19,2223,2142,1934,-208
2020,7,14,20,2345,2262,1954,-308
2020,7,14,21,2443,2347,2003,-344
2020,7,14,22,2496,2350,2015,-335
2020,7,14,23,2532,2379,2017,-362
2020,7,15,0,2529,2374,2111,-263
2020,7,15,1,2483,2310,2081,-229
2020,7,15,2,2416,2240,2062,-178
2020,7,15,3,2349,2189,1940,-249
2020,7,15,4,2245,2091,1937,-154
2020,7,15,5,2074,1911,1711,-200
2020,7,15,6,1902,1765,1612,-153
2020,7,15,7,1769,1643,1607,-36
2020,7,15,8,1620,1580,1610,30
2020,7,15,9,1551,1515,1608,93
2020,7,15,10,1506,1464,1661,197
2020,7,15,11,1496,1457,1549,92
2020,7,15,12,1510,1486,1493,7
2020,7,15,13,1541,1516,1464,-52
2020,7,15,14,1611,1594,1568,-26
2020,7,15,15,1691,1666,1569,-97
2020,7,15,16,1788,1751,1525,-226
2020,7,15,17,1893,1841,1489,-352
2020,7,15,18,2018,1944,1530,-414
2020,7,15,19,2147,2057,1574,-483
2020,7,15,20,2264,2125,1654,-471
2020,7,15,21,2359,2233,1729,-504
2020,7,15,22,2418,2293,2022,-271
2020,7,15,23,2433,2338,2138,-200
2020,7,16,0,2411,2322,2061,-261
2020,7,16,1,2350,2173,1911,-262
2020,7,16,2,2277,2033,1579,-454
2020,7,16,3,2238,2014,1722,-292
2020,7,16,4,2152,1933,1605,-328
2020,7,16,5,1985,1795,1488,-307
2020,7,16,6,1825,1689,1404,-285
2020,7,16,7,1689,1597,1390,-207
2020,7,16,8,1600,1546,1370,-176
2020,7,16,9,1525,1494,1451,-43
2020,7,16,10,1483,1453,1593,140
2020,7,16,11,1474,1460,1460,0
2020,7,16,12,1491,1494,1316,-178
2020,7,16,13,1531,1538,1302,-236
2020,7,16,14,1586,1589,1265,-324
2020,7,16,15,1641,1668,1357,-311
2020,7,16,16,1716,1766,1454,-312
2020,7,16,17,1816,1885,1539,-346
2020,7,16,18,1933,1969,1611,-358
2020,7,16,19,2045,2074,1730,-344
2020,7,16,20,2151,2180,1851,-329
2020,7,16,21,2229,2270,2054,-216
2020,7,16,22,2272,2341,2233,-108
2020,7,16,23,2299,2383,2279,-104
2020,7,17,0,2274,2381,2331,-50
2020,7,17,1,2197,2305,2105,-200
2020,7,17,2,2151,2209,2056,-153
2020,7,17,3,2118,2141,2175,34
2020,7,17,4,2039,2040,2154,114
2020,7,17,5,1910,1883,2038,155
2020,7,17,6,1764,1738,1796,58
2020,7,17,7,1644,1637,1681,44
2020,7,17,8,1535,1562,1750,188
2020,7,17,9,1473,1514,1728,214
2020,7,17,10,1439,1480,1702,222
2020,7,17,11,1435,1462,1646,184
2020,7,17,12,1457,1479,1607,128
2020,7,17,13,1500,1509,1600,91
2020,7,17,14,1557,1558,1663,105
2020,7,17,15,1628,1641,1731,90
2020,7,17,16,1703,1747,1834,87
2020,7,17,17,1809,1877,1882,5
2020,7,17,18,1905,1985,1923,-62
2020,7,17,19,2025,2084,2011,-73
2020,7,17,20,2125,2196,2073,-123
2020,7,17,21,2192,2281,2133,-148
2020,7,17,22,2234,2341,2226,-115
2020,7,17,23,2252,2377,2294,-83
2020,7,18,0,2238,2407,2353,-54
2020,7,18,1,2161,2291,2283,-8
2020,7,18,2,2106,2182,1996,-186
2020,7,18,3,2073,2128,1912,-216
2020,7,18,4,2006,2052,1914,-138
2020,7,18,5,1885,1901,1879,-22
2020,7,18,6,1756,1763,1856,93
2020,7,18,7,1644,1627,1814,187
2020,7,18,8,1573,1581,1853,272
2020,7,18,9,1495,1509,1813,304
2020,7,18,10,1453,1477,1931,454
2020,7,18,11,1427,1437,1890,453
2020,7,18,12,1422,1441,1768,327
2020,7,18,13,1416,1444,1736,292
2020,7,18,14,1446,1472,1692,220
2020,7,18,15,1523,1558,1737,179
2020,7,18,16,1611,1659,1841,182
2020,7,18,17,1720,1746,1936,190
2020,7,18,18,1823,1865,2062,197
2020,7,18,19,1928,1976,2025,49
2020,7,18,20,2026,2070,2092,22
2020,7,18,21,2101,2156,2200,44
2020,7,18,22,2170,2233,2235,2
2020,7,18,23,2200,2301,2402,101
2020,7,19,0,2208,2351,2477,126
2020,7,19,1,2174,2335,2427,92
2020,7,19,2,2128,2221,2222,1
2020,7,19,3,2090,2138,2126,-12
2020,7,19,4,2015,2011,2065,54
2020,7,19,5,1897,1885,1825,-60
2020,7,19,6,1759,1746,1784,38
2020,7,19,7,1645,1625,1799,174
2020,7,19,8,1577,1533,1742,209
2020,7,19,9,1504,1481,1706,225
2020,7,19,10,1454,1430,1661,231
2020,7,19,11,1426,1406,1612,206
2020,7,19,12,1415,1396,1557,161
2020,7,19,13,1403,1378,1482,104
2020,7,19,14,1433,1430,1579,149
2020,7,19,15,1507,1519,1632,113
2020,7,19,16,1605,1624,1792,168
2020,7,19,17,1718,1743,1863,120
2020,7,19,18,1830,1864,1905,41
2020,7,19,19,1945,1978,1916,-62
2020,7,19,20,2044,2090,1961,-129
2020,7,19,21,2127,2161,2076,-85
2020,7,19,22,2187,2224,2286,62
2020,7,19,23,2207,2286,2376,90
2020,7,20,0,2194,2321,2264,-57
2020,7,20,1,2148,2268,2304,36
2020,7,20,2,2112,2156,2250,94
2020,7,20,3,2086,2077,2014,-63
2020,7,20,4,2006,1998,1888,-110
2020,7,20,5,1872,1849,1976,127
2020,7,20,6,1738,1680,1879,199
2020,7,20,7,1615,1580,1686,106
2020,7,20,8,1551,1508,1603,95
2020,7,20,9,1493,1459,1637,178
2020,7,20,10,1459,1429,1703,274
2020,7,20,11,1443,1406,1657,251
2020,7,20,12,1464,1464,1618,154
2020,7,20,13,1504,1460,1605,145
2020,7,20,14,1572,1541,1632,91
2020,7,20,15,1639,1614,1776,162
2020,7,20,16,1724,1709,1861,152
2020,7,20,17,1835,1810,1946,136
2020,7,20,18,1932,1925,2069,144
2020,7,20,19,2051,2032,2049,17
2020,7,20,20,2167,2168,2009,-159
2020,7,20,21,2248,2287,2119,-168
2020,7,20,22,2308,2358,2198,-160
2020,7,20,23,2328,2397,2270,-127
2020,7,21,0,2301,2402,2413,11
2020,7,21,1,2235,2307,2355,48
2020,7,21,2,2172,2150,2114,-36
2020,7,21,3,2133,2107,2117,10
2020,7,21,4,2047,2075,2114,39
2020,7,21,5,1905,1918,2083,165
2020,7,21,6,1757,1757,2030,273
2020,7,21,7,1628,1640,1771,131
2020,7,21,8,1572,1552,1729,177
2020,7,21,9,1509,1483,1750,267
2020,7,21,10,1465,1438,1704,266
2020,7,21,11,1465,1421,1679,258
2020,7,21,12,1490,1449,1704,255
2020,7,21,13,1548,1485,1688,203
2020,7,21,14,1608,1556,1787,231
2020,7,21,15,1675,1655,1892,237
2020,7,21,16,1753,1742,1843,101
2020,7,21,17,1839,1856,1864,8
2020,7,21,18,1938,1972,1922,-50
2020,7,21,19,2048,2087,2005,-82
2020,7,21,20,2143,2194,2170,-24
2020,7,21,21,2221,2259,2365,106
2020,7,21,22,2244,2300,2349,49
2020,7,21,23,2249,2305,2339,34
2020,7,22,0,2200,2257,2278,21
2020,7,22,1,2136,2172,2217,45
2020,7,22,2,2088,2071,2086,15
2020,7,22,3,2050,2039,2055,16
2020,7,22,4,1977,1957,1977,20
2020,7,22,5,1849,1808,2046,238
2020,7,22,6,1705,1669,1993,324
2020,7,22,7,1597,1570,1911,341
2020,7,22,8,1545,1493,1776,283
2020,7,22,9,1476,1456,1588,132
2020,7,22,10,1443,1432,1571,139
2020,7,22,11,1437,1422,1590,168
2020,7,22,12,1476,1460,1561,101
2020,7,22,13,1531,1507,1567,60
2020,7,22,14,1586,1559,1582,23
2020,7,22,15,1638,1657,1720,63
2020,7,22,16,1697,1686,1787,101
2020,7,22,17,1770,1787,1874,87
2020,7,22,18,1855,1905,1910,5
2020,7,22,19,1935,2029,1963,-66
2020,7,22,20,2025,2074,2010,-64
2020,7,22,21,2097,2012,1899,-113
2020,7,22,22,2152,1992,1941,-51
2020,7,22,23,2168,2001,1927,-74
2020,7,23,0,2154,1991,1878,-113
2020,7,23,1,2080,1939,1814,-125
2020,7,23,2,2012,1937,2005,68
2020,7,23,3,2002,1881,1995,114
2020,7,23,4,1935,1807,1907,100
2020,7,23,5,1806,1681,1876,195
2020,7,23,6,1671,1557,1770,213
2020,7,23,7,1575,1478,1637,159
2020,7,23,8,1506,1417,1598,181
2020,7,23,9,1450,1374,1618,244
2020,7,23,10,1414,1360,1615,255
2020,7,23,11,1410,1345,1623,278
2020,7,23,12,1443,1386,1588,202
2020,7,23,13,1501,1438,1598,160
2020,7,23,14,1554,1495,1612,117
2020,7,23,15,1600,1562,1683,121
2020,7,23,16,1672,1620,1745,125
2020,7,23,17,1746,1679,1841,162
2020,7,23,18,1821,1747,1837,90
2020,7,23,19,1906,1811,1827,16
2020,7,23,20,1989,1899,1885,-14
2020,7,23,21,2068,2010,2100,90
2020,7,23,22,2140,2070,2065,-5
2020,7,23,23,2167,2117,1978,-139
2020,7,24,0,2166,2076,1920,-156
2020,7,24,1,2112,2014,1798,-216
2020,7,24,2,2050,1893,1717,-176
2020,7,24,3,2014,1850,1759,-91
2020,7,24,4,1937,1778,1844,66
2020,7,24,5,1818,1673,1845,172
2020,7,24,6,1684,1555,1746,191
2020,7,24,7,1570,1471,1630,159
2020,7,24,8,1481,1417,1616,199
2020,7,24,9,1430,1382,1596,214
2020,7,24,10,1399,1363,1608,245
2020,7,24,11,1391,1372,1661,289
2020,7,24,12,1415,1404,1689,285
2020,7,24,13,1471,1456,1651,195
2020,7,24,14,1513,1497,1687,190
2020,7,24,15,1575,1559,1789,230
2020,7,24,16,1629,1613,1886,273
2020,7,24,17,1699,1690,1905,215
2020,7,24,18,1774,1801,1975,174
2020,7,24,19,1849,1878,2051,173
2020,7,24,20,1928,1954,2019,65
2020,7,24,21,1985,2048,2101,53
2020,7,24,22,2023,2060,2091,31
2020,7,24,23,2023,2014,1908,-106
2020,7,25,0,1993,1918,1754,-164
2020,7,25,1,1928,1843,1624,-219
2020,7,25,2,1885,1791,1637,-154
2020,7,25,3,1881,1804,1688,-116
2020,7,25,4,1832,1755,1757,2
2020,7,25,5,1735,1667,1813,146
2020,7,25,6,1635,1559,1860,301
2020,7,25,7,1540,1473,1873,400
2020,7,25,8,1479,1410,1759,349
2020,7,25,9,1418,1382,1741,359
2020,7,25,10,1390,1341,1730,389
2020,7,25,11,1359,1328,1695,367
2020,7,25,12,1357,1348,1673,325
2020,7,25,13,1368,1360,1636,276
2020,7,25,14,1387,1400,1652,252
2020,7,25,15,1448,1458,1659,201
2020,7,25,16,1506,1529,1647,118
2020,7,25,17,1575,1581,1692,111
2020,7,25,18,1665,1641,1744,103
2020,7,25,19,1733,1723,1756,33
2020,7,25,20,1798,1773,1794,21
2020,7,25,21,1859,1845,1853,8
2020,7,25,22,1910,1907,1907,0
2020,7,25,23,1938,1922,2062,140
2020,7,26,0,1947,1917,1966,49
2020,7,26,1,1926,1879,1944,65
2020,7,26,2,1876,1869,1911,42
2020,7,26,3,1848,1800,1820,20
2020,7,26,4,1795,1745,1821,76
2020,7,26,5,1709,1654,1714,60
2020,7,26,6,1614,1541,1780,239
2020,7,26,7,1515,1474,1741,267
2020,7,26,8,1476,1414,1549,135
2020,7,26,9,1421,1368,1545,177
2020,7,26,10,1384,1339,1548,209
2020,7,26,11,1364,1314,1521,207
2020,7,26,12,1357,1321,1549,228
2020,7,26,13,1345,1324,1606,282
2020,7,26,14,1363,1368,1663,295
2020,7,26,15,1417,1424,1693,269
2020,7,26,16,1494,1506,1819,313
2020,7,26,17,1580,1610,1938,328
2020,7,26,18,1664,1707,2037,330
2020,7,26,19,1745,1817,2099,282
2020,7,26,20,1831,1918,2157,239
2020,7,26,21,1895,1943,2136,193
2020,7,26,22,1963,1915,2075,160
2020,7,26,23,2011,1846,1902,56
2020,7,27,0,2035,1827,1841,14
2020,7,27,1,2025,1788,1806,18
2020,7,27,2,1981,1724,1852,128
2020,7,27,3,1950,1745,1846,101
2020,7,27,4,1884,1700,1906,206
2020,7,27,5,1775,1602,1737,135
2020,7,27,6,1641,1487,1627,140
2020,7,27,7,1532,1405,1629,224
2020,7,27,8,1486,1364,1664,300
2020,7,27,9,1428,1338,1641,303
2020,7,27,10,1402,1321,1641,320
2020,7,27,11,1397,1311,1727,416
2020,7,27,12,1428,1354,1789,435
2020,7,27,13,1478,1403,1766,363
2020,7,27,14,1537,1467,1781,314
2020,7,27,15,1597,1534,1854,320
2020,7,27,16,1658,1583,1920,337
2020,7,27,17,1744,1653,1942,289
2020,7,27,18,1826,1723,1907,184
2020,7,27,19,1906,1813,1986,173
2020,7,27,20,1997,1789,1911,122
2020,7,27,21,2068,1878,2044,166
2020,7,27,22,2110,1956,2054,98
2020,7,27,23,2136,1989,2199,210
2020,7,28,0,2126,2040,2230,190
2020,7,28,1,2069,2041,1986,-55
2020,7,28,2,1994,1957,1920,-37
2020,7,28,3,1973,1952,1977,25
2020,7,28,4,1914,1874,1965,91
2020,7,28,5,1787,1719,1782,63
2020,7,28,6,1647,1586,1885,299
2020,7,28,7,1540,1484,1932,448
2020,7,28,8,1454,1414,1943,529
2020,7,28,9,1411,1375,1816,441
2020,7,28,10,1381,1343,1765,422
2020,7,28,11,1370,1350,1720,370
2020,7,28,12,1410,1379,1717,338
2020,7,28,13,1463,1413,1797,384
2020,7,28,14,1526,1494,1796,302
2020,7,28,15,1578,1556,1847,291
2020,7,28,16,1639,1628,1976,348
2020,7,28,17,1724,1710,2087,377
2020,7,28,18,1806,1821,2204,383
2020,7,28,19,1880,1904,2208,304
2020,7,28,20,1982,2002,2346,344
2020,7,28,21,2052,2077,2366,289
2020,7,28,22,2106,2150,2271,121
2020,7,28,23,2136,2220,2129,-91
2020,7,29,0,2124,2138,2080,-58
2020,7,29,1,2090,2059,2038,-21
2020,7,29,2,2035,1991,2097,106
2020,7,29,3,2003,1910,1996,86
2020,7,29,4,1931,1844,1906,62
2020,7,29,5,1805,1724,1824,100
2020,7,29,6,1661,1583,1786,203
2020,7,29,7,1547,1500,1806,306
2020,7,29,8,1491,1441,1778,337
2020,7,29,9,1433,1397,1747,350
2020,7,29,10,1399,1347,1671,324
2020,7,29,11,1389,1344,1658,314
2020,7,29,12,1414,1374,1637,263
2020,7,29,13,1453,1412,1599,187
2020,7,29,14,1526,1485,1675,190
2020,7,29,15,1598,1561,1700,139
2020,7,29,16,1672,1653,1599,-54
2020,7,29,17,1784,1748,1679,-69
2020,7,29,18,1897,1868,1711,-157
2020,7,29,19,2004,1995,1717,-278
2020,7,29,20,2122,2119,1774,-345
2020,7,29,21,2211,2217,1846,-371
2020,7,29,22,2279,2281,1908,-373
2020,7,29,23,2318,2336,1865,-471
2020,7,30,0,2321,2360,1844,-516
2020,7,30,1,2270,2352,1798,-554
2020,7,30,2,2183,2307,1780,-527
2020,7,30,3,2137,2197,1744,-453
2020,7,30,4,2055,2067,1513,-554
2020,7,30,5,1899,1879,1343,-536
2020,7,30,6,1743,1690,1262,-428
2020,7,30,7,1611,1564,1220,-344
2020,7,30,8,1543,1475,1270,-205
2020,7,30,9,1483,1421,1278,-143
2020,7,30,10,1439,1380,1274,-106
2020,7,30,11,1425,1364,1277,-87
2020,7,30,12,1446,1397,1246,-151
2020,7,30,13,1479,1430,1285,-145
2020,7,30,14,1553,1490,1471,-19
2020,7,30,15,1627,1574,1687,113
2020,7,30,16,1727,1657,1811,154
2020,7,30,17,1849,1785,1808,23
2020,7,30,18,1979,1917,1803,-114
2020,7,30,19,2098,2062,1849,-213
2020,7,30,20,2230,2201,1931,-270
2020,7,30,21,2319,2294,2029,-265
2020,7,30,22,2384,2381,2116,-265
2020,7,30,23,2428,2446,2147,-299
2020,7,31,0,2431,2259,1910,-349
2020,7,31,1,2369,2458,2144,-314
2020,7,31,2,2279,2378,2265,-113
2020,7,31,3,2209,2280,2144,-136
2020,7,31,4,2108,2174,1963,-211
2020,7,31,5,1954,1998,1898,-100
2020,7,31,6,1789,1824,1826,2
2020,7,31,7,1660,1684,1826,142
2020,7,31,8,1586,1593,1768,175
2020,7,31,9,1517,1516,1696,180
2020,7,31,10,1477,1480,1586,106
2020,7,31,11,1461,1474,1449,-25
2020,7,31,12,1486,1502,1376,-126
2020,7,31,13,1535,1517,1388,-129
2020,7,31,14,1590,1583,1472,-111
2020,7,31,15,1651,1682,1543,-139
2020,7,31,16,1728,1766,1561,-205
2020,7,31,17,1812,1863,1586,-277
2020,7,31,18,1914,1971,1599,-372
2020,7,31,19,2008,2065,1654,-411
2020,7,31,20,2103,2167,1773,-394
2020,7,31,21,2176,2249,1825,-424
2020,7,31,22,2237,2337,1887,-450
2020,7,31,23,2272,2381,1939,-442
2020,8,1,0,2274,2374,1962,-412
2020,8,1,1,2199,2263,1847,-416
2020,8,1,2,2112,1972,1844,-128
2020,8,1,3,2067,1935,1866,-69
2020,8,1,4,2003,1859,1916,57
2020,8,1,5,1882,1740,1719,-21
2020,8,1,6,1748,1606,1709,103
2020,8,1,7,1639,1506,1538,32
2020,8,1,8,1552,1441,1384,-57
2020,8,1,9,1483,1387,1305,-82
2020,8,1,10,1440,1350,1217,-133
2020,8,1,11,1416,1334,1214,-120
2020,8,1,12,1419,1336,1185,-151
2020,8,1,13,1417,1334,1183,-151
2020,8,1,14,1451,1361,1242,-119
2020,8,1,15,1520,1424,1394,-30
2020,8,1,16,1603,1489,1451,-38
2020,8,1,17,1717,1584,1537,-47
2020,8,1,18,1825,1687,1566,-121
2020,8,1,19,1934,1796,1649,-147
2020,8,1,20,2048,1898,1717,-181
2020,8,1,21,2139,1993,1740,-253
2020,8,1,22,2202,1852,1626,-226
2020,8,1,23,2229,2148,1980,-168
2020,8,2,0,2219,2177,2022,-155
2020,8,2,1,2149,2079,1912,-167
2020,8,2,2,2074,1998,1738,-260
2020,8,2,3,2017,1941,1694,-247
2020,8,2,4,1960,1856,1669,-187
2020,8,2,5,1847,1721,1557,-164
2020,8,2,6,1727,1597,1464,-133
2020,8,2,7,1610,1516,1209,-307
2020,8,2,8,1527,1450,990,-460
2020,8,2,9,1462,1403,864,-539
2020,8,2,10,1417,1368,868,-500
2020,8,2,11,1402,1340,903,-437
2020,8,2,12,1400,1345,859,-486
2020,8,2,13,1391,1335,840,-495
2020,8,2,14,1418,1367,916,-451
2020,8,2,15,1488,1427,1098,-329
2020,8,2,16,1585,1520,1345,-175
2020,8,2,17,1690,1626,1554,-72
2020,8,2,18,1803,1751,1665,-86
2020,8,2,19,1912,1880,1765,-115
2020,8,2,20,2025,1938,1800,-138
2020,8,2,21,2112,1999,1835,-164
2020,8,2,22,2165,2122,1846,-276
2020,8,2,23,2196,2096,1787,-309
2020,8,3,0,2212,2043,1764,-279
2020,8,3,1,2159,1927,1922,-5
2020,8,3,2,2088,1823,1803,-20
2020,8,3,3,2039,1806,1702,-104
2020,8,3,4,1973,1746,1568,-178
2020,8,3,5,1853,1633,1490,-143
2020,8,3,6,1700,1511,1410,-101
2020,8,3,7,1590,1431,1323,-108
2020,8,3,8,1521,1371,1284,-87
2020,8,3,9,1462,1334,1273,-61
2020,8,3,10,1433,1312,1287,-25
2020,8,3,11,1432,1314,1274,-40
2020,8,3,12,1458,1352,1264,-88
2020,8,3,13,1499,1388,1273,-115
2020,8,3,14,1564,1460,1379,-81
2020,8,3,15,1626,1527,1486,-41
2020,8,3,16,1700,1598,1542,-56
2020,8,3,17,1801,1685,1614,-71
2020,8,3,18,1910,1785,1638,-147
2020,8,3,19,2023,1914,1697,-217
2020,8,3,20,2138,2023,1785,-238
2020,8,3,21,2230,2122,1911,-211
2020,8,3,22,2302,2215,2033,-182
2020,8,3,23,2358,2270,2071,-199
2020,8,4,0,2375,2294,1962,-332
2020,8,4,1,2328,2168,1846,-322
2020,8,4,2,2244,2042,1900,-142
2020,8,4,3,2191,1998,1959,-39
2020,8,4,4,2100,1927,1827,-100
2020,8,4,5,1950,1767,1851,84
2020,8,4,6,1775,1631,1780,149
2020,8,4,7,1650,1549,1670,121
2020,8,4,8,1513,1483,1676,193
2020,8,4,9,1461,1451,1696,245
2020,8,4,10,1415,1406,1726,320
2020,8,4,11,1400,1403,1753,350
2020,8,4,12,1427,1431,1743,312
2020,8,4,13,1474,1471,1784,313
2020,8,4,14,1551,1536,1858,322
2020,8,4,15,1619,1598,1960,362
2020,8,4,16,1701,1685,2042,357
2020,8,4,17,1810,1786,2138,352
2020,8,4,18,1921,1910,2212,302
2020,8,4,19,2039,2039,2219,180
2020,8,4,20,2171,2162,2256,94
2020,8,4,21,2247,2280,2275,-5
2020,8,4,22,2319,2356,2384,28
2020,8,4,23,2389,2395,2323,-72
2020,8,5,0,2375,2400,2311,-89
2020,8,5,1,2326,2371,2250,-121
2020,8,5,2,2231,2286,2115,-171
2020,8,5,3,2165,2229,2107,-122
2020,8,5,4,2074,2114,2110,-4
2020,8,5,5,1920,1945,2061,116
2020,8,5,6,1744,1767,2086,319
2020,8,5,7,1631,1647,2026,379
2020,8,5,8,1556,1573,1990,417
2020,8,5,9,1494,1503,1961,458
2020,8,5,10,1453,1463,1870,407
2020,8,5,11,1448,1444,1819,375
2020,8,5,12,1470,1475,1949,474
2020,8,5,13,1513,1528,1968,440
2020,8,5,14,1570,1578,2075,497
2020,8,5,15,1645,1708,2286,578
2020,8,5,16,1735,1702,2184,482
2020,8,5,17,1832,1842,2059,217
2020,8,5,18,1947,1966,1890,-76
2020,8,5,19,2068,2086,1878,-208
2020,8,5,20,2178,2181,1925,-256
2020,8,5,21,2265,2240,2009,-231
2020,8,5,22,2332,2235,2002,-233
2020,8,5,23,2393,2181,2096,-85
2020,8,6,0,2375,2174,1993,-181
2020,8,6,1,2288,2096,1911,-185
2020,8,6,2,2183,2018,1748,-270
2020,8,6,3,2145,2014,1718,-296
2020,8,6,4,2058,1932,1725,-207
2020,8,6,5,1905,1798,1753,-45
2020,8,6,6,1749,1670,1736,66
2020,8,6,7,1629,1567,1628,61
2020,8,6,8,1560,1483,1491,8
2020,8,6,9,1507,1435,1635,200
2020,8,6,10,1467,1408,1638,230
2020,8,6,11,1461,1401,1626,225
2020,8,6,12,1490,1438,1669,231
2020,8,6,13,1534,1471,1681,210
2020,8,6,14,1589,1536,1736,200
2020,8,6,15,1656,1618,1871,253
2020,8,6,16,1731,1707,1911,204
2020,8,6,17,1833,1814,2006,192
2020,8,6,18,1952,1904,2000,96
2020,8,6,19,2062,2039,2010,-29
2020,8,6,20,2168,2130,2133,3
2020,8,6,21,2257,2208,2284,76
2020,8,6,22,2328,2292,2356,64
2020,8,6,23,2369,2332,2407,75
2020,8,7,0,2359,2327,2456,129
2020,8,7,1,2278,2252,2387,135
2020,8,7,2,2179,2147,2477,330
2020,8,7,3,2131,2111,2350,239
2020,8,7,4,2049,2025,2238,213
2020,8,7,5,1909,1864,2042,178
2020,8,7,6,1762,1708,1981,273
2020,8,7,7,1647,1597,2019,422
2020,8,7,8,1552,1519,2035,516
2020,8,7,9,1497,1465,2002,537
2020,8,7,10,1459,1438,1960,522
2020,8,7,11,1445,1424,1999,575
2020,8,7,12,1474,1456,2074,618
2020,8,7,13,1522,1493,2064,571
2020,8,7,14,1572,1540,1954,414
2020,8,7,15,1649,1639,1952,313
2020,8,7,16,1716,1727,2021,294
2020,8,7,17,1804,1820,2055,235
2020,8,7,18,1933,1919,2065,146
2020,8,7,19,2043,2036,2072,36
2020,8,7,20,2145,2120,2030,-90
2020,8,7,21,2224,2131,2125,-6
2020,8,7,22,2285,2140,2157,17
2020,8,7,23,2327,2149,2213,64
2020,8,8,0,2320,2108,2320,212
2020,8,8,1,2239,2095,2400,305
2020,8,8,2,2125,2032,2281,249
2020,8,8,3,2095,2003,2056,53
2020,8,8,4,2020,1929,2011,82
2020,8,8,5,1896,1812,1996,184
2020,8,8,6,1769,1673,1988,315
2020,8,8,7,1653,1580,1877,297
2020,8,8,8,1578,1515,1846,331
2020,8,8,9,1515,1469,1870,401
2020,8,8,10,1473,1429,1868,439
2020,8,8,11,1448,1405,1809,404
2020,8,8,12,1446,1416,1824,408
2020,8,8,13,1444,1412,1892,480
2020,8,8,14,1472,1447,1952,505
2020,8,8,15,1547,1508,2045,537
2020,8,8,16,1621,1574,2101,527
2020,8,8,17,1729,1670,2121,451
2020,8,8,18,1838,1797,2018,221
2020,8,8,19,1949,1909,1995,86
2020,8,8,20,2046,2028,1981,-47
2020,8,8,21,2126,2123,2116,-7
2020,8,8,22,2201,2215,2195,-20
2020,8,8,23,2251,2268,2203,-65
2020,8,9,0,2258,2294,2225,-69
2020,8,9,1,2211,2286,2336,50
2020,8,9,2,2113,2193,2274,81
2020,8,9,3,2081,2125,2274,149
2020,8,9,4,2011,2042,2253,211
2020,8,9,5,1889,1865,2159,294
2020,8,9,6,1761,1712,2030,318
2020,8,9,7,1646,1613,1877,264
2020,8,9,8,1556,1548,1810,262
2020,8,9,9,1493,1492,1826,334
2020,8,9,10,1448,1455,1924,469
2020,8,9,11,1420,1449,2059,610
2020,8,9,12,1413,1437,2063,626
2020,8,9,13,1405,1399,1965,566
2020,8,9,14,1430,1420,2012,592
2020,8,9,15,1501,1508,2079,571
2020,8,9,16,1590,1604,2125,521
2020,8,9,17,1695,1708,2107,399
2020,8,9,18,1818,1840,2066,226
2020,8,9,19,1943,1971,2137,166
2020,8,9,20,2042,2085,2158,73
2020,8,9,21,2133,2158,2254,96
2020,8,9,22,2203,2232,2320,88
2020,8,9,23,2256,2296,2376,80
2020,8,10,0,2272,2342,2511,169
2020,8,10,1,2219,2316,2410,94
2020,8,10,2,2147,2215,2363,148
2020,8,10,3,2111,2187,2349,162
2020,8,10,4,2038,2070,2251,181
2020,8,10,5,1902,1886,2177,291
2020,8,10,6,1754,1726,2026,300
2020,8,10,7,1640,1612,1953,341
2020,8,10,8,1546,1529,1888,359
2020,8,10,9,1488,1476,1807,331
2020,8,10,10,1459,1441,1773,332
2020,8,10,11,1444,1435,1788,353
2020,8,10,12,1465,1474,1724,250
2020,8,10,13,1505,1546,1773,227
2020,8,10,14,1579,1550,1788,238
2020,8,10,15,1643,1661,1857,196
2020,8,10,16,1723,1759,1949,190
2020,8,10,17,1839,1872,2009,137
2020,8,10,18,1950,2008,2039,31
2020,8,10,19,2078,2159,2114,-45
2020,8,10,20,2193,2266,2181,-85
2020,8,10,21,2269,2329,2251,-78
2020,8,10,22,2338,2371,2200,-171
2020,8,10,23,2382,2400,2158,-242
2020,8,11,0,2393,2392,2123,-269
2020,8,11,1,2333,2350,2032,-318
2020,8,11,2,2228,2245,2013,-232
2020,8,11,3,2176,2192,1956,-236
2020,8,11,4,2097,2074,1787,-287
2020,8,11,5,1937,1891,1754,-137
2020,8,11,6,1775,1721,1721,0
2020,8,11,7,1645,1601,1795,194
2020,8,11,8,1574,1526,1826,300
2020,8,11,9,1512,1488,1891,403
2020,8,11,10,1465,1453,1866,413
2020,8,11,11,1448,1419,1791,372
2020,8,11,12,1476,1421,1698,277
2020,8,11,13,1517,1455,1657,202
2020,8,11,14,1590,1512,1755,243
2020,8,11,15,1660,1616,1819,203
2020,8,11,16,1740,1716,1902,186
2020,8,11,17,1845,1838,1954,116
2020,8,11,18,1959,1958,1931,-27
2020,8,11,19,2089,2083,1987,-96
2020,8,11,20,2199,2197,2087,-110
2020,8,11,21,2280,2282,2192,-90
2020,8,11,22,2353,2340,2213,-127
2020,8,11,23,2415,2378,2265,-113
2020,8,12,0,2426,2405,2285,-120
2020,8,12,1,2371,2364,2240,-124
2020,8,12,2,2274,2274,2176,-98
2020,8,12,3,2218,2197,1999,-198
2020,8,12,4,2121,2056,1828,-228
2020,8,12,5,1952,1898,1705,-193
2020,8,12,6,1786,1724,1596,-128
2020,8,12,7,1664,1599,1615,16
2020,8,12,8,1567,1519,1683,164
2020,8,12,9,1510,1471,1770,299
2020,8,12,10,1475,1432,1750,318
2020,8,12,11,1456,1427,1713,286
2020,8,12,12,1485,1445,1729,284
2020,8,12,13,1524,1489,1750,261
2020,8,12,14,1591,1520,1820,300
2020,8,12,15,1662,1602,1843,241
2020,8,12,16,1746,1638,1842,204
2020,8,12,17,1844,1811,1944,133
2020,8,12,18,1959,1953,1967,14
2020,8,12,19,2100,2105,2039,-66
2020,8,12,20,2212,2229,2124,-105
2020,8,12,21,2291,2334,2284,-50
2020,8,12,22,2367,2350,2257,-93
2020,8,12,23,2417,2471,2296,-175
2020,8,13,0,2417,2413,2236,-177
2020,8,13,1,2364,2320,2142,-178
2020,8,13,2,2243,2185,2111,-74
2020,8,13,3,2213,2141,2209,68
2020,8,13,4,2110,2035,2146,111
2020,8,13,5,1943,1893,2087,194
2020,8,13,6,1777,1757,1994,237
2020,8,13,7,1666,1653,1837,184
2020,8,13,8,1588,1584,1816,232
2020,8,13,9,1527,1535,1749,214
2020,8,13,10,1488,1489,1682,193
2020,8,13,11,1477,1488,1730,242
2020,8,13,12,1499,1504,1718,214
2020,8,13,13,1537,1536,1749,213
2020,8,13,14,1585,1587,1743,156
2020,8,13,15,1661,1677,1797,120
2020,8,13,16,1745,1775,1870,95
2020,8,13,17,1856,1893,1926,33
2020,8,13,18,1975,2048,1946,-102
2020,8,13,19,2096,2178,2046,-132
2020,8,13,20,2221,2283,2161,-122
2020,8,13,21,2312,2387,2253,-134
2020,8,13,22,2358,2459,2281,-178
2020,8,13,23,2386,2482,2370,-112
2020,8,14,0,2384,2505,2631,126
2020,8,14,1,2330,2462,2477,15
2020,8,14,2,2219,2359,2276,-83
2020,8,14,3,2174,2299,2165,-134
2020,8,14,4,2086,2176,1998,-178
2020,8,14,5,1923,1994,1934,-60
2020,8,14,6,1774,1822,1997,175
2020,8,14,7,1650,1712,1888,176
2020,8,14,8,1604,1620,1789,169
2020,8,14,9,1549,1553,1733,180
2020,8,14,10,1500,1505,1690,185
2020,8,14,11,1492,1478,1688,210
2020,8,14,12,1516,1506,1707,201
2020,8,14,13,1553,1547,1710,163
2020,8,14,14,1597,1603,1758,155
2020,8,14,15,1676,1707,1831,124
2020,8,14,16,1759,1823,1882,59
2020,8,14,17,1857,1936,1989,53
2020,8,14,18,1984,2075,2041,-34
2020,8,14,19,2110,2214,2085,-129
2020,8,14,20,2219,2330,2162,-168
2020,8,14,21,2307,2414,2478,64
2020,8,14,22,2367,2402,2449,47
2020,8,14,23,2402,2384,2274,-110
2020,8,15,0,2400,2371,2328,-43
2020,8,15,1,2344,2319,2365,46
2020,8,15,2,2231,2277,2237,-40
2020,8,15,3,2189,2215,2320,105
2020,8,15,4,2108,2110,2187,77
2020,8,15,5,1968,1965,1927,-38
2020,8,15,6,1824,1805,1869,64
2020,8,15,7,1709,1680,1759,79
2020,8,15,8,1630,1590,1751,161
2020,8,15,9,1570,1517,1748,231
2020,8,15,10,1519,1481,1680,199
2020,8,15,11,1488,1458,1655,197
2020,8,15,12,1480,1450,1642,192
2020,8,15,13,1478,1456,1620,164
2020,8,15,14,1500,1483,1649,166
2020,8,15,15,1584,1566,1782,216
2020,8,15,16,1674,1678,1883,205
2020,8,15,17,1782,1813,1965,152
2020,8,15,18,1918,1961,2031,70
2020,8,15,19,2046,2100,2029,-71
2020,8,15,20,2160,2210,2146,-64
2020,8,15,21,2243,2292,2230,-62
2020,8,15,22,2305,2395,2435,40
2020,8,15,23,2331,2362,2356,-6
2020,8,16,0,2311,2282,2405,123
2020,8,16,1,2239,2198,2446,248
2020,8,16,2,2144,2093,2212,119
2020,8,16,3,2093,2045,2125,80
2020,8,16,4,2020,1961,2137,176
2020,8,16,5,1892,1829,1958,129
2020,8,16,6,1768,1680,1746,66
2020,8,16,7,1656,1573,1699,126
2020,8,16,8,1577,1485,1719,234
2020,8,16,9,1518,1430,1697,267
2020,8,16,10,1479,1398,1657,259
2020,8,16,11,1435,1372,1616,244
2020,8,16,12,1436,1373,1599,226
2020,8,16,13,1416,1369,1593,224
2020,8,16,14,1436,1394,1613,219
2020,8,16,15,1506,1460,1737,277
2020,8,16,16,1595,1552,1843,291
2020,8,16,17,1698,1657,1900,243
2020,8,16,18,1816,1771,1950,179
2020,8,16,19,1952,1913,1979,66
2020,8,16,20,2046,2044,2014,-30
2020,8,16,21,2133,2145,2144,-1
2020,8,16,22,2196,2232,2254,22
2020,8,16,23,2222,2268,2290,22
2020,8,17,0,2228,2268,2333,65
2020,8,17,1,2177,2234,2265,31
2020,8,17,2,2097,2170,2242,72
2020,8,17,3,2060,2149,2287,138
2020,8,17,4,2004,2039,2163,124
2020,8,17,5,1871,1879,1946,67
2020,8,17,6,1726,1730,1831,101
2020,8,17,7,1614,1625,1743,118
2020,8,17,8,1522,1555,1686,131
2020,8,17,9,1473,1518,1662,144
2020,8,17,10,1443,1474,1682,208
2020,8,17,11,1431,1446,1647,201
2020,8,17,12,1464,1476,1703,227
2020,8,17,13,1520,1538,1863,325
2020,8,17,14,1580,1597,1911,314
2020,8,17,15,1642,1680,1955,275
2020,8,17,16,1708,1786,1943,157
2020,8,17,17,1785,1890,1964,74
2020,8,17,18,1890,2005,2020,15
2020,8,17,19,2013,2129,2041,-88
2020,8,17,20,2109,2221,2175,-46
2020,8,17,21,2188,2303,2275,-28
2020,8,17,22,2233,2327,2377,50
2020,8,17,23,2253,2337,2420,83
2020,8,18,0,2234,2340,2442,102
2020,8,18,1,2180,2306,2460,154
2020,8,18,2,2106,2196,2445,249
2020,8,18,3,2074,2133,2388,255
2020,8,18,4,1995,2018,2334,316
2020,8,18,5,1850,1841,2093,252
2020,8,18,6,1700,1701,1961,260
2020,8,18,7,1600,1600,1765,165
2020,8,18,8,1529,1521,1590,69
2020,8,18,9,1483,1499,1428,-71
2020,8,18,10,1446,1436,1306,-130
2020,8,18,11,1438,1427,1190,-237
2020,8,18,12,1458,1464,1104,-360
2020,8,18,13,1513,1515,1139,-376
2020,8,18,14,1562,1558,1241,-317
2020,8,18,15,1634,1653,1365,-288
2020,8,18,16,1700,1702,1418,-284
2020,8,18,17,1803,1795,1470,-325
2020,8,18,18,1917,1898,1586,-312
2020,8,18,19,2045,2017,1698,-319
2020,8,18,20,2163,2122,1739,-383
2020,8,18,21,2253,2218,1887,-331
2020,8,18,22,2309,2293,1968,-325
2020,8,18,23,2341,2311,2008,-303
2020,8,19,0,2328,2305,1980,-325
2020,8,19,1,2274,2229,1925,-304
2020,8,19,2,2192,2132,1873,-259
2020,8,19,3,2142,2137,1903,-234
2020,8,19,4,2044,2013,1900,-113
2020,8,19,5,1887,1842,1776,-66
2020,8,19,6,1733,1699,1720,21
2020,8,19,7,1621,1594,1510,-84
2020,8,19,8,1551,1516,1365,-151
2020,8,19,9,1499,1462,1357,-105
2020,8,19,10,1465,1430,1375,-55
2020,8,19,11,1452,1427,1335,-92
2020,8,19,12,1477,1443,1384,-59
2020,8,19,13,1531,1497,1489,-8
2020,8,19,14,1573,1543,1586,43
2020,8,19,15,1644,1614,1632,18
2020,8,19,16,1724,1703,1713,10
2020,8,19,17,1833,1803,1756,-47
2020,8,19,18,1958,1926,1749,-177
2020,8,19,19,2096,2047,1826,-221
2020,8,19,20,2221,2172,1813,-359
2020,8,19,21,2315,2283,1921,-362
2020,8,19,22,2367,2380,2030,-350
2020,8,19,23,2402,2382,1989,-393
2020,8,20,0,2377,2362,2040,-322
2020,8,20,1,2311,2294,2096,-198
2020,8,20,2,2208,2206,1961,-245
2020,8,20,3,2153,2187,1876,-311
2020,8,20,4,2056,2053,1878,-175
2020,8,20,5,1895,1912,1789,-123
2020,8,20,6,1758,1753,1634,-119
2020,8,20,7,1641,1647,1552,-95
2020,8,20,8,1571,1573,1424,-149
2020,8,20,9,1517,1526,1408,-118
2020,8,20,10,1474,1491,1426,-65
2020,8,20,11,1471,1478,1352,-126
2020,8,20,12,1484,1498,1284,-214
2020,8,20,13,1534,1548,1307,-241
2020,8,20,14,1573,1587,1310,-277
2020,8,20,15,1652,1656,1395,-261
2020,8,20,16,1735,1742,1402,-340
2020,8,20,17,1851,1857,1399,-458
2020,8,20,18,1971,1967,1469,-498
2020,8,20,19,2103,2111,1622,-489
2020,8,20,20,2229,2248,1743,-505
2020,8,20,21,2322,2346,1815,-531
2020,8,20,22,2394,2443,1954,-489
2020,8,20,23,2429,2469,2006,-463
2020,8,21,0,2429,2444,1917,-527
2020,8,21,1,2382,2349,1910,-439
2020,8,21,2,2255,2262,1961,-301
2020,8,21,3,2209,2226,1994,-232
2020,8,21,4,2101,2089,1837,-252
2020,8,21,5,1947,1902,1780,-122
2020,8,21,6,1807,1756,1687,-69
2020,8,21,7,1688,1665,1637,-28
2020,8,21,8,1596,1618,1511,-107
2020,8,21,9,1553,1552,1471,-81
2020,8,21,10,1498,1507,1240,-267
2020,8,21,11,1487,1485,1148,-337
2020,8,21,12,1506,1511,1080,-431
2020,8,21,13,1544,1565,1065,-500
2020,8,21,14,1589,1593,1132,-461
2020,8,21,15,1671,1664,1282,-382
2020,8,21,16,1764,1758,1345,-413
2020,8,21,17,1871,1878,1226,-652
2020,8,21,18,1998,2002,1321,-681
2020,8,21,19,2126,2131,1360,-771
2020,8,21,20,2252,2302,1661,-641
2020,8,21,21,2332,2266,1814,-452
2020,8,21,22,2384,2413,1964,-449
2020,8,21,23,2402,2457,2030,-427
2020,8,22,0,2379,2457,2178,-279
2020,8,22,1,2313,2399,2113,-286
2020,8,22,2,2212,2290,1956,-334
2020,8,22,3,2172,2241,1959,-282
2020,8,22,4,2084,2112,1838,-274
2020,8,22,5,1952,1947,1531,-416
2020,8,22,6,1818,1817,1388,-429
2020,8,22,7,1694,1704,1306,-398
2020,8,22,8,1612,1609,1228,-381
2020,8,22,9,1558,1544,1148,-396
2020,8,22,10,1506,1482,1153,-329
2020,8,22,11,1471,1457,1129,-328
2020,8,22,12,1463,1446,1108,-338
2020,8,22,13,1464,1449,1151,-298
2020,8,22,14,1486,1456,1201,-255
2020,8,22,15,1566,1515,1263,-252
2020,8,22,16,1653,1596,1334,-262
2020,8,22,17,1762,1706,1356,-350
2020,8,22,18,1885,1852,1383,-469
2020,8,22,19,2014,1983,1512,-471
2020,8,22,20,2121,2115,1704,-411
2020,8,22,21,2203,2212,1865,-347
2020,8,22,22,2272,2295,1906,-389
2020,8,22,23,2294,2340,1919,-421
2020,8,23,0,2269,2353,1885,-468
2020,8,23,1,2209,2288,1842,-446
2020,8,23,2,2139,2208,1761,-447
2020,8,23,3,2087,2184,1619,-565
2020,8,23,4,2011,2055,1474,-581
2020,8,23,5,1877,1917,1394,-523
2020,8,23,6,1774,1772,1367,-405
2020,8,23,7,1660,1659,1321,-338
2020,8,23,8,1566,1580,1311,-269
2020,8,23,9,1521,1513,1219,-294
2020,8,23,10,1463,1474,1131,-343
2020,8,23,11,1432,1436,1104,-332
2020,8,23,12,1426,1420,1103,-317
2020,8,23,13,1407,1415,1157,-258
2020,8,23,14,1430,1419,1189,-230
2020,8,23,15,1504,1492,1232,-260
2020,8,23,16,1605,1584,1357,-227
2020,8,23,17,1718,1699,1447,-252
2020,8,23,18,1857,1837,1462,-375
2020,8,23,19,1997,1983,1531,-452
2020,8,23,20,2100,2112,1664,-448
2020,8,23,21,2187,2220,1759,-461
2020,8,23,22,2261,2279,1922,-357
2020,8,23,23,2296,2314,1835,-479
2020,8,24,0,2285,2326,1827,-499
2020,8,24,1,2235,2294,1938,-356
2020,8,24,2,2170,2215,1893,-322
2020,8,24,3,2118,2187,1750,-437
2020,8,24,4,2039,2055,1547,-508
2020,8,24,5,1898,1893,1413,-480
2020,8,24,6,1772,1736,1317,-419
2020,8,24,7,1660,1634,1295,-339
2020,8,24,8,1564,1552,1214,-338
2020,8,24,9,1515,1491,1141,-350
2020,8,24,10,1479,1443,1137,-306
2020,8,24,11,1466,1424,1181,-243
2020,8,24,12,1486,1457,1248,-209
2020,8,24,13,1534,1510,1307,-203
2020,8,24,14,1598,1601,1410,-191
2020,8,24,15,1676,1621,1469,-152
2020,8,24,16,1747,1705,1538,-167
2020,8,24,17,1852,1816,1596,-220
2020,8,24,18,1973,1930,1616,-314
2020,8,24,19,2101,2067,1600,-467
2020,8,24,20,2216,2188,1725,-463
2020,8,24,21,2296,2295,1846,-449
2020,8,24,22,2350,2362,1917,-445
2020,8,24,23,2363,2366,1971,-395
2020,8,25,0,2337,2314,2014,-300
2020,8,25,1,2274,2215,1879,-336
2020,8,25,2,2192,2142,1794,-348
2020,8,25,3,2159,2121,1666,-455
2020,8,25,4,2068,2004,1792,-212
2020,8,25,5,1912,1841,1621,-220
2020,8,25,6,1752,1687,1446,-241
2020,8,25,7,1636,1574,1305,-269
2020,8,25,8,1560,1492,1243,-249
2020,8,25,9,1509,1437,1202,-235
2020,8,25,10,1472,1406,1204,-202
2020,8,25,11,1461,1389,1208,-181
2020,8,25,12,1486,1425,1170,-255
2020,8,25,13,1542,1469,1151,-318
2020,8,25,14,1584,1516,1283,-233
2020,8,25,15,1650,1584,1378,-206
2020,8,25,16,1714,1650,1453,-197
2020,8,25,17,1802,1751,1559,-192
2020,8,25,18,1914,1862,1562,-300
2020,8,25,19,2027,1985,1667,-318
2020,8,25,20,2131,2096,1701,-395
2020,8,25,21,2229,2201,1779,-422
2020,8,25,22,2298,2290,1790,-500
2020,8,25,23,2331,2339,1771,-568
2020,8,26,0,2312,2343,1861,-482
2020,8,26,1,2256,2291,1954,-337
2020,8,26,2,2180,2194,1854,-340
2020,8,26,3,2145,2147,1850,-297
2020,8,26,4,2054,2020,1672,-348
2020,8,26,5,1900,1864,1613,-251
2020,8,26,6,1741,1716,1586,-130
2020,8,26,7,1638,1612,1461,-151
2020,8,26,8,1547,1537,1419,-118
2020,8,26,9,1497,1754,1727,-27
2020,8,26,10,1452,1426,1498,72
2020,8,26,11,1446,1413,1414,1
2020,8,26,12,1475,1451,1387,-64
2020,8,26,13,1529,1500,1342,-158
2020,8,26,14,1568,1519,1388,-131
2020,8,26,15,1623,1575,1529,-46
2020,8,26,16,1690,1667,1620,-47
2020,8,26,17,1778,1768,1643,-125
2020,8,26,18,1887,1830,1578,-252
2020,8,26,19,2012,2015,1717,-298
2020,8,26,20,2122,2124,1774,-350
2020,8,26,21,2224,2229,1860,-369
2020,8,26,22,2296,2318,1915,-403
2020,8,26,23,2330,2360,2016,-344
2020,8,27,0,2304,2370,2014,-356
2020,8,27,1,2237,2290,2044,-246
2020,8,27,2,2173,2202,1970,-232
2020,8,27,3,2149,2155,1908,-247
2020,8,27,4,2048,2028,1688,-340
2020,8,27,5,1894,1857,1551,-306
2020,8,27,6,1736,1710,1570,-140
2020,8,27,7,1623,1608,1427,-181
2020,8,27,8,1556,1526,1323,-203
2020,8,27,9,1502,1484,1294,-190
2020,8,27,10,1464,1456,1296,-160
2020,8,27,11,1453,1454,1312,-142
2020,8,27,12,1480,1482,1257,-225
2020,8,27,13,1536,1533,1278,-255
2020,8,27,14,1568,1573,1359,-214
2020,8,27,15,1627,1645,1463,-182
2020,8,27,16,1694,1725,1554,-171
2020,8,27,17,1786,1839,1664,-175
2020,8,27,18,1897,1945,1663,-282
2020,8,27,19,2017,2088,1852,-236
2020,8,27,20,2134,2189,1843,-346
2020,8,27,21,2234,2279,1854,-425
2020,8,27,22,2330,2363,1930,-433
2020,8,27,23,2370,2419,2049,-370
2020,8,28,0,2366,2425,2054,-371
2020,8,28,1,2308,2343,1972,-371
2020,8,28,2,2229,2254,1936,-318
2020,8,28,3,2192,2204,2047,-157
2020,8,28,4,2093,2094,2004,-90
2020,8,28,5,1940,1931,1843,-88
2020,8,28,6,1776,1784,1730,-54
2020,8,28,7,1660,1665,1683,18
2020,8,28,8,1590,1582,1664,82
2020,8,28,9,1532,1525,1644,119
2020,8,28,10,1493,1493,1633,140
2020,8,28,11,1469,1478,1674,196
2020,8,28,12,1499,1506,1745,239
2020,8,28,13,1536,1556,1774,218
2020,8,28,14,1581,1600,1789,189
2020,8,28,15,1640,1700,1743,43
2020,8,28,16,1719,1771,1699,-72
2020,8,28,17,1824,1880,1699,-181
2020,8,28,18,1946,2006,1739,-267
2020,8,28,19,2081,2127,1735,-392
2020,8,28,20,2193,2247,1814,-433
2020,8,28,21,2294,2330,1884,-446
2020,8,28,22,2354,2383,1954,-429
2020,8,28,23,2384,2428,1930,-498
2020,8,29,0,2353,2431,1915,-516
2020,8,29,1,2275,2272,1940,-332
2020,8,29,2,2195,2144,1864,-280
2020,8,29,3,2155,2079,1772,-307
2020,8,29,4,2065,1940,1757,-183
2020,8,29,5,1930,1796,1737,-59
2020,8,29,6,1786,1685,1777,92
2020,8,29,7,1675,1600,1824,224
2020,8,29,8,1597,1513,1599,86
2020,8,29,9,1537,1454,1612,158
2020,8,29,10,1490,1411,1440,29
2020,8,29,11,1460,1386,1394,8
2020,8,29,12,1454,1384,1369,-15
2020,8,29,13,1450,1408,1318,-90
2020,8,29,14,1462,1412,1296,-116
2020,8,29,15,1523,1481,1354,-127
2020,8,29,16,1600,1561,1422,-139
2020,8,29,17,1690,1664,1420,-244
2020,8,29,18,1793,1783,1466,-317
2020,8,29,19,1905,1903,1505,-398
2020,8,29,20,2006,1981,1681,-300
2020,8,29,21,2092,2039,1760,-279
2020,8,29,22,2164,2107,1831,-276
2020,8,29,23,2202,2153,1929,-224
2020,8,30,0,2211,2125,1841,-284
2020,8,30,1,2159,2102,1781,-321
2020,8,30,2,2107,2030,1625,-405
2020,8,30,3,2067,1992,1591,-401
2020,8,30,4,1990,1880,1498,-382
2020,8,30,5,1871,1756,1547,-209
2020,8,30,6,1746,1643,1501,-142
2020,8,30,7,1639,1540,1305,-235
2020,8,30,8,1550,1482,1219,-263
2020,8,30,9,1490,1416,1206,-210
2020,8,30,10,1450,1381,1220,-161
2020,8,30,11,1419,1366,1247,-119
2020,8,30,12,1414,1373,1222,-151
2020,8,30,13,1399,1390,1205,-185
2020,8,30,14,1411,1384,1310,-74
2020,8,30,15,1473,1440,1382,-58
2020,8,30,16,1550,1501,1434,-67
2020,8,30,17,1641,1563,1508,-55
2020,8,30,18,1758,1661,1613,-48
2020,8,30,19,1868,1761,1546,-215
2020,8,30,20,1967,1876,1669,-207
2020,8,30,21,2059,1962,1743,-219
2020,8,30,22,2124,2021,1821,-200
2020,8,30,23,2151,2086,1806,-280
2020,8,31,0,2161,2125,1884,-241
2020,8,31,1,2121,2079,1758,-321
2020,8,31,2,2080,2017,1725,-292
2020,8,31,3,2047,1992,1662,-330
2020,8,31,4,1971,1881,1524,-357
2020,8,31,5,1843,1724,1388,-336
2020,8,31,6,1705,1597,1343,-254
2020,8,31,7,1595,1497,1293,-204
2020,8,31,8,1503,1431,1255,-176
2020,8,31,9,1455,1395,1196,-199
2020,8,31,10,1425,1372,1057,-315
2020,8,31,11,1410,1376,1016,-360
2020,8,31,12,1436,1413,1050,-363
2020,8,31,13,1490,1484,1130,-354
2020,8,31,14,1541,1557,1210,-347
2020,8,31,15,1597,1605,1261,-344
2020,8,31,16,1659,1683,1329,-354
2020,8,31,17,1749,1765,1379,-386
2020,8,31,18,1858,1823,1510,-313
2020,8,31,19,1973,1866,1576,-290
2020,8,31,20,2076,1941,1650,-291
2020,8,31,21,2164,2040,1755,-285
2020,8,31,22,2224,2115,1843,-272
2020,8,31,23,2248,2154,1863,-291
2020,9,1,0,2253,2096,1930,-166
2020,9,1,1,2202,1997,1931,-66
2020,9,1,2,2138,1918,1886,-32
2020,9,1,3,2115,1898,1720,-178
2020,9,1,4,2023,1787,1809,22
2020,9,1,5,1870,1650,1626,-24
2020,9,1,6,1711,1533,1602,69
2020,9,1,7,1599,1444,1601,157
2020,9,1,8,1506,1392,1533,141
2020,9,1,9,1455,1369,1617,248
2020,9,1,10,1425,1345,1610,265
2020,9,1,11,1415,1348,1593,245
2020,9,1,12,1442,1386,1731,345
2020,9,1,13,1512,1464,1812,348
2020,9,1,14,1549,1508,1940,432
2020,9,1,15,1590,1586,2003,417
2020,9,1,16,1623,1645,2153,508
2020,9,1,17,1679,1690,2177,487
2020,9,1,18,1742,1703,2146,443
2020,9,1,19,1803,1731,2035,304
2020,9,1,20,1860,1736,1995,259
2020,9,1,21,1918,1753,2149,396
2020,9,1,22,1960,1777,2012,235
2020,9,1,23,1982,1806,2028,222
2020,9,2,0,1985,1809,1974,165
2020,9,2,1,1932,1799,1968,169
2020,9,2,2,1899,1750,1875,125
2020,9,2,3,1870,1747,1864,117
2020,9,2,4,1810,1664,1565,-99
2020,9,2,5,1687,1549,1398,-151
2020,9,2,6,1563,1430,1218,-212
2020,9,2,7,1481,1345,1175,-170
2020,9,2,8,1392,1305,1294,-11
2020,9,2,9,1359,1262,1330,68
2020,9,2,10,1327,1250,1271,21
2020,9,2,11,1325,1257,1287,30
2020,9,2,12,1364,1294,1273,-21
2020,9,2,13,1435,1361,1352,-9
2020,9,2,14,1469,1386,1531,145
2020,9,2,15,1496,1421,1699,278
2020,9,2,16,1533,1472,1813,341
2020,9,2,17,1593,1517,1828,311
2020,9,2,18,1671,1589,1877,288
2020,9,2,19,1744,1690,1842,152
2020,9,2,20,1844,1781,1787,6
2020,9,2,21,1937,1903,1813,-90
2020,9,2,22,2038,2001,1789,-212
2020,9,2,23,2107,2082,1876,-206
2020,9,3,0,2121,2122,1909,-213
2020,9,3,1,2090,2104,1849,-255
2020,9,3,2,2045,2014,1904,-110
2020,9,3,3,1993,1956,1929,-27
2020,9,3,4,1902,1834,1673,-161
2020,9,3,5,1751,1674,1588,-86
2020,9,3,6,1613,1519,1613,94
2020,9,3,7,1506,1418,1568,150
2020,9,3,8,1423,1358,1538,180
2020,9,3,9,1381,1321,1576,255
2020,9,3,10,1351,1298,1587,289
2020,9,3,11,1340,1299,1569,270
2020,9,3,12,1368,1332,1580,248
2020,9,3,13,1432,1401,1580,179
2020,9,3,14,1477,1438,1631,193
2020,9,3,15,1529,1504,1660,156
2020,9,3,16,1585,1555,1648,93
2020,9,3,17,1660,1628,1673,45
2020,9,3,18,1773,1734,1721,-13
2020,9,3,19,1883,1847,1837,-10
2020,9,3,20,1979,1972,1874,-98
2020,9,3,21,2082,2119,2039,-80
2020,9,3,22,2172,2223,2208,-15
2020,9,3,23,2243,2275,2307,32
2020,9,4,0,2253,2359,2358,-1
2020,9,4,1,2210,2313,2335,22
2020,9,4,2,2126,2180,2466,286
2020,9,4,3,2067,2103,2435,332
2020,9,4,4,1969,1963,2329,366
2020,9,4,5,1830,1803,2042,239
2020,9,4,6,1685,1664,1886,222
2020,9,4,7,1558,1560,1802,242
2020,9,4,8,1479,1492,1671,179
2020,9,4,9,1428,1438,1568,130
2020,9,4,10,1393,1405,1484,79
2020,9,4,11,1381,1397,1483,86
2020,9,4,12,1407,1426,1452,26
2020,9,4,13,1467,1480,1456,-24
2020,9,4,14,1504,1514,1514,0
2020,9,4,15,1563,1585,1594,9
2020,9,4,16,1630,1654,1757,103
2020,9,4,17,1706,1758,1800,42
2020,9,4,18,1805,1867,1834,-33
2020,9,4,19,1914,1990,1912,-78
2020,9,4,20,2007,2090,1934,-156
2020,9,4,21,2112,2190,1972,-218
2020,9,4,22,2168,2286,2015,-271
2020,9,4,23,2228,2329,2060,-269
2020,9,5,0,2233,2294,2126,-168
2020,9,5,1,2178,2227,2166,-61
2020,9,5,2,2113,2150,2068,-82
2020,9,5,3,2064,2093,2113,20
2020,9,5,4,1970,1981,1944,-37
2020,9,5,5,1835,1828,1870,42
2020,9,5,6,1685,1692,1745,53
2020,9,5,7,1596,1580,1743,163
2020,9,5,8,1542,1505,1669,164
2020,9,5,9,1482,1455,1584,129
2020,9,5,10,1433,1414,1580,166
2020,9,5,11,1405,1392,1502,110
2020,9,5,12,1406,1385,1452,67
2020,9,5,13,1405,1395,1450,55
2020,9,5,14,1421,1403,1403,0
2020,9,5,15,1493,1464,1502,38
2020,9,5,16,1567,1555,1607,52
2020,9,5,17,1666,1657,1701,44
2020,9,5,18,1769,1770,1758,-12
2020,9,5,19,1877,1896,1785,-111
2020,9,5,20,1973,2006,1822,-184
2020,9,5,21,2065,2099,1942,-157
2020,9,5,22,2149,2151,2052,-99
2020,9,5,23,2202,2174,2019,-155
2020,9,6,0,2233,2176,2004,-172
2020,9,6,1,2169,2121,1937,-184
2020,9,6,2,2100,2040,1933,-107
2020,9,6,3,2053,1997,1871,-126
2020,9,6,4,1965,1903,1865,-38
2020,9,6,5,1846,1774,1745,-29
2020,9,6,6,1720,1643,1729,86
2020,9,6,7,1611,1603,1768,165
2020,9,6,8,1515,1471,1659,188
2020,9,6,9,1460,1413,1609,196
2020,9,6,10,1415,1342,1618,276
2020,9,6,11,1394,1353,1643,290
2020,9,6,12,1383,1357,1635,278
2020,9,6,13,1382,1360,1648,288
2020,9,6,14,1390,1358,1648,290
2020,9,6,15,1461,1426,1838,412
2020,9,6,16,1536,1506,1915,409
2020,9,6,17,1638,1585,2016,431
2020,9,6,18,1738,1689,2037,348
2020,9,6,19,1859,1802,2000,198
2020,9,6,20,1968,1916,1950,34
2020,9,6,21,2076,2041,1936,-105
2020,9,6,22,2174,2149,2083,-66
2020,9,6,23,2246,2241,2243,2
2020,9,7,0,2300,2296,2268,-28
2020,9,7,1,2263,2277,2181,-96
2020,9,7,2,2189,2195,2164,-31
2020,9,7,3,2133,2109,2178,69
2020,9,7,4,2028,1953,2139,186
2020,9,7,5,1873,1804,1932,128
2020,9,7,6,1731,1672,1796,124
2020,9,7,7,1625,1570,1789,219
2020,9,7,8,1531,1498,1775,277
2020,9,7,9,1470,1445,1781,336
2020,9,7,10,1422,1403,1747,344
2020,9,7,11,1387,1380,1673,293
2020,9,7,12,1374,1396,1674,278
2020,9,7,13,1370,1396,1737,341
2020,9,7,14,1379,1394,1702,308
2020,9,7,15,1445,1425,1712,287
2020,9,7,16,1527,1510,1748,238
2020,9,7,17,1624,1634,1832,198
2020,9,7,18,1742,1736,1847,111
2020,9,7,19,1867,1849,1882,33
2020,9,7,20,1982,1988,1918,-70
2020,9,7,21,2092,2117,2038,-79
2020,9,7,22,2191,2218,2197,-21
2020,9,7,23,2268,2294,2312,18
2020,9,8,0,2303,2317,2260,-57
2020,9,8,1,2257,2250,2132,-118
2020,9,8,2,2189,2170,1981,-189
2020,9,8,3,2119,2088,1973,-115
2020,9,8,4,2009,1936,1888,-48
2020,9,8,5,1857,1760,1707,-53
2020,9,8,6,1722,1605,1713,108
2020,9,8,7,1614,1510,1762,252
2020,9,8,8,1488,1431,1799,368
2020,9,8,9,1439,1380,1803,423
2020,9,8,10,1404,1355,1743,388
2020,9,8,11,1385,1364,1723,359
2020,9,8,12,1422,1388,1679,291
2020,9,8,13,1479,1500,1856,356
2020,9,8,14,1537,1547,1971,424
2020,9,8,15,1591,1598,2105,507
2020,9,8,16,1619,1621,2175,554
2020,9,8,17,1684,1691,2259,568
2020,9,8,18,1761,1740,2201,461
2020,9,8,19,1820,1777,2275,498
2020,9,8,20,1861,1805,2273,468
2020,9,8,21,1893,1829,2359,530
2020,9,8,22,1896,1800,2258,458
2020,9,8,23,1857,1758,2145,387
2020,9,9,0,1793,1719,2102,383
2020,9,9,1,1759,1670,2015,345
2020,9,9,2,1708,1656,1987,331
2020,9,9,3,1701,1635,2002,367
2020,9,9,4,1657,1558,1953,395
2020,9,9,5,1558,1457,1873,416
2020,9,9,6,1453,1373,1722,349
2020,9,9,7,1394,1321,1570,249
2020,9,9,8,1281,1291,1544,253
2020,9,9,9,1257,1253,1519,266
2020,9,9,10,1245,1243,1419,176
2020,9,9,11,1256,1255,1394,139
2020,9,9,12,1309,1293,1362,69
2020,9,9,13,1391,1377,1337,-40
2020,9,9,14,1441,1436,1369,-67
2020,9,9,15,1448,1476,1436,-40
2020,9,9,16,1440,1525,1460,-65
2020,9,9,17,1437,1530,1392,-138
2020,9,9,18,1439,1537,1446,-91
2020,9,9,19,1440,1556,1545,-11
2020,9,9,20,1441,1531,1623,92
2020,9,9,21,1460,1514,1622,108
2020,9,9,22,1470,1513,1582,69
2020,9,9,23,1488,1541,1581,40
2020,9,10,0,1512,1551,1579,28
2020,9,10,1,1544,1569,1568,-1
2020,9,10,2,1575,1611,1554,-57
2020,9,10,3,1603,1610,1553,-57
2020,9,10,4,1566,1554,1533,-21
2020,9,10,5,1474,1448,1458,10
2020,9,10,6,1380,1364,1431,67
2020,9,10,7,1316,1300,1339,39
2020,9,10,8,1298,1331,1324,-7
2020,9,10,9,1277,1258,1199,-59
2020,9,10,10,1266,1246,1166,-80
2020,9,10,11,1272,1265,1191,-74
2020,9,10,12,1320,1318,1245,-73
2020,9,10,13,1400,1403,1294,-109
2020,9,10,14,1451,1460,1315,-145
2020,9,10,15,1450,1514,1347,-167
2020,9,10,16,1420,1532,1376,-156
2020,9,10,17,1407,1523,1368,-155
2020,9,10,18,1402,1535,1354,-181
2020,9,10,19,1400,1507,1332,-175
2020,9,10,20,1398,1512,1322,-190
2020,9,10,21,1411,1476,1259,-217
2020,9,10,22,1422,1443,1176,-267
2020,9,10,23,1440,1451,1150,-301
2020,9,11,0,1469,1492,1155,-337
2020,9,11,1,1511,1495,1224,-271
2020,9,11,2,1546,1546,1235,-311
2020,9,11,3,1577,1576,1248,-328
2020,9,11,4,1546,1512,1226,-286
2020,9,11,5,1470,1460,1169,-291
2020,9,11,6,1385,1346,1081,-265
2020,9,11,7,1312,1293,1072,-221
2020,9,11,8,1291,1250,1062,-188
2020,9,11,9,1261,1231,1112,-119
2020,9,11,10,1249,1210,1196,-14
2020,9,11,11,1256,1237,1227,-10
2020,9,11,12,1293,1283,1269,-14
2020,9,11,13,1368,1367,1333,-34
2020,9,11,14,1410,1415,1402,-13
2020,9,11,15,1413,1443,1442,-1
2020,9,11,16,1404,1417,1434,17
2020,9,11,17,1397,1387,1484,97
2020,9,11,18,1393,1372,1488,116
2020,9,11,19,1404,1360,1498,138
2020,9,11,20,1413,1372,1540,168
2020,9,11,21,1444,1399,1618,219
2020,9,11,22,1489,1436,1646,210
2020,9,11,23,1523,1460,1661,201
2020,9,12,0,1547,1475,1616,141
2020,9,12,1,1569,1481,1530,49
2020,9,12,2,1587,1520,1435,-85
2020,9,12,3,1605,1526,1443,-83
2020,9,12,4,1567,1489,1382,-107
2020,9,12,5,1475,1413,1321,-92
2020,9,12,6,1389,1349,1339,-10
2020,9,12,7,1321,1284,1225,-59
2020,9,12,8,1275,1246,863,-383
2020,9,12,9,1251,1219,855,-364
2020,9,12,10,1228,1212,876,-336
2020,9,12,11,1224,1211,830,-381
2020,9,12,12,1233,1223,846,-377
2020,9,12,13,1249,1264,856,-408
2020,9,12,14,1257,1282,814,-468
2020,9,12,15,1291,1299,794,-505
2020,9,12,16,1307,1314,831,-483
2020,9,12,17,1322,1302,853,-449
2020,9,12,18,1351,1309,851,-458
2020,9,12,19,1375,1325,871,-454
2020,9,12,20,1413,1355,916,-439
2020,9,12,21,1460,1390,928,-462
2020,9,12,22,1510,1436,948,-488
2020,9,12,23,1564,1477,1008,-469
2020,9,13,0,1601,1524,1007,-517
2020,9,13,1,1625,1518,948,-570
2020,9,13,2,1636,1545,934,-611
2020,9,13,3,1629,1534,952,-582
2020,9,13,4,1580,1479,932,-547
2020,9,13,5,1497,1397,903,-494
2020,9,13,6,1403,1329,951,-378
2020,9,13,7,1327,1268,926,-342
2020,9,13,8,1288,1233,898,-335
2020,9,13,9,1256,1209,865,-344
2020,9,13,10,1233,1190,850,-340
2020,9,13,11,1223,1199,854,-345
2020,9,13,12,1229,1209,914,-295
2020,9,13,13,1227,1241,957,-284
2020,9,13,14,1237,1240,1015,-225
2020,9,13,15,1276,1251,1168,-83
2020,9,13,16,1306,1269,1219,-50
2020,9,13,17,1338,1290,1290,0
2020,9,13,18,1380,1325,1370,45
2020,9,13,19,1435,1373,1451,78
2020,9,13,20,1484,1420,1529,109
2020,9,13,21,1535,1478,1557,79
2020,9,13,22,1582,1552,1536,-16
2020,9,13,23,1637,1611,1522,-89
2020,9,14,0,1673,1662,1466,-196
2020,9,14,1,1691,1667,1326,-341
2020,9,14,2,1663,1673,1321,-352
2020,9,14,3,1672,1656,1355,-301
2020,9,14,4,1621,1558,1358,-200
2020,9,14,5,1528,1447,1300,-147
2020,9,14,6,1416,1348,1213,-135
2020,9,14,7,1332,1292,1163,-129
2020,9,14,8,1284,1246,1122,-124
2020,9,14,9,1254,1209,1104,-105
2020,9,14,10,1232,1197,1132,-65
2020,9,14,11,1237,1215,1214,-1
2020,9,14,12,1276,1266,1271,5
2020,9,14,13,1338,1348,1282,-66
2020,9,14,14,1383,1383,1351,-32
2020,9,14,15,1412,1406,1475,69
2020,9,14,16,1425,1415,1525,110
2020,9,14,17,1454,1434,1543,109
2020,9,14,18,1493,1468,1585,117
2020,9,14,19,1530,1498,1560,62
2020,9,14,20,1582,1556,1568,12
2020,9,14,21,1638,1622,1568,-54
2020,9,14,22,1683,1682,1585,-97
2020,9,14,23,1722,1734,1588,-146
2020,9,15,0,1730,1793,1607,-186
2020,9,15,1,1712,1800,1534,-266
2020,9,15,2,1682,1774,1496,-278
2020,9,15,3,1689,1713,1464,-249
2020,9,15,4,1630,1614,1404,-210
2020,9,15,5,1533,1497,1296,-201
2020,9,15,6,1425,1385,1221,-164
2020,9,15,7,1339,1313,1256,-57
2020,9,15,8,1281,1263,1307,44
2020,9,15,9,1254,1234,1295,61
2020,9,15,10,1237,1226,1313,87
2020,9,15,11,1245,1238,1338,100
2020,9,15,12,1288,1278,1377,99
2020,9,15,13,1368,1353,1442,89
2020,9,15,14,1411,1418,1509,91
2020,9,15,15,1433,1416,1591,175
2020,9,15,16,1440,1410,1581,171
2020,9,15,17,1466,1432,1617,185
2020,9,15,18,1510,1485,1685,200
2020,9,15,19,1532,1536,1713,177
2020,9,15,20,1622,1603,1691,88
2020,9,15,21,1682,1676,1729,53
2020,9,15,22,1756,1741,1647,-94
2020,9,15,23,1798,1826,1598,-228
2020,9,16,0,1822,1854,1689,-165
2020,9,16,1,1800,1815,1543,-272
2020,9,16,2,1776,1796,1488,-308
2020,9,16,3,1754,1749,1507,-242
2020,9,16,4,1671,1647,1479,-168
2020,9,16,5,1554,1518,1345,-173
2020,9,16,6,1437,1405,1312,-93
2020,9,16,7,1351,1325,1244,-81
2020,9,16,8,1313,1283,1218,-65
2020,9,16,9,1277,1259,1238,-21
2020,9,16,10,1254,1237,1214,-23
2020,9,16,11,1256,1245,1187,-58
2020,9,16,12,1298,1291,1171,-120
2020,9,16,13,1371,1363,1246,-117
2020,9,16,14,1412,1389,1267,-122
2020,9,16,15,1446,1393,1316,-77
2020,9,16,16,1461,1416,1427,11
2020,9,16,17,1501,1461,1595,134
2020,9,16,18,1561,1511,1627,116
2020,9,16,19,1619,1587,1750,163
2020,9,16,20,1695,1689,1806,117
2020,9,16,21,1779,1741,1859,118
2020,9,16,22,1858,1815,1913,98
2020,9,16,23,1914,1881,1990,109
2020,9,17,0,1931,1866,2072,206
2020,9,17,1,1901,1827,1996,169
2020,9,17,2,1867,1812,1977,165
2020,9,17,3,1817,1778,2004,226
2020,9,17,4,1735,1692,1977,285
2020,9,17,5,1610,1579,2014,435
2020,9,17,6,1486,1460,1908,448
2020,9,17,7,1390,1359,1798,439
2020,9,17,8,1341,1304,1631,327
2020,9,17,9,1296,1278,1556,278
2020,9,17,10,1265,1259,1478,219
2020,9,17,11,1267,1271,1449,178
2020,9,17,12,1310,1310,1395,85
2020,9,17,13,1387,1387,1467,80
2020,9,17,14,1434,1412,1449,37
2020,9,17,15,1453,1421,1496,75
2020,9,17,16,1473,1447,1498,51
2020,9,17,17,1505,1479,1580,101
2020,9,17,18,1560,1521,1649,128
2020,9,17,19,1587,1579,1662,83
2020,9,17,20,1670,1644,1686,42
2020,9,17,21,1729,1724,1830,106
2020,9,17,22,1792,1790,1819,29
2020,9,17,23,1848,1853,1795,-58
2020,9,18,0,1868,1854,1802,-52
2020,9,18,1,1850,1822,1759,-63
2020,9,18,2,1840,1800,1700,-100
2020,9,18,3,1799,1748,1706,-42
2020,9,18,4,1707,1650,1653,3
2020,9,18,5,1593,1533,1592,59
2020,9,18,6,1477,1411,1527,116
2020,9,18,7,1383,1341,1508,167
2020,9,18,8,1331,1294,1519,225
2020,9,18,9,1296,1260,1486,226
2020,9,18,10,1269,1252,1388,136
2020,9,18,11,1275,1257,1356,99
2020,9,18,12,1313,1294,1282,-12
2020,9,18,13,1381,1376,1325,-51
2020,9,18,14,1425,1413,1365,-48
2020,9,18,15,1454,1420,1489,69
2020,9,18,16,1477,1435,1531,96
2020,9,18,17,1509,1462,1577,115
2020,9,18,18,1556,1505,1625,120
2020,9,18,19,1606,1554,1656,102
2020,9,18,20,1673,1620,1730,110
2020,9,18,21,1737,1688,1785,97
2020,9,18,22,1797,1750,1818,68
2020,9,18,23,1857,1789,1835,46
2020,9,19,0,1864,1790,1834,44
2020,9,19,1,1831,1757,1728,-29
2020,9,19,2,1816,1737,1698,-39
2020,9,19,3,1780,1713,1705,-8
2020,9,19,4,1711,1647,1661,14
2020,9,19,5,1608,1553,1597,44
2020,9,19,6,1496,1437,1564,127
2020,9,19,7,1406,1356,1527,171
2020,9,19,8,1340,1303,1446,143
2020,9,19,9,1296,1261,1417,156
2020,9,19,10,1268,1239,1374,135
2020,9,19,11,1260,1233,1332,99
2020,9,19,12,1266,1247,1313,66
2020,9,19,13,1287,1289,1332,43
2020,9,19,14,1301,1290,1371,81
2020,9,19,15,1345,1309,1524,215
2020,9,19,16,1375,1352,1510,158
2020,9,19,17,1405,1376,1448,72
2020,9,19,18,1455,1407,1323,-84
2020,9,19,19,1503,1463,1334,-129
2020,9,19,20,1563,1510,1371,-139
2020,9,19,21,1628,1578,1459,-119
2020,9,19,22,1693,1646,1544,-102
2020,9,19,23,1762,1694,1554,-140
2020,9,20,0,1796,1727,1548,-179
2020,9,20,1,1794,1714,1487,-227
2020,9,20,2,1782,1699,1587,-112
2020,9,20,3,1740,1673,1640,-33
2020,9,20,4,1663,1612,1628,16
2020,9,20,5,1572,1508,1523,15
2020,9,20,6,1467,1406,1345,-61
2020,9,20,7,1387,1347,1333,-14
2020,9,20,8,1330,1289,1316,27
2020,9,20,9,1285,1263,1287,24
2020,9,20,10,1259,1247,1302,55
2020,9,20,11,1246,1242,1323,81
2020,9,20,12,1249,1253,1325,72
2020,9,20,13,1265,1283,1337,54
2020,9,20,14,1272,1266,1326,60
2020,9,20,15,1310,1280,1367,87
2020,9,20,16,1344,1325,1490,165
2020,9,20,17,1381,1352,1539,187
2020,9,20,18,1433,1387,1466,79
2020,9,20,19,1500,1456,1406,-50
2020,9,20,20,1564,1531,1369,-162
2020,9,20,21,1633,1618,1386,-232
2020,9,20,22,1707,1721,1433,-288
2020,9,20,23,1776,1804,1469,-335
2020,9,21,0,1829,1843,1486,-357
2020,9,21,1,1831,1825,1495,-330
2020,9,21,2,1819,1821,1581,-240
2020,9,21,3,1779,1766,1546,-220
2020,9,21,4,1689,1658,1486,-172
2020,9,21,5,1581,1540,1349,-191
2020,9,21,6,1461,1414,1215,-199
2020,9,21,7,1381,1338,1220,-118
2020,9,21,8,1321,1282,1194,-88
2020,9,21,9,1283,1253,1213,-40
2020,9,21,10,1261,1236,1190,-46
2020,9,21,11,1265,1244,1156,-88
2020,9,21,12,1306,1284,1080,-204
2020,9,21,13,1379,1374,1081,-293
2020,9,21,14,1424,1400,1201,-199
2020,9,21,15,1451,1404,1326,-78
2020,9,21,16,1472,1431,1389,-42
2020,9,21,17,1514,1479,1423,-56
2020,9,21,18,1567,1527,1423,-104
2020,9,21,19,1624,1606,1424,-182
2020,9,21,20,1694,1674,1461,-213
2020,9,21,21,1765,1768,1531,-237
2020,9,21,22,1828,1850,1575,-275
2020,9,21,23,1889,1912,1630,-282
2020,9,22,0,1915,1921,1720,-201
2020,9,22,1,1877,1872,1650,-222
2020,9,22,2,1854,1852,1677,-175
2020,9,22,3,1815,1805,1700,-105
2020,9,22,4,1723,1710,1633,-77
2020,9,22,5,1599,1586,1472,-114
2020,9,22,6,1474,1466,1186,-280
2020,9,22,7,1380,1384,1105,-279
2020,9,22,8,1326,1325,1094,-231
2020,9,22,9,1289,1283,1096,-187
2020,9,22,10,1271,1258,1062,-196
2020,9,22,11,1273,1261,1059,-202
2020,9,22,12,1315,1290,1093,-197
2020,9,22,13,1403,1381,1079,-302
2020,9,22,14,1440,1393,1112,-281
2020,9,22,15,1465,1399,1243,-156
2020,9,22,16,1478,1432,1309,-123
2020,9,22,17,1512,1472,1336,-136
2020,9,22,18,1560,1527,1375,-152
2020,9,22,19,1629,1612,1426,-186
2020,9,22,20,1706,1697,1444,-253
2020,9,22,21,1800,1789,1498,-291
2020,9,22,22,1880,1880,1509,-371
2020,9,22,23,1934,1882,1594,-288
2020,9,23,0,1948,1881,1503,-378
2020,9,23,1,1909,1836,1410,-426
2020,9,23,2,1908,1817,1474,-343
2020,9,23,3,1847,1778,1535,-243
2020,9,23,4,1752,1672,1479,-193
2020,9,23,5,1619,1560,1305,-255
2020,9,23,6,1488,1447,1168,-279
2020,9,23,7,1395,1377,1106,-271
2020,9,23,8,1346,1327,1063,-264
2020,9,23,9,1310,1297,1082,-215
2020,9,23,10,1286,1275,1108,-167
2020,9,23,11,1288,1273,1114,-159
2020,9,23,12,1325,1319,1171,-148
2020,9,23,13,1407,1405,1259,-146
2020,9,23,14,1450,1437,1383,-54
2020,9,23,15,1467,1446,1510,64
2020,9,23,16,1488,1478,1712,234
2020,9,23,17,1528,1526,1839,313
2020,9,23,18,1580,1602,2003,401
2020,9,23,19,1652,1678,2049,371
2020,9,23,20,1733,1756,2031,275
2020,9,23,21,1824,1823,2001,178
2020,9,23,22,1887,1905,1992,87
2020,9,23,23,1959,1966,2040,74
2020,9,24,0,1959,1969,1992,23
2020,9,24,1,1916,1927,1846,-81
2020,9,24,2,1907,2048,1958,-90
2020,9,24,3,1856,1830,1972,142
2020,9,24,4,1760,1714,1876,162
2020,9,24,5,1622,1591,1714,123
2020,9,24,6,1501,1462,1531,69
2020,9,24,7,1410,1380,1409,29
2020,9,24,8,1347,1329,1350,21
2020,9,24,9,1312,1296,1318,22
2020,9,24,10,1282,1275,1300,25
2020,9,24,11,1286,1276,1271,-5
2020,9,24,12,1320,1320,1268,-52
2020,9,24,13,1403,1391,1337,-54
2020,9,24,14,1434,1423,1436,13
2020,9,24,15,1455,1439,1559,120
2020,9,24,16,1486,1462,1582,120
2020,9,24,17,1525,1512,1633,121
2020,9,24,18,1585,1583,1696,113
2020,9,24,19,1656,1672,1750,78
2020,9,24,20,1746,1759,1767,8
2020,9,24,21,1833,1862,1785,-77
2020,9,24,22,1924,1946,1806,-140
2020,9,24,23,1995,2004,1918,-86
2020,9,25,0,2006,2020,1914,-106
2020,9,25,1,1970,1966,1875,-91
2020,9,25,2,1950,1908,1823,-85
2020,9,25,3,1897,1838,1797,-41
2020,9,25,4,1792,1727,1691,-36
2020,9,25,5,1660,1593,1605,12
2020,9,25,6,1531,1466,1598,132
2020,9,25,7,1435,1390,1603,213
2020,9,25,8,1358,1332,1590,258
2020,9,25,9,1316,1299,1547,248
2020,9,25,10,1289,1281,1534,253
2020,9,25,11,1288,1288,1677,389
2020,9,25,12,1323,1332,1771,439
2020,9,25,13,1407,1399,1837,438
2020,9,25,14,1445,1423,1830,407
2020,9,25,15,1467,1434,1890,456
2020,9,25,16,1498,1464,1914,450
2020,9,25,17,1542,1503,1864,361
2020,9,25,18,1612,1569,1921,352
2020,9,25,19,1689,1643,1999,356
2020,9,25,20,1781,1753,2071,318
2020,9,25,21,1883,1863,2201,338
2020,9,25,22,1966,1960,2251,291
2020,9,25,23,2020,2018,2263,245
2020,9,26,0,2033,2019,2236,217
2020,9,26,1,1992,1956,2087,131
2020,9,26,2,1966,1914,1980,66
2020,9,26,3,1901,1849,1994,145
2020,9,26,4,1804,1748,1921,173
2020,9,26,5,1679,1625,1823,198
2020,9,26,6,1553,1532,1829,297
2020,9,26,7,1459,1449,1771,322
2020,9,26,8,1394,1382,1808,426
2020,9,26,9,1346,1335,1805,470
2020,9,26,10,1315,1307,1770,463
2020,9,26,11,1303,1299,1832,533
2020,9,26,12,1301,1313,1827,514
2020,9,26,13,1324,1343,1872,529
2020,9,26,14,1334,1337,1811,474
2020,9,26,15,1377,1362,1848,486
2020,9,26,16,1420,1409,1941,532
2020,9,26,17,1471,1468,2101,633
2020,9,26,18,1549,1532,2236,704
2020,9,26,19,1630,1619,2303,684
2020,9,26,20,1719,1703,2296,593
2020,9,26,21,1812,1794,2303,509
2020,9,26,22,1909,1874,2342,468
2020,9,26,23,1975,1940,2434,494
2020,9,27,0,2005,1952,2314,362
2020,9,27,1,1971,1913,2215,302
2020,9,27,2,1936,1873,2132,259
2020,9,27,3,1868,1793,2024,231
2020,9,27,4,1773,1693,1929,236
2020,9,27,5,1660,1583,1759,176
2020,9,27,6,1549,1485,1805,320
2020,9,27,7,1454,1405,1829,424
2020,9,27,8,1366,1338,1841,503
2020,9,27,9,1320,1303,1842,539
2020,9,27,10,1291,1282,1807,525
2020,9,27,11,1275,1272,1739,467
2020,9,27,12,1276,1283,1727,444
2020,9,27,13,1292,1301,1707,406
2020,9,27,14,1294,1291,1786,495
2020,9,27,15,1325,1338,1776,438
2020,9,27,16,1363,1380,1816,436
2020,9,27,17,1412,1419,1981,562
2020,9,27,18,1486,1481,2038,557
2020,9,27,19,1568,1553,1992,439
2020,9,27,20,1653,1656,2051,395
2020,9,27,21,1751,1746,2089,343
2020,9,27,22,1834,1841,2152,311
2020,9,27,23,1899,1916,2185,269
2020,9,28,0,1919,1950,2085,135
2020,9,28,1,1896,1922,1977,55
2020,9,28,2,1903,1898,1906,8
2020,9,28,3,1848,1814,1875,61
2020,9,28,4,1747,1704,1785,81
2020,9,28,5,1617,1568,1724,156
2020,9,28,6,1475,1452,1768,316
2020,9,28,7,1385,1371,1719,348
2020,9,28,8,1259,1320,1713,393
2020,9,28,9,1229,1278,1699,421
2020,9,28,10,1216,1248,1650,402
2020,9,28,11,1229,1252,1631,379
2020,9,28,12,1284,1292,1576,284
2020,9,28,13,1370,1372,1549,177
2020,9,28,14,1418,1402,1566,164
2020,9,28,15,1424,1396,1494,98
2020,9,28,16,1424,1393,1452,59
2020,9,28,17,1419,1150,1536,386
2020,9,28,18,1422,1187,1578,391
2020,9,28,19,1424,1184,1529,345
2020,9,28,20,1428,1203,1541,338
2020,9,28,21,1452,1222,1603,381
2020,9,28,22,1471,1264,1629,365
2020,9,28,23,1500,1260,1617,357
2020,9,29,0,1529,1286,1572,286
2020,9,29,1,1563,1296,1516,220
2020,9,29,2,1583,1326,1519,193
2020,9,29,3,1594,1293,1515,222
2020,9,29,4,1541,1213,1425,212
2020,9,29,5,1449,1132,1298,166
2020,9,29,6,1350,1094,1257,163
2020,9,29,7,1287,1040,1260,220
2020,9,29,8,1285,1003,1205,202
2020,9,29,9,1241,983,1201,218
2020,9,29,10,1228,977,1209,232
2020,9,29,11,1237,994,1218,224
2020,9,29,12,1289,1045,1231,186
2020,9,29,13,1388,1139,1254,115
2020,9,29,14,1433,1136,1288,152
2020,9,29,15,1423,1106,1397,291
2020,9,29,16,1396,1101,1454,353
2020,9,29,17,1380,1095,1502,407
2020,9,29,18,1377,1097,1460,363
2020,9,29,19,1385,1106,1450,344
2020,9,29,20,1424,1133,1461,328
2020,9,29,21,1463,1166,1463,297
2020,9,29,22,1510,1210,1463,253
2020,9,29,23,1553,1251,1451,200
2020,9,30,0,1581,1272,1400,128
2020,9,30,1,1608,1314,1423,109
2020,9,30,2,1635,1304,1451,147
2020,9,30,3,1634,1276,1428,152
2020,9,30,4,1582,1201,1409,208
2020,9,30,5,1468,1093,1331,238
2020,9,30,6,1361,1051,1366,315
2020,9,30,7,1295,1001,1303,302
2020,9,30,8,1259,987,1289,302
2020,9,30,9,1230,972,1285,313
2020,9,30,10,1217,965,1295,330
2020,9,30,11,1231,983,1270,287
2020,9,30,12,1279,1035,1296,261
2020,9,30,13,1355,1130,1322,192
2020,9,30,14,1396,1108,1311,203
2020,9,30,15,1387,1108,1446,338
2020,9,30,16,1373,1123,1499,376
2020,9,30,17,1369,1125,1544,419
2020,9,30,18,1392,1149,1523,374
2020,9,30,19,1429,1186,1535,349
2020,9,30,20,1479,1229,1518,289
2020,9,30,21,1544,1316,1575,259
2020,9,30,22,1611,1390,1643,253
2020,9,30,23,1665,1432,1642,210
2020,10,1,0,1694,1481,1607,126
2020,10,1,1,1689,1463,1558,95
2020,10,1,2,1688,1442,1550,108
2020,10,1,3,1677,1371,1408,37
2020,10,1,4,1612,1307,1285,-22
2020,10,1,5,1508,1220,1239,19
2020,10,1,6,1405,1148,1247,99
2020,10,1,7,1322,1077,1238,161
2020,10,1,8,1282,1258,1387,129
2020,10,1,9,1247,1236,1377,141
2020,10,1,10,1231,1222,1372,150
2020,10,1,11,1239,1227,1358,131
2020,10,1,12,1282,1277,1388,111
2020,10,1,13,1357,1365,1441,76
2020,10,1,14,1400,1390,1471,81
2020,10,1,15,1403,1395,1549,154
2020,10,1,16,1405,1395,1630,235
2020,10,1,17,1404,1427,1679,252
2020,10,1,18,1422,1458,1768,310
2020,10,1,19,1448,1503,1766,263
2020,10,1,20,1497,1557,1770,213
2020,10,1,21,1550,1613,1742,129
2020,10,1,22,1596,1687,1832,145
2020,10,1,23,1636,1738,1822,84
2020,10,2,0,1658,1752,1793,41
2020,10,2,1,1647,1724,1717,-7
2020,10,2,2,1649,1713,1711,-2
2020,10,2,3,1649,1664,1594,-70
2020,10,2,4,1591,1576,1548,-28
2020,10,2,5,1495,1463,1489,26
2020,10,2,6,1391,1367,1415,48
2020,10,2,7,1317,1301,1398,97
2020,10,2,8,1271,1252,1394,142
2020,10,2,9,1244,1228,1420,192
2020,10,2,10,1230,1219,1432,213
2020,10,2,11,1240,1227,1427,200
2020,10,2,12,1278,1276,1462,186
2020,10,2,13,1356,1367,1463,96
2020,10,2,14,1392,1393,1496,103
2020,10,2,15,1396,1393,1603,210
2020,10,2,16,1392,1393,1651,258
2020,10,2,17,1393,1413,1701,288
2020,10,2,18,1418,1429,1775,346
2020,10,2,19,1452,1470,1780,310
2020,10,2,20,1501,1524,1754,230
2020,10,2,21,1564,1594,1788,194
2020,10,2,22,1614,1645,1807,162
2020,10,2,23,1666,1684,1907,223
2020,10,3,0,1681,1692,1807,115
2020,10,3,1,1669,1666,1748,82
2020,10,3,2,1673,1667,1758,91
2020,10,3,3,1650,1606,1756,150
2020,10,3,4,1583,1537,1640,103
2020,10,3,5,1494,1447,1674,227
2020,10,3,6,1400,1355,1686,331
2020,10,3,7,1329,1288,1635,347
2020,10,3,8,1282,1251,1596,345
2020,10,3,9,1251,1217,1565,348
2020,10,3,10,1232,1210,1551,341
2020,10,3,11,1232,1211,1527,316
2020,10,3,12,1244,1240,1563,323
2020,10,3,13,1272,1283,1554,271
2020,10,3,14,1287,1297,1554,257
2020,10,3,15,1292,1304,1637,333
2020,10,3,16,1294,1304,1689,385
2020,10,3,17,1299,1314,1784,470
2020,10,3,18,1329,1338,1742,404
2020,10,3,19,1369,1400,1769,369
2020,10,3,20,1416,1428,1765,337
2020,10,3,21,1470,1484,1796,312
2020,10,3,22,1539,1550,1867,317
2020,10,3,23,1612,1612,1903,291
2020,10,4,0,1650,1650,1859,209
2020,10,4,1,1639,1645,1813,168
2020,10,4,2,1643,1651,1764,113
2020,10,4,3,1618,1589,1755,166
2020,10,4,4,1557,1511,1734,223
2020,10,4,5,1465,1432,1627,195
2020,10,4,6,1382,1350,1581,231
2020,10,4,7,1314,1282,1537,255
2020,10,4,8,1278,1241,1470,229
2020,10,4,9,1244,1210,1448,238
2020,10,4,10,1228,1192,1417,225
2020,10,4,11,1227,1192,1404,212
2020,10,4,12,1238,1211,1418,207
2020,10,4,13,1262,1248,1421,173
2020,10,4,14,1274,1254,1467,213
2020,10,4,15,1295,1264,1586,322
2020,10,4,16,1299,1281,1626,345
2020,10,4,17,1303,1283,1554,271
2020,10,4,18,1322,1314,1566,252
2020,10,4,19,1352,1320,1581,261
2020,10,4,20,1395,1365,1613,248
2020,10,4,21,1446,1416,1702,286
2020,10,4,22,1495,1488,1688,200
2020,10,4,23,1551,1567,1663,96
2020,10,5,0,1594,1633,1542,-91
2020,10,5,1,1619,1633,1396,-237
2020,10,5,2,1639,1652,1420,-232
2020,10,5,3,1625,1590,1385,-205
2020,10,5,4,1570,1501,1381,-120
2020,10,5,5,1475,1399,1354,-45
2020,10,5,6,1377,1313,1326,13
2020,10,5,7,1303,1250,1283,33
2020,10,5,8,1266,1221,1125,-96
2020,10,5,9,1235,1203,1038,-165
2020,10,5,10,1222,1196,1029,-167
2020,10,5,11,1231,1205,1001,-204
2020,10,5,12,1276,1259,1026,-233
2020,10,5,13,1344,1345,1053,-292
2020,10,5,14,1390,1389,1141,-248
2020,10,5,15,1388,1390,1150,-240
2020,10,5,16,1379,1397,1197,-200
2020,10,5,17,1389,1408,1270,-138
2020,10,5,18,1424,1443,1289,-154
2020,10,5,19,1466,1492,1329,-163
2020,10,5,20,1527,1543,1340,-203
2020,10,5,21,1591,1624,1409,-215
2020,10,5,22,1656,1701,1505,-196
2020,10,5,23,1711,1757,1532,-225
2020,10,6,0,1736,1785,1469,-316
2020,10,6,1,1724,1746,1343,-403
2020,10,6,2,1711,1734,1370,-364
2020,10,6,3,1696,1663,1341,-322
2020,10,6,4,1618,1562,1269,-293
2020,10,6,5,1508,1450,1204,-246
2020,10,6,6,1403,1352,1111,-241
2020,10,6,7,1327,1291,1042,-249
2020,10,6,8,1275,1246,1066,-180
2020,10,6,9,1246,1226,1063,-163
2020,10,6,10,1229,1215,1038,-177
2020,10,6,11,1237,1227,1039,-188
2020,10,6,12,1281,1278,1029,-249
2020,10,6,13,1360,1368,1033,-335
2020,10,6,14,1401,1404,1028,-376
2020,10,6,15,1400,1396,1114,-282
2020,10,6,16,1380,1397,1137,-260
2020,10,6,17,1391,1405,1162,-243
2020,10,6,18,1418,1443,1231,-212
2020,10,6,19,1460,1487,1281,-206
2020,10,6,20,1528,1568,1242,-326
2020,10,6,21,1602,1652,1255,-397
2020,10,6,22,1674,1729,1310,-419
2020,10,6,23,1722,1793,1316,-477
2020,10,7,0,1743,1826,1226,-600
2020,10,7,1,1736,1788,1146,-642
2020,10,7,2,1723,1762,1172,-590
2020,10,7,3,1690,1686,1123,-563
2020,10,7,4,1609,1581,1107,-474
2020,10,7,5,1507,1468,1024,-444
2020,10,7,6,1389,1366,1028,-338
2020,10,7,7,1315,1297,1007,-290
2020,10,7,8,1287,1256,1040,-216
2020,10,7,9,1253,1226,1043,-183
2020,10,7,10,1236,1219,987,-232
2020,10,7,11,1243,1231,976,-255
2020,10,7,12,1288,1275,977,-298
2020,10,7,13,1367,1366,1023,-343
2020,10,7,14,1413,1403,1072,-331
2020,10,7,15,1417,1388,1118,-270
2020,10,7,16,1407,1385,1170,-215
2020,10,7,17,1416,1389,1199,-190
2020,10,7,18,1450,1425,1247,-178
2020,10,7,19,1500,1481,1275,-206
2020,10,7,20,1566,1545,1302,-243
2020,10,7,21,1643,1633,1312,-321
2020,10,7,22,1710,1706,1357,-349
2020,10,7,23,1763,1764,1357,-407
2020,10,8,0,1782,1798,1281,-517
2020,10,8,1,1758,1768,1259,-509
2020,10,8,2,1745,1737,1242,-495
2020,10,8,3,1706,1660,1200,-460
2020,10,8,4,1627,1570,1166,-404
2020,10,8,5,1517,1451,1140,-311
2020,10,8,6,1405,1343,1112,-231
2020,10,8,7,1331,1274,1048,-226
2020,10,8,8,1294,1236,1065,-171
2020,10,8,9,1261,1210,979,-231
2020,10,8,10,1244,1202,975,-227
2020,10,8,11,1252,1212,993,-219
2020,10,8,12,1296,1264,1037,-227
2020,10,8,13,1379,1356,1069,-287
2020,10,8,14,1419,1397,1108,-289
2020,10,8,15,1424,1389,1197,-192
2020,10,8,16,1419,1395,1221,-174
2020,10,8,17,1430,1401,1240,-161
2020,10,8,18,1458,1428,1260,-168
2020,10,8,19,1497,1476,1317,-159
2020,10,8,20,1559,1571,1403,-168
2020,10,8,21,1630,1631,1403,-228
2020,10,8,22,1703,1699,1444,-255
2020,10,8,23,1753,1771,1517,-254
2020,10,9,0,1780,1803,1512,-291
2020,10,9,1,1765,1774,1544,-230
2020,10,9,2,1764,1752,1552,-200
2020,10,9,3,1717,1684,1616,-68
2020,10,9,4,1636,1582,1587,5
2020,10,9,5,1535,1469,1531,62
2020,10,9,6,1426,1372,1570,198
2020,10,9,7,1344,1301,1556,255
2020,10,9,8,1292,1258,1551,293
2020,10,9,9,1261,1231,1572,341
2020,10,9,10,1245,1226,1543,317
2020,10,9,11,1253,1237,1485,248
2020,10,9,12,1292,1283,1484,201
2020,10,9,13,1365,1370,1471,101
2020,10,9,14,1410,1402,1549,147
2020,10,9,15,1416,1385,1600,215
2020,10,9,16,1410,1390,1676,286
2020,10,9,17,1416,1398,1711,313
2020,10,9,18,1445,1427,1668,241
2020,10,9,19,1479,1480,1731,251
2020,10,9,20,1536,1542,1737,195
2020,10,9,21,1606,1621,1779,158
2020,10,9,22,1666,1693,1807,114
2020,10,9,23,1706,1740,1824,84
2020,10,10,0,1730,1764,1735,-29
2020,10,10,1,1709,1738,1658,-80
2020,10,10,2,1698,1723,1614,-109
2020,10,10,3,1664,1649,1563,-86
2020,10,10,4,1595,1565,1497,-68
2020,10,10,5,1505,1467,1433,-34
2020,10,10,6,1414,1375,1395,20
2020,10,10,7,1340,1300,1398,98
2020,10,10,8,1288,1250,1446,196
2020,10,10,9,1256,1231,1461,230
2020,10,10,10,1235,1215,1444,229
2020,10,10,11,1234,1216,1429,213
2020,10,10,12,1248,1240,1426,186
2020,10,10,13,1280,1285,1437,152
2020,10,10,14,1300,1302,1393,91
2020,10,10,15,1299,1306,1451,145
2020,10,10,16,1306,1315,1504,189
2020,10,10,17,1309,1330,1527,197
2020,10,10,18,1330,1354,1552,198
2020,10,10,19,1359,1395,1636,241
2020,10,10,20,1411,1444,1630,186
2020,10,10,21,1472,1499,1654,155
2020,10,10,22,1541,1577,1700,123
2020,10,10,23,1621,1638,1845,207
2020,10,11,0,1651,1684,1859,175
2020,10,11,1,1654,1674,1806,132
2020,10,11,2,1657,1666,1809,143
2020,10,11,3,1625,1602,1776,174
2020,10,11,4,1558,1531,1664,133
2020,10,11,5,1473,1432,1562,130
2020,10,11,6,1388,1350,1501,151
2020,10,11,7,1313,1294,1513,219
2020,10,11,8,1280,1248,1525,277
2020,10,11,9,1246,1229,1492,263
2020,10,11,10,1228,1212,1474,262
2020,10,11,11,1227,1212,1463,251
2020,10,11,12,1240,1233,1456,223
2020,10,11,13,1270,1264,1459,195
2020,10,11,14,1278,1269,1489,220
2020,10,11,15,1299,1276,1574,298
2020,10,11,16,1300,1292,1641,349
2020,10,11,17,1305,1306,1639,333
2020,10,11,18,1327,1332,1704,372
2020,10,11,19,1359,1371,1751,380
2020,10,11,20,1411,1411,1804,393
2020,10,11,21,1450,1460,1952,492
2020,10,11,22,1511,1520,1989,469
2020,10,11,23,1565,1592,2019,427
2020,10,12,0,1604,1649,1870,221
2020,10,12,1,1626,1667,1869,202
2020,10,12,2,1641,1683,1822,139
2020,10,12,3,1616,1623,1768,145
2020,10,12,4,1554,1536,1739,203
2020,10,12,5,1456,1437,1628,191
2020,10,12,6,1366,1342,1609,267
2020,10,12,7,1291,1284,1623,339
2020,10,12,8,1254,1024,1332,308
2020,10,12,9,1229,977,1307,330
2020,10,12,10,1223,926,1237,311
2020,10,12,11,1232,985,1142,157
2020,10,12,12,1280,1064,1160,96
2020,10,12,13,1363,1094,1145,51
2020,10,12,14,1407,1110,1176,66
2020,10,12,15,1399,1105,1299,194
2020,10,12,16,1378,1127,1307,180
2020,10,12,17,1364,1142,1371,229
2020,10,12,18,1366,1153,1443,290
2020,10,12,19,1383,1205,1482,277
2020,10,12,20,1418,1245,1556,311
2020,10,12,21,1457,1284,1569,285
2020,10,12,22,1502,1307,1676,369
2020,10,12,23,1537,1309,1688,379
2020,10,13,0,1569,1367,1611,244
2020,10,13,1,1586,1372,1520,148
2020,10,13,2,1607,1375,1508,133
2020,10,13,3,1608,1325,1517,192
2020,10,13,4,1543,1224,1510,286
2020,10,13,5,1447,1173,1480,307
2020,10,13,6,1352,1066,1394,328
2020,10,13,7,1283,1055,1338,283
2020,10,13,8,1264,1022,1268,246
2020,10,13,9,1243,1010,1271,261
2020,10,13,10,1233,997,1208,211
2020,10,13,11,1243,1016,1208,192
2020,10,13,12,1291,1051,1166,115
2020,10,13,13,1376,1098,1197,99
2020,10,13,14,1419,1147,1313,166
2020,10,13,15,1406,1123,1436,313
2020,10,13,16,1375,1071,1437,366
2020,10,13,17,1354,1060,1459,399
2020,10,13,18,1364,1081,1469,388
2020,10,13,19,1391,1115,1485,370
2020,10,13,20,1440,1158,1475,317
2020,10,13,21,1501,1232,1510,278
2020,10,13,22,1561,1299,1655,356
2020,10,13,23,1615,1345,1770,425
2020,10,14,0,1648,1394,1713,319
2020,10,14,1,1650,1389,1637,248
2020,10,14,2,1659,1375,1673,298
2020,10,14,3,1639,1317,1585,268
2020,10,14,4,1566,1255,1549,294
2020,10,14,5,1464,1198,1481,283
2020,10,14,6,1365,1120,1328,208
2020,10,14,7,1300,1069,1320,251
2020,10,14,8,1268,1030,1338,308
2020,10,14,9,1247,1007,1334,327
2020,10,14,10,1234,994,1312,318
2020,10,14,11,1244,1027,1284,257
2020,10,14,12,1291,1137,1324,187
2020,10,14,13,1369,1241,1372,131
2020,10,14,14,1418,1287,1439,152
2020,10,14,15,1410,1271,1536,265
2020,10,14,16,1390,1260,1557,297
2020,10,14,17,1381,1261,1580,319
2020,10,14,18,1398,1287,1595,308
2020,10,14,19,1433,1306,1605,299
2020,10,14,20,1491,1353,1620,267
2020,10,14,21,1564,1432,1646,214
2020,10,14,22,1640,1446,1719,273
2020,10,14,23,1700,1461,1823,362
2020,10,15,0,1731,1447,1729,282
2020,10,15,1,1734,1427,1689,262
2020,10,15,2,1732,1408,1683,275
2020,10,15,3,1696,1346,1650,304
2020,10,15,4,1612,1283,1572,289
2020,10,15,5,1503,1234,1487,253
2020,10,15,6,1405,1149,1341,192
2020,10,15,7,1326,1085,1291,206
2020,10,15,8,1279,1251,1440,189
2020,10,15,9,1251,1235,1428,193
2020,10,15,10,1239,1226,1438,212
2020,10,15,11,1248,1234,1498,264
2020,10,15,12,1292,1286,1575,289
2020,10,15,13,1390,1376,1570,194
2020,10,15,14,1436,1425,1638,213
2020,10,15,15,1436,1407,1729,322
2020,10,15,16,1416,1389,1746,357
2020,10,15,17,1404,1390,1722,332
2020,10,15,18,1410,1409,1675,266
2020,10,15,19,1438,1445,1651,206
2020,10,15,20,1475,1476,1658,182
2020,10,15,21,1531,1531,1708,177
2020,10,15,22,1576,1595,1797,202
2020,10,15,23,1609,1641,1891,250
2020,10,16,0,1637,1701,1943,242
2020,10,16,1,1651,1698,1922,224
2020,10,16,2,1675,1689,1880,191
2020,10,16,3,1649,1626,1896,270
2020,10,16,4,1571,1539,1793,254
2020,10,16,5,1472,1445,1649,204
2020,10,16,6,1381,1357,1482,125
2020,10,16,7,1310,1323,1506,183
2020,10,16,8,1260,1249,1474,225
2020,10,16,9,1243,1224,1493,269
2020,10,16,10,1234,1226,1458,232
2020,10,16,11,1245,1243,1461,218
2020,10,16,12,1297,1296,1457,161
2020,10,16,13,1392,1383,1453,70
2020,10,16,14,1442,1437,1503,66
2020,10,16,15,1438,1524,1641,117
2020,10,16,16,1411,1404,1709,305
2020,10,16,17,1387,1390,1733,343
2020,10,16,18,1377,1382,1733,351
2020,10,16,19,1376,1384,1721,337
2020,10,16,20,1402,1403,1715,312
2020,10,16,21,1436,1428,1773,345
2020,10,16,22,1469,1471,1785,314
2020,10,16,23,1506,1516,1780,264
2020,10,17,0,1529,1549,1870,321
2020,10,17,1,1544,1564,1866,302
2020,10,17,2,1572,1577,1904,327
2020,10,17,3,1571,1548,1937,389
2020,10,17,4,1516,1485,1872,387
2020,10,17,5,1442,1407,1619,212
2020,10,17,6,1360,1346,1445,99
2020,10,17,7,1304,1285,1470,185
2020,10,17,8,1291,1248,1491,243
2020,10,17,9,1266,1229,1507,278
2020,10,17,10,1254,1218,1534,316
2020,10,17,11,1259,1220,1532,312
2020,10,17,12,1273,1248,1503,255
2020,10,17,13,1312,1300,1556,256
2020,10,17,14,1335,1319,1577,258
2020,10,17,15,1325,1315,1676,361
2020,10,17,16,1309,1306,1804,498
2020,10,17,17,1291,1297,1828,531
2020,10,17,18,1292,1306,1796,490
2020,10,17,19,1310,1323,1831,508
2020,10,17,20,1339,1339,1847,508
2020,10,17,21,1387,1384,1856,472
2020,10,17,22,1459,1445,1856,411
2020,10,17,23,1544,1511,1861,350
2020,10,18,0,1576,1569,1964,395
2020,10,18,1,1594,1599,1938,339
2020,10,18,2,1609,1606,1957,351
2020,10,18,3,1573,1548,1875,327
2020,10,18,4,1525,1480,1803,323
2020,10,18,5,1439,1403,1741,338
2020,10,18,6,1363,1319,1679,360
2020,10,18,7,1307,1263,1537,274
2020,10,18,8,1277,1214,1514,300
2020,10,18,9,1250,1195,1440,245
2020,10,18,10,1238,1180,1467,287
2020,10,18,11,1240,1179,1500,321
2020,10,18,12,1249,1211,1492,281
2020,10,18,13,1281,1250,1500,250
2020,10,18,14,1291,1271,1527,256
2020,10,18,15,1308,1280,1610,330
2020,10,18,16,1304,1286,1656,370
2020,10,18,17,1297,1288,1670,382
2020,10,18,18,1316,1306,1708,402
2020,10,18,19,1346,1339,1771,432
2020,10,18,20,1381,1377,1746,369
2020,10,18,21,1430,1421,1797,376
2020,10,18,22,1495,1484,1811,327
2020,10,18,23,1544,1557,1765,208
2020,10,19,0,1584,1625,1794,169
2020,10,19,1,1615,1651,1791,140
2020,10,19,2,1631,1649,1797,148
2020,10,19,3,1606,1583,1705,122
2020,10,19,4,1543,1500,1707,207
2020,10,19,5,1452,1407,1684,277
2020,10,19,6,1362,1307,1620,313
2020,10,19,7,1299,1252,1465,213
2020,10,19,8,1259,1222,1429,207
2020,10,19,9,1235,1200,1488,288
2020,10,19,10,1225,1193,1522,329
2020,10,19,11,1239,1209,1505,296
2020,10,19,12,1286,1267,1476,209
2020,10,19,13,1373,1364,1526,162
2020,10,19,14,1416,1421,1599,178
2020,10,19,15,1408,1410,1675,265
2020,10,19,16,1381,1404,1741,337
2020,10,19,17,1367,1392,1809,417
2020,10,19,18,1381,1416,1883,467
2020,10,19,19,1402,1442,1870,428
2020,10,19,20,1450,1475,1832,357
2020,10,19,21,1497,1534,1827,293
2020,10,19,22,1547,1583,1876,293
2020,10,19,23,1591,1651,1944,293
2020,10,20,0,1624,1686,1916,230
2020,10,20,1,1636,1684,1898,214
2020,10,20,2,1650,1665,1865,200
2020,10,20,3,1637,1602,1783,181
2020,10,20,4,1563,1508,1770,262
2020,10,20,5,1466,1406,1552,146
2020,10,20,6,1370,1320,1514,194
2020,10,20,7,1301,1258,1455,197
2020,10,20,8,1249,1224,1185,-39
2020,10,20,9,1224,1211,1036,-175
2020,10,20,10,1209,1204,1010,-194
2020,10,20,11,1225,1222,989,-233
2020,10,20,12,1280,1275,984,-291
2020,10,20,13,1373,1374,979,-395
2020,10,20,14,1425,1427,1036,-391
2020,10,20,15,1416,1407,1116,-291
2020,10,20,16,1383,1386,1175,-211
2020,10,20,17,1365,1378,1194,-184
2020,10,20,18,1368,1399,1173,-226
2020,10,20,19,1399,1427,1211,-216
2020,10,20,20,1442,1463,1208,-255
2020,10,20,21,1493,1519,1234,-285
2020,10,20,22,1553,1577,1343,-234
2020,10,20,23,1598,1629,1389,-240
2020,10,21,0,1629,1670,1357,-313
2020,10,21,1,1648,1670,1292,-378
2020,10,21,2,1656,1659,1262,-397
2020,10,21,3,1632,1596,1256,-340
2020,10,21,4,1558,1504,1226,-278
2020,10,21,5,1460,1403,1160,-243
2020,10,21,6,1362,1305,1146,-159
2020,10,21,7,1296,1250,1119,-131
2020,10,21,8,1256,1215,1126,-89
2020,10,21,9,1240,1198,1081,-117
2020,10,21,10,1226,1196,974,-222
2020,10,21,11,1242,1212,975,-237
2020,10,21,12,1292,1264,966,-298
2020,10,21,13,1386,1370,944,-426
2020,10,21,14,1437,1421,912,-509
2020,10,21,15,1430,1399,1028,-371
2020,10,21,16,1400,1386,1113,-273
2020,10,21,17,1375,1371,1143,-228
2020,10,21,18,1385,1379,1191,-188
2020,10,21,19,1400,1411,1281,-130
2020,10,21,20,1444,1446,1331,-115
2020,10,21,21,1495,1495,1344,-151
2020,10,21,22,1546,1552,1288,-264
2020,10,21,23,1599,1601,1223,-378
2020,10,22,0,1625,1637,1175,-462
2020,10,22,1,1641,1650,1186,-464
2020,10,22,2,1653,1627,1234,-393
2020,10,22,3,1629,1571,1198,-373
2020,10,22,4,1548,1494,1080,-414
2020,10,22,5,1454,1398,1023,-375
2020,10,22,6,1361,1313,1028,-285
2020,10,22,7,1294,1258,1015,-243
2020,10,22,8,1258,1219,952,-267
2020,10,22,9,1234,1201,910,-291
2020,10,22,10,1226,1194,911,-283
2020,10,22,11,1239,1216,857,-359
2020,10,22,12,1284,1269,893,-376
2020,10,22,13,1379,1369,921,-448
2020,10,22,14,1435,1420,956,-464
2020,10,22,15,1431,1414,1013,-401
2020,10,22,16,1397,1389,935,-454
2020,10,22,17,1380,1387,1084,-303
2020,10,22,18,1388,1391,1183,-208
2020,10,22,19,1402,1418,1212,-206
2020,10,22,20,1441,1456,1222,-234
2020,10,22,21,1494,1491,1263,-228
2020,10,22,22,1539,1541,1302,-239
2020,10,22,23,1583,1581,1332,-249
2020,10,23,0,1612,1613,1194,-419
2020,10,23,1,1619,1631,1100,-531
2020,10,23,2,1641,1605,1065,-540
2020,10,23,3,1614,1555,1040,-515
2020,10,23,4,1544,1495,989,-506
2020,10,23,5,1456,1401,868,-533
2020,10,23,6,1365,1315,848,-467
2020,10,23,7,1295,1255,858,-397
2020,10,23,8,1252,1216,913,-303
2020,10,23,9,1232,1199,930,-269
2020,10,23,10,1225,1199,876,-323
2020,10,23,11,1239,1215,914,-301
2020,10,23,12,1286,1264,923,-341
2020,10,23,13,1379,1359,968,-391
2020,10,23,14,1437,1413,984,-429
2020,10,23,15,1440,1402,1063,-339
2020,10,23,16,1407,1379,1090,-289
2020,10,23,17,1379,1376,1125,-251
2020,10,23,18,1371,1370,1122,-248
2020,10,23,19,1382,1386,1146,-240
2020,10,23,20,1401,1403,1207,-196
2020,10,23,21,1426,1426,1142,-284
2020,10,23,22,1455,1459,1164,-295
2020,10,23,23,1498,1498,1138,-360
2020,10,24,0,1519,1528,1027,-501
2020,10,24,1,1545,1562,973,-589
2020,10,24,2,1563,1568,1008,-560
2020,10,24,3,1559,1551,997,-554
2020,10,24,4,1503,1525,945,-580
2020,10,24,5,1432,1491,913,-578
2020,10,24,6,1363,1334,806,-528
2020,10,24,7,1303,1284,750,-534
2020,10,24,8,1278,1247,744,-503
2020,10,24,9,1254,1225,766,-459
2020,10,24,10,1242,1214,824,-390
2020,10,24,11,1250,1219,828,-391
2020,10,24,12,1268,1188,840,-348
2020,10,24,13,1309,1296,902,-394
2020,10,24,14,1338,1343,931,-412
2020,10,24,15,1333,1325,996,-329
2020,10,24,16,1316,1310,1111,-199
2020,10,24,17,1291,1286,1141,-145
2020,10,24,18,1277,1273,1158,-115
2020,10,24,19,1285,1274,1140,-134
2020,10,24,20,1303,1297,1053,-244
2020,10,24,21,1343,1329,1140,-189
2020,10,24,22,1393,1350,1229,-121
2020,10,24,23,1480,1408,1259,-149
2020,10,25,0,1522,1475,1239,-236
2020,10,25,1,1555,1540,1177,-363
2020,10,25,2,1582,1559,960,-599
2020,10,25,3,1555,1504,951,-553
2020,10,25,4,1503,1448,917,-531
2020,10,25,5,1432,1377,903,-474
2020,10,25,6,1360,1309,936,-373
2020,10,25,7,1296,1251,835,-416
2020,10,25,8,1265,1216,751,-465
2020,10,25,9,1238,1192,683,-509
2020,10,25,10,1228,1179,611,-568
2020,10,25,11,1228,1178,617,-561
2020,10,25,12,1243,1192,664,-528
2020,10,25,13,1275,1232,697,-535
2020,10,25,14,1294,1298,819,-479
2020,10,25,15,1318,1293,1141,-152
2020,10,25,16,1319,1321,1356,35
2020,10,25,17,1309,1346,1534,188
2020,10,25,18,1318,1368,1715,347
2020,10,25,19,1346,1371,1762,391
2020,10,25,20,1367,1385,1758,373
2020,10,25,21,1404,1402,1729,327
2020,10,25,22,1441,1424,1660,236
2020,10,25,23,1486,1451,1622,171
2020,10,26,0,1518,1491,1682,191
2020,10,26,1,1555,1557,1732,175
2020,10,26,2,1593,1564,1783,219
2020,10,26,3,1582,1527,1801,274
2020,10,26,4,1517,1462,1796,334
2020,10,26,5,1437,1381,1748,367
2020,10,26,6,1350,1306,1607,301
2020,10,26,7,1291,1257,1450,193
2020,10,26,8,1270,1231,1380,149
2020,10,26,9,1245,1227,1311,84
2020,10,26,10,1245,1233,1309,76
2020,10,26,11,1258,1265,1366,101
2020,10,26,12,1308,1325,1375,50
2020,10,26,13,1397,1434,1371,-63
2020,10,26,14,1468,1519,1331,-188
2020,10,26,15,1491,1566,1364,-202
2020,10,26,16,1469,1604,1376,-228
2020,10,26,17,1437,1642,1352,-290
2020,10,26,18,1428,1700,1260,-440
2020,10,26,19,1426,1731,1257,-474
2020,10,26,20,1423,1729,1218,-511
2020,10,26,21,1432,1733,1199,-534
2020,10,26,22,1451,1726,1151,-575
2020,10,26,23,1486,1738,1165,-573
2020,10,27,0,1528,1775,1313,-462
2020,10,27,1,1599,1841,1598,-243
2020,10,27,2,1649,1839,1641,-198
2020,10,27,3,1658,1810,1598,-212
2020,10,27,4,1610,1734,1496,-238
2020,10,27,5,1535,1638,1483,-155
2020,10,27,6,1449,1544,1356,-188
2020,10,27,7,1391,1488,1006,-482
2020,10,27,8,1471,1459,1288,-171
2020,10,27,9,1454,1450,1246,-204
2020,10,27,10,1453,1465,990,-475
2020,10,27,11,1466,1471,957,-514
2020,10,27,12,1508,1526,930,-596
2020,10,27,13,1590,1609,955,-654
2020,10,27,14,1686,1700,916,-784
2020,10,27,15,1707,1720,962,-758
2020,10,27,16,1666,1744,871,-873
2020,10,27,17,1622,1747,801,-946
2020,10,27,18,1603,1729,791,-938
2020,10,27,19,1586,1713,883,-830
2020,10,27,20,1573,1682,950,-732
2020,10,27,21,1570,1707,993,-714
2020,10,27,22,1580,1660,1025,-635
2020,10,27,23,1605,1656,989,-667
2020,10,28,0,1644,1700,934,-766
2020,10,28,1,1719,1786,955,-831
2020,10,28,2,1787,1788,1017,-771
2020,10,28,3,1799,1752,998,-754
2020,10,28,4,1772,1685,1005,-680
2020,10,28,5,1691,1596,954,-642
2020,10,28,6,1598,1516,1000,-516
2020,10,28,7,1532,1466,1022,-444
2020,10,28,8,1495,1450,889,-561
2020,10,28,9,1479,1432,808,-624
2020,10,28,10,1479,1440,834,-606
2020,10,28,11,1492,1460,826,-634
2020,10,28,12,1534,1515,840,-675
2020,10,28,13,1619,1610,925,-685
2020,10,28,14,1710,1688,973,-715
2020,10,28,15,1717,1711,1009,-702
2020,10,28,16,1662,1695,1021,-674
2020,10,28,17,1617,1674,990,-684
2020,10,28,18,1580,1666,1020,-646
2020,10,28,19,1553,1627,994,-633
2020,10,28,20,1533,1595,973,-622
2020,10,28,21,1530,1556,1175,-381
2020,10,28,22,1528,1531,1112,-419
2020,10,28,23,1547,1532,1062,-470
2020,10,29,0,1578,1570,1060,-510
2020,10,29,1,1638,1669,1212,-457
2020,10,29,2,1725,1710,1311,-399
2020,10,29,3,1744,1709,1249,-460
2020,10,29,4,1721,1645,1187,-458
2020,10,29,5,1652,1558,1044,-514
2020,10,29,6,1566,1490,970,-520
2020,10,29,7,1502,1452,915,-537
2020,10,29,8,1444,1413,899,-514
2020,10,29,9,1425,1401,863,-538
2020,10,29,10,1418,1405,841,-564
2020,10,29,11,1437,1434,872,-562
2020,10,29,12,1485,1503,916,-587
2020,10,29,13,1583,1603,983,-620
2020,10,29,14,1673,1663,951,-712
2020,10,29,15,1664,1644,987,-657
2020,10,29,16,1604,1590,968,-622
2020,10,29,17,1545,1542,919,-623
2020,10,29,18,1499,1503,915,-588
2020,10,29,19,1472,1460,924,-536
2020,10,29,20,1444,1416,935,-481
2020,10,29,21,1441,1395,967,-428
2020,10,29,22,1438,1388,1020,-368
2020,10,29,23,1458,1419,993,-426
2020,10,30,0,1494,1474,967,-507
2020,10,30,1,1544,1564,1122,-442
2020,10,30,2,1623,1590,1261,-329
2020,10,30,3,1645,1592,1222,-370
2020,10,30,4,1623,1550,1181,-369
2020,10,30,5,1563,1477,1162,-315
2020,10,30,6,1483,1407,1141,-266
2020,10,30,7,1419,1364,1152,-212
2020,10,30,8,1368,1346,1174,-172
2020,10,30,9,1349,1331,1146,-185
2020,10,30,10,1343,1330,1120,-210
2020,10,30,11,1369,1343,1181,-162
2020,10,30,12,1411,1418,1131,-287
2020,10,30,13,1505,1524,1180,-344
2020,10,30,14,1591,1589,1211,-378
2020,10,30,15,1603,1567,1235,-332
2020,10,30,16,1559,1510,1191,-319
2020,10,30,17,1507,1457,1103,-354
2020,10,30,18,1469,1413,1047,-366
2020,10,30,19,1439,1387,1017,-370
2020,10,30,20,1417,1368,1019,-349
2020,10,30,21,1410,1368,1067,-301
2020,10,30,22,1410,1374,1096,-278
2020,10,30,23,1429,1410,1061,-349
2020,10,31,0,1459,1451,1138,-313
2020,10,31,1,1499,1534,1238,-296
2020,10,31,2,1556,1553,1332,-221
2020,10,31,3,1587,1543,1261,-282
2020,10,31,4,1565,1509,1215,-294
2020,10,31,5,1513,1456,1210,-246
2020,10,31,6,1442,1389,1175,-214
2020,10,31,7,1388,1343,1192,-151
2020,10,31,8,1347,1317,1069,-248
2020,10,31,9,1330,1297,1021,-276
2020,10,31,10,1322,1294,1032,-262
2020,10,31,11,1329,1317,1085,-232
2020,10,31,12,1351,1339,1075,-264
2020,10,31,13,1408,1391,1091,-300
2020,10,31,14,1446,1440,1110,-330
2020,10,31,15,1426,1435,1148,-287
2020,10,31,16,1412,1401,1167,-234
2020,10,31,17,1378,1352,1145,-207
2020,10,31,18,1360,1328,1236,-92
2020,10,31,19,1345,1316,1297,-19
2020,10,31,20,1337,1299,1265,-34
2020,10,31,21,1333,1303,1283,-20
2020,10,31,22,1349,1312,1198,-114
2020,10,31,23,1392,1358,1009,-349
2020,11,1,0,1436,1424,916,-508
2020,11,1,1,1495,1489,900,-589
2020,11,1,2,1545,1506,915,-591
2020,11,1,3,1553,1480,836,-644
2020,11,1,4,1520,1441,829,-612
2020,11,1,5,1474,1382,815,-567
2020,11,1,6,1410,1326,944,-382
2020,11,1,7,1357,1289,1039,-250
2020,11,1,8,1328,1275,1038,-237
2020,11,1,9,1305,1260,1053,-207
2020,11,1,10,1300,1232,988,-244
2020,11,1,11,1304,1228,811,-417
2020,11,1,12,1327,1251,806,-445
2020,11,1,13,1364,1299,764,-535
2020,11,1,14,1391,1324,699,-625
2020,11,1,15,1412,1328,781,-547
2020,11,1,16,1405,1321,855,-466
2020,11,1,17,1388,1312,904,-408
2020,11,1,18,1380,1310,894,-416
2020,11,1,19,1378,1315,904,-411
2020,11,1,20,1377,1309,994,-315
2020,11,1,21,1399,1315,1016,-299
2020,11,1,22,1427,1328,1087,-241
2020,11,1,23,1469,1363,1028,-335
2020,11,2,0,1535,1422,960,-462
2020,11,2,1,1590,1527,1044,-483
2020,11,2,2,1598,1551,1028,-523
2020,11,2,3,1548,1529,965,-564
2020,11,2,4,1475,1491,909,-582
2020,11,2,5,1437,1431,881,-550
2020,11,2,6,1393,1353,880,-473
2020,11,2,7,1338,1296,875,-421
2020,11,2,8,1312,1272,877,-395
2020,11,2,9,1293,1258,863,-395
2020,11,2,10,1292,1261,815,-446
2020,11,2,11,1305,1271,825,-446
2020,11,2,12,1352,1312,852,-460
2020,11,2,13,1439,1383,862,-521
2020,11,2,14,1518,1460,911,-549
2020,11,2,15,1526,1462,1019,-443
2020,11,2,16,1492,1431,1018,-413
2020,11,2,17,1467,1396,992,-404
2020,11,2,18,1464,1380,1033,-347
2020,11,2,19,1456,1385,1063,-322
2020,11,2,20,1454,1389,1095,-294
2020,11,2,21,1474,1394,1081,-313
2020,11,2,22,1494,1411,1057,-354
2020,11,2,23,1522,1439,981,-458
2020,11,3,0,1574,1470,940,-530
2020,11,3,1,1606,1567,1034,-533
2020,11,3,2,1597,1590,1098,-492
2020,11,3,3,1550,1553,1104,-449
2020,11,3,4,1474,1524,1062,-462
2020,11,3,5,1430,1464,1074,-390
2020,11,3,6,1387,1395,1065,-330
2020,11,3,7,1321,1334,1025,-309
2020,11,3,8,1295,1302,1072,-230
2020,11,3,9,1271,1284,1005,-279
2020,11,3,10,1264,1274,981,-293
2020,11,3,11,1274,1278,1003,-275
2020,11,3,12,1315,1307,990,-317
2020,11,3,13,1398,1380,1061,-319
2020,11,3,14,1491,1450,1105,-345
2020,11,3,15,1492,1447,1123,-324
2020,11,3,16,1467,1421,1072,-349
2020,11,3,17,1450,1402,1064,-338
2020,11,3,18,1452,1364,1041,-323
2020,11,3,19,1455,1354,1004,-350
2020,11,3,20,1457,1363,1035,-328
2020,11,3,21,1477,1375,1013,-362
2020,11,3,22,1491,1394,1050,-344
2020,11,3,23,1515,1425,1026,-399
2020,11,4,0,1554,1473,1043,-430
2020,11,4,1,1619,1563,1209,-354
2020,11,4,2,1608,1587,1277,-310
2020,11,4,3,1581,1547,1143,-404
2020,11,4,4,1541,1532,1180,-352
2020,11,4,5,1469,1478,1180,-298
2020,11,4,6,1377,1406,1091,-315
2020,11,4,7,1307,1345,1042,-303
2020,11,4,8,1313,1309,1076,-233
2020,11,4,9,1287,1282,1035,-247
2020,11,4,10,1274,1266,975,-291
2020,11,4,11,1278,1266,993,-273
2020,11,4,12,1315,1290,946,-344
2020,11,4,13,1386,1346,829,-517
2020,11,4,14,1466,1431,877,-554
2020,11,4,15,1475,1444,961,-483
2020,11,4,16,1456,1398,987,-411
2020,11,4,17,1448,1373,978,-395
2020,11,4,18,1455,1360,988,-372
2020,11,4,19,1472,1368,1110,-258
2020,11,4,20,1490,1408,1308,-100
2020,11,4,21,1514,1413,1205,-208
2020,11,4,22,1539,1422,1165,-257
2020,11,4,23,1569,1465,1199,-266
2020,11,5,0,1595,1506,1191,-315
2020,11,5,1,1651,1593,1136,-457
2020,11,5,2,1652,1595,1129,-466
2020,11,5,3,1618,1550,1179,-371
2020,11,5,4,1571,1505,1274,-231
2020,11,5,5,1498,1438,1299,-139
2020,11,5,6,1408,1361,1340,-21
2020,11,5,7,1335,1292,1440,148
2020,11,5,8,1332,1258,1446,188
2020,11,5,9,1300,1238,1395,157
2020,11,5,10,1285,1236,1397,161
2020,11,5,11,1286,1244,1290,46
2020,11,5,12,1314,1270,1371,101
2020,11,5,13,1375,1335,1422,87
2020,11,5,14,1460,1416,1388,-28
2020,11,5,15,1474,1421,1456,35
2020,11,5,16,1467,1391,1438,47
2020,11,5,17,1466,1374,1474,100
2020,11,5,18,1467,1369,1502,133
2020,11,5,19,1481,1375,1526,151
2020,11,5,20,1498,1391,1545,154
2020,11,5,21,1521,1433,1550,117
2020,11,5,22,1542,1453,1493,40
2020,11,5,23,1565,1493,1504,11
2020,11,6,0,1599,1506,1486,-20
2020,11,6,1,1652,1579,1537,-42
2020,11,6,2,1650,1586,1560,-26
2020,11,6,3,1619,1559,1525,-34
2020,11,6,4,1585,1528,1523,-5
2020,11,6,5,1518,1463,1419,-44
2020,11,6,6,1426,1381,1401,20
2020,11,6,7,1354,1305,1452,147
2020,11,6,8,1302,1260,1460,200
2020,11,6,9,1278,1243,1484,241
2020,11,6,10,1268,1242,1537,295
2020,11,6,11,1273,1244,1558,314
2020,11,6,12,1301,1265,1517,252
2020,11,6,13,1363,1319,1519,200
2020,11,6,14,1444,1401,1567,166
2020,11,6,15,1461,1413,1721,308
2020,11,6,16,1442,1393,1821,428
2020,11,6,17,1433,1377,1931,554
2020,11,6,18,1427,1370,1969,599
2020,11,6,19,1444,1394,2163,769
2020,11,6,20,1462,1411,2273,862
2020,11,6,21,1480,1415,2332,917
2020,11,6,22,1490,1428,2346,918
2020,11,6,23,1520,1446,2290,844
2020,11,7,0,1552,1437,2258,821
2020,11,7,1,1613,1554,2167,613
2020,11,7,2,1607,1571,2092,521
2020,11,7,3,1572,1517,1969,452
2020,11,7,4,1530,1522,1996,474
2020,11,7,5,1476,1479,1971,492
2020,11,7,6,1403,1405,1979,574
2020,11,7,7,1340,1334,1850,516
2020,11,7,8,1305,1299,1832,533
2020,11,7,9,1277,1271,1833,562
2020,11,7,10,1262,1251,1835,584
2020,11,7,11,1253,1238,1864,626
2020,11,7,12,1259,1246,1769,523
2020,11,7,13,1279,1275,1853,578
2020,11,7,14,1334,1290,1860,570
2020,11,7,15,1361,1300,1934,634
2020,11,7,16,1360,1310,2023,713
2020,11,7,17,1362,1319,2076,757
2020,11,7,18,1364,1382,2231,849
2020,11,7,19,1373,1422,2307,885
2020,11,7,20,1382,1426,2299,873
2020,11,7,21,1402,1438,2290,852
2020,11,7,22,1420,1452,2317,865
2020,11,7,23,1457,1470,2326,856
2020,11,8,0,1511,1491,2180,689
2020,11,8,1,1586,1582,2254,672
2020,11,8,2,1585,1589,2260,671
2020,11,8,3,1552,1563,2197,634
2020,11,8,4,1510,1528,2264,736
2020,11,8,5,1455,1476,2230,754
2020,11,8,6,1390,1409,2225,816
2020,11,8,7,1329,1350,2164,814
2020,11,8,8,1291,1301,2056,755
2020,11,8,9,1261,1268,2027,759
2020,11,8,10,1254,1256,2030,774
2020,11,8,11,1252,1239,1997,758
2020,11,8,12,1250,1214,1889,675
2020,11,8,13,1260,1244,1972,728
2020,11,8,14,1328,1278,1932,654
2020,11,8,15,1382,1295,1960,665
2020,11,8,16,1398,1297,1886,589
2020,11,8,17,1416,1281,1971,690
2020,11,8,18,1405,1289,1937,648
2020,11,8,19,1416,1312,2081,769
2020,11,8,20,1424,1331,2131,800
2020,11,8,21,1455,1325,2070,745
2020,11,8,22,1454,1347,2041,694
2020,11,8,23,1496,1394,2110,716
2020,11,9,0,1526,1464,2198,734
2020,11,9,1,1622,1596,2280,684
2020,11,9,2,1631,1630,2287,657
2020,11,9,3,1615,1595,2190,595
2020,11,9,4,1568,1559,2150,591
2020,11,9,5,1500,1496,2186,690
2020,11,9,6,1413,1416,2141,725
2020,11,9,7,1333,1363,1973,610
2020,11,9,8,1312,1295,1921,626
2020,11,9,9,1292,1275,1892,617
2020,11,9,10,1285,1270,1876,606
2020,11,9,11,1291,1273,1888,615
2020,11,9,12,1311,1299,1901,602
2020,11,9,13,1367,1364,1848,484
2020,11,9,14,1484,1453,1902,449
2020,11,9,15,1537,1472,1900,428
2020,11,9,16,1530,1455,1938,483
2020,11,9,17,1536,1443,1920,477
2020,11,9,18,1527,1442,2051,609
2020,11,9,19,1536,1448,2119,671
2020,11,9,20,1546,1450,2148,698
2020,11,9,21,1568,1464,2152,688
2020,11,9,22,1557,1490,2193,703
2020,11,9,23,1584,1509,2217,708
2020,11,10,0,1632,1563,2154,591
2020,11,10,1,1729,1703,2213,510
2020,11,10,2,1723,1712,2261,549
2020,11,10,3,1714,1685,2225,540
2020,11,10,4,1674,1663,2235,572
2020,11,10,5,1595,1605,2241,636
2020,11,10,6,1496,1529,2248,719
2020,11,10,7,1412,1470,2128,658
2020,11,10,8,1437,1426,2004,578
2020,11,10,9,1420,1409,1991,582
2020,11,10,10,1410,1404,2033,629
2020,11,10,11,1417,1410,2046,636
2020,11,10,12,1445,1430,2053,623
2020,11,10,13,1521,1489,1997,508
2020,11,10,14,1637,1583,1923,340
2020,11,10,15,1643,1586,1943,357
2020,11,10,16,1595,1539,1885,346
2020,11,10,17,1553,1509,1805,296
2020,11,10,18,1524,1471,1778,307
2020,11,10,19,1507,1462,1789,327
2020,11,10,20,1498,1443,1812,369
2020,11,10,21,1481,1428,1847,419
2020,11,10,22,1480,1442,2007,565
2020,11,10,23,1510,1469,2031,562
2020,11,11,0,1581,1554,2022,468
2020,11,11,1,1716,1742,2164,422
2020,11,11,2,1764,1738,2164,426
2020,11,11,3,1724,1720,2159,439
2020,11,11,4,1706,1701,2152,451
2020,11,11,5,1646,1644,2114,470
2020,11,11,6,1556,1562,2023,461
2020,11,11,7,1493,1498,1955,457
2020,11,11,8,1469,1443,1868,425
2020,11,11,9,1447,1430,1893,463
2020,11,11,10,1442,1419,1829,410
2020,11,11,11,1448,1411,1798,387
2020,11,11,12,1468,1438,1861,423
2020,11,11,13,1539,1494,1907,413
2020,11,11,14,1647,1569,1947,378
2020,11,11,15,1648,1575,1999,424
2020,11,11,16,1592,1532,1929,397
2020,11,11,17,1537,1487,1740,253
2020,11,11,18,1495,1448,1687,239
2020,11,11,19,1467,1394,1649,255
2020,11,11,20,1444,1401,1788,387
2020,11,11,21,1437,1388,1836,448
2020,11,11,22,1441,1405,1863,458
2020,11,11,23,1473,1435,1856,421
2020,11,12,0,1538,1504,1747,243
2020,11,12,1,1675,1635,2070,435
2020,11,12,2,1712,1677,2119,442
2020,11,12,3,1692,1672,2018,346
2020,11,12,4,1674,1651,2101,450
2020,11,12,5,1626,1610,2208,598
2020,11,12,6,1549,1534,2169,635
2020,11,12,7,1484,1460,2075,615
2020,11,12,8,1467,1425,2080,655
2020,11,12,9,1448,1411,2153,742
2020,11,12,10,1432,1397,2167,770
2020,11,12,11,1430,1406,2183,777
2020,11,12,12,1461,1441,2212,771
2020,11,12,13,1524,1520,2304,784
2020,11,12,14,1626,1611,2397,786
2020,11,12,15,1624,1627,2346,719
2020,11,12,16,1564,1576,2164,588
2020,11,12,17,1521,1522,2091,569
2020,11,12,18,1477,1486,2151,665
2020,11,12,19,1462,1471,2255,784
2020,11,12,20,1449,1460,2289,829
2020,11,12,21,1452,1445,2264,819
2020,11,12,22,1458,1441,2182,741
2020,11,12,23,1477,1458,2056,598
2020,11,13,0,1536,1519,2114,595
2020,11,13,1,1734,1644,2201,557
2020,11,13,2,1690,1674,2184,510
2020,11,13,3,1693,1653,2192,539
2020,11,13,4,1680,1636,2164,528
2020,11,13,5,1632,1601,2075,474
2020,11,13,6,1556,1522,1968,446
2020,11,13,7,1493,1451,1887,436
2020,11,13,8,1434,1399,1994,595
2020,11,13,9,1416,1371,1995,624
2020,11,13,10,1393,1365,1959,594
2020,11,13,11,1401,1369,1841,472
2020,11,13,12,1428,1393,1756,363
2020,11,13,13,1491,1448,1726,278
2020,11,13,14,1582,1561,1761,200
2020,11,13,15,1583,1609,1762,153
2020,11,13,16,1528,1606,1774,168
2020,11,13,17,1478,1568,1812,244
2020,11,13,18,1440,1496,1731,235
2020,11,13,19,1406,1464,1719,255
2020,11,13,20,1403,1432,1739,307
2020,11,13,21,1397,1413,1760,347
2020,11,13,22,1402,1413,1740,327
2020,11,13,23,1427,1431,1755,324
2020,11,14,0,1489,1484,1852,368
2020,11,14,1,1606,1614,2013,399
2020,11,14,2,1637,1655,2141,486
2020,11,14,3,1617,1625,2167,542
2020,11,14,4,1607,1611,2170,559
2020,11,14,5,1582,1572,2143,571
2020,11,14,6,1523,1517,2083,566
2020,11,14,7,1456,1438,2067,629
2020,11,14,8,1426,1414,2038,624
2020,11,14,9,1396,1385,2019,634
2020,11,14,10,1379,1371,1986,615
2020,11,14,11,1376,1356,1976,620
2020,11,14,12,1382,1369,2001,632
2020,11,14,13,1417,1412,2023,611
2020,11,14,14,1464,1459,2040,581
2020,11,14,15,1469,1467,2113,646
2020,11,14,16,1447,1447,2193,746
2020,11,14,17,1413,1373,2109,736
2020,11,14,18,1385,1393,2117,724
2020,11,14,19,1377,1376,2108,732
2020,11,14,20,1372,1376,2108,732
2020,11,14,21,1360,1376,2128,752
2020,11,14,22,1362,1381,2151,770
2020,11,14,23,1396,1414,2146,732
2020,11,15,0,1467,1505,2228,723
2020,11,15,1,1584,1640,2264,624
2020,11,15,2,1646,1655,2183,528
2020,11,15,3,1621,1636,2179,543
2020,11,15,4,1597,1604,2079,475
2020,11,15,5,1572,1542,1926,384
2020,11,15,6,1521,1482,1978,496
2020,11,15,7,1464,1419,1990,571
2020,11,15,8,1420,1382,1905,523
2020,11,15,9,1396,1366,1820,454
2020,11,15,10,1387,1359,1826,467
2020,11,15,11,1390,1365,1879,514
2020,11,15,12,1390,1380,1764,384
2020,11,15,13,1415,1425,1366,-59
2020,11,15,14,1463,1465,1377,-88
2020,11,15,15,1471,1457,1366,-91
2020,11,15,16,1448,1418,1486,68
2020,11,15,17,1418,1397,1529,132
2020,11,15,18,1389,1374,1709,335
2020,11,15,19,1376,1354,1788,434
2020,11,15,20,1369,1349,1885,536
2020,11,15,21,1356,1343,1865,522
2020,11,15,22,1362,1355,1867,512
2020,11,15,23,1394,1393,1911,518
2020,11,16,0,1463,1470,1843,373
2020,11,16,1,1588,1604,1859,255
2020,11,16,2,1646,1636,1890,254
2020,11,16,3,1636,1604,1690,86
2020,11,16,4,1616,1576,1672,96
2020,11,16,5,1566,1533,1715,182
2020,11,16,6,1496,1453,1752,299
2020,11,16,7,1430,1391,1703,312
2020,11,16,8,1378,1346,1671,325
2020,11,16,9,1358,1334,1633,299
2020,11,16,10,1354,1325,1579,254
2020,11,16,11,1363,1331,1577,246
2020,11,16,12,1396,1365,1585,220
2020,11,16,13,1475,1437,1592,155
2020,11,16,14,1567,1531,1624,93
2020,11,16,15,1566,1543,1823,280
2020,11,16,16,1509,1491,1761,270
2020,11,16,17,1464,1437,1701,264
2020,11,16,18,1429,1407,1675,268
2020,11,16,19,1425,1385,1627,242
2020,11,16,20,1420,1380,1569,189
2020,11,16,21,1422,1378,1447,69
2020,11,16,22,1427,1392,1392,0
2020,11,16,23,1455,1440,1456,16
2020,11,17,0,1501,1539,1406,-133
2020,11,17,1,1600,1666,1498,-168
2020,11,17,2,1634,1640,1472,-168
2020,11,17,3,1625,1605,1542,-63
2020,11,17,4,1604,1581,1548,-33
2020,11,17,5,1547,1514,1527,13
2020,11,17,6,1464,1450,1514,64
2020,11,17,7,1393,1381,1498,117
2020,11,17,8,1349,1337,1467,130
2020,11,17,9,1331,1327,1384,57
2020,11,17,10,1324,1333,1357,24
2020,11,17,11,1333,1343,1313,-30
2020,11,17,12,1370,1379,1294,-85
2020,11,17,13,1457,1456,1314,-142
2020,11,17,14,1548,1540,1415,-125
2020,11,17,15,1546,1539,1466,-73
2020,11,17,16,1489,1450,1463,13
2020,11,17,17,1440,1380,1531,151
2020,11,17,18,1407,1353,1661,308
2020,11,17,19,1393,1334,1734,400
2020,11,17,20,1393,1333,1827,494
2020,11,17,21,1391,1347,1846,499
2020,11,17,22,1404,1372,1828,456
2020,11,17,23,1431,1421,1899,478
2020,11,18,0,1486,1514,1818,304
2020,11,18,1,1603,1638,1895,257
2020,11,18,2,1633,1649,1931,282
2020,11,18,3,1614,1615,1877,262
2020,11,18,4,1590,1586,1823,237
2020,11,18,5,1528,1534,1749,215
2020,11,18,6,1443,1448,1672,224
2020,11,18,7,1372,1383,1658,275
2020,11,18,8,1319,1355,1702,347
2020,11,18,9,1301,1335,1818,483
2020,11,18,10,1292,1332,1864,532
2020,11,18,11,1300,1332,1869,537
2020,11,18,12,1336,1358,1808,450
2020,11,18,13,1415,1426,1839,413
2020,11,18,14,1497,1492,1741,249
2020,11,18,15,1504,1511,1761,250
2020,11,18,16,1460,1420,1747,327
2020,11,18,17,1429,1368,1605,237
2020,11,18,18,1419,1373,1773,400
2020,11,18,19,1416,1368,1817,449
2020,11,18,20,1416,1378,1895,517
2020,11,18,21,1428,1378,1956,578
2020,11,18,22,1446,1408,1952,544
2020,11,18,23,1476,1464,1938,474
2020,11,19,0,1537,1526,1894,368
2020,11,19,1,1645,1634,2052,418
2020,11,19,2,1647,1646,2059,413
2020,11,19,3,1608,1602,2028,426
2020,11,19,4,1577,1569,1930,361
2020,11,19,5,1512,1504,1894,390
2020,11,19,6,1431,1430,1871,441
2020,11,19,7,1357,1361,1888,527
2020,11,19,8,1325,1316,1869,553
2020,11,19,9,1302,1291,1782,491
2020,11,19,10,1285,1284,1729,445
2020,11,19,11,1291,1285,1742,457
2020,11,19,12,1324,1307,1766,459
2020,11,19,13,1391,1391,1818,427
2020,11,19,14,1478,1475,1848,373
2020,11,19,15,1489,1481,1877,396
2020,11,19,16,1455,1418,1896,478
2020,11,19,17,1429,1370,1894,524
2020,11,19,18,1416,1345,1820,475
2020,11,19,19,1418,1362,1816,454
2020,11,19,20,1440,1376,1827,451
2020,11,19,21,1454,1382,1882,500
2020,11,19,22,1477,1416,1973,557
2020,11,19,23,1507,1462,1980,518
2020,11,20,0,1560,1522,1943,421
2020,11,20,1,1660,1625,2003,378
2020,11,20,2,1650,1626,2021,395
2020,11,20,3,1612,1576,1908,332
2020,11,20,4,1583,1541,1893,352
2020,11,20,5,1521,1476,1775,299
2020,11,20,6,1437,1396,1686,290
2020,11,20,7,1368,1328,1786,458
2020,11,20,8,1311,1283,1666,383
2020,11,20,9,1292,1250,1586,336
2020,11,20,10,1276,1245,1541,296
2020,11,20,11,1281,1267,1506,239
2020,11,20,12,1308,1297,1458,161
2020,11,20,13,1377,1362,1464,102
2020,11,20,14,1461,1434,1499,65
2020,11,20,15,1483,1454,1679,225
2020,11,20,16,1442,1395,1514,119
2020,11,20,17,1413,1345,1333,-12
2020,11,20,18,1413,1320,1222,-98
2020,11,20,19,1413,1327,1179,-148
2020,11,20,20,1424,1368,1168,-200
2020,11,20,21,1428,1320,1062,-258
2020,11,20,22,1449,1341,1073,-268
2020,11,20,23,1476,1405,1079,-326
2020,11,21,0,1523,1475,1189,-286
2020,11,21,1,1616,1577,1376,-201
2020,11,21,2,1620,1568,1430,-138
2020,11,21,3,1580,1539,1356,-183
2020,11,21,4,1562,1512,1374,-138
2020,11,21,5,1513,1467,1322,-145
2020,11,21,6,1441,1405,1272,-133
2020,11,21,7,1378,1335,1275,-60
2020,11,21,8,1318,0,1275,0
2020,11,21,9,1294,0,1586,0
2020,11,21,10,1280,0,1541,0
2020,11,21,11,1281,0,1506,0
2020,11,21,12,1287,0,1458,0
2020,11,21,13,1321,0,1464,0
2020,11,21,14,1369,0,1499,0
2020,11,21,15,1393,0,1679,0
2020,11,21,16,1374,0,1514,0
2020,11,21,17,1353,0,1333,0
2020,11,21,18,1343,0,1222,0
2020,11,21,19,1342,0,1179,0
2020,11,21,20,1341,0,1168,0
2020,11,21,21,1339,0,1062,0
2020,11,21,22,1355,0,1073,0
2020,11,21,23,1391,0,1079,0
2020,11,22,0,1471,0,1189,0
2020,11,22,1,1576,0,1376,0
2020,11,22,2,1598,0,1430,0
2020,11,22,3,1563,0,1356,0
2020,11,22,4,1530,0,1374,0
2020,11,22,5,1481,0,1322,0
2020,11,22,6,1424,0,1272,0
2020,11,22,7,1368,0,1275,0
2020,11,22,8,0,0,0,0
2020,11,22,9,0,0,0,0
2020,11,22,10,0,0,0,0
2020,11,22,11,0,0,0,0
2020,11,22,12,0,0,0,0
2020,11,22,13,0,0,0,0
2020,11,22,14,0,0,0,0
2020,11,22,15,0,0,0,0
2020,11,22,16,0,0,0,0
2020,11,22,17,0,0,0,0
2020,11,22,18,0,0,0,0
2020,11,22,19,0,0,0,0
2020,11,22,20,0,0,0,0
2020,11,22,21,0,0,0,0
2020,11,22,22,0,0,0,0
2020,11,22,23,0,0,0,0
2020,11,23,0,0,0,0,0
2020,11,23,1,0,0,0,0
2020,11,23,2,0,0,0,0
2020,11,23,3,0,0,0,0
2020,11,23,4,0,0,0,0
2020,11,23,5,0,0,0,0
2020,11,23,6,0,0,0,0
2020,11,23,7,0,0,0,0
2020,11,23,8,0,1325,1548,223
2020,11,23,9,0,1301,1608,307
2020,11,23,10,0,1285,1593,308
2020,11,23,11,0,1283,1533,250
2020,11,23,12,0,1300,1579,279
2020,11,23,13,0,1361,1619,258
2020,11,23,14,0,1453,1616,163
2020,11,23,15,0,1499,1674,175
2020,11,23,16,0,1514,1711,197
2020,11,23,17,0,1510,1623,113
2020,11,23,18,0,1517,1726,209
2020,11,23,19,0,1501,1724,223
2020,11,23,20,0,1484,1745,261
2020,11,23,21,0,1463,1854,391
2020,11,23,22,0,1441,1866,425
2020,11,23,23,0,1446,1909,463
2020,11,24,0,0,1506,1972,466
2020,11,24,1,0,1627,2092,465
2020,11,24,2,0,1634,2040,406
2020,11,24,3,0,1608,2021,413
2020,11,24,4,0,1569,2069,500
2020,11,24,5,0,1507,1969,462
2020,11,24,6,0,1436,1836,400
2020,11,24,7,0,1365,1902,537
2020,11,24,8,1338,1326,2055,729
2020,11,24,9,1320,1307,2141,834
2020,11,24,10,1312,1292,2014,722
2020,11,24,11,1324,1289,1892,603
2020,11,24,12,1355,1314,1953,639
2020,11,24,13,1446,1363,1974,611
2020,11,24,14,1542,1441,1970,529
2020,11,24,15,1553,1478,1995,517
2020,11,24,16,1510,1488,2111,623
2020,11,24,17,1479,1476,2168,692
2020,11,24,18,1452,1476,2068,592
2020,11,24,19,1435,1483,2098,615
2020,11,24,20,1432,1472,2018,546
2020,11,24,21,1434,1461,2022,561
2020,11,24,22,1441,1469,2002,533
2020,11,24,23,1473,1492,1963,471
2020,11,25,0,1551,1552,1848,296
2020,11,25,1,1684,1697,1836,139
2020,11,25,2,1702,1711,1760,49
2020,11,25,3,1678,1685,1682,-3
2020,11,25,4,1652,1653,1683,30
2020,11,25,5,1590,1597,1679,82
2020,11,25,6,1506,1536,1726,190
2020,11,25,7,1434,1446,1509,63
2020,11,25,8,1417,1402,1590,188
2020,11,25,9,1397,1382,1737,355
2020,11,25,10,1388,1382,1927,545
2020,11,25,11,1396,1386,1999,613
2020,11,25,12,1429,1414,2086,672
2020,11,25,13,1508,1474,2042,568
2020,11,25,14,1611,1562,2041,479
2020,11,25,15,1620,1579,2099,520
2020,11,25,16,1563,1544,2157,613
2020,11,25,17,1501,1506,2141,635
2020,11,25,18,1458,1481,2181,700
2020,11,25,19,1430,1452,2105,653
2020,11,25,20,1410,1433,2085,652
2020,11,25,21,1398,1427,2076,649
2020,11,25,22,1400,1430,2058,628
2020,11,25,23,1430,1454,2059,605
2020,11,26,0,1503,1524,2092,568
2020,11,26,1,1640,1675,2180,505
2020,11,26,2,1676,1708,2183,475
2020,11,26,3,1665,1689,2200,511
2020,11,26,4,1655,1681,2213,532
2020,11,26,5,1598,1635,2196,561
2020,11,26,6,1532,1573,2215,642
2020,11,26,7,1473,1502,2154,652
2020,11,26,8,1439,1459,2074,615
2020,11,26,9,1413,1429,1920,491
2020,11,26,10,1398,1421,1990,569
2020,11,26,11,1389,1419,2047,628
2020,11,26,12,1399,1436,2010,574
2020,11,26,13,1445,1469,1996,527
2020,11,26,14,1508,1519,1918,399
2020,11,26,15,1541,1524,1842,318
2020,11,26,16,1567,1491,1836,345
2020,11,26,17,1596,1472,1782,310
2020,11,26,18,1594,1435,1741,306
2020,11,26,19,1580,1413,1912,499
2020,11,26,20,1528,1387,1927,540
2020,11,26,21,1457,1355,1926,571
2020,11,26,22,1414,1339,1876,537
2020,11,26,23,1418,1350,1719,369
2020,11,27,0,1449,1401,1544,143
2020,11,27,1,1542,1508,1690,182
2020,11,27,2,1576,1529,1675,146
2020,11,27,3,1577,1515,1691,176
2020,11,27,4,1583,1516,1718,202
2020,11,27,5,1547,1492,1763,271
2020,11,27,6,1504,1453,1819,366
2020,11,27,7,1458,1415,1866,451
2020,11,27,8,1421,1383,1752,369
2020,11,27,9,1395,1370,1818,448
2020,11,27,10,1386,1360,1856,496
2020,11,27,11,1381,1371,1999,628
2020,11,27,12,1403,1397,2050,653
2020,11,27,13,1454,1440,2109,669
2020,11,27,14,1514,1496,2166,670
2020,11,27,15,1525,1498,2251,753
2020,11,27,16,1523,1468,2260,792
2020,11,27,17,1510,1502,2337,835
2020,11,27,18,1487,1490,2328,838
2020,11,27,19,1457,1497,2369,872
2020,11,27,20,1456,1508,2389,881
2020,11,27,21,1450,1497,2336,839
2020,11,27,22,1442,1517,2287,770
2020,11,27,23,1451,1533,2137,604
2020,11,28,0,1518,1591,2115,524
2020,11,28,1,1663,1690,2170,480
2020,11,28,2,1682,1709,2100,391
2020,11,28,3,1671,1702,1822,120
2020,11,28,4,1688,1653,1682,29
2020,11,28,5,1634,1623,1690,67
2020,11,28,6,1584,1538,1694,156
2020,11,28,7,1530,1475,1626,151
2020,11,28,8,1481,1425,1506,81
2020,11,28,9,1455,1400,1408,8
2020,11,28,10,1448,1387,1340,-47
2020,11,28,11,1439,1386,1295,-91
2020,11,28,12,1449,1404,1243,-161
2020,11,28,13,1479,1433,1265,-168
2020,11,28,14,1526,1480,1269,-211
2020,11,28,15,1546,1502,1343,-159
2020,11,28,16,1521,1538,1518,-20
2020,11,28,17,1488,1535,1743,208
2020,11,28,18,1450,1475,1943,468
2020,11,28,19,1428,1421,1918,497
2020,11,28,20,1411,1386,1886,500
2020,11,28,21,1387,1367,1895,528
2020,11,28,22,1395,1367,1876,509
2020,11,28,23,1431,1402,1893,491
2020,11,29,0,1523,1487,1831,344
2020,11,29,1,1680,1647,1907,260
2020,11,29,2,1726,1675,1924,249
2020,11,29,3,1698,1660,1991,331
2020,11,29,4,1680,1635,1875,240
2020,11,29,5,1637,1589,1820,231
2020,11,29,6,1583,1533,1822,289
2020,11,29,7,1522,1477,1808,331
2020,11,29,8,1493,1430,1714,284
2020,11,29,9,1472,1409,1641,232
2020,11,29,10,1460,1410,1647,237
2020,11,29,11,1461,1408,1638,230
2020,11,29,12,1461,1416,1672,256
2020,11,29,13,1491,1461,1665,204
2020,11,29,14,1531,1522,1684,162
2020,11,29,15,1538,1533,1783,250
2020,11,29,16,1516,1500,1936,436
2020,11,29,17,1479,1462,1853,391
2020,11,29,18,1439,1428,1954,526
2020,11,29,19,1418,1407,1958,551
2020,11,29,20,1407,1396,1945,549
2020,11,29,21,1389,1392,1954,562
2020,11,29,22,1395,1408,1957,549
2020,11,29,23,1434,1466,1877,411
2020,11,30,0,1529,1539,1933,394
2020,11,30,1,1699,1703,1998,295
2020,11,30,2,1747,1733,2037,304
2020,11,30,3,1725,1730,2048,318
2020,11,30,4,1710,1703,2066,363
2020,11,30,5,1662,1628,2030,402
2020,11,30,6,1583,1556,1886,330
2020,11,30,7,1515,1487,1735,248
2020,11,30,8,1484,1456,1644,188
2020,11,30,9,1465,1444,1596,152
2020,11,30,10,1453,1445,1637,192
2020,11,30,11,1462,1454,1628,174
2020,11,30,12,1491,1493,1700,207
2020,11,30,13,1556,1565,1714,149
2020,11,30,14,1656,1676,1762,86
2020,11,30,15,1674,1704,1860,156
2020,11,30,16,1627,1642,1936,294
2020,11,30,17,1579,1602,2013,411
2020,11,30,18,1531,1569,2182,613
2020,11,30,19,1501,1544,2242,698
2020,11,30,20,1493,1522,2347,825
2020,11,30,21,1482,1507,2332,825
2020,11,30,22,1485,1506,2489,983
2020,11,30,23,1520,1535,2447,912
2020,12,1,0,1596,1617,2300,683
2020,12,1,1,1738,1784,2385,601
2020,12,1,2,1782,1816,2278,462
2020,12,1,3,1760,1802,2224,422
2020,12,1,4,1751,1785,2229,444
2020,12,1,5,1698,1717,2071,354
2020,12,1,6,1615,1644,1968,324
2020,12,1,7,1535,1564,1980,416
2020,12,1,8,1508,1520,2002,482
2020,12,1,9,1494,1500,1904,404
2020,12,1,10,1488,1491,1841,350
2020,12,1,11,1498,1496,1816,320
2020,12,1,12,1527,1526,1740,214
2020,12,1,13,1605,1591,1796,205
2020,12,1,14,1711,1672,1873,201
2020,12,1,15,1722,1688,2027,339
2020,12,1,16,1648,1633,2049,416
2020,12,1,17,1590,1570,1993,423
2020,12,1,18,1538,1689,2011,322
2020,12,1,19,1503,1649,2061,412
2020,12,1,20,1486,1616,2067,451
2020,12,1,21,1470,1628,2056,428
2020,12,1,22,1471,1662,2015,353
2020,12,1,23,1502,1717,1993,276
2020,12,2,0,1585,1805,1989,184
2020,12,2,1,1743,1934,1957,23
2020,12,2,2,1793,1987,2136,149
2020,12,2,3,1782,1960,2134,174
2020,12,2,4,1775,1941,2115,174
2020,12,2,5,1714,1923,2162,239
2020,12,2,6,1634,1798,2123,325
2020,12,2,7,1560,1725,2019,294
2020,12,2,8,1505,1454,1819,365
2020,12,2,9,1489,1468,1803,335
2020,12,2,10,1479,1467,1791,324
2020,12,2,11,1494,1464,1811,347
2020,12,2,12,1585,1495,1835,340
2020,12,2,13,1677,1573,1841,268
2020,12,2,14,1780,1668,1874,206
2020,12,2,15,1802,1739,1951,212
2020,12,2,16,1754,1750,1980,230
2020,12,2,17,1712,1744,1972,228
2020,12,2,18,1676,1691,1897,206
2020,12,2,19,1642,1641,1715,74
2020,12,2,20,1626,1606,1662,56
2020,12,2,21,1600,1572,1584,12
2020,12,2,22,1591,1572,1538,-34
2020,12,2,23,1609,1606,1464,-142
2020,12,3,0,1691,1706,1522,-184
2020,12,3,1,1841,1863,1770,-93
2020,12,3,2,1901,1883,1825,-58
2020,12,3,3,1881,1863,1829,-34
2020,12,3,4,1858,1836,1790,-46
2020,12,3,5,1780,1776,1632,-144
2020,12,3,6,1683,1699,1552,-147
2020,12,3,7,1609,1625,1507,-118
2020,12,3,8,1590,1580,1452,-128
2020,12,3,9,1575,1569,1442,-127
2020,12,3,10,1573,1568,1416,-152
2020,12,3,11,1579,1572,1464,-108
2020,12,3,12,1612,1586,1516,-70
2020,12,3,13,1689,1658,1533,-125
2020,12,3,14,1796,1753,1544,-209
2020,12,3,15,1810,1787,1619,-168
2020,12,3,16,1741,1738,1709,-29
2020,12,3,17,1686,1693,1578,-115
2020,12,3,18,1630,1641,1559,-82
2020,12,3,19,1590,1605,1600,-5
2020,12,3,20,1566,1566,1562,-4
2020,12,3,21,1539,1547,1564,17
2020,12,3,22,1542,1549,1515,-34
2020,12,3,23,1579,1585,1502,-83
2020,12,4,0,1673,1682,1571,-111
2020,12,4,1,1842,1858,1782,-76
2020,12,4,2,1888,1885,1887,2
2020,12,4,3,1869,1869,1906,37
2020,12,4,4,1857,1850,1896,46
2020,12,4,5,1801,1778,1726,-52
2020,12,4,6,1714,1696,1647,-49
2020,12,4,7,1634,1614,1615,1
2020,12,4,8,1581,1568,1613,45
2020,12,4,9,1560,1556,1632,76
2020,12,4,10,1553,1557,1639,82
2020,12,4,11,1562,1570,1673,103
2020,12,4,12,1587,1595,1729,134
2020,12,4,13,1656,1663,1741,78
2020,12,4,14,1760,1759,1638,-121
2020,12,4,15,1775,1788,1621,-167
2020,12,4,16,1707,1715,1690,-25
2020,12,4,17,1636,1645,1694,49
2020,12,4,18,1570,1592,1684,92
2020,12,4,19,1524,1551,1692,141
2020,12,4,20,1490,1512,1788,276
2020,12,4,21,1467,1481,1780,299
2020,12,4,22,1466,1478,1705,227
2020,12,4,23,1495,1511,1588,77
2020,12,5,0,1584,1601,1645,44
2020,12,5,1,1730,1774,1815,41
2020,12,5,2,1774,1801,1879,78
2020,12,5,3,1750,1792,1909,117
2020,12,5,4,1753,1782,1864,82
2020,12,5,5,1717,1743,1819,76
2020,12,5,6,1661,1658,1808,150
2020,12,5,7,1590,1581,1843,262
2020,12,5,8,1538,1526,1969,443
2020,12,5,9,1517,1500,1998,498
2020,12,5,10,1508,1492,2041,549
2020,12,5,11,1510,1500,2067,567
2020,12,5,12,1511,1512,2085,573
2020,12,5,13,1545,1565,2146,581
2020,12,5,14,1595,1624,2125,501
2020,12,5,15,1610,1620,2003,383
2020,12,5,16,1567,1582,1894,312
2020,12,5,17,1520,1545,1902,357
2020,12,5,18,1472,1508,1956,448
2020,12,5,19,1443,1476,2019,543
2020,12,5,20,1411,1440,2053,613
2020,12,5,21,1399,1412,2028,616
2020,12,5,22,1406,1415,1949,534
2020,12,5,23,1445,1446,1801,355
2020,12,6,0,1539,1534,1614,80
2020,12,6,1,1699,1713,1814,101
2020,12,6,2,1750,1745,1785,40
2020,12,6,3,1727,1743,1665,-78
2020,12,6,4,1714,1726,1515,-211
2020,12,6,5,1677,1694,1373,-321
2020,12,6,6,1623,1596,1423,-173
2020,12,6,7,1555,1532,1426,-106
2020,12,6,8,1518,1488,1418,-70
2020,12,6,9,1495,1470,1379,-91
2020,12,6,10,1489,1458,1370,-88
2020,12,6,11,1490,1459,1400,-59
2020,12,6,12,1491,1473,1514,41
2020,12,6,13,1521,1506,1601,95
2020,12,6,14,1565,1555,1644,89
2020,12,6,15,1582,1560,1711,151
2020,12,6,16,1543,1525,1690,165
2020,12,6,17,1502,1485,1549,64
2020,12,6,18,1458,1446,1485,39
2020,12,6,19,1433,1414,1490,76
2020,12,6,20,1416,1392,1483,91
2020,12,6,21,1396,1372,1468,96
2020,12,6,22,1404,1381,1383,2
2020,12,6,23,1444,1425,1346,-79
2020,12,7,0,1547,1529,1456,-73
2020,12,7,1,1710,1713,1585,-128
2020,12,7,2,1767,1744,1659,-85
2020,12,7,3,1757,1737,1548,-189
2020,12,7,4,1744,1717,1442,-275
2020,12,7,5,1692,1669,1353,-316
2020,12,7,6,1618,1578,1346,-232
2020,12,7,7,1544,1497,1356,-141
2020,12,7,8,1487,1460,1351,-109
2020,12,7,9,1471,1450,1241,-209
2020,12,7,10,1464,1455,1231,-224
2020,12,7,11,1476,1466,1241,-225
2020,12,7,12,1505,1503,1268,-235
2020,12,7,13,1568,1577,1239,-338
2020,12,7,14,1674,1683,1225,-458
2020,12,7,15,1693,1719,1374,-345
2020,12,7,16,1627,1660,1437,-223
2020,12,7,17,1578,1592,1404,-188
2020,12,7,18,1528,1530,1390,-140
2020,12,7,19,1504,1512,1358,-154
2020,12,7,20,1479,1428,1249,-179
2020,12,7,21,1466,1465,1284,-181
2020,12,7,22,1463,1458,1288,-170
2020,12,7,23,1505,1502,1187,-315
2020,12,8,0,1597,1565,1148,-417
2020,12,8,1,1741,1757,1317,-440
2020,12,8,2,1786,1795,1360,-435
2020,12,8,3,1770,1784,1364,-420
2020,12,8,4,1757,1764,1332,-432
2020,12,8,5,1708,1704,1292,-412
2020,12,8,6,1625,1607,1246,-361
2020,12,8,7,1546,1530,1168,-362
2020,12,8,8,1477,1481,1147,-334
2020,12,8,9,1460,1461,1166,-295
2020,12,8,10,1456,1486,1206,-280
2020,12,8,11,1463,1464,1213,-251
2020,12,8,12,1501,1493,1265,-228
2020,12,8,13,1580,1600,1375,-225
2020,12,8,14,1686,1703,1423,-280
2020,12,8,15,1695,1717,1544,-173
2020,12,8,16,1623,1650,1651,1
2020,12,8,17,1562,1584,1608,24
2020,12,8,18,1514,1526,1650,124
2020,12,8,19,1479,1485,1679,194
2020,12,8,20,1457,1454,1663,209
2020,12,8,21,1444,1429,1673,244
2020,12,8,22,1449,1437,1595,158
2020,12,8,23,1487,1469,1505,36
2020,12,9,0,1576,1555,1544,-11
2020,12,9,1,1730,1724,1718,-6
2020,12,9,2,1766,1765,1811,46
2020,12,9,3,1756,1769,1782,13
2020,12,9,4,1741,1757,1803,46
2020,12,9,5,1686,1697,1850,153
2020,12,9,6,1601,1595,1866,271
2020,12,9,7,1526,1524,1915,391
2020,12,9,8,1481,1487,1903,416
2020,12,9,9,1459,1465,1948,483
2020,12,9,10,1457,1464,1997,533
2020,12,9,11,1464,1476,2004,528
2020,12,9,12,1494,1510,1998,488
2020,12,9,13,1575,1578,2031,453
2020,12,9,14,1682,1670,2018,348
2020,12,9,15,1704,1699,2053,354
2020,12,9,16,1636,1653,2064,411
2020,12,9,17,1568,1584,2090,506
2020,12,9,18,1519,1519,2084,565
2020,12,9,19,1487,1481,2141,660
2020,12,9,20,1463,1456,2130,674
2020,12,9,21,1447,1432,2152,720
2020,12,9,22,1454,1399,2044,645
2020,12,9,23,1493,1466,1920,454
2020,12,10,0,1572,1548,1897,349
2020,12,10,1,1735,1727,2032,305
2020,12,10,2,1769,1772,2022,250
2020,12,10,3,1757,1761,2038,277
2020,12,10,4,1746,1755,2067,312
2020,12,10,5,1692,1712,2097,385
2020,12,10,6,1604,1615,2094,479
2020,12,10,7,1530,1539,2043,504
2020,12,10,8,1479,1485,1838,353
2020,12,10,9,1456,1471,1814,343
2020,12,10,10,1451,1464,1750,286
2020,12,10,11,1457,1469,1648,179
2020,12,10,12,1482,1493,1643,150
2020,12,10,13,1569,1542,1582,40
2020,12,10,14,1685,1647,1553,-94
2020,12,10,15,1731,1709,1618,-91
2020,12,10,16,1694,1734,1693,-41
2020,12,10,17,1665,1764,1724,-40
2020,12,10,18,1642,1791,1676,-115
2020,12,10,19,1622,1818,1693,-125
2020,12,10,20,1606,1780,1631,-149
2020,12,10,21,1596,1699,1626,-73
2020,12,10,22,1593,1680,1689,9
2020,12,10,23,1619,1696,1733,37
2020,12,11,0,1696,1768,1869,101
2020,12,11,1,1821,1907,2011,104
2020,12,11,2,1848,1912,2039,127
2020,12,11,3,1821,1868,2083,215
2020,12,11,4,1801,1814,2070,256
2020,12,11,5,1734,1734,2160,426
2020,12,11,6,1638,1696,2233,537
2020,12,11,7,1556,1535,2124,589
2020,12,11,8,1498,1482,2154,672
2020,12,11,9,1477,1441,2166,725
2020,12,11,10,1467,1435,2113,678
2020,12,11,11,1470,1433,2050,617
2020,12,11,12,1498,1462,2110,648
2020,12,11,13,1562,1521,2101,580
2020,12,11,14,1674,1617,2127,510
2020,12,11,15,1714,1663,2105,442
2020,12,11,16,1677,1655,2222,567
2020,12,11,17,1638,1608,2208,600
2020,12,11,18,1605,1574,2310,736
2020,12,11,19,1573,1555,2369,814
2020,12,11,20,1549,1559,2391,832
2020,12,11,21,1528,1554,2383,829
2020,12,11,22,1519,1553,2437,884
2020,12,11,23,1548,1600,2376,776
2020,12,12,0,1635,1690,2397,707
2020,12,12,1,1780,1802,2317,515
2020,12,12,2,1813,1824,2317,493
2020,12,12,3,1799,1800,2214,414
2020,12,12,4,1793,1788,2192,404
2020,12,12,5,1740,1731,2110,379
2020,12,12,6,1658,1647,2016,369
2020,12,12,7,1588,1574,2004,430
2020,12,12,8,1532,1525,1970,445
2020,12,12,9,1513,1500,1934,434
2020,12,12,10,1503,1491,1788,297
2020,12,12,11,1493,1494,1795,301
2020,12,12,12,1505,1519,1726,207
2020,12,12,13,1539,1515,1663,148
2020,12,12,14,1591,1625,1643,18
2020,12,12,15,1621,1633,1676,43
2020,12,12,16,1607,1563,1776,213
2020,12,12,17,1570,1616,1949,333
2020,12,12,18,1532,1617,2092,475
2020,12,12,19,1503,1640,2148,508
2020,12,12,20,1477,1648,2202,554
2020,12,12,21,1449,1631,2123,492
2020,12,12,22,1450,1634,2083,449
2020,12,12,23,1483,1672,2136,464
2020,12,13,0,1567,1762,2269,507
2020,12,13,1,1721,1873,2362,489
2020,12,13,2,1763,1885,2210,325
2020,12,13,3,1747,1859,2319,460
2020,12,13,4,1725,1830,2429,599
2020,12,13,5,1683,1770,2410,640
2020,12,13,6,1620,1689,2322,633
2020,12,13,7,1549,1617,2242,625
2020,12,13,8,1529,1564,2194,630
2020,12,13,9,1500,1530,2121,591
2020,12,13,10,1500,1522,2098,576
2020,12,13,11,1494,1526,2106,580
2020,12,13,12,1507,1510,2154,644
2020,12,13,13,1544,1624,2141,517
2020,12,13,14,1587,1716,2111,395
2020,12,13,15,1619,1665,2018,353
2020,12,13,16,1621,1646,2050,404
2020,12,13,17,1600,1622,1884,262
2020,12,13,18,1581,1600,1838,238
2020,12,13,19,1568,1560,1794,234
2020,12,13,20,1550,1531,1841,310
2020,12,13,21,1528,1529,1820,291
2020,12,13,22,1530,1504,1747,243
2020,12,13,23,1571,1552,1707,155
2020,12,14,0,1665,1673,1762,89
2020,12,14,1,1833,1884,1922,38
2020,12,14,2,1883,1935,1902,-33
2020,12,14,3,1871,1927,1834,-93
2020,12,14,4,1845,1878,1564,-314
2020,12,14,5,1790,1811,1457,-354
2020,12,14,6,1709,1706,1517,-189
2020,12,14,7,1633,1633,1500,-133
2020,12,14,8,1576,1592,1573,-19
2020,12,14,9,1558,1577,1600,23
2020,12,14,10,1552,1565,1634,69
2020,12,14,11,1560,1569,1606,37
2020,12,14,12,1590,1606,1625,19
2020,12,14,13,1657,1673,1689,16
2020,12,14,14,1767,1779,1732,-47
2020,12,14,15,1803,1823,1770,-53
2020,12,14,16,1759,1802,1840,38
2020,12,14,17,1713,1802,1804,2
2020,12,14,18,1668,1842,1960,118
2020,12,14,19,1631,1808,1933,125
2020,12,14,20,1604,1775,1957,182
2020,12,14,21,1567,1726,1886,160
2020,12,14,22,1564,1701,1879,178
2020,12,14,23,1605,1703,1764,61
2020,12,15,0,1694,1771,1817,46
2020,12,15,1,1859,1946,1967,21
2020,12,15,2,1896,1966,1951,-15
2020,12,15,3,1886,1940,1966,26
2020,12,15,4,1866,1914,2007,93
2020,12,15,5,1800,1837,1985,148
2020,12,15,6,1709,1728,2025,297
2020,12,15,7,1618,1636,2127,491
2020,12,15,8,1568,1572,2062,490
2020,12,15,9,1552,1541,2061,520
2020,12,15,10,1544,1530,2071,541
2020,12,15,11,1552,1540,2165,625
2020,12,15,12,1574,1579,2152,573
2020,12,15,13,1657,1666,2202,536
2020,12,15,14,1785,1792,2204,412
2020,12,15,15,1819,1813,2101,288
2020,12,15,16,1783,1821,1909,88
2020,12,15,17,1744,1794,1919,125
2020,12,15,18,1706,1523,1698,175
2020,12,15,19,1678,1703,1920,217
2020,12,15,20,1648,1684,2272,588
2020,12,15,21,1622,1661,2268,607
2020,12,15,22,1616,1651,2179,528
2020,12,15,23,1652,1682,2035,353
2020,12,16,0,1747,1760,1999,239
2020,12,16,1,1923,2018,2155,137
2020,12,16,2,1960,1978,2154,176
2020,12,16,3,1943,1955,2073,118
2020,12,16,4,1923,1924,2069,145
2020,12,16,5,1857,1856,2012,156
2020,12,16,6,1757,1760,2046,286
2020,12,16,7,1669,1666,2015,349
2020,12,16,8,1609,1618,2008,390
2020,12,16,9,1589,1595,2039,444
2020,12,16,10,1583,1584,2102,518
2020,12,16,11,1588,1591,2114,523
2020,12,16,12,1592,1629,2102,473
2020,12,16,13,1669,1700,2025,325
2020,12,16,14,1794,1792,2058,266
2020,12,16,15,1832,1834,2104,270
2020,12,16,16,1775,1779,2094,315
2020,12,16,17,1727,1720,2056,336
2020,12,16,18,1684,1674,1991,317
2020,12,16,19,1638,1626,1915,289
2020,12,16,20,1602,1590,1893,303
2020,12,16,21,1570,1551,1911,360
2020,12,16,22,1571,1563,1935,372
2020,12,16,23,1609,1608,1917,309
2020,12,17,0,1713,1691,1932,241
2020,12,17,1,1897,1873,1981,108
2020,12,17,2,1930,1923,2130,207
2020,12,17,3,1916,1902,2153,251
2020,12,17,4,1906,1898,2052,154
2020,12,17,5,1847,1883,2023,140
2020,12,17,6,1751,1733,1834,101
2020,12,17,7,1661,1647,1899,252
2020,12,17,8,1610,1592,1893,301
2020,12,17,9,1586,1582,1787,205
2020,12,17,10,1579,1575,1753,178
2020,12,17,11,1587,1587,1681,94
2020,12,17,12,1591,1618,1626,8
2020,12,17,13,1666,1700,1741,41
2020,12,17,14,1801,1808,1771,-37
2020,12,17,15,1834,1848,1824,-24
2020,12,17,16,1788,1798,1944,146
2020,12,17,17,1734,1725,1875,150
2020,12,17,18,1678,1676,1874,198
2020,12,17,19,1639,1631,1904,273
2020,12,17,20,1611,1604,1984,380
2020,12,17,21,1580,1604,2022,418
2020,12,17,22,1574,1644,2072,428
2020,12,17,23,1608,1695,2051,356
2020,12,18,0,1702,1765,1968,203
2020,12,18,1,1895,1920,2014,94
2020,12,18,2,1915,1936,1823,-113
2020,12,18,3,1892,1906,1690,-216
2020,12,18,4,1882,1877,1621,-256
2020,12,18,5,1822,1804,1649,-155
2020,12,18,6,1731,1707,1662,-45
2020,12,18,7,1632,1611,1644,33
2020,12,18,8,1553,1554,1627,73
2020,12,18,9,1533,1526,1629,103
2020,12,18,10,1519,1522,1637,115
2020,12,18,11,1523,1529,1650,121
2020,12,18,12,1534,1556,1653,97
2020,12,18,13,1611,1615,1667,52
2020,12,18,14,1735,1719,1709,-10
2020,12,18,15,1772,1777,1795,18
2020,12,18,16,1732,1723,1791,68
2020,12,18,17,1685,1664,1757,93
2020,12,18,18,1649,1616,1814,198
2020,12,18,19,1619,1580,1858,278
2020,12,18,20,1597,1559,1806,247
2020,12,18,21,1571,1557,1808,251
2020,12,18,22,1563,1517,1780,263
2020,12,18,23,1598,1543,1715,172
2020,12,19,0,1698,1585,1664,79
2020,12,19,1,1864,1775,1742,-33
2020,12,19,2,1893,1845,1719,-126
2020,12,19,3,1863,1830,1694,-136
2020,12,19,4,1858,1819,1607,-212
2020,12,19,5,1822,1769,1459,-310
2020,12,19,6,1737,1687,1436,-251
2020,12,19,7,1653,1612,1433,-179
2020,12,19,8,1598,1558,1410,-148
2020,12,19,9,1571,1520,1394,-126
2020,12,19,10,1560,1506,1380,-126
2020,12,19,11,1555,1501,1425,-76
2020,12,19,12,1570,1521,1456,-65
2020,12,19,13,1604,1564,1453,-111
2020,12,19,14,1669,1623,1512,-111
2020,12,19,15,1698,1651,1662,11
2020,12,19,16,1674,1618,1820,202
2020,12,19,17,1655,1560,1854,294
2020,12,19,18,1613,1544,1916,372
2020,12,19,19,1587,1519,1857,338
2020,12,19,20,1561,1490,1846,356
2020,12,19,21,1530,1459,1837,378
2020,12,19,22,1524,1444,1838,394
2020,12,19,23,1563,1483,1781,298
2020,12,20,0,1662,1577,1786,209
2020,12,20,1,1841,1766,1867,101
2020,12,20,2,1879,1814,1844,30
2020,12,20,3,1858,1808,1785,-23
2020,12,20,4,1835,1781,1843,62
2020,12,20,5,1797,1740,1847,107
2020,12,20,6,1722,1663,1570,-93
2020,12,20,7,1646,1587,1596,9
2020,12,20,8,1602,1552,1557,5
2020,12,20,9,1574,1535,1644,109
2020,12,20,10,1565,1521,1663,142
2020,12,20,11,1564,1516,1595,79
2020,12,20,12,1570,1519,1595,76
2020,12,20,13,1598,1538,1628,90
2020,12,20,14,1650,1589,1575,-14
2020,12,20,15,1675,1620,1593,-27
2020,12,20,16,1660,1593,1650,57
2020,12,20,17,1625,1553,1486,-67
2020,12,20,18,1585,1514,1497,-17
2020,12,20,19,1562,1477,1607,130
2020,12,20,20,1536,1470,1660,190
2020,12,20,21,1513,1458,1675,217
2020,12,20,22,1512,1457,1683,226
2020,12,20,23,1554,1488,1624,136
2020,12,21,0,1649,1571,1561,-10
2020,12,21,1,1838,1780,1659,-121
2020,12,21,2,1889,1828,1603,-225
2020,12,21,3,1874,1821,1594,-227
2020,12,21,4,1849,1795,1611,-184
2020,12,21,5,1797,1714,1555,-159
2020,12,21,6,1704,1626,1492,-134
2020,12,21,7,1623,1550,1495,-55
2020,12,21,8,1557,1499,1519,20
2020,12,21,9,1537,1474,1498,24
2020,12,21,10,1528,1469,1436,-33
2020,12,21,11,1537,1469,1436,-33
2020,12,21,12,1565,1502,1463,-39
2020,12,21,13,1636,1575,1398,-177
2020,12,21,14,1755,1670,1491,-179
2020,12,21,15,1784,1710,1672,-38
2020,12,21,16,1733,1658,1792,134
2020,12,21,17,1672,1594,1769,175
2020,12,21,18,1618,1548,1711,163
2020,12,21,19,1582,1513,1634,121
2020,12,21,20,1555,1478,1604,126
2020,12,21,21,1528,1449,1547,98
2020,12,21,22,1526,1453,1512,59
2020,12,21,23,1564,1482,1463,-19
2020,12,22,0,1657,1564,1443,-121
2020,12,22,1,1836,1733,1576,-157
2020,12,22,2,1873,1786,1678,-108
2020,12,22,3,1863,1779,1743,-36
2020,12,22,4,1843,1766,1773,7
2020,12,22,5,1785,1712,1708,-4
2020,12,22,6,1685,1628,1679,51
2020,12,22,7,1588,1542,1628,86
2020,12,22,8,1497,1492,1623,131
2020,12,22,9,1479,1474,1544,70
2020,12,22,10,1474,1470,1575,105
2020,12,22,11,1478,1473,1650,177
2020,12,22,12,1513,1506,1714,208
2020,12,22,13,1593,1562,1819,257
2020,12,22,14,1715,1661,1869,208
2020,12,22,15,1739,1707,1967,260
2020,12,22,16,1669,1661,2125,464
2020,12,22,17,1606,1598,2161,563
2020,12,22,18,1560,1559,2223,664
2020,12,22,19,1520,1522,2159,637
2020,12,22,20,1498,1491,2135,644
2020,12,22,21,1477,1503,2178,675
2020,12,22,22,1474,1537,2147,610
2020,12,22,23,1512,1586,2176,590
2020,12,23,0,1605,1629,2155,526
2020,12,23,1,1791,1789,2166,377
2020,12,23,2,1823,1833,2155,322
2020,12,23,3,1812,1812,2128,316
2020,12,23,4,1800,1801,2128,327
2020,12,23,5,1733,1750,2066,316
2020,12,23,6,1639,1649,2031,382
2020,12,23,7,1551,1562,1985,423
2020,12,23,8,1502,1508,1978,470
2020,12,23,9,1477,1480,1893,413
2020,12,23,10,1472,1468,1891,423
2020,12,23,11,1481,1477,1915,438
2020,12,23,12,1515,1508,1929,421
2020,12,23,13,1598,1570,1882,312
2020,12,23,14,1699,1649,1878,229
2020,12,23,15,1742,1686,1905,219
2020,12,23,16,1709,1660,2164,504
2020,12,23,17,1672,1630,2088,458
2020,12,23,18,1649,1614,2083,469
2020,12,23,19,1638,1580,2011,431
2020,12,23,20,1622,1571,2018,447
2020,12,23,21,1602,1579,2087,508
2020,12,23,22,1608,1595,2117,522
2020,12,23,23,1644,1642,2152,510
2020,12,24,0,1739,1723,2133,410
2020,12,24,1,1910,1893,2260,367
2020,12,24,2,1947,1919,2274,355
2020,12,24,3,1947,1902,2185,283
2020,12,24,4,1919,1886,2162,276
2020,12,24,5,1838,1836,2042,206
2020,12,24,6,1755,1749,1992,243
2020,12,24,7,1669,1673,1940,267
2020,12,24,8,1599,1617,1919,302
2020,12,24,9,1552,1584,1764,180
2020,12,24,10,1523,1569,1839,270
2020,12,24,11,1511,1575,1830,255
2020,12,24,12,1523,1609,1883,274
2020,12,24,13,1569,1668,1956,288
2020,12,24,14,1635,1740,1875,135
2020,12,24,15,1679,1764,1961,197
2020,12,24,16,1697,1730,2060,330
2020,12,24,17,1693,1678,2028,350
2020,12,24,18,1657,1639,1983,344
2020,12,24,19,1625,1596,1922,326
2020,12,24,20,1594,1540,1833,293
2020,12,24,21,1568,1518,1822,304
2020,12,24,22,1581,1515,1840,325
2020,12,24,23,1600,1569,1790,221
2020,12,25,0,1653,1697,1746,49
2020,12,25,1,1767,1838,1956,118
2020,12,25,2,1772,1847,1944,97
2020,12,25,3,1751,1819,1934,115
2020,12,25,4,1738,1821,1843,22
2020,12,25,5,1697,1790,1784,-6
2020,12,25,6,1649,1736,1731,-5
2020,12,25,7,1595,1671,1726,55
2020,12,25,8,1549,1617,1644,27
2020,12,25,9,1514,1588,1636,48
2020,12,25,10,1492,1569,1675,106
2020,12,25,11,1478,1566,1703,137
2020,12,25,12,1484,1587,1694,107
2020,12,25,13,1518,1634,1726,92
2020,12,25,14,1573,1687,1741,54
2020,12,25,15,1613,1709,1661,-48
2020,12,25,16,1629,1665,1636,-29
2020,12,25,17,1616,1591,1576,-15
2020,12,25,18,1601,1539,1617,78
2020,12,25,19,1578,1516,1642,126
2020,12,25,20,1538,1476,1712,236
2020,12,25,21,1512,1450,1769,319
2020,12,25,22,1491,1464,1754,290
2020,12,25,23,1495,1487,1790,303
2020,12,26,0,1549,1525,1753,228
2020,12,26,1,1700,1685,1962,277
2020,12,26,2,1747,1751,1951,200
2020,12,26,3,1751,1760,1972,212
2020,12,26,4,1756,1769,2011,242
2020,12,26,5,1704,1738,2036,298
2020,12,26,6,1651,1686,1967,281
2020,12,26,7,1598,1620,1942,322
2020,12,26,8,1564,1568,1877,309
2020,12,26,9,1542,1545,1887,342
2020,12,26,10,1535,1533,1925,392
2020,12,26,11,1532,1530,1875,345
2020,12,26,12,1539,1540,1888,348
2020,12,26,13,1581,1586,1883,297
2020,12,26,14,1616,1650,1956,306
2020,12,26,15,1636,1664,1941,277
2020,12,26,16,1605,1613,2045,432
2020,12,26,17,1551,1547,2018,471
2020,12,26,18,1504,1511,2046,535
2020,12,26,19,1471,1469,2058,589
2020,12,26,20,1441,1435,1986,551
2020,12,26,21,1418,1411,2028,617
2020,12,26,22,1423,1413,2036,623
2020,12,26,23,1472,1449,1991,542
2020,12,27,0,1580,1533,2035,502
2020,12,27,1,1774,1707,2178,471
2020,12,27,2,1815,1769,2171,402
2020,12,27,3,1781,1768,2150,382
2020,12,27,4,1747,1756,2139,383
2020,12,27,5,1703,1707,2070,363
2020,12,27,6,1636,1633,2024,391
2020,12,27,7,1564,1562,2003,441
2020,12,27,8,1507,1510,2035,525
2020,12,27,9,1482,1487,2073,586
2020,12,27,10,1473,1477,2067,590
2020,12,27,11,1477,1471,2036,565
2020,12,27,12,1485,1477,2013,536
2020,12,27,13,1514,1491,1965,474
2020,12,27,14,1552,1541,1929,388
2020,12,27,15,1572,1562,2043,481
2020,12,27,16,1557,1527,2078,551
2020,12,27,17,1520,1484,2024,540
2020,12,27,18,1486,1447,1953,506
2020,12,27,19,1467,1433,1953,520
2020,12,27,20,1453,1402,1877,475
2020,12,27,21,1436,1388,1871,483
2020,12,27,22,1442,1417,1919,502
2020,12,27,23,1485,1449,1894,445
2020,12,28,0,1590,1540,1691,151
2020,12,28,1,1786,1730,1535,-195
2020,12,28,2,1815,1778,1550,-228
2020,12,28,3,1806,1771,1507,-264
2020,12,28,4,1784,1731,1483,-248
2020,12,28,5,1727,1673,1421,-252
2020,12,28,6,1636,1585,1435,-150
2020,12,28,7,1551,533,480,-53
2020,12,28,8,1493,1423,1466,43
2020,12,28,9,1467,1404,1467,63
2020,12,28,10,1457,1397,1480,83
2020,12,28,11,1463,1396,1507,111
2020,12,28,12,1487,1416,1485,69
2020,12,28,13,1556,1475,1448,-27
2020,12,28,14,1666,1559,1500,-59
2020,12,28,15,1706,1589,1625,36
2020,12,28,16,1677,1606,1778,172
2020,12,28,17,1637,1601,1892,291
2020,12,28,18,1610,1605,1966,361
2020,12,28,19,1588,1613,1942,329
2020,12,28,20,1570,1571,1902,331
2020,12,28,21,1554,1555,1844,289
2020,12,28,22,1553,1553,1857,304
2020,12,28,23,1586,1548,1869,321
2020,12,29,0,1674,1610,1796,186
2020,12,29,1,1841,1782,1893,111
2020,12,29,2,1867,1830,1922,92
2020,12,29,3,1850,1793,1873,80
2020,12,29,4,1830,1761,1796,35
2020,12,29,5,1764,1697,1755,58
2020,12,29,6,1659,1595,1787,192
2020,12,29,7,1563,1507,1838,331
2020,12,29,8,1386,1451,1809,358
2020,12,29,9,1372,1419,1759,340
2020,12,29,10,1371,1409,1651,242
2020,12,29,11,1378,1431,1564,133
2020,12,29,12,1405,1436,1484,48
2020,12,29,13,1489,1493,1508,15
2020,12,29,14,1635,1581,1580,-1
2020,12,29,15,1687,1633,1561,-72
2020,12,29,16,1647,1643,1748,105
2020,12,29,17,1609,1644,1826,182
2020,12,29,18,1586,1619,1951,332
2020,12,29,19,1565,1582,1961,379
2020,12,29,20,1552,1545,1920,375
2020,12,29,21,1539,1514,1943,429
2020,12,29,22,1549,1527,1933,406
2020,12,29,23,1590,1572,1931,359
2020,12,30,0,1694,1656,1861,205
2020,12,30,1,1877,1818,1940,122
2020,12,30,2,1876,1863,2029,166
2020,12,30,3,1844,1841,1980,139
2020,12,30,4,1848,1828,1981,153
2020,12,30,5,1798,1778,1973,195
2020,12,30,6,1704,1709,2025,316
2020,12,30,7,1477,1629,2026,397
2020,12,30,8,1550,1577,2114,537
2020,12,30,9,1527,1551,1929,378
2020,12,30,10,1521,1545,1910,365
2020,12,30,11,1532,1553,1802,249
2020,12,30,12,1554,1584,1728,144
2020,12,30,13,1626,1644,1746,102
2020,12,30,14,1737,1743,1736,-7
2020,12,30,15,1768,1784,1715,-69
2020,12,30,16,1725,1725,1821,96
2020,12,30,17,1675,1642,1843,201
2020,12,30,18,1637,1609,1905,296
2020,12,30,19,1613,1583,1863,280
2020,12,30,20,1585,1549,1758,209
2020,12,30,21,1562,1517,1666,149
2020,12,30,22,1568,1514,1583,69
2020,12,30,23,1604,1549,1504,-45
2020,12,31,0,1695,1661,1589,-72
2020,12,31,1,1876,1849,1679,-170
2020,12,31,2,1918,1914,1745,-169
2020,12,31,3,1913,1904,1773,-131
2020,12,31,4,1898,1892,1733,-159
2020,12,31,5,1844,1835,1754,-81
2020,12,31,6,1749,1741,1829,88
2020,12,31,7,1659,1665,1798,133
2020,12,31,8,1615,1595,1830,235
2020,12,31,9,1595,1572,1867,295
2020,12,31,10,1591,1579,1895,316
2020,12,31,11,1601,1584,1922,338
2020,12,31,12,1634,1614,1926,312
2020,12,31,13,1701,1642,1867,225
2020,12,31,14,1793,1734,1818,84
2020,12,31,15,1821,1770,1858,88
2020,12,31,16,1759,1746,1840,94
2020,12,31,17,1709,1673,1870,197
2020,12,31,18,1648,1621,1989,368
2020,12,31,19,1610,1577,1888,311
2020,12,31,20,1577,1527,1828,301
2020,12,31,21,1545,1500,1718,218
2020,12,31,22,1545,1497,1733,236
2020,12,31,23,1583,1530,1676,146
2021,1,1,0,1683,1634,1611,-23
2021,1,1,1,1866,1824,1700,-124
2021,1,1,2,1903,1865,1807,-58
2021,1,1,3,1897,1824,1731,-93
2021,1,1,4,1876,1801,1704,-97
2021,1,1,5,1808,1761,1727,-34
2021,1,1,6,1736,1701,1750,49
2021,1,1,7,1666,1643,1774,131
2021,1,1,8,1624,1597,1801,204
2021,1,1,9,1595,1576,1870,294
2021,1,1,10,1588,1547,1833,286
2021,1,1,11,1582,1550,1818,268
2021,1,1,12,1597,1555,1832,277
2021,1,1,13,1625,1592,1719,127
2021,1,1,14,1682,1631,1718,87
2021,1,1,15,1711,1635,1717,82
2021,1,1,16,1697,1602,1600,-2
2021,1,1,17,1669,1560,1722,162
2021,1,1,18,1630,1539,1883,344
2021,1,1,19,1599,1513,1893,380
2021,1,1,20,1578,1491,1823,332
2021,1,1,21,1551,1478,1789,311
2021,1,1,22,1542,1486,1788,302
2021,1,1,23,1577,1534,1725,191
2021,1,2,0,1673,1635,1668,33
2021,1,2,1,1870,1792,1616,-176
2021,1,2,2,1925,1827,1639,-188
2021,1,2,3,1919,1812,1629,-183
2021,1,2,4,1894,1798,1655,-143
2021,1,2,5,1817,1753,1700,-53
2021,1,2,6,1741,1697,1768,71
2021,1,2,7,1673,1636,1885,249
2021,1,2,8,1613,1609,1921,312
2021,1,2,9,1586,1583,1992,409
2021,1,2,10,1575,1497,1976,479
2021,1,2,11,1572,1500,1998,498
2021,1,2,12,1583,1518,2077,559
2021,1,2,13,1615,1558,2091,533
2021,1,2,14,1659,1618,2144,526
2021,1,2,15,1686,1653,2197,544
2021,1,2,16,1663,1641,2345,704
2021,1,2,17,1617,1605,2290,685
2021,1,2,18,1572,1555,2335,780
2021,1,2,19,1539,1521,2269,748
2021,1,2,20,1498,1488,2133,645
2021,1,2,21,1473,1493,2192,699
2021,1,2,22,1474,1491,2227,736
2021,1,2,23,1511,1506,2214,708
2021,1,3,0,1605,1583,2195,612
2021,1,3,1,1788,1752,2206,454
2021,1,3,2,1842,1820,2288,468
2021,1,3,3,1823,1807,2244,437
2021,1,3,4,1797,1784,2261,477
2021,1,3,5,1754,1731,2233,502
2021,1,3,6,1688,1655,2173,518
2021,1,3,7,1618,1586,2121,535
2021,1,3,8,1568,1529,2145,616
2021,1,3,9,1541,1500,2124,624
2021,1,3,10,1537,1480,2054,574
2021,1,3,11,1540,1487,2111,624
2021,1,3,12,1549,1501,2076,575
2021,1,3,13,1576,1519,2063,544
2021,1,3,14,1618,1574,1999,425
2021,1,3,15,1642,1600,2029,429
2021,1,3,16,1619,1567,2107,540
2021,1,3,17,1572,1517,1993,476
2021,1,3,18,1523,1490,1957,467
2021,1,3,19,1493,1480,1997,517
2021,1,3,20,1470,1470,2064,594
2021,1,3,21,1448,1476,2105,629
2021,1,3,22,1451,1462,2124,662
2021,1,3,23,1487,1487,2173,686
2021,1,4,0,1584,1561,2078,517
2021,1,4,1,1774,1747,2205,458
2021,1,4,2,1832,1818,2282,464
2021,1,4,3,1823,1785,2227,442
2021,1,4,4,1805,1754,2255,501
2021,1,4,5,1751,1701,2182,481
2021,1,4,6,1658,1614,2084,470
2021,1,4,7,1580,1532,2119,587
2021,1,4,8,1526,1479,2123,644
2021,1,4,9,1503,1468,1964,496
2021,1,4,10,1497,1471,2103,632
2021,1,4,11,1507,1484,2138,654
2021,1,4,12,1533,1510,2188,678
2021,1,4,13,1603,1571,2194,623
2021,1,4,14,1712,1667,2245,578
2021,1,4,15,1745,1719,2175,456
2021,1,4,16,1691,1680,2034,354
2021,1,4,17,1630,1630,1878,248
2021,1,4,18,1584,1580,1888,308
2021,1,4,19,1546,1526,1808,282
2021,1,4,20,1518,1491,1747,256
2021,1,4,21,1502,1405,1643,238
2021,1,4,22,1503,1464,1709,245
2021,1,4,23,1541,1481,1682,201
2021,1,5,0,1628,1558,1562,4
2021,1,5,1,1804,1722,1769,47
2021,1,5,2,1853,1779,1930,151
2021,1,5,3,1843,1756,1906,150
2021,1,5,4,1826,1740,1825,85
2021,1,5,5,1763,1684,1843,159
2021,1,5,6,1661,1613,1854,241
2021,1,5,7,1572,1533,1921,388
2021,1,5,8,1500,1498,1966,468
2021,1,5,9,1482,1477,1962,485
2021,1,5,10,1480,1482,2026,544
2021,1,5,11,1484,1484,2076,592
2021,1,5,12,1521,1523,2090,567
2021,1,5,13,1599,1581,2183,602
2021,1,5,14,1709,1688,2322,634
2021,1,5,15,1730,1732,2348,616
2021,1,5,16,1661,1686,2439,753
2021,1,5,17,1596,1637,2336,699
2021,1,5,18,1551,1583,2302,719
2021,1,5,19,1513,1536,2252,716
2021,1,5,20,1488,1505,2135,630
2021,1,5,21,1469,1488,2129,641
2021,1,5,22,1472,1490,2122,632
2021,1,5,23,1503,1530,2214,684
2021,1,6,0,1593,1584,2192,608
2021,1,6,1,1772,1742,2403,661
2021,1,6,2,1819,1795,2439,644
2021,1,6,3,1810,1774,2362,588
2021,1,6,4,1791,1758,2323,565
2021,1,6,5,1733,1698,2327,629
2021,1,6,6,1639,1613,2225,612
2021,1,6,7,1556,1543,2120,577
2021,1,6,8,1516,1494,2030,536
2021,1,6,9,1495,1480,1945,465
2021,1,6,10,1493,1477,1865,388
2021,1,6,11,1502,1491,1896,405
2021,1,6,12,1537,1520,1903,383
2021,1,6,13,1613,1596,2000,404
2021,1,6,14,1725,1700,2064,364
2021,1,6,15,1763,1759,2173,414
2021,1,6,16,1706,1713,2100,387
2021,1,6,17,1642,1655,2019,364
2021,1,6,18,1593,1609,1905,296
2021,1,6,19,1559,1558,1841,283
2021,1,6,20,1528,1517,1885,368
2021,1,6,21,1507,1493,1941,448
2021,1,6,22,1514,1488,1931,443
2021,1,6,23,1544,1513,1875,362
2021,1,7,0,1627,1572,1954,382
2021,1,7,1,1802,1733,2023,290
2021,1,7,2,1854,1788,2033,245
2021,1,7,3,1846,1787,2004,217
2021,1,7,4,1828,1767,1896,129
2021,1,7,5,1774,1713,1843,130
2021,1,7,6,1683,1625,1925,300
2021,1,7,7,1597,1548,2037,489
2021,1,7,8,1550,1505,2066,561
2021,1,7,9,1534,1490,2021,531
2021,1,7,10,1529,1495,1907,412
2021,1,7,11,1542,1500,1853,353
2021,1,7,12,1581,1530,1875,345
2021,1,7,13,1658,1611,1907,296
2021,1,7,14,1760,1711,1869,158
2021,1,7,15,1778,1755,1732,-23
2021,1,7,16,1709,1715,1774,59
2021,1,7,17,1630,1643,1745,102
2021,1,7,18,1574,1575,1707,132
2021,1,7,19,1534,1522,1755,233
2021,1,7,20,1502,1483,1652,169
2021,1,7,21,1481,1455,1599,144
2021,1,7,22,1483,1449,1588,139
2021,1,7,23,1514,1474,1623,149
2021,1,8,0,1593,1541,1576,35
2021,1,8,1,1764,1683,1671,-12
2021,1,8,2,1828,1744,1664,-80
2021,1,8,3,1823,1735,1604,-131
2021,1,8,4,1807,1721,1574,-147
2021,1,8,5,1749,1665,1589,-76
2021,1,8,6,1662,1620,1694,74
2021,1,8,7,1580,1535,1614,79
2021,1,8,8,1521,1477,1668,191
2021,1,8,9,1502,1461,1631,170
2021,1,8,10,1498,1452,1734,282
2021,1,8,11,1504,1463,1731,268
2021,1,8,12,1539,1489,1694,205
2021,1,8,13,1610,1570,1718,148
2021,1,8,14,1714,1676,1745,69
2021,1,8,15,1749,1741,1852,111
2021,1,8,16,1687,1692,1840,148
2021,1,8,17,1614,1624,1828,204
2021,1,8,18,1560,1565,1654,89
2021,1,8,19,1511,1514,1617,103
2021,1,8,20,1481,1485,1580,95
2021,1,8,21,1459,1458,1598,140
2021,1,8,22,1455,1455,1596,141
2021,1,8,23,1491,1462,1534,72
2021,1,9,0,1568,1528,1572,44
2021,1,9,1,1733,1670,1739,69
2021,1,9,2,1779,1716,1905,189
2021,1,9,3,1765,1712,1909,197
2021,1,9,4,1758,1697,1853,156
2021,1,9,5,1720,1663,1788,125
2021,1,9,6,1652,1602,1703,101
2021,1,9,7,1577,1531,1695,164
2021,1,9,8,1550,1482,1678,196
2021,1,9,9,1519,1458,1622,164
2021,1,9,10,1509,1445,1672,227
2021,1,9,11,1510,1447,1661,214
2021,1,9,12,1524,1460,1676,216
2021,1,9,13,1556,1502,1700,198
2021,1,9,14,1595,1567,1743,176
2021,1,9,15,1631,1592,1873,281
2021,1,9,16,1621,1573,1932,359
2021,1,9,17,1578,1587,1962,375
2021,1,9,18,1543,1574,1873,299
2021,1,9,19,1516,1553,1929,376
2021,1,9,20,1488,1551,1982,431
2021,1,9,21,1470,1542,1965,423
2021,1,9,22,1472,1571,1918,347
2021,1,9,23,1506,1629,1887,258
2021,1,10,0,1597,1721,1891,170
2021,1,10,1,1761,1827,1952,125
2021,1,10,2,1820,1846,1866,20
2021,1,10,3,1800,1811,1838,27
2021,1,10,4,1777,1772,1911,139
2021,1,10,5,1735,1721,1919,198
2021,1,10,6,1673,1639,1926,287
2021,1,10,7,1607,1567,1904,337
2021,1,10,8,1564,1517,1925,408
2021,1,10,9,1532,1489,1830,341
2021,1,10,10,1524,1475,1767,292
2021,1,10,11,1528,1476,1730,254
2021,1,10,12,1543,1484,1772,288
2021,1,10,13,1567,1529,1822,293
2021,1,10,14,1609,1582,1809,227
2021,1,10,15,1643,1619,1818,199
2021,1,10,16,1642,1635,1813,178
2021,1,10,17,1620,1606,1669,63
2021,1,10,18,1588,1568,1638,70
2021,1,10,19,1574,1541,1605,64
2021,1,10,20,1548,1567,1580,13
2021,1,10,21,1533,1600,1627,27
2021,1,10,22,1532,1585,1630,45
2021,1,10,23,1564,1590,1520,-70
2021,1,11,0,1652,1660,1514,-146
2021,1,11,1,1817,1817,1675,-142
2021,1,11,2,1887,1879,1753,-126
2021,1,11,3,1875,1864,1703,-161
2021,1,11,4,1846,1840,1685,-155
2021,1,11,5,1792,1771,1731,-40
2021,1,11,6,1709,1682,1737,55
2021,1,11,7,1629,1613,1732,119
2021,1,11,8,1587,1555,1800,245
2021,1,11,9,1566,1545,1822,277
2021,1,11,10,1558,1542,1834,292
2021,1,11,11,1573,1546,1819,273
2021,1,11,12,1605,1587,1809,222
2021,1,11,13,1668,1662,1819,157
2021,1,11,14,1770,1771,1896,125
2021,1,11,15,1817,1835,1974,139
2021,1,11,16,1773,1801,2032,231
2021,1,11,17,1717,1733,1761,28
2021,1,11,18,1663,1680,1786,106
2021,1,11,19,1618,1629,1679,50
2021,1,11,20,1581,1587,1592,5
2021,1,11,21,1553,1548,1589,41
2021,1,11,22,1541,1533,1519,-14
2021,1,11,23,1574,1553,1512,-41
2021,1,12,0,1656,1635,1628,-7
2021,1,12,1,1828,1791,1782,-9
2021,1,12,2,1891,1868,1789,-79
2021,1,12,3,1886,1859,1819,-40
2021,1,12,4,1873,1843,1797,-46
2021,1,12,5,1807,1779,1866,87
2021,1,12,6,1720,1690,1933,243
2021,1,12,7,1632,1622,2012,390
2021,1,12,8,1584,1592,1977,385
2021,1,12,9,1565,1567,1970,403
2021,1,12,10,1562,1564,2007,443
2021,1,12,11,1572,1579,2017,438
2021,1,12,12,1614,1608,2013,405
2021,1,12,13,1693,1680,2042,362
2021,1,12,14,1803,1799,2060,261
2021,1,12,15,1838,1843,2096,253
2021,1,12,16,1775,1808,2192,384
2021,1,12,17,1698,1729,2175,446
2021,1,12,18,1630,1662,2021,359
2021,1,12,19,1576,1607,1978,371
2021,1,12,20,1541,1558,1930,372
2021,1,12,21,1524,1524,1941,417
2021,1,12,22,1511,1508,1935,427
2021,1,12,23,1532,1532,1923,391
2021,1,13,0,1612,1599,1897,298
2021,1,13,1,1779,1749,2135,386
2021,1,13,2,1845,1824,2184,360
2021,1,13,3,1843,1824,2161,337
2021,1,13,4,1833,1817,2160,343
2021,1,13,5,1773,1763,2185,422
2021,1,13,6,1689,1677,2222,545
2021,1,13,7,1604,1616,2191,575
2021,1,13,8,1562,1557,2153,596
2021,1,13,9,1551,1526,2127,601
2021,1,13,10,1547,1519,2166,647
2021,1,13,11,1560,1530,2179,649
2021,1,13,12,1612,1574,2152,578
2021,1,13,13,1693,1631,2149,518
2021,1,13,14,1796,1722,2237,515
2021,1,13,15,1828,1776,2279,503
2021,1,13,16,1758,1724,2428,704
2021,1,13,17,1673,1642,2294,652
2021,1,13,18,1609,1592,2287,695
2021,1,13,19,1560,1555,2270,715
2021,1,13,20,1527,1501,2219,718
2021,1,13,21,1505,1458,2167,709
2021,1,13,22,1502,1460,2165,705
2021,1,13,23,1529,1489,2133,644
2021,1,14,0,1600,1573,2183,610
2021,1,14,1,1751,1720,2214,494
2021,1,14,2,1819,1758,2244,486
2021,1,14,3,1819,1738,2278,540
2021,1,14,4,1795,1716,2295,579
2021,1,14,5,1724,1673,2248,575
2021,1,14,6,1645,1593,2159,566
2021,1,14,7,1568,1524,2085,561
2021,1,14,8,1459,1476,1987,511
2021,1,14,9,1443,1474,2072,598
2021,1,14,10,1438,1468,2079,611
2021,1,14,11,1437,1473,2074,601
2021,1,14,12,1456,1500,2069,569
2021,1,14,13,1514,1551,2028,477
2021,1,14,14,1638,1662,2069,407
2021,1,14,15,1690,1707,2224,517
2021,1,14,16,1648,1680,2250,570
2021,1,14,17,1591,1629,2119,490
2021,1,14,18,1551,1588,2020,432
2021,1,14,19,1517,1546,2067,521
2021,1,14,20,1489,1480,2037,557
2021,1,14,21,1470,1462,1988,526
2021,1,14,22,1477,1449,1998,549
2021,1,14,23,1506,1478,2026,548
2021,1,15,0,1591,1531,1998,467
2021,1,15,1,1747,1694,2209,515
2021,1,15,2,1765,1760,2270,510
2021,1,15,3,1761,1751,2239,488
2021,1,15,4,1767,1728,2225,497
2021,1,15,5,1712,1674,2307,633
2021,1,15,6,1620,1610,2249,639
2021,1,15,7,1536,1538,2092,554
2021,1,15,8,1508,1469,2017,548
2021,1,15,9,1489,1450,1951,501
2021,1,15,10,1483,1448,1833,385
2021,1,15,11,1492,1455,1804,349
2021,1,15,12,1527,1490,1891,401
2021,1,15,13,1601,1557,1957,400
2021,1,15,14,1712,1656,1974,318
2021,1,15,15,1747,1709,2044,335
2021,1,15,16,1683,1671,2083,412
2021,1,15,17,1612,1603,2097,494
2021,1,15,18,1557,1544,2067,523
2021,1,15,19,1524,1518,1990,472
2021,1,15,20,1494,1471,1888,417
2021,1,15,21,1468,1441,1798,357
2021,1,15,22,1459,1432,1818,386
2021,1,15,23,1497,1450,1814,364
2021,1,16,0,1577,1515,1755,240
2021,1,16,1,1717,1649,1873,224
2021,1,16,2,1765,1717,2118,401
2021,1,16,3,1751,1710,2056,346
2021,1,16,4,1749,1689,2106,417
2021,1,16,5,1709,1647,2096,449
2021,1,16,6,1645,1585,1985,400
2021,1,16,7,1576,1525,1870,345
2021,1,16,8,1517,1479,1840,361
2021,1,16,9,1493,1455,1874,419
2021,1,16,10,1490,1447,1925,478
2021,1,16,11,1494,1454,1989,535
2021,1,16,12,1508,1470,2004,534
2021,1,16,13,1537,1515,2035,520
2021,1,16,14,1591,1561,2049,488
2021,1,16,15,1629,1597,2135,538
2021,1,16,16,1595,1586,2253,667
2021,1,16,17,1537,1564,2243,679
2021,1,16,18,1491,1514,2250,736
2021,1,16,19,1454,1448,2025,577
2021,1,16,20,1426,1407,1968,561
2021,1,16,21,1405,1394,1957,563
2021,1,16,22,1407,1390,1986,596
2021,1,16,23,1437,1423,2058,635
2021,1,17,0,1519,1483,1855,372
2021,1,17,1,1677,1624,1763,139
2021,1,17,2,1739,1707,1748,41
2021,1,17,3,1723,1704,1705,1
2021,1,17,4,1702,1685,1710,25
2021,1,17,5,1667,1622,1789,167
2021,1,17,6,1611,1555,1705,150
2021,1,17,7,1548,1486,1878,392
2021,1,17,8,1513,1437,1965,528
2021,1,17,9,1488,1428,1957,529
2021,1,17,10,1485,1418,1952,534
2021,1,17,11,1490,1429,1959,530
2021,1,17,12,1503,1442,1952,510
2021,1,17,13,1533,1478,1915,437
2021,1,17,14,1573,1527,1878,351
2021,1,17,15,1609,1559,1943,384
2021,1,17,16,1589,1533,2007,474
2021,1,17,17,1532,1486,1868,382
2021,1,17,18,1487,1440,1879,439
2021,1,17,19,1456,1399,1907,508
2021,1,17,20,1435,1375,1894,519
2021,1,17,21,1418,1365,1943,578
2021,1,17,22,1416,1367,1974,607
2021,1,17,23,1451,1387,2000,613
2021,1,18,0,1531,1466,1975,509
2021,1,18,1,1692,1611,2013,402
2021,1,18,2,1758,1689,2087,398
2021,1,18,3,1755,1685,2001,316
2021,1,18,4,1733,1665,2062,397
2021,1,18,5,1684,1627,2075,448
2021,1,18,6,1604,1562,2064,502
2021,1,18,7,1533,1503,2161,658
2021,1,18,8,1481,1472,2058,586
2021,1,18,9,1461,1452,2116,664
2021,1,18,10,1460,1445,2062,617
2021,1,18,11,1471,1449,1995,546
2021,1,18,12,1509,1467,2010,543
2021,1,18,13,1583,1548,2021,473
2021,1,18,14,1692,1599,1987,388
2021,1,18,15,1723,1629,2009,380
2021,1,18,16,1666,1607,1904,297
2021,1,18,17,1604,1576,1839,263
2021,1,18,18,1561,1560,1859,299
2021,1,18,19,1527,1540,1876,336
2021,1,18,20,1494,1573,1987,414
2021,1,18,21,1473,1599,2011,412
2021,1,18,22,1471,1575,1987,412
2021,1,18,23,1504,1589,1984,395
2021,1,19,0,1572,1641,2042,401
2021,1,19,1,1711,1758,2114,356
2021,1,19,2,1762,1790,2162,372
2021,1,19,3,1760,1768,2155,387
2021,1,19,4,1737,1736,2183,447
2021,1,19,5,1676,1694,2198,504
2021,1,19,6,1590,1610,2197,587
2021,1,19,7,1511,1552,2134,582
2021,1,19,8,1468,1505,2091,586
2021,1,19,9,1449,1467,2062,595
2021,1,19,10,1442,1457,2015,558
2021,1,19,11,1451,1463,2020,557
2021,1,19,12,1483,1505,2012,507
2021,1,19,13,1558,1573,2053,480
2021,1,19,14,1670,1681,2182,501
2021,1,19,15,1736,1754,2208,454
2021,1,19,16,1721,1774,2174,400
2021,1,19,17,1692,1773,2156,383
2021,1,19,18,1675,1758,2245,487
2021,1,19,19,1651,1765,2234,469
2021,1,19,20,1629,1733,2176,443
2021,1,19,21,1617,1722,2150,428
2021,1,19,22,1612,1702,2089,387
2021,1,19,23,1643,1749,2041,292
2021,1,20,0,1701,1780,1922,142
2021,1,20,1,1827,1888,1834,-54
2021,1,20,2,1870,1928,1786,-142
2021,1,20,3,1858,1895,1724,-171
2021,1,20,4,1830,1871,1644,-227
2021,1,20,5,1764,1798,1580,-218
2021,1,20,6,1671,1694,1557,-137
2021,1,20,7,1591,1605,1538,-67
2021,1,20,8,1519,1550,1487,-63
2021,1,20,9,1495,1519,1492,-27
2021,1,20,10,1490,1506,1538,32
2021,1,20,11,1495,1504,1610,106
2021,1,20,12,1529,1514,1690,176
2021,1,20,13,1605,1564,1746,182
2021,1,20,14,1707,1670,1664,-6
2021,1,20,15,1756,1749,1841,92
2021,1,20,16,1712,1767,2017,250
2021,1,20,17,1655,1784,2034,250
2021,1,20,18,1605,1750,2030,280
2021,1,20,19,1559,1720,1965,245
2021,1,20,20,1534,1670,1936,266
2021,1,20,21,1514,1617,2066,449
2021,1,20,22,1504,1554,2063,509
2021,1,20,23,1529,1564,2124,560
2021,1,21,0,1597,1608,2045,437
2021,1,21,1,1742,1746,2098,352
2021,1,21,2,1799,1821,2116,295
2021,1,21,3,1795,1800,2140,340
2021,1,21,4,1768,1768,2081,313
2021,1,21,5,1714,1712,1982,270
2021,1,21,6,1624,1623,1988,365
2021,1,21,7,1552,1552,2014,462
2021,1,21,8,1516,1506,2043,537
2021,1,21,9,1485,1486,2028,542
2021,1,21,10,1480,1471,1950,479
2021,1,21,11,1495,1478,1874,396
2021,1,21,12,1534,1498,1889,391
2021,1,21,13,1611,1558,1911,353
2021,1,21,14,1716,1661,1893,232
2021,1,21,15,1766,1714,1955,241
2021,1,21,16,1717,1678,2016,338
2021,1,21,17,1656,1604,1893,289
2021,1,21,18,1609,1545,1822,277
2021,1,21,19,1571,1485,1925,440
2021,1,21,20,1545,1457,1866,409
2021,1,21,21,1529,1454,1828,374
2021,1,21,22,1533,1463,1964,501
2021,1,21,23,1560,1497,2049,552
2021,1,22,0,1624,1541,1884,343
2021,1,22,1,1752,1649,1987,338
2021,1,22,2,1810,1725,2025,300
2021,1,22,3,1805,1710,1920,210
2021,1,22,4,1794,1688,2035,347
2021,1,22,5,1734,1644,2102,458
2021,1,22,6,1646,1562,2066,504
2021,1,22,7,1554,1495,1926,431
2021,1,22,8,1502,1442,1849,407
2021,1,22,9,1478,1431,1776,345
2021,1,22,10,1471,1428,1784,356
2021,1,22,11,1484,1429,1805,376
2021,1,22,12,1501,1454,1678,224
2021,1,22,13,1561,1522,1715,193
2021,1,22,14,1670,1631,1712,81
2021,1,22,15,1715,1692,1717,25
2021,1,22,16,1673,1652,1762,110
2021,1,22,17,1618,1588,1730,142
2021,1,22,18,1570,1534,1749,215
2021,1,22,19,1529,1483,1847,364
2021,1,22,20,1499,1458,1943,485
2021,1,22,21,1475,1431,1985,554
2021,1,22,22,1463,1426,1905,479
2021,1,22,23,1486,1451,1858,407
2021,1,23,0,1553,1510,1786,276
2021,1,23,1,1676,1616,1787,171
2021,1,23,2,1736,1686,1898,212
2021,1,23,3,1717,1659,1974,315
2021,1,23,4,1707,1636,1987,351
2021,1,23,5,1665,1589,1934,345
2021,1,23,6,1597,1528,1949,421
2021,1,23,7,1529,1456,1910,454
2021,1,23,8,1470,1437,1912,475
2021,1,23,9,1444,1373,1859,486
2021,1,23,10,1430,1366,1886,520
2021,1,23,11,1430,1361,1885,524
2021,1,23,12,1442,1376,1919,543
2021,1,23,13,1463,1412,1939,527
2021,1,23,14,1514,1480,1955,475
2021,1,23,15,1569,1512,1981,469
2021,1,23,16,1570,1496,2073,577
2021,1,23,17,1545,1482,2157,675
2021,1,23,18,1510,1450,2164,714
2021,1,23,19,1486,1452,2127,675
2021,1,23,20,1455,1457,2148,691
2021,1,23,21,1437,1428,2126,698
2021,1,23,22,1432,1416,2096,680
2021,1,23,23,1462,1443,2124,681
2021,1,24,0,1533,1506,2088,582
2021,1,24,1,1665,1617,2009,392
2021,1,24,2,1719,1693,1976,283
2021,1,24,3,1703,1677,2085,408
2021,1,24,4,1677,1639,2078,439
2021,1,24,5,1638,1596,2090,494
2021,1,24,6,1573,1535,2110,575
2021,1,24,7,1517,1462,2056,594
2021,1,24,8,1480,1423,1961,538
2021,1,24,9,1453,1393,1774,381
2021,1,24,10,1443,1376,1709,333
2021,1,24,11,1438,1367,1654,287
2021,1,24,12,1446,1377,1674,297
2021,1,24,13,1469,1403,1689,286
2021,1,24,14,1513,1449,1661,212
2021,1,24,15,1569,1482,1783,301
2021,1,24,16,1585,1490,1831,341
2021,1,24,17,1565,1485,1839,354
2021,1,24,18,1546,1454,1801,347
2021,1,24,19,1532,1424,1859,435
2021,1,24,20,1523,1413,1940,527
2021,1,24,21,1510,1474,1954,480
2021,1,24,22,1511,1479,1980,501
2021,1,24,23,1545,1532,1927,395
2021,1,25,0,1622,1614,1916,302
2021,1,25,1,1779,1730,1942,212
2021,1,25,2,1835,1790,1947,157
2021,1,25,3,1809,1769,1856,87
2021,1,25,4,1776,1716,1906,190
2021,1,25,5,1716,1646,1924,278
2021,1,25,6,1634,1562,1862,300
2021,1,25,7,1559,1498,1875,377
2021,1,25,8,1508,1463,1897,434
2021,1,25,9,1490,1455,1984,529
2021,1,25,10,1481,1457,2068,611
2021,1,25,11,1491,1462,2083,621
2021,1,25,12,1517,1501,2047,546
2021,1,25,13,1588,1580,2124,544
2021,1,25,14,1701,1689,2193,504
2021,1,25,15,1769,1733,2213,480
2021,1,25,16,1760,1734,2311,577
2021,1,25,17,1728,1728,2330,602
2021,1,25,18,1700,1687,2324,637
2021,1,25,19,1668,1670,2330,660
2021,1,25,20,1642,1657,2350,693
2021,1,25,21,1624,1664,2343,679
2021,1,25,22,1614,1658,2277,619
2021,1,25,23,1638,1666,2188,522
2021,1,26,0,1702,1711,1993,282
2021,1,26,1,1843,1813,1863,50
2021,1,26,2,1900,1873,1927,54
2021,1,26,3,1881,1848,1923,75
2021,1,26,4,1851,1808,1860,52
2021,1,26,5,1786,1740,1810,70
2021,1,26,6,1690,1651,1700,49
2021,1,26,7,1606,1585,1620,35
2021,1,26,8,1546,1537,1724,187
2021,1,26,9,1525,1506,1831,325
2021,1,26,10,1522,1491,1771,280
2021,1,26,11,1529,1492,1829,337
2021,1,26,12,1563,1523,1778,255
2021,1,26,13,1635,1591,1901,310
2021,1,26,14,1753,1695,1988,293
2021,1,26,15,1815,1755,1989,234
2021,1,26,16,1810,1770,1942,172
2021,1,26,17,1790,1755,1993,238
2021,1,26,18,1751,1747,2067,320
2021,1,26,19,1724,1715,2098,383
2021,1,26,20,1702,1709,2108,399
2021,1,26,21,1685,1691,2236,545
2021,1,26,22,1672,1683,2333,650
2021,1,26,23,1700,1691,2282,591
2021,1,27,0,1770,1739,2238,499
2021,1,27,1,1915,1860,2335,475
2021,1,27,2,1959,1937,2402,465
2021,1,27,3,1939,1927,2478,551
2021,1,27,4,1906,1886,2419,533
2021,1,27,5,1838,1828,2413,585
2021,1,27,6,1745,1748,2418,670
2021,1,27,7,1669,1676,2350,674
2021,1,27,8,1623,1620,2239,619
2021,1,27,9,1604,1602,2325,723
2021,1,27,10,1597,1608,2229,621
2021,1,27,11,1605,1613,2192,579
2021,1,27,12,1644,1641,2109,468
2021,1,27,13,1724,1706,2023,317
2021,1,27,14,1835,1815,1918,103
2021,1,27,15,1879,1854,1967,113
2021,1,27,16,1831,1830,1901,71
2021,1,27,17,1762,1760,1924,164
2021,1,27,18,1697,1702,1905,203
2021,1,27,19,1644,1652,1957,305
2021,1,27,20,1603,1594,1950,356
2021,1,27,21,1579,1553,1873,320
2021,1,27,22,1565,1545,1913,368
2021,1,27,23,1593,1550,1921,371
2021,1,28,0,1678,1613,1812,199
2021,1,28,1,1824,1753,1833,80
2021,1,28,2,1891,1892,1882,-10
2021,1,28,3,1885,1880,1849,-31
2021,1,28,4,1861,1846,1807,-39
2021,1,28,5,1797,1792,1626,-166
2021,1,28,6,1711,1713,1554,-159
2021,1,28,7,1634,1628,1586,-42
2021,1,28,8,1593,1580,1600,20
2021,1,28,9,1574,1559,1672,113
2021,1,28,10,1573,1560,1766,206
2021,1,28,11,1583,1559,1776,217
2021,1,28,12,1609,1598,1813,215
2021,1,28,13,1684,1673,1757,84
2021,1,28,14,1791,1779,1756,-23
2021,1,28,15,1835,1837,1804,-33
2021,1,28,16,1778,1842,1922,80
2021,1,28,17,1701,1795,2006,211
2021,1,28,18,1641,1755,2039,284
2021,1,28,19,1594,1724,1898,174
2021,1,28,20,1566,1663,1870,207
2021,1,28,21,1541,1615,1857,242
2021,1,28,22,1528,1593,1881,288
2021,1,28,23,1546,1586,1786,200
2021,1,29,0,1613,1632,1867,235
2021,1,29,1,1747,1739,1942,203
2021,1,29,2,1820,1829,2034,205
2021,1,29,3,1815,1814,2014,200
2021,1,29,4,1798,1787,1983,196
2021,1,29,5,1746,1715,2035,320
2021,1,29,6,1665,1634,2098,464
2021,1,29,7,1586,1558,2017,459
2021,1,29,8,1533,1508,1949,441
2021,1,29,9,1505,1496,1921,425
2021,1,29,10,1495,1500,1994,494
2021,1,29,11,1503,1507,1981,474
2021,1,29,12,1535,1527,1908,381
2021,1,29,13,1608,1581,1782,201
2021,1,29,14,1714,1679,1873,194
2021,1,29,15,1748,1747,1949,202
2021,1,29,16,1699,1768,1968,200
2021,1,29,17,1634,1741,1970,229
2021,1,29,18,1584,1699,2039,340
2021,1,29,19,1539,1649,2089,440
2021,1,29,20,1498,1607,2126,519
2021,1,29,21,1479,1548,2121,573
2021,1,29,22,1464,1577,2219,642
2021,1,29,23,1491,1552,2255,703
2021,1,30,0,1560,1590,2135,545
2021,1,30,1,1661,1690,2185,495
2021,1,30,2,1743,1771,2331,560
2021,1,30,3,1725,1747,2280,533
2021,1,30,4,1714,1717,2185,468
2021,1,30,5,1674,1674,2220,546
2021,1,30,6,1607,1601,2185,584
2021,1,30,7,1539,1543,2180,637
2021,1,30,8,1500,1483,2070,587
2021,1,30,9,1470,1482,2260,778
2021,1,30,10,1465,1459,2266,807
2021,1,30,11,1464,1468,2241,773
2021,1,30,12,1478,1495,2249,754
2021,1,30,13,1513,1522,2252,730
2021,1,30,14,1565,1573,2322,749
2021,1,30,15,1613,1598,2305,707
2021,1,30,16,1624,1601,2389,788
2021,1,30,17,1599,1565,2341,776
2021,1,30,18,1563,1545,2349,804
2021,1,30,19,1540,1491,2302,811
2021,1,30,20,1508,1473,2306,833
2021,1,30,21,1486,1436,2299,863
2021,1,30,22,1477,1412,2262,850
2021,1,30,23,1504,1431,2286,855
2021,1,31,0,1581,1492,2211,719
2021,1,31,1,1696,1614,2148,534
2021,1,31,2,1777,1723,2198,475
2021,1,31,3,1764,1725,2176,451
2021,1,31,4,1735,1707,2188,481
2021,1,31,5,1689,1654,2207,553
2021,1,31,6,1632,1594,2107,513
2021,1,31,7,1571,1537,2062,525
2021,1,31,8,1543,1480,2004,524
2021,1,31,9,1524,1473,2005,532
2021,1,31,10,1518,1467,1957,490
2021,1,31,11,1523,1467,1870,403
2021,1,31,12,1531,1485,1814,329
2021,1,31,13,1531,1529,1770,241
2021,1,31,14,1605,1588,1833,245
2021,1,31,15,1638,1617,1847,230
2021,1,31,16,1631,1581,1842,261
2021,1,31,17,1578,1538,1833,295
2021,1,31,18,1530,1499,1792,293
2021,1,31,19,1495,1441,1766,325
2021,1,31,20,1468,1400,1726,326
2021,1,31,21,1448,1372,1722,350
2021,1,31,22,1438,1368,1751,383
2021,1,31,23,1466,1396,1716,320
2021,2,1,0,1546,1474,1676,202
2021,2,1,1,1684,1603,1741,138
2021,2,1,2,1776,1717,1813,96
2021,2,1,3,1772,1714,1784,70
2021,2,1,4,1749,1702,1723,21
2021,2,1,5,1696,1652,1680,28
2021,2,1,6,1620,1585,1634,49
2021,2,1,7,1550,1500,1642,142
2021,2,1,8,1514,1514,1670,156
2021,2,1,9,1497,1439,1563,124
2021,2,1,10,1495,1434,1522,88
2021,2,1,11,1509,1453,1469,16
2021,2,1,12,1539,1504,1473,-31
2021,2,1,13,1616,1585,1516,-69
2021,2,1,14,1718,1679,1635,-44
2021,2,1,15,1762,1734,1699,-35
2021,2,1,16,1723,1693,1805,112
2021,2,1,17,1661,1668,1775,107
2021,2,1,18,1615,1652,1801,149
2021,2,1,19,1574,1603,1908,305
2021,2,1,20,1540,1565,1999,434
2021,2,1,21,1521,1565,2052,487
2021,2,1,22,1511,1603,2090,487
2021,2,1,23,1536,1644,2132,488
2021,2,2,0,1599,1678,2121,443
2021,2,2,1,1714,1779,2135,356
2021,2,2,2,1796,1872,2315,443
2021,2,2,3,1791,1858,2323,465
2021,2,2,4,1770,1798,2180,382
2021,2,2,5,1706,1746,2099,353
2021,2,2,6,1622,1686,1996,310
2021,2,2,7,1544,1637,2019,382
2021,2,2,8,1446,1615,2003,388
2021,2,2,9,1427,1595,1993,398
2021,2,2,10,1422,1592,2025,433
2021,2,2,11,1428,1591,2059,468
2021,2,2,12,1467,1607,2104,497
2021,2,2,13,1548,1664,2062,398
2021,2,2,14,1656,1750,2117,367
2021,2,2,15,1691,1755,2140,385
2021,2,2,16,1642,1686,2042,356
2021,2,2,17,1586,1585,1974,389
2021,2,2,18,1543,1522,1996,474
2021,2,2,19,1500,1521,2029,508
2021,2,2,20,1472,1498,2071,573
2021,2,2,21,1462,1513,1919,406
2021,2,2,22,1458,1507,1839,332
2021,2,2,23,1480,1534,1847,313
2021,2,3,0,1542,1550,1714,164
2021,2,3,1,1640,1612,1562,-50
2021,2,3,2,1723,1680,1527,-153
2021,2,3,3,1720,1664,1602,-62
2021,2,3,4,1694,1651,1698,47
2021,2,3,5,1630,1628,1754,126
2021,2,3,6,1544,1579,1715,136
2021,2,3,7,1455,1489,1683,194
2021,2,3,8,1391,1344,1619,275
2021,2,3,9,1367,1328,1640,312
2021,2,3,10,1362,1322,1688,366
2021,2,3,11,1369,1321,1735,414
2021,2,3,12,1404,1354,1827,473
2021,2,3,13,1491,1430,1863,433
2021,2,3,14,1597,1525,1930,405
2021,2,3,15,1631,1579,2007,428
2021,2,3,16,1594,1559,2007,448
2021,2,3,17,1551,1529,2106,577
2021,2,3,18,1522,1490,2106,616
2021,2,3,19,1480,1474,2134,660
2021,2,3,20,1457,1484,2135,651
2021,2,3,21,1450,1494,2132,638
2021,2,3,22,1461,1501,2123,622
2021,2,3,23,1483,1516,2103,587
2021,2,4,0,1540,1550,2040,490
2021,2,4,1,1635,1615,2080,465
2021,2,4,2,1696,1688,2152,464
2021,2,4,3,1683,1661,2138,477
2021,2,4,4,1649,1629,2099,470
2021,2,4,5,1591,1574,2123,549
2021,2,4,6,1501,1486,2100,614
2021,2,4,7,1427,1414,1960,546
2021,2,4,8,1384,-9999,-9999,-9999
2021,2,4,9,1359,-9999,-9999,-9999
2021,2,4,10,1356,-9999,-9999,-9999
2021,2,4,11,1363,-9999,-9999,-9999
2021,2,4,12,1396,-9999,-9999,-9999
2021,2,4,13,1479,-9999,-9999,-9999
2021,2,4,14,1591,-9999,-9999,-9999
2021,2,4,15,1640,-9999,-9999,-9999
2021,2,4,16,1625,-9999,-9999,-9999
2021,2,4,17,1590,-9999,-9999,-9999
2021,2,4,18,1558,-9999,-9999,-9999
2021,2,4,19,1528,-9999,-9999,-9999
2021,2,4,20,1511,-9999,-9999,-9999
2021,2,4,21,1500,-9999,-9999,-9999
2021,2,4,22,1501,-9999,-9999,-9999
2021,2,4,23,1518,-9999,-9999,-9999
2021,2,5,0,1584,-9999,-9999,-9999
2021,2,5,1,1698,-9999,-9999,-9999
2021,2,5,2,1759,-9999,-9999,-9999
2021,2,5,3,1752,-9999,-9999,-9999
2021,2,5,4,1731,-9999,-9999,-9999
2021,2,5,5,1671,-9999,-9999,-9999
2021,2,5,6,1586,-9999,-9999,-9999
2021,2,5,7,1509,-9999,-9999,-9999
