Year,Month,Day,Hour,Forecast_Demand_MWh,Adjusted_Demand_MWh,Adjusted_Generation_MWh,Adjusted_Interchange_MWh
2015,7,1,8,1900,3066,2232,-834
2015,7,1,9,1874,2865,2069,-796
2015,7,1,10,1852,2735,1909,-826
2015,7,1,11,1837,2710,1839,-871
2015,7,1,12,1830,2752,1808,-944
2015,7,1,13,1829,2911,1974,-937
2015,7,1,14,1890,2975,1645,-1330
2015,7,1,15,1967,3198,1692,-1506
2015,7,1,16,2151,3366,1686,-1680
2015,7,1,17,2208,3658,1885,-1773
2015,7,1,18,2308,3828,2024,-1804
2015,7,1,19,2547,3938,2191,-1747
2015,7,1,20,2561,3975,2211,-1764
2015,7,1,21,2561,4073,2302,-1771
2015,7,1,22,2561,4146,2346,-1800
2015,7,1,23,2611,4216,2397,-1819
2015,7,2,0,2611,4257,2403,-1854
2015,7,2,1,2612,4288,2418,-1870
2015,7,2,2,2611,4240,2408,-1832
2015,7,2,3,2558,4142,2329,-1813
2015,7,2,4,2494,4040,2242,-1798
2015,7,2,5,2506,3939,2172,-1767
2015,7,2,6,2498,3799,2430,-1369
2015,7,2,7,2430,3449,2379,-1070
2015,7,2,8,1668,3161,2067,-1094
2015,7,2,9,1675,2950,1874,-1076
2015,7,2,10,1571,2818,1736,-1082
2015,7,2,11,1577,2742,1691,-1051
2015,7,2,12,1806,2698,1751,-947
2015,7,2,13,1802,2803,1843,-960
2015,7,2,14,1797,2964,1658,-1306
2015,7,2,15,2108,3273,1976,-1297
2015,7,2,16,2255,3531,2170,-1361
2015,7,2,17,2448,3712,2236,-1476
2015,7,2,18,2580,3848,2427,-1421
2015,7,2,19,2660,3924,2515,-1409
2015,7,2,20,2723,3966,2422,-1544
2015,7,2,21,2768,4029,2451,-1578
2015,7,2,22,2826,4078,2468,-1610
2015,7,2,23,2859,4112,2389,-1723
2015,7,3,0,2859,4137,2427,-1710
2015,7,3,1,2860,4137,2362,-1775
2015,7,3,2,2872,4072,2356,-1716
2015,7,3,3,2774,3934,2217,-1717
2015,7,3,4,2785,3924,2421,-1503
2015,7,3,5,2795,3847,2348,-1499
2015,7,3,6,2795,3672,2343,-1329
2015,7,3,7,2613,3350,2355,-995
2015,7,3,8,2091,3086,2248,-838
2015,7,3,9,1885,2857,1974,-883
2015,7,3,10,1665,2704,1859,-845
2015,7,3,11,1665,2642,1838,-804
2015,7,3,12,1665,2628,1817,-811
2015,7,3,13,1665,2669,1898,-771
2015,7,3,14,1643,2783,1864,-919
2015,7,3,15,1759,3043,1876,-1167
2015,7,3,16,1746,3292,2021,-1271
2015,7,3,17,1914,3475,2091,-1384
2015,7,3,18,2146,3636,2262,-1374
2015,7,3,19,2478,3750,2346,-1404
2015,7,3,20,2483,3806,2405,-1401
2015,7,3,21,2498,3830,2426,-1404
2015,7,3,22,2437,3848,2404,-1444
2015,7,3,23,2472,3884,2337,-1547
2015,7,4,0,2501,3915,2342,-1573
2015,7,4,1,2524,3928,2338,-1590
2015,7,4,2,2542,3838,2258,-1580
2015,7,4,3,2453,3808,2139,-1669
2015,7,4,4,2465,3735,2157,-1578
2015,7,4,5,2466,3738,2201,-1537
2015,7,4,6,2300,3585,2239,-1346
2015,7,4,7,2201,3296,2113,-1183
2015,7,4,8,1468,2923,1874,-1049
2015,7,4,9,1157,2508,1555,-953
2015,7,4,10,1106,2364,1402,-962
2015,7,4,11,1065,2295,1376,-919
2015,7,4,12,1041,2271,1391,-880
2015,7,4,13,1032,2238,1384,-854
2015,7,4,14,1030,2294,1373,-921
2015,7,4,15,1037,2475,1393,-1082
2015,7,4,16,1699,2718,1434,-1284
2015,7,4,17,1802,2956,1570,-1386
2015,7,4,18,1800,3225,1693,-1532
2015,7,4,19,2140,3326,1732,-1594
2015,7,4,20,2215,3448,1885,-1563
2015,7,4,21,2216,3562,2123,-1439
2015,7,4,22,2218,3639,2167,-1472
2015,7,4,23,2221,3670,2144,-1526
2015,7,5,0,2224,3673,2133,-1540
2015,7,5,1,2216,3612,2207,-1405
2015,7,5,2,2228,3530,2167,-1363
2015,7,5,3,2120,3209,1837,-1372
2015,7,5,4,2139,3087,1805,-1282
2015,7,5,5,2159,3047,1789,-1258
2015,7,5,6,2182,2948,1957,-991
2015,7,5,7,2025,2813,1827,-986
2015,7,5,8,1441,2610,1682,-928
2015,7,5,9,1280,2349,1468,-881
2015,7,5,10,1288,2268,1555,-713
2015,7,5,11,1299,2229,1602,-627
2015,7,5,12,1302,2220,1641,-579
2015,7,5,13,1300,2230,1750,-480
2015,7,5,14,1292,2229,1654,-575
2015,7,5,15,1595,2278,1451,-827
2015,7,5,16,2018,2544,1609,-935
2015,7,5,17,2110,2985,1964,-1021
2015,7,5,18,2286,3210,2122,-1088
2015,7,5,19,2273,3354,2130,-1224
2015,7,5,20,2561,3550,2313,-1237
2015,7,5,21,2548,3699,2393,-1306
2015,7,5,22,2534,3769,2409,-1360
2015,7,5,23,2522,3820,2376,-1444
2015,7,6,0,2511,3852,2377,-1475
2015,7,6,1,2501,3869,2322,-1547
2015,7,6,2,2491,3874,2297,-1577
2015,7,6,3,2369,3813,2063,-1750
2015,7,6,4,2413,3753,2000,-1753
2015,7,6,5,2268,3731,2153,-1578
2015,7,6,6,2400,3526,2176,-1350
2015,7,6,7,2324,3176,1902,-1274
2015,7,6,8,1516,2895,1759,-1136
2015,7,6,9,1376,2595,1586,-1009
2015,7,6,10,1344,2465,1466,-999
2015,7,6,11,1344,2430,1474,-956
2015,7,6,12,1344,2509,1565,-944
2015,7,6,13,1516,2710,1689,-1021
2015,7,6,14,1566,2905,1702,-1203
2015,7,6,15,2010,3154,1795,-1359
2015,7,6,16,2049,3427,2213,-1214
2015,7,6,17,2144,3580,2307,-1273
2015,7,6,18,2654,3735,2515,-1220
2015,7,6,19,2862,3809,2448,-1361
2015,7,6,20,2894,3905,2513,-1392
2015,7,6,21,2951,3972,2585,-1387
2015,7,6,22,2965,3975,2442,-1533
2015,7,6,23,2976,4002,2383,-1619
2015,7,7,0,3031,4016,2331,-1685
2015,7,7,1,3057,4047,2334,-1713
2015,7,7,2,3123,3966,2314,-1652
2015,7,7,3,3052,3834,2179,-1655
2015,7,7,4,3105,3735,2183,-1552
2015,7,7,5,3125,3671,2186,-1485
2015,7,7,6,3139,3509,2434,-1075
2015,7,7,7,2688,3134,2291,-843
2015,7,7,8,2125,2905,2272,-633
2015,7,7,9,1919,2723,2189,-534
2015,7,7,10,1582,2559,1729,-830
2015,7,7,11,1412,2438,1688,-750
2015,7,7,12,1417,2482,1695,-787
2015,7,7,13,1621,2659,1748,-911
2015,7,7,14,1527,2864,1694,-1170
2015,7,7,15,1640,3113,1824,-1289
2015,7,7,16,2117,3266,1928,-1338
2015,7,7,17,2154,3360,1956,-1404
2015,7,7,18,2349,3463,1794,-1669
2015,7,7,19,2792,3619,1915,-1704
2015,7,7,20,2791,3714,1950,-1764
2015,7,7,21,2791,3734,1971,-1763
2015,7,7,22,2837,3810,2104,-1706
2015,7,7,23,2838,3875,2305,-1570
2015,7,8,0,2839,3923,2317,-1606
2015,7,8,1,2840,3919,2191,-1728
2015,7,8,2,2839,3878,2150,-1728
2015,7,8,3,2847,3813,2185,-1628
2015,7,8,4,2814,3762,2274,-1488
2015,7,8,5,2729,3709,2244,-1465
2015,7,8,6,2829,3553,2438,-1115
2015,7,8,7,2417,3217,2364,-853
2015,7,8,8,2266,2948,2186,-762
2015,7,8,9,1614,2667,1846,-821
2015,7,8,10,1620,2593,1792,-801
2015,7,8,11,1624,2556,1751,-805
2015,7,8,12,1585,2631,1833,-798
2015,7,8,13,1589,2770,1976,-794
2015,7,8,14,1595,2901,1847,-1054
2015,7,8,15,2091,3302,2135,-1167
2015,7,8,16,2377,3488,2397,-1091
2015,7,8,17,2388,3592,2399,-1193
2015,7,8,18,2458,3704,2398,-1306
2015,7,8,19,2621,3793,2429,-1364
2015,7,8,20,2981,3878,2414,-1464
2015,7,8,21,2984,3948,2402,-1546
2015,7,8,22,2962,4022,2386,-1636
2015,7,8,23,2945,4094,2391,-1703
2015,7,9,0,2941,4158,2408,-1750
2015,7,9,1,2937,4209,2457,-1752
2015,7,9,2,2932,4151,2434,-1717
2015,7,9,3,2940,4056,2376,-1680
2015,7,9,4,2858,3964,2382,-1582
2015,7,9,5,2763,3889,2327,-1562
2015,7,9,6,2870,3709,2579,-1130
2015,7,9,7,2413,3331,2434,-897
2015,7,9,8,2110,3053,2314,-739
2015,7,9,9,2110,2856,2175,-681
2015,7,9,10,2081,2749,2070,-679
2015,7,9,11,2056,2752,2081,-671
2015,7,9,12,2125,2803,2095,-708
2015,7,9,13,1791,2881,1989,-892
2015,7,9,14,1691,3032,1781,-1251
2015,7,9,15,2136,3281,1907,-1374
2015,7,9,16,2221,3467,2041,-1426
2015,7,9,17,2222,3598,2060,-1538
2015,7,9,18,2372,3702,2165,-1537
2015,7,9,19,2568,3798,2476,-1322
2015,7,9,20,2776,3873,2627,-1246
2015,7,9,21,2926,3965,2904,-1061
2015,7,9,22,2925,4043,2947,-1096
2015,7,9,23,2998,4037,2536,-1501
2015,7,10,0,2998,4089,2548,-1541
2015,7,10,1,2998,4126,2571,-1555
2015,7,10,2,3005,4081,2439,-1642
2015,7,10,3,2908,4016,2478,-1538
2015,7,10,4,2853,3891,2492,-1399
2015,7,10,5,2824,3798,2408,-1390
2015,7,10,6,2835,3622,2588,-1034
2015,7,10,7,2280,3284,2449,-835
2015,7,10,8,2232,3067,2421,-646
2015,7,10,9,2114,2894,2337,-557
2015,7,10,10,2109,2783,2239,-544
2015,7,10,11,2105,2714,2158,-556
2015,7,10,12,2102,2765,2223,-542
2015,7,10,13,2141,2880,2182,-698
2015,7,10,14,2032,2883,1919,-964
2015,7,10,15,2086,3083,1930,-1153
2015,7,10,16,2277,3355,2118,-1237
2015,7,10,17,2587,3449,2183,-1266
2015,7,10,18,2654,3467,2161,-1306
2015,7,10,19,2659,3497,2274,-1223
2015,7,10,20,2920,3493,2450,-1043
2015,7,10,21,2928,3498,2522,-976
2015,7,10,22,2931,3452,2460,-992
2015,7,10,23,2932,3448,2451,-997
2015,7,11,0,2937,3458,2484,-974
2015,7,11,1,2954,3514,2653,-861
2015,7,11,2,2983,3439,2582,-857
2015,7,11,3,2912,3378,2406,-972
2015,7,11,4,2687,3382,2389,-993
2015,7,11,5,2693,3373,2131,-1242
2015,7,11,6,2672,3270,2403,-867
2015,7,11,7,2505,3064,2423,-641
2015,7,11,8,1858,2853,2156,-697
2015,7,11,9,1686,2597,1958,-639
2015,7,11,10,1667,2458,1816,-642
2015,7,11,11,1655,2395,1765,-630
2015,7,11,12,1647,2404,1756,-648
2015,7,11,13,1642,2470,1750,-720
2015,7,11,14,1574,2592,1854,-738
2015,7,11,15,1705,2744,1863,-881
2015,7,11,16,1854,3081,2063,-1018
2015,7,11,17,2022,3221,2138,-1083
2015,7,11,18,2018,3268,2119,-1149
2015,7,11,19,2022,3258,2077,-1181
2015,7,11,20,2359,3271,1987,-1284
2015,7,11,21,2361,3267,2051,-1216
2015,7,11,22,2378,3249,2086,-1163
2015,7,11,23,2405,3252,2154,-1098
2015,7,12,0,2441,3265,2189,-1076
2015,7,12,1,2473,3294,2177,-1117
2015,7,12,2,2496,3253,2124,-1129
2015,7,12,3,2509,3229,2126,-1103
2015,7,12,4,2460,3248,2184,-1064
2015,7,12,5,2460,3081,1934,-1147
2015,7,12,6,2496,2953,1951,-1002
2015,7,12,7,2407,2764,1947,-817
2015,7,12,8,1661,2616,1942,-674
2015,7,12,9,1643,2479,1897,-582
2015,7,12,10,1615,2365,1762,-603
2015,7,12,11,1519,2297,1681,-616
2015,7,12,12,1485,2351,1747,-604
2015,7,12,13,1517,2563,1906,-657
2015,7,12,14,1497,2624,1966,-658
2015,7,12,15,1485,2743,2014,-729
2015,7,12,16,1928,2926,2134,-792
2015,7,12,17,2175,3131,2313,-818
2015,7,12,18,2279,3255,2391,-864
2015,7,12,19,2471,3298,2492,-806
2015,7,12,20,2733,3295,2528,-767
2015,7,12,21,2857,3370,2599,-771
2015,7,12,22,2852,3405,2630,-775
2015,7,12,23,2849,3465,2633,-832
2015,7,13,0,3028,3523,2628,-895
2015,7,13,1,3039,3572,2613,-959
2015,7,13,2,3063,3588,2685,-903
2015,7,13,3,2956,3582,2704,-878
2015,7,13,4,2959,3557,2737,-820
2015,7,13,5,2856,3539,2733,-806
2015,7,13,6,2952,3417,2774,-643
2015,7,13,7,2537,3082,2519,-563
2015,7,13,8,2265,2812,2306,-506
2015,7,13,9,1835,2658,1991,-667
2015,7,13,10,1587,2448,1818,-630
2015,7,13,11,1577,2444,1785,-659
2015,7,13,12,1643,2528,1897,-631
2015,7,13,13,1779,2615,1873,-742
2015,7,13,14,1539,2810,1729,-1081
2015,7,13,15,2067,3170,1893,-1277
2015,7,13,16,2227,3361,2303,-1058
2015,7,13,17,2277,3523,2467,-1056
2015,7,13,18,2396,3573,2425,-1148
2015,7,13,19,2619,3591,2379,-1212
2015,7,13,20,2793,3700,2668,-1032
2015,7,13,21,2846,3725,2792,-933
2015,7,13,22,2819,3805,2999,-806
2015,7,13,23,2873,3816,2989,-827
2015,7,14,0,2840,3819,2954,-865
2015,7,14,1,2846,3852,2966,-886
2015,7,14,2,2821,3836,3020,-816
2015,7,14,3,2703,3726,2693,-1033
2015,7,14,4,2658,3648,2532,-1116
2015,7,14,5,2595,3602,2612,-990
2015,7,14,6,2624,3454,2754,-700
2015,7,14,7,2535,3129,2635,-494
2015,7,14,8,2115,2832,2372,-460
2015,7,14,9,2093,2692,2271,-421
2015,7,14,10,2021,2630,2222,-408
2015,7,14,11,1983,2602,2184,-418
2015,7,14,12,1969,2669,2173,-496
2015,7,14,13,1956,2810,2234,-576
2015,7,14,14,1900,2852,1864,-988
2015,7,14,15,1894,3080,1885,-1195
2015,7,14,16,2465,3420,2154,-1266
2015,7,14,17,2447,3542,2253,-1289
2015,7,14,18,2447,3621,2440,-1181
2015,7,14,19,2458,3677,2447,-1230
2015,7,14,20,2552,3749,2573,-1176
2015,7,14,21,2683,3806,2634,-1172
2015,7,14,22,2707,3850,2712,-1138
2015,7,14,23,2743,3872,2733,-1139
2015,7,15,0,2781,3915,2716,-1199
2015,7,15,1,2817,3942,2782,-1160
2015,7,15,2,2811,3879,2698,-1181
2015,7,15,3,2795,3791,2655,-1136
2015,7,15,4,2649,3711,2627,-1084
2015,7,15,5,2729,3590,2370,-1220
2015,7,15,6,2585,3476,2660,-816
2015,7,15,7,2515,3140,2515,-625
2015,7,15,8,2365,2912,2418,-494
2015,7,15,9,2095,2823,2474,-349
2015,7,15,10,2083,2739,2456,-283
2015,7,15,11,2070,2693,2352,-341
2015,7,15,12,2107,2629,2223,-406
2015,7,15,13,2192,2670,2187,-483
2015,7,15,14,2030,2813,1933,-880
2015,7,15,15,2118,3051,2098,-953
2015,7,15,16,2163,3254,2264,-990
2015,7,15,17,2343,3365,2270,-1095
2015,7,15,18,2406,3440,2305,-1135
2015,7,15,19,2450,3501,2371,-1130
2015,7,15,20,2554,3573,2530,-1043
2015,7,15,21,2604,3586,2712,-874
2015,7,15,22,2643,3583,2794,-789
2015,7,15,23,2647,3621,2787,-834
2015,7,16,0,2553,3669,2723,-946
2015,7,16,1,2676,3676,2717,-959
2015,7,16,2,2689,3604,2644,-960
2015,7,16,3,2583,3506,2563,-943
2015,7,16,4,2552,3435,2504,-931
2015,7,16,5,2476,3422,2389,-1033
2015,7,16,6,2601,3212,2443,-769
2015,7,16,7,2576,2938,2441,-497
2015,7,16,8,1724,2745,2219,-526
2015,7,16,9,1568,2478,1880,-598
2015,7,16,10,1485,2332,1782,-550
2015,7,16,11,1349,2228,1788,-440
2015,7,16,12,1467,2377,1856,-521
2015,7,16,13,1444,2520,1970,-550
2015,7,16,14,1447,2669,1819,-850
2015,7,16,15,1502,2881,1915,-966
2015,7,16,16,1708,3110,2190,-920
2015,7,16,17,1864,3155,1987,-1168
2015,7,16,18,1862,3284,2125,-1159
2015,7,16,19,1983,3323,2230,-1093
2015,7,16,20,2390,3377,2331,-1046
2015,7,16,21,2597,3414,2483,-931
2015,7,16,22,2708,3437,2672,-765
2015,7,16,23,2791,3454,2755,-699
2015,7,17,0,2794,3409,2624,-785
2015,7,17,1,2794,3430,2641,-789
2015,7,17,2,2791,3382,2417,-965
2015,7,17,3,2457,3338,2364,-974
2015,7,17,4,2268,3252,2154,-1098
2015,7,17,5,2120,3280,2213,-1067
2015,7,17,6,2162,3153,2379,-774
2015,7,17,7,1967,2860,2217,-643
2015,7,17,8,1483,2602,1956,-646
2015,7,17,9,1295,2448,1828,-620
2015,7,17,10,1288,2354,1731,-623
2015,7,17,11,1283,2328,1672,-656
2015,7,17,12,1278,2346,1574,-772
2015,7,17,13,1302,2445,1565,-880
2015,7,17,14,1372,2507,1401,-1106
2015,7,17,15,1802,2907,1777,-1130
2015,7,17,16,2182,3129,1947,-1182
2015,7,17,17,2294,3320,2149,-1171
2015,7,17,18,2345,3404,2189,-1215
2015,7,17,19,2394,3513,2334,-1179
2015,7,17,20,2718,3521,2306,-1215
2015,7,17,21,2718,3535,2287,-1248
2015,7,17,22,2719,3588,2313,-1275
2015,7,17,23,2709,3629,2344,-1285
2015,7,18,0,2708,3701,2390,-1311
2015,7,18,1,2708,3746,2480,-1266
2015,7,18,2,2709,3679,2449,-1230
2015,7,18,3,2564,3561,2352,-1209
2015,7,18,4,2475,3478,2320,-1158
2015,7,18,5,2484,3440,2239,-1201
2015,7,18,6,2527,3284,2276,-1008
2015,7,18,7,2042,3028,2237,-791
2015,7,18,8,1781,2762,1982,-780
2015,7,18,9,1515,2650,1836,-814
2015,7,18,10,1527,2564,1745,-819
2015,7,18,11,1449,2441,1706,-735
2015,7,18,12,1454,2446,1731,-715
2015,7,18,13,1457,2481,1780,-701
2015,7,18,14,1461,2331,1497,-834
2015,7,18,15,1541,2531,1538,-993
2015,7,18,16,2189,2924,1760,-1164
2015,7,18,17,2424,3125,1848,-1277
2015,7,18,18,2430,3367,1940,-1427
2015,7,18,19,2519,3512,2053,-1459
2015,7,18,20,2644,3607,2186,-1421
2015,7,18,21,2631,3709,2269,-1440
2015,7,18,22,2614,3763,2324,-1439
2015,7,18,23,2599,3822,2409,-1413
2015,7,19,0,2598,3900,2366,-1534
2015,7,19,1,2585,3947,2406,-1541
2015,7,19,2,2622,3938,2378,-1560
2015,7,19,3,2610,3887,2282,-1605
2015,7,19,4,2587,3806,2251,-1555
2015,7,19,5,2592,3782,2262,-1520
2015,7,19,6,2581,3618,2330,-1288
2015,7,19,7,2068,3326,2338,-988
2015,7,19,8,1994,3087,2278,-809
2015,7,19,9,1728,2931,2157,-774
2015,7,19,10,1566,2857,2082,-775
2015,7,19,11,1566,2810,2016,-794
2015,7,19,12,1567,2778,1995,-783
2015,7,19,13,1407,2627,1883,-744
2015,7,19,14,1412,2629,1779,-850
2015,7,19,15,1734,2839,1843,-996
2015,7,19,16,2331,3121,2043,-1078
2015,7,19,17,2559,3516,2297,-1219
2015,7,19,18,2572,3720,2526,-1194
2015,7,19,19,3024,3859,2783,-1076
2015,7,19,20,3072,3960,2814,-1146
2015,7,19,21,3078,4030,2931,-1099
2015,7,19,22,3091,4077,2952,-1125
2015,7,19,23,3123,4107,2854,-1253
2015,7,20,0,3141,4158,2889,-1269
2015,7,20,1,3186,4189,2901,-1288
2015,7,20,2,3221,4134,2945,-1189
2015,7,20,3,3263,4074,2775,-1299
2015,7,20,4,3288,3969,2669,-1300
2015,7,20,5,2853,3938,2597,-1341
2015,7,20,6,2785,3704,2627,-1077
2015,7,20,7,2478,3329,2403,-926
2015,7,20,8,1880,3082,2173,-909
2015,7,20,9,1693,2831,2004,-827
2015,7,20,10,1330,2409,1569,-840
2015,7,20,11,1236,2379,1535,-844
2015,7,20,12,1218,2473,1613,-860
2015,7,20,13,1205,2693,1652,-1041
2015,7,20,14,1199,2971,1780,-1191
2015,7,20,15,1842,3134,1716,-1418
2015,7,20,16,2123,3353,1941,-1412
2015,7,20,17,2251,3485,1951,-1534
2015,7,20,18,2326,3600,2073,-1527
2015,7,20,19,2357,3726,2274,-1452
2015,7,20,20,2814,3821,2492,-1329
2015,7,20,21,2834,3877,2543,-1334
2015,7,20,22,2859,3912,2456,-1456
2015,7,20,23,2893,3962,2531,-1431
2015,7,21,0,2931,3996,2579,-1417
2015,7,21,1,2969,4045,2631,-1414
2015,7,21,2,2992,4002,2620,-1382
2015,7,21,3,2997,3903,2662,-1241
2015,7,21,4,2712,3784,2654,-1130
2015,7,21,5,2681,3726,2511,-1215
2015,7,21,6,2634,3462,2326,-1136
2015,7,21,7,2606,3041,2142,-899
2015,7,21,8,1804,2784,2051,-733
2015,7,21,9,1750,2585,1906,-679
2015,7,21,10,1678,2454,1825,-629
2015,7,21,11,1589,2390,1794,-596
2015,7,21,12,1565,2454,1873,-581
2015,7,21,13,1863,2810,2130,-680
2015,7,21,14,1948,3002,2164,-838
2015,7,21,15,2251,3300,2342,-958
2015,7,21,16,2320,3344,2312,-1032
2015,7,21,17,2462,3378,2203,-1175
2015,7,21,18,2448,3445,2190,-1255
2015,7,21,19,2596,3542,2452,-1090
2015,7,21,20,2680,3653,2706,-947
2015,7,21,21,2694,3623,2616,-1007
2015,7,21,22,2706,3601,2532,-1069
2015,7,21,23,2722,3583,2484,-1099
2015,7,22,0,2735,3587,2519,-1068
2015,7,22,1,2750,3600,2536,-1064
2015,7,22,2,2772,3539,2492,-1047
2015,7,22,3,2777,3471,2489,-982
2015,7,22,4,2637,3433,2409,-1024
2015,7,22,5,2638,3446,2418,-1028
2015,7,22,6,2638,3211,2344,-867
2015,7,22,7,2584,2832,2086,-746
2015,7,22,8,1723,2632,1970,-662
2015,7,22,9,1491,2329,1812,-517
2015,7,22,10,1464,2259,1774,-485
2015,7,22,11,1426,2241,1735,-506
2015,7,22,12,1464,2381,1829,-552
2015,7,22,13,1677,2663,1929,-734
2015,7,22,14,1783,2844,1842,-1002
2015,7,22,15,2071,3132,1925,-1207
2015,7,22,16,2376,3255,2036,-1219
2015,7,22,17,2471,3365,2191,-1174
2015,7,22,18,2453,3402,2182,-1220
2015,7,22,19,2473,3464,2423,-1041
2015,7,22,20,2745,3563,2659,-904
2015,7,22,21,2760,3525,2627,-898
2015,7,22,22,2796,3521,2665,-856
2015,7,22,23,2836,3541,2693,-848
2015,7,23,0,2868,3551,2584,-967
2015,7,23,1,2905,3595,2668,-927
2015,7,23,2,2915,3615,2796,-819
2015,7,23,3,2863,3547,2744,-803
2015,7,23,4,2660,3517,2645,-872
2015,7,23,5,2570,3499,2599,-900
2015,7,23,6,2624,3341,2669,-672
2015,7,23,7,2543,3044,2567,-477
2015,7,23,8,2254,2815,2404,-411
2015,7,23,9,1988,2711,2254,-457
2015,7,23,10,1804,2603,2023,-580
2015,7,23,11,1755,2599,1993,-606
2015,7,23,12,1745,2671,2099,-572
2015,7,23,13,2214,2800,2186,-614
2015,7,23,14,2059,2935,1961,-974
2015,7,23,15,2199,3100,1961,-1139
2015,7,23,16,2299,3169,1865,-1304
2015,7,23,17,2383,3261,1897,-1364
2015,7,23,18,2494,3369,2034,-1335
2015,7,23,19,2499,3538,2223,-1315
2015,7,23,20,2635,3577,2255,-1322
2015,7,23,21,2668,3593,2245,-1348
2015,7,23,22,2690,3620,2269,-1351
2015,7,23,23,2727,3660,2273,-1387
2015,7,24,0,2760,3675,2281,-1394
2015,7,24,1,2786,3694,2292,-1402
2015,7,24,2,2778,3676,2387,-1289
2015,7,24,3,2791,3611,2348,-1263
2015,7,24,4,2597,3525,2352,-1173
2015,7,24,5,2598,3521,2304,-1217
2015,7,24,6,2696,3310,2338,-972
2015,7,24,7,2442,3038,2271,-767
2015,7,24,8,1898,2796,2062,-734
2015,7,24,9,1686,2631,1862,-769
2015,7,24,10,1536,2522,1742,-780
2015,7,24,11,1515,2514,1767,-747
2015,7,24,12,1501,2634,1841,-793
2015,7,24,13,1723,2790,1966,-824
2015,7,24,14,1572,2903,1803,-1100
2015,7,24,15,1951,3178,1878,-1300
2015,7,24,16,2076,3329,1917,-1412
2015,7,24,17,2170,3458,2105,-1353
2015,7,24,18,2233,3504,2113,-1391
2015,7,24,19,2272,3546,2210,-1336
2015,7,24,20,2321,3555,2305,-1250
2015,7,24,21,2270,3566,2336,-1230
2015,7,24,22,2274,3523,2340,-1183
2015,7,24,23,2289,3520,2351,-1169
2015,7,25,0,2311,3530,2304,-1226
2015,7,25,1,2335,3570,2364,-1206
2015,7,25,2,2355,3536,2403,-1133
2015,7,25,3,2413,3483,2473,-1010
2015,7,25,4,2330,3478,2517,-961
2015,7,25,5,2251,3468,2460,-1008
2015,7,25,6,2303,3279,2360,-919
2015,7,25,7,2151,3049,2279,-770
2015,7,25,8,2054,2852,2265,-587
2015,7,25,9,1625,2538,1860,-678
2015,7,25,10,1647,2438,1744,-694
2015,7,25,11,1627,2451,1901,-550
2015,7,25,12,1614,2426,1794,-632
2015,7,25,13,1609,2461,1763,-698
2015,7,25,14,1502,2334,1536,-798
2015,7,25,15,1646,2489,1532,-957
2015,7,25,16,1687,2665,1547,-1118
2015,7,25,17,1674,2779,1653,-1126
2015,7,25,18,1858,2855,1770,-1085
2015,7,25,19,1851,2889,1831,-1058
2015,7,25,20,1856,2887,1795,-1092
2015,7,25,21,1869,2866,1783,-1083
2015,7,25,22,1889,2839,1784,-1055
2015,7,25,23,1915,2821,1769,-1052
2015,7,26,0,1942,2833,1797,-1036
2015,7,26,1,1962,2841,1833,-1008
2015,7,26,2,1972,2830,1830,-1000
2015,7,26,3,1973,2824,1736,-1088
2015,7,26,4,1965,2826,1706,-1120
2015,7,26,5,1908,3046,1960,-1086
2015,7,26,6,2045,2992,2196,-796
2015,7,26,7,1926,2843,2176,-667
2015,7,26,8,1496,2560,1841,-719
2015,7,26,9,1342,2316,1683,-633
2015,7,26,10,1316,2227,1578,-649
2015,7,26,11,1143,2079,1483,-596
2015,7,26,12,1118,2119,1570,-549
2015,7,26,13,1091,2266,1573,-693
2015,7,26,14,1066,2312,1504,-808
2015,7,26,15,1699,2632,1679,-953
2015,7,26,16,1683,2842,1773,-1069
2015,7,26,17,1888,2997,1854,-1143
2015,7,26,18,1991,3092,1881,-1211
2015,7,26,19,2039,3137,1934,-1203
2015,7,26,20,2110,3200,2028,-1172
2015,7,26,21,2119,3162,1992,-1170
2015,7,26,22,2106,3151,2016,-1135
2015,7,26,23,2157,3165,2018,-1147
2015,7,27,0,2201,3212,2015,-1197
2015,7,27,1,2280,3294,2225,-1069
2015,7,27,2,2312,3294,2276,-1018
2015,7,27,3,2311,3207,2231,-976
2015,7,27,4,2299,3189,2205,-984
2015,7,27,5,2288,3161,2059,-1102
2015,7,27,6,2290,3029,2145,-884
2015,7,27,7,2056,2592,1584,-1008
2015,7,27,8,1410,2406,1509,-897
2015,7,27,9,1385,2381,1657,-724
2015,7,27,10,1363,2315,1454,-861
2015,7,27,11,1353,2326,1492,-834
2015,7,27,12,1349,2409,1515,-894
2015,7,27,13,1474,2627,1668,-959
2015,7,27,14,1457,2751,1511,-1240
2015,7,27,15,1843,3091,1680,-1411
2015,7,27,16,2053,3250,1726,-1524
2015,7,27,17,2030,3367,1864,-1503
2015,7,27,18,2149,3437,1937,-1500
2015,7,27,19,2150,3475,2121,-1354
2015,7,27,20,2175,3521,2356,-1165
2015,7,27,21,2233,3531,2339,-1192
2015,7,27,22,2282,3529,2388,-1141
2015,7,27,23,2326,3521,2412,-1109
2015,7,28,0,2357,3549,2440,-1109
2015,7,28,1,2375,3588,2450,-1138
2015,7,28,2,2377,3592,2490,-1102
2015,7,28,3,2372,3513,2394,-1119
2015,7,28,4,2359,3490,2331,-1159
2015,7,28,5,2333,3523,2319,-1204
2015,7,28,6,2338,3303,2248,-1055
2015,7,28,7,1984,2988,2074,-914
2015,7,28,8,1672,2610,1775,-835
2015,7,28,9,1543,2473,1693,-780
2015,7,28,10,1525,2404,1648,-756
2015,7,28,11,1514,2382,1564,-818
2015,7,28,12,1513,2445,1662,-783
2015,7,28,13,1576,2663,1886,-777
2015,7,28,14,1761,2670,1577,-1093
2015,7,28,15,2183,3075,1915,-1160
2015,7,28,16,2395,3235,2085,-1150
2015,7,28,17,2462,3332,2170,-1162
2015,7,28,18,2462,3466,2297,-1169
2015,7,28,19,2660,3474,2446,-1028
2015,7,28,20,2921,3647,2812,-835
2015,7,28,21,2922,3676,2842,-834
2015,7,28,22,2926,3718,2916,-802
2015,7,28,23,2934,3733,2899,-834
2015,7,29,0,2945,3782,2907,-875
2015,7,29,1,2957,3852,2975,-877
2015,7,29,2,3021,3802,2919,-883
2015,7,29,3,3022,3714,2854,-860
2015,7,29,4,2852,3594,2673,-921
2015,7,29,5,2822,3614,2585,-1029
2015,7,29,6,2776,3379,2536,-843
2015,7,29,7,2440,3087,2299,-788
2015,7,29,8,1913,2863,2217,-646
2015,7,29,9,1911,2719,2173,-546
2015,7,29,10,1833,2673,2128,-545
2015,7,29,11,1834,2681,2106,-575
2015,7,29,12,1834,2730,2119,-611
2015,7,29,13,2276,2856,2168,-688
2015,7,29,14,2255,3010,2124,-886
2015,7,29,15,2400,3236,2100,-1136
2015,7,29,16,2506,3407,2145,-1262
2015,7,29,17,2534,3551,2264,-1287
2015,7,29,18,2542,3677,2383,-1294
2015,7,29,19,2744,3768,2528,-1240
2015,7,29,20,2887,3867,2699,-1168
2015,7,29,21,2994,3963,2761,-1202
2015,7,29,22,2999,4031,2805,-1226
2015,7,29,23,3006,4102,2849,-1253
2015,7,30,0,3014,4148,2921,-1227
2015,7,30,1,3009,4199,2941,-1258
2015,7,30,2,3028,4132,2905,-1227
2015,7,30,3,3038,4045,2835,-1210
2015,7,30,4,2939,3945,2742,-1203
2015,7,30,5,2923,3897,2661,-1236
2015,7,30,6,2912,3605,2602,-1003
2015,7,30,7,2369,3268,2507,-761
2015,7,30,8,1822,3001,2234,-767
2015,7,30,9,1969,2818,2266,-552
2015,7,30,10,1969,2720,2240,-480
2015,7,30,11,1969,2699,2209,-490
2015,7,30,12,2049,2787,2244,-543
2015,7,30,13,2149,2930,2271,-659
2015,7,30,14,1624,2914,1847,-1067
2015,7,30,15,2100,3112,1788,-1324
2015,7,30,16,2130,3456,2016,-1440
2015,7,30,17,2225,3639,2218,-1421
2015,7,30,18,2544,3766,2208,-1558
2015,7,30,19,2644,3838,2312,-1526
2015,7,30,20,2794,3949,2518,-1431
2015,7,30,21,2899,4058,2639,-1419
2015,7,30,22,2887,4132,2738,-1394
2015,7,30,23,2887,4228,2815,-1413
2015,7,31,0,2875,4303,2812,-1491
2015,7,31,1,2874,4286,2682,-1604
2015,7,31,2,2886,4279,2782,-1497
2015,7,31,3,2878,4173,2685,-1488
2015,7,31,4,2793,4071,2513,-1558
2015,7,31,5,2636,4002,2399,-1603
2015,7,31,6,2633,3681,2427,-1254
2015,7,31,7,2380,3385,2403,-982
2015,7,31,8,2135,3121,2189,-932
2015,7,31,9,2035,2959,2194,-765
2015,7,31,10,2036,2866,2245,-621
2015,7,31,11,2036,2815,2209,-606
2015,7,31,12,2036,2835,2218,-617
2015,7,31,13,2186,2941,2206,-735
2015,7,31,14,2086,3080,2026,-1054
2015,7,31,15,2131,3305,1967,-1338
2015,7,31,16,2134,3471,2034,-1437
2015,7,31,17,2338,3676,2269,-1407
2015,7,31,18,2525,3766,2274,-1492
2015,7,31,19,2732,3862,2491,-1371
2015,7,31,20,2933,3985,2619,-1366
2015,7,31,21,2941,4092,2673,-1419
2015,7,31,22,2949,4136,2619,-1517
2015,7,31,23,2935,4177,2569,-1608
2015,8,1,0,2946,4226,2588,-1638
2015,8,1,1,2948,4282,2566,-1716
2015,8,1,2,2959,4177,2585,-1592
2015,8,1,3,2954,4060,2513,-1547
2015,8,1,4,2742,3924,2352,-1572
2015,8,1,5,2474,3951,2352,-1599
2015,8,1,6,2466,3687,2500,-1187
2015,8,1,7,2361,3328,2513,-815
2015,8,1,8,2036,3073,2352,-721
2015,8,1,9,1952,2849,2178,-671
2015,8,1,10,1908,2735,2090,-645
2015,8,1,11,1698,2700,2059,-641
2015,8,1,12,1625,2626,1988,-638
2015,8,1,13,1619,2610,1934,-676
2015,8,1,14,1616,2345,1493,-852
2015,8,1,15,1799,2583,1681,-902
2015,8,1,16,2080,2910,1917,-993
2015,8,1,17,2301,3362,2173,-1189
2015,8,1,18,2318,3489,2253,-1236
2015,8,1,19,2431,3572,2230,-1342
2015,8,1,20,2549,3657,2252,-1405
2015,8,1,21,2584,3718,2284,-1434
2015,8,1,22,2608,3775,2290,-1485
2015,8,1,23,2631,3773,2311,-1462
2015,8,2,0,2634,3812,2359,-1453
2015,8,2,1,2642,3824,2366,-1458
2015,8,2,2,2647,3821,2400,-1421
2015,8,2,3,2663,3789,2506,-1283
2015,8,2,4,2583,3704,2377,-1327
2015,8,2,5,2595,3656,2418,-1238
2015,8,2,6,2586,3482,2522,-960
2015,8,2,7,2371,3226,2541,-685
2015,8,2,8,2032,2855,2326,-529
2015,8,2,9,1840,2701,2267,-434
2015,8,2,10,1690,2574,2057,-517
2015,8,2,11,1640,2520,1977,-543
2015,8,2,12,1709,2500,1943,-557
2015,8,2,13,1709,2505,1936,-569
2015,8,2,14,1745,2418,1787,-631
2015,8,2,15,2105,2730,1962,-768
2015,8,2,16,2236,2931,2055,-876
2015,8,2,17,2271,3098,2062,-1036
2015,8,2,18,2321,3306,2165,-1141
2015,8,2,19,2483,3455,2256,-1199
2015,8,2,20,2487,3450,2052,-1398
2015,8,2,21,2495,3515,2112,-1403
2015,8,2,22,2593,3616,2296,-1320
2015,8,2,23,2641,3684,2324,-1360
2015,8,3,0,2660,3757,2388,-1369
2015,8,3,1,2682,3798,2429,-1369
2015,8,3,2,2704,3779,2450,-1329
2015,8,3,3,2722,3751,2455,-1296
2015,8,3,4,2691,3766,2473,-1293
2015,8,3,5,2650,3739,2512,-1227
2015,8,3,6,2650,3486,2552,-934
2015,8,3,7,2363,3171,2373,-798
2015,8,3,8,1848,2916,2124,-792
2015,8,3,9,1814,2773,2078,-695
2015,8,3,10,1622,2590,2002,-588
2015,8,3,11,1404,2383,1806,-577
2015,8,3,12,1404,2467,1861,-606
2015,8,3,13,1797,2848,2081,-767
2015,8,3,14,1744,2830,1847,-983
2015,8,3,15,2119,3148,2024,-1124
2015,8,3,16,2201,3442,2169,-1273
2015,8,3,17,2277,3579,2261,-1318
2015,8,3,18,2294,3632,2340,-1292
2015,8,3,19,2451,3699,2202,-1497
2015,8,3,20,2637,3804,2332,-1472
2015,8,3,21,2746,3843,2404,-1439
2015,8,3,22,2743,3878,2436,-1442
2015,8,3,23,2920,3931,2510,-1421
2015,8,4,0,2938,3948,2482,-1466
2015,8,4,1,2956,3936,2236,-1700
2015,8,4,2,2978,4009,2657,-1352
2015,8,4,3,3008,3899,2595,-1304
2015,8,4,4,2934,3869,2763,-1106
2015,8,4,5,2929,3810,2776,-1034
2015,8,4,6,2840,3563,2860,-703
2015,8,4,7,2517,3178,2452,-726
2015,8,4,8,2286,3032,2475,-557
2015,8,4,9,2049,2849,2294,-555
2015,8,4,10,1876,2578,1997,-581
2015,8,4,11,1856,2523,1900,-623
2015,8,4,12,1831,2589,1961,-628
2015,8,4,13,1984,2751,2099,-652
2015,8,4,14,1920,2732,1698,-1034
2015,8,4,15,2007,2986,1939,-1047
2015,8,4,16,2154,3404,2187,-1217
2015,8,4,17,2217,3512,2244,-1268
2015,8,4,18,2215,3618,2373,-1245
2015,8,4,19,2302,3608,2211,-1397
2015,8,4,20,2326,3730,2376,-1354
2015,8,4,21,2410,3761,2453,-1308
2015,8,4,22,2404,3810,2465,-1345
2015,8,4,23,2528,3831,2412,-1419
2015,8,5,0,2466,3855,2544,-1311
2015,8,5,1,2534,3893,2614,-1279
2015,8,5,2,2633,3860,2512,-1348
2015,8,5,3,2650,3469,2303,-1166
2015,8,5,4,2463,3373,2133,-1240
2015,8,5,5,2434,3454,2268,-1186
2015,8,5,6,2488,3253,2295,-958
2015,8,5,7,2357,3030,2249,-781
2015,8,5,8,1906,2852,2104,-748
2015,8,5,9,1829,2709,2046,-663
2015,8,5,10,1658,2550,1978,-572
2015,8,5,11,1646,2517,1978,-539
2015,8,5,12,1697,2575,2008,-567
2015,8,5,13,2042,2734,2016,-718
2015,8,5,14,1766,2894,1967,-927
2015,8,5,15,1770,3250,2225,-1025
2015,8,5,16,2202,3367,2275,-1092
2015,8,5,17,2328,3445,2324,-1121
2015,8,5,18,2452,3498,2419,-1079
2015,8,5,19,2469,3541,2510,-1031
2015,8,5,20,2581,3560,2541,-1019
2015,8,5,21,2592,3633,2736,-897
2015,8,5,22,2598,3581,2586,-995
2015,8,5,23,2599,3581,2538,-1043
2015,8,6,0,2599,3605,2595,-1010
2015,8,6,1,2614,3621,2637,-984
2015,8,6,2,2652,3579,2520,-1059
2015,8,6,3,2646,3528,2642,-886
2015,8,6,4,2557,3540,2628,-912
2015,8,6,5,2477,3502,2588,-914
2015,8,6,6,2557,3305,2664,-641
2015,8,6,7,2502,3019,2490,-529
2015,8,6,8,1770,2658,2054,-604
2015,8,6,9,1695,2530,1973,-557
2015,8,6,10,1519,2379,1901,-478
2015,8,6,11,1496,2347,1747,-600
2015,8,6,12,1781,2701,2034,-667
2015,8,6,13,1950,2848,2010,-838
2015,8,6,14,1810,2855,1724,-1131
2015,8,6,15,1979,3109,1850,-1259
2015,8,6,16,2092,3380,2208,-1172
2015,8,6,17,2186,3486,2181,-1305
2015,8,6,18,2298,3558,2279,-1279
2015,8,6,19,2297,3600,2299,-1301
2015,8,6,20,2559,3655,2408,-1247
2015,8,6,21,2561,3673,2426,-1247
2015,8,6,22,2579,3686,2497,-1189
2015,8,6,23,2587,3710,2547,-1163
2015,8,7,0,2592,3765,2616,-1149
2015,8,7,1,2600,3802,2670,-1132
2015,8,7,2,2608,3737,2618,-1119
2015,8,7,3,2609,3664,2546,-1118
2015,8,7,4,2546,3631,2515,-1116
2015,8,7,5,2439,3617,2456,-1161
2015,8,7,6,2526,3420,2486,-934
2015,8,7,7,2289,3137,2353,-784
2015,8,7,8,2028,2892,2257,-635
2015,8,7,9,1790,2782,2123,-659
2015,8,7,10,1787,2685,2019,-666
2015,8,7,11,1784,2673,2009,-664
2015,8,7,12,1782,2692,2027,-665
2015,8,7,13,1803,2841,2080,-761
2015,8,7,14,1788,2940,1839,-1101
2015,8,7,15,2228,3155,1908,-1247
2015,8,7,16,2210,3314,1975,-1339
2015,8,7,17,2340,3475,2143,-1332
2015,8,7,18,2339,3576,2204,-1372
2015,8,7,19,2335,3622,2331,-1291
2015,8,7,20,2540,3658,2477,-1181
2015,8,7,21,2482,3742,2557,-1185
2015,8,7,22,2460,3792,2591,-1201
2015,8,7,23,2486,3822,2574,-1248
2015,8,8,0,2489,3865,2596,-1269
2015,8,8,1,2498,3917,2676,-1241
2015,8,8,2,2525,3820,2609,-1211
2015,8,8,3,2530,3714,2558,-1156
2015,8,8,4,2361,3640,2371,-1269
2015,8,8,5,2360,3588,2270,-1318
2015,8,8,6,2296,3401,2210,-1191
2015,8,8,7,2295,3166,2241,-925
2015,8,8,8,2019,2976,2067,-909
2015,8,8,9,1594,2833,1994,-839
2015,8,8,10,1589,2743,1928,-815
2015,8,8,11,1584,2684,1869,-815
2015,8,8,12,1558,2688,1869,-819
2015,8,8,13,1555,2734,1852,-882
2015,8,8,14,1226,2554,1452,-1102
2015,8,8,15,1224,2697,1522,-1175
2015,8,8,16,1507,3024,1620,-1404
2015,8,8,17,1631,3192,1639,-1553
2015,8,8,18,1737,3323,1733,-1590
2015,8,8,19,1786,3399,1810,-1589
2015,8,8,20,1791,3476,1890,-1586
2015,8,8,21,1800,3522,2023,-1499
2015,8,8,22,1786,3497,2087,-1410
2015,8,8,23,1785,3479,2078,-1401
2015,8,9,0,1809,3467,2075,-1392
2015,8,9,1,1845,3408,1936,-1472
2015,8,9,2,1868,3410,1948,-1462
2015,8,9,3,1862,3358,2005,-1353
2015,8,9,4,1884,3398,2067,-1331
2015,8,9,5,1908,3409,2134,-1275
2015,8,9,6,1901,3249,2119,-1130
2015,8,9,7,1696,3025,2060,-965
2015,8,9,8,1246,2520,1453,-1067
2015,8,9,9,1127,2297,1362,-935
2015,8,9,10,1013,2126,1252,-874
2015,8,9,11,1002,2102,1198,-904
2015,8,9,12,994,2128,1263,-865
2015,8,9,13,1310,2391,1471,-920
2015,8,9,14,1440,2429,1478,-951
2015,8,9,15,1616,2732,1772,-960
2015,8,9,16,1784,3014,2027,-987
2015,8,9,17,2276,3200,2143,-1057
2015,8,9,18,2274,3339,2204,-1135
2015,8,9,19,2279,3428,2262,-1166
2015,8,9,20,2389,3474,2342,-1132
2015,8,9,21,2422,3507,2370,-1137
2015,8,9,22,2420,3562,2440,-1122
2015,8,9,23,2421,3625,2456,-1169
2015,8,10,0,2421,3695,2589,-1106
2015,8,10,1,2419,3786,2650,-1136
2015,8,10,2,2414,3774,2676,-1098
2015,8,10,3,2413,3692,2572,-1120
2015,8,10,4,2409,3684,2585,-1099
2015,8,10,5,2409,3626,2561,-1065
2015,8,10,6,2379,3358,2336,-1022
2015,8,10,7,2273,3080,2098,-982
2015,8,10,8,2283,2839,2004,-835
2015,8,10,9,1766,2700,1873,-827
2015,8,10,10,1693,2647,1786,-861
2015,8,10,11,1693,2623,1714,-909
2015,8,10,12,1783,2738,1841,-897
2015,8,10,13,1925,2910,1911,-999
2015,8,10,14,1811,3123,1989,-1134
2015,8,10,15,2038,3330,2202,-1128
2015,8,10,16,2248,3432,2211,-1221
2015,8,10,17,2258,3565,2270,-1295
2015,8,10,18,2257,3684,2356,-1328
2015,8,10,19,2297,3790,2552,-1238
2015,8,10,20,2479,3890,2848,-1042
2015,8,10,21,2489,3958,2948,-1010
2015,8,10,22,2492,4003,3025,-978
2015,8,10,23,2516,4048,3029,-1019
2015,8,11,0,2513,4066,2568,-1498
2015,8,11,1,2510,4109,2559,-1550
2015,8,11,2,2509,4031,2633,-1398
2015,8,11,3,2438,3944,2903,-1041
2015,8,11,4,2334,3860,2649,-1211
2015,8,11,5,2262,3782,2557,-1225
2015,8,11,6,2294,3464,2355,-1109
2015,8,11,7,2064,3175,2249,-926
2015,8,11,8,1803,2982,2109,-873
2015,8,11,9,1703,2852,2045,-807
2015,8,11,10,1589,2714,2011,-703
2015,8,11,11,1640,2702,1962,-740
2015,8,11,12,1691,2705,1772,-933
2015,8,11,13,1806,2885,1845,-1040
2015,8,11,14,1574,2885,1762,-1123
2015,8,11,15,2030,3119,1976,-1143
2015,8,11,16,2084,3288,2106,-1182
2015,8,11,17,2249,3445,2268,-1177
2015,8,11,18,2546,3560,2371,-1189
2015,8,11,19,2733,3616,2460,-1156
2015,8,11,20,2937,3688,2592,-1096
2015,8,11,21,2936,3771,2674,-1097
2015,8,11,22,2933,3831,2726,-1105
2015,8,11,23,2972,3871,2744,-1127
2015,8,12,0,2964,3898,2689,-1209
2015,8,12,1,2967,3978,2768,-1210
2015,8,12,2,2961,3881,2677,-1204
2015,8,12,3,2954,3769,2579,-1190
2015,8,12,4,2937,3764,2680,-1084
2015,8,12,5,2663,3653,2479,-1174
2015,8,12,6,2676,3410,2559,-851
2015,8,12,7,2503,3043,2267,-776
2015,8,12,8,1869,2824,2060,-764
2015,8,12,9,1747,2666,1969,-697
2015,8,12,10,1747,2592,1830,-762
2015,8,12,11,1748,2570,1844,-726
2015,8,12,12,1748,2610,1903,-707
2015,8,12,13,1862,2776,2088,-688
2015,8,12,14,1865,2938,1922,-1016
2015,8,12,15,2204,3168,1941,-1227
2015,8,12,16,2337,3345,2095,-1250
2015,8,12,17,2534,3441,2320,-1121
2015,8,12,18,2566,3565,2318,-1247
2015,8,12,19,2743,3596,2588,-1008
2015,8,12,20,2868,3690,2687,-1003
2015,8,12,21,2857,3702,2629,-1073
2015,8,12,22,2855,3717,2612,-1105
2015,8,12,23,2854,3794,2607,-1187
2015,8,13,0,2853,3867,2632,-1235
2015,8,13,1,2853,3917,2651,-1266
2015,8,13,2,2853,3872,2581,-1291
2015,8,13,3,2853,3799,2577,-1222
2015,8,13,4,2872,3789,2477,-1312
2015,8,13,5,2736,3699,2405,-1294
2015,8,13,6,2650,3441,2541,-900
2015,8,13,7,2317,3146,2371,-775
2015,8,13,8,1827,2926,2051,-875
2015,8,13,9,1544,2677,1838,-839
2015,8,13,10,1293,2314,1474,-840
2015,8,13,11,1179,2226,1387,-839
2015,8,13,12,1253,2368,1484,-884
2015,8,13,13,1894,2748,1755,-993
2015,8,13,14,1890,2834,1588,-1246
2015,8,13,15,1928,3111,1775,-1336
2015,8,13,16,2095,3359,2068,-1291
2015,8,13,17,2242,3467,2183,-1284
2015,8,13,18,2267,3516,2366,-1150
2015,8,13,19,2318,3637,2496,-1141
2015,8,13,20,2657,3717,2565,-1152
2015,8,13,21,2657,3795,2707,-1088
2015,8,13,22,2657,3858,2911,-947
2015,8,13,23,2657,3936,2954,-982
2015,8,14,0,2657,3994,2932,-1062
2015,8,14,1,2657,3992,2782,-1210
2015,8,14,2,2656,3921,2672,-1249
2015,8,14,3,2656,3824,2540,-1284
2015,8,14,4,2548,3804,2454,-1350
2015,8,14,5,2549,3723,2343,-1380
2015,8,14,6,2550,3439,2311,-1128
2015,8,14,7,2321,3220,2390,-830
2015,8,14,8,1821,2988,2101,-887
2015,8,14,9,1446,2772,1915,-857
2015,8,14,10,1446,2669,1872,-797
2015,8,14,11,1346,2627,1693,-934
2015,8,14,12,1247,2507,1376,-1131
2015,8,14,13,1348,2811,1559,-1252
2015,8,14,14,1451,3098,1716,-1382
2015,8,14,15,1969,3323,2068,-1255
2015,8,14,16,1994,3481,2142,-1339
2015,8,14,17,2081,3491,2153,-1338
2015,8,14,18,2183,3474,2148,-1326
2015,8,14,19,2235,3546,2014,-1532
2015,8,14,20,2280,3562,2035,-1527
2015,8,14,21,2306,3621,2226,-1395
2015,8,14,22,2316,3555,2161,-1394
2015,8,14,23,2317,3536,2186,-1350
2015,8,15,0,2317,3530,2236,-1294
2015,8,15,1,2317,3511,2225,-1286
2015,8,15,2,2316,3436,2084,-1352
2015,8,15,3,2316,3388,2132,-1256
2015,8,15,4,2311,3404,2134,-1270
2015,8,15,5,2215,3349,2137,-1212
2015,8,15,6,2174,3169,2066,-1103
2015,8,15,7,2124,2789,1836,-953
2015,8,15,8,1242,2481,1632,-849
2015,8,15,9,1243,2337,1515,-822
2015,8,15,10,1243,2274,1464,-810
2015,8,15,11,1240,2235,1471,-764
2015,8,15,12,1230,2242,1504,-738
2015,8,15,13,1210,2304,1546,-758
2015,8,15,14,1179,2379,1576,-803
2015,8,15,15,1510,2568,1674,-894
2015,8,15,16,1736,2947,1892,-1055
2015,8,15,17,2011,3191,2023,-1168
2015,8,15,18,2187,3266,1989,-1277
2015,8,15,19,2180,3314,1966,-1348
2015,8,15,20,2180,3326,2061,-1265
2015,8,15,21,2191,3299,2150,-1149
2015,8,15,22,2210,3272,2180,-1092
2015,8,15,23,2233,3251,2318,-933
2015,8,16,0,2308,3269,2260,-1009
2015,8,16,1,2324,3292,2296,-996
2015,8,16,2,2330,3287,2234,-1053
2015,8,16,3,2328,3284,2231,-1053
2015,8,16,4,2314,3352,2299,-1053
2015,8,16,5,2238,3356,2300,-1056
2015,8,16,6,2206,3188,2256,-932
2015,8,16,7,2116,2985,2185,-800
2015,8,16,8,1779,2731,1871,-860
2015,8,16,9,1313,2428,1571,-857
2015,8,16,10,1144,2249,1455,-794
2015,8,16,11,1136,2158,1304,-854
2015,8,16,12,1134,2145,1287,-858
2015,8,16,13,1133,2221,1357,-864
2015,8,16,14,1182,2276,1380,-896
2015,8,16,15,1702,2476,1518,-958
2015,8,16,16,1872,2934,1810,-1124
2015,8,16,17,2096,3195,2007,-1188
2015,8,16,18,2260,3278,2124,-1154
2015,8,16,19,2415,3346,2250,-1096
2015,8,16,20,2561,3379,2416,-963
2015,8,16,21,2618,3372,2550,-822
2015,8,16,22,2676,3393,2561,-832
2015,8,16,23,2676,3424,2605,-819
2015,8,17,0,2676,3467,2644,-823
2015,8,17,1,2696,3534,2655,-879
2015,8,17,2,2697,3558,2687,-871
2015,8,17,3,2698,3528,2673,-855
2015,8,17,4,2694,3548,2636,-912
2015,8,17,5,2623,3515,2655,-860
2015,8,17,6,2518,3254,2498,-756
2015,8,17,7,2468,2959,2172,-787
2015,8,17,8,1817,2706,1907,-799
2015,8,17,9,1588,2589,1918,-671
2015,8,17,10,1588,2542,1918,-624
2015,8,17,11,1588,2544,1921,-623
2015,8,17,12,1637,2712,2084,-628
2015,8,17,13,2063,2887,2196,-691
2015,8,17,14,2069,2977,2152,-825
2015,8,17,15,2378,3209,2287,-922
2015,8,17,16,2431,3396,2481,-915
2015,8,17,17,2638,3525,2626,-899
2015,8,17,18,2705,3636,2733,-903
2015,8,17,19,2708,3708,2699,-1009
2015,8,17,20,2780,3740,2643,-1097
2015,8,17,21,2882,3785,2701,-1084
2015,8,17,22,2880,3817,2753,-1064
2015,8,17,23,2878,3848,2815,-1033
2015,8,18,0,2875,3921,2818,-1103
2015,8,18,1,2874,3951,2904,-1047
2015,8,18,2,2874,3909,2914,-995
2015,8,18,3,2874,3820,2837,-983
2015,8,18,4,2770,3824,2779,-1045
2015,8,18,5,2695,3728,2726,-1002
2015,8,18,6,2695,3433,2682,-751
2015,8,18,7,2440,3149,2354,-795
2015,8,18,8,1856,2938,2157,-781
2015,8,18,9,1604,2654,1886,-768
2015,8,18,10,1510,2559,1790,-769
2015,8,18,11,1510,2532,1777,-755
2015,8,18,12,1510,2589,1802,-787
2015,8,18,13,1670,2797,1941,-856
2015,8,18,14,1676,2891,1756,-1135
2015,8,18,15,2204,3049,1675,-1374
2015,8,18,16,2284,3269,2014,-1255
2015,8,18,17,2531,3319,1952,-1367
2015,8,18,18,2594,3430,2049,-1381
2015,8,18,19,2581,3650,2227,-1423
2015,8,18,20,2855,3739,2389,-1350
2015,8,18,21,2933,3803,2455,-1348
2015,8,18,22,2932,3864,2509,-1355
2015,8,18,23,2931,3924,2500,-1424
2015,8,19,0,2931,3983,2535,-1448
2015,8,19,1,2931,4096,2516,-1580
2015,8,19,2,2930,4083,2532,-1551
2015,8,19,3,2942,3974,2505,-1469
2015,8,19,4,2920,3966,2490,-1476
2015,8,19,5,2795,3853,2383,-1470
2015,8,19,6,2895,3537,2360,-1177
2015,8,19,7,2425,3251,2346,-905
2015,8,19,8,2012,3033,2182,-851
2015,8,19,9,1944,2902,2074,-828
2015,8,19,10,1684,2812,2024,-788
2015,8,19,11,1584,2702,1953,-749
2015,8,19,12,1729,2749,1956,-793
2015,8,19,13,2265,2915,1976,-939
2015,8,19,14,2015,3031,1826,-1205
2015,8,19,15,2149,3318,1906,-1412
2015,8,19,16,2251,3572,2193,-1379
2015,8,19,17,2369,3691,2400,-1291
2015,8,19,18,2507,3807,2405,-1402
2015,8,19,19,2832,3899,2427,-1472
2015,8,19,20,2904,3988,2388,-1600
2015,8,19,21,2921,4076,2462,-1614
2015,8,19,22,2948,4134,2462,-1672
2015,8,19,23,2981,4204,2502,-1702
2015,8,20,0,3004,4250,2592,-1658
2015,8,20,1,3044,4283,2769,-1514
2015,8,20,2,3085,4212,2792,-1420
2015,8,20,3,3122,4098,2607,-1491
2015,8,20,4,2887,4078,2618,-1460
2015,8,20,5,2754,3936,2493,-1443
2015,8,20,6,2784,3607,2390,-1217
2015,8,20,7,2635,3190,2220,-970
2015,8,20,8,1908,2908,2114,-794
2015,8,20,9,1544,2518,1819,-699
2015,8,20,10,1437,2442,1867,-575
2015,8,20,11,1423,2392,1788,-604
2015,8,20,12,1407,2477,1811,-666
2015,8,20,13,1747,2882,2048,-834
2015,8,20,14,1620,3066,1896,-1170
2015,8,20,15,1953,3240,1885,-1355
2015,8,20,16,2156,3317,1866,-1451
2015,8,20,17,2139,3513,2036,-1477
2015,8,20,18,2154,3528,1998,-1530
2015,8,20,19,2280,3546,2036,-1510
2015,8,20,20,2381,3455,1969,-1486
2015,8,20,21,2351,3470,2134,-1336
2015,8,20,22,2379,3526,2206,-1320
2015,8,20,23,2384,3564,2209,-1355
2015,8,21,0,2384,3593,2248,-1345
2015,8,21,1,2384,3606,2303,-1303
2015,8,21,2,2371,3540,2212,-1328
2015,8,21,3,2485,3473,2158,-1315
2015,8,21,4,2378,3521,2212,-1309
2015,8,21,5,2386,3419,2182,-1237
2015,8,21,6,2286,3182,2161,-1021
2015,8,21,7,2014,2912,1994,-918
2015,8,21,8,1245,2492,1642,-850
2015,8,21,9,1247,2313,1563,-750
2015,8,21,10,1250,2217,1481,-736
2015,8,21,11,1252,2197,1477,-720
2015,8,21,12,1283,2316,1597,-719
2015,8,21,13,1283,2496,1728,-768
2015,8,21,14,1250,2586,1504,-1082
2015,8,21,15,1361,2782,1560,-1222
2015,8,21,16,1789,3021,1763,-1258
2015,8,21,17,1830,3039,1737,-1302
2015,8,21,18,1967,3106,1756,-1350
2015,8,21,19,1968,3101,1703,-1398
2015,8,21,20,2218,3132,1737,-1395
2015,8,21,21,2218,3231,1832,-1399
2015,8,21,22,2213,3304,1879,-1425
2015,8,21,23,2242,3123,1729,-1394
2015,8,22,0,2263,3186,1781,-1405
2015,8,22,1,2223,3193,1776,-1417
2015,8,22,2,2287,3153,1736,-1417
2015,8,22,3,2327,3287,1848,-1439
2015,8,22,4,2314,3384,1873,-1511
2015,8,22,5,2289,3455,2116,-1339
2015,8,22,6,2339,3235,2036,-1199
2015,8,22,7,2161,3011,2040,-971
2015,8,22,8,1921,2832,1928,-904
2015,8,22,9,1982,2720,1885,-835
2015,8,22,10,1937,2658,1857,-801
2015,8,22,11,1902,2624,1819,-805
2015,8,22,12,1904,2651,1836,-815
2015,8,22,13,1947,2697,1902,-795
2015,8,22,14,1658,2650,1590,-1060
2015,8,22,15,1974,2808,1667,-1141
2015,8,22,16,2004,3075,1851,-1224
2015,8,22,17,2194,3260,1977,-1283
2015,8,22,18,2387,3348,2053,-1295
2015,8,22,19,2389,3369,2116,-1253
2015,8,22,20,2483,3376,2223,-1153
2015,8,22,21,2477,3368,2285,-1083
2015,8,22,22,2472,3370,2293,-1077
2015,8,22,23,2521,3397,2354,-1043
2015,8,23,0,2551,3425,2282,-1143
2015,8,23,1,2547,3476,2323,-1153
2015,8,23,2,2542,3447,2290,-1157
2015,8,23,3,2530,3406,2271,-1135
2015,8,23,4,2423,3465,2363,-1102
2015,8,23,5,2344,3370,2290,-1080
2015,8,23,6,2399,3194,2282,-912
2015,8,23,7,2265,2981,2246,-735
2015,8,23,8,1577,2787,1911,-876
2015,8,23,9,1417,2553,1807,-746
2015,8,23,10,1257,2336,1657,-679
2015,8,23,11,1257,2307,1645,-662
2015,8,23,12,1257,2309,1641,-668
2015,8,23,13,1256,2348,1656,-692
2015,8,23,14,1256,2275,1506,-769
2015,8,23,15,1764,2420,1584,-836
2015,8,23,16,2248,2822,1757,-1065
2015,8,23,17,2274,3127,1918,-1209
2015,8,23,18,2300,3281,2019,-1262
2015,8,23,19,2404,3354,2111,-1243
2015,8,23,20,2466,3388,2184,-1204
2015,8,23,21,2496,3404,2251,-1153
2015,8,23,22,2581,3404,2251,-1153
2015,8,23,23,2602,3457,2259,-1198
2015,8,24,0,2597,3555,2375,-1180
2015,8,24,1,2611,3604,2427,-1177
2015,8,24,2,2578,3591,2397,-1194
2015,8,24,3,2582,3555,2367,-1188
2015,8,24,4,2460,3605,2369,-1236
2015,8,24,5,2478,3490,2230,-1260
2015,8,24,6,2381,3206,2162,-1044
2015,8,24,7,2377,2884,1875,-1009
2015,8,24,8,1755,2725,1790,-935
2015,8,24,9,1567,2570,1689,-881
2015,8,24,10,1377,2397,1631,-766
2015,8,24,11,1276,2348,1645,-703
2015,8,24,12,1273,2435,1683,-752
2015,8,24,13,1519,2638,1869,-769
2015,8,24,14,1825,2980,1947,-1033
2015,8,24,15,2120,3179,2037,-1142
2015,8,24,16,2202,3330,2193,-1137
2015,8,24,17,2254,3439,2340,-1099
2015,8,24,18,2403,3489,2278,-1211
2015,8,24,19,2595,3528,2388,-1140
2015,8,24,20,2759,3576,2523,-1053
2015,8,24,21,2755,3603,2627,-976
2015,8,24,22,2739,3613,2684,-929
2015,8,24,23,2758,3638,2662,-976
2015,8,25,0,2753,3662,2689,-973
2015,8,25,1,2779,3683,2714,-969
2015,8,25,2,2793,3626,2657,-969
2015,8,25,3,2800,3562,2606,-956
2015,8,25,4,2687,3629,2644,-985
2015,8,25,5,2710,3490,2476,-1014
2015,8,25,6,2561,3197,2300,-897
2015,8,25,7,2069,2885,2028,-857
2015,8,25,8,1808,2719,1981,-738
2015,8,25,9,1628,2551,1896,-655
2015,8,25,10,1530,2567,1908,-659
2015,8,25,11,1467,2500,1836,-664
2015,8,25,12,1506,2546,1752,-794
2015,8,25,13,1882,2791,1999,-792
2015,8,25,14,1682,3021,2068,-953
2015,8,25,15,1871,3201,2100,-1101
2015,8,25,16,2030,3309,2195,-1114
2015,8,25,17,2088,3388,2235,-1153
2015,8,25,18,2245,3465,2361,-1104
2015,8,25,19,2283,3506,2439,-1067
2015,8,25,20,2427,3542,2591,-951
2015,8,25,21,2421,3574,2721,-853
2015,8,25,22,2622,3602,2771,-831
2015,8,25,23,2626,3619,2777,-842
2015,8,26,0,2631,3646,2774,-872
2015,8,26,1,2640,3663,2735,-928
2015,8,26,2,2653,3628,2717,-911
2015,8,26,3,2683,3570,2678,-892
2015,8,26,4,2570,3632,2717,-915
2015,8,26,5,2367,3502,2603,-899
2015,8,26,6,2374,3224,2585,-639
2015,8,26,7,2249,2959,2387,-572
2015,8,26,8,2066,2791,2311,-480
2015,8,26,9,1822,2686,2161,-525
2015,8,26,10,1729,2629,2095,-534
2015,8,26,11,1644,2621,2036,-585
2015,8,26,12,1724,2687,2075,-612
2015,8,26,13,2110,2916,2214,-702
2015,8,26,14,1765,3098,2090,-1008
2015,8,26,15,2103,3290,2091,-1199
2015,8,26,16,2375,3410,2180,-1230
2015,8,26,17,2408,3510,2389,-1121
2015,8,26,18,2413,3586,2396,-1190
2015,8,26,19,2517,3651,2486,-1165
2015,8,26,20,2650,3702,2610,-1092
2015,8,26,21,2650,3733,2695,-1038
2015,8,26,22,2650,3762,2744,-1018
2015,8,26,23,2754,3791,2733,-1058
2015,8,27,0,2754,3829,2718,-1111
2015,8,27,1,2753,3853,2728,-1125
2015,8,27,2,2754,3803,2725,-1078
2015,8,27,3,2778,3742,2637,-1105
2015,8,27,4,2575,3806,2655,-1151
2015,8,27,5,2447,3654,2539,-1115
2015,8,27,6,2599,3357,2544,-813
2015,8,27,7,2348,3063,2420,-643
2015,8,27,8,1934,2842,2327,-515
2015,8,27,9,1791,2684,2168,-516
2015,8,27,10,1730,2618,2094,-524
2015,8,27,11,1644,2463,1935,-528
2015,8,27,12,1650,2587,2031,-556
2015,8,27,13,1883,2830,2057,-773
2015,8,27,14,1843,3030,2052,-978
2015,8,27,15,2234,3200,2066,-1134
2015,8,27,16,2377,3347,2203,-1144
2015,8,27,17,2494,3475,2405,-1070
2015,8,27,18,2600,3601,2627,-974
2015,8,27,19,2703,3677,2690,-987
2015,8,27,20,2939,3729,2795,-934
2015,8,27,21,2948,3839,2919,-920
2015,8,27,22,2948,3917,2996,-921
2015,8,27,23,2945,3985,3008,-977
2015,8,28,0,2945,3989,2947,-1042
2015,8,28,1,2955,3956,2894,-1062
2015,8,28,2,2972,3894,2917,-977
2015,8,28,3,2998,3758,2859,-899
2015,8,28,4,2845,3826,2910,-916
2015,8,28,5,2842,3661,2850,-811
2015,8,28,6,2819,3383,2758,-625
2015,8,28,7,2544,3126,2492,-634
2015,8,28,8,1744,2789,2103,-686
2015,8,28,9,1577,2642,1931,-711
2015,8,28,10,1563,2614,1897,-717
2015,8,28,11,1545,2574,1827,-747
2015,8,28,12,1534,2624,1858,-766
2015,8,28,13,1852,2788,1994,-794
2015,8,28,14,1702,2953,1900,-1053
2015,8,28,15,2186,3230,1955,-1275
2015,8,28,16,2186,3410,2102,-1308
2015,8,28,17,2286,3543,2301,-1242
2015,8,28,18,2386,3645,2434,-1211
2015,8,28,19,2426,3654,2358,-1296
2015,8,28,20,2580,3696,2552,-1144
2015,8,28,21,2581,3718,2690,-1028
2015,8,28,22,2588,3726,2867,-859
2015,8,28,23,2606,3712,2894,-818
2015,8,29,0,2622,3702,2888,-814
2015,8,29,1,2639,3675,2773,-902
2015,8,29,2,2657,3597,2674,-923
2015,8,29,3,2647,3565,2710,-855
2015,8,29,4,2526,3613,2655,-958
2015,8,29,5,2511,3498,2610,-888
2015,8,29,6,2467,3242,2463,-779
2015,8,29,7,2151,2928,2288,-640
2015,8,29,8,1865,2717,1987,-730
2015,8,29,9,1605,2582,1858,-724
2015,8,29,10,1503,2504,1796,-708
2015,8,29,11,1501,2455,1823,-632
2015,8,29,12,1501,2495,1880,-615
2015,8,29,13,1503,2553,1870,-683
2015,8,29,14,1510,2632,1789,-843
2015,8,29,15,1531,2784,1843,-941
2015,8,29,16,1587,2863,1635,-1228
2015,8,29,17,1796,3063,1878,-1185
2015,8,29,18,1849,3055,1871,-1184
2015,8,29,19,2032,2962,1783,-1179
2015,8,29,20,2029,2696,1655,-1041
2015,8,29,21,2013,2237,1170,-1067
2015,8,29,22,2003,2211,1236,-975
2015,8,29,23,2000,2414,1628,-786
2015,8,30,0,2004,2655,1792,-863
2015,8,30,1,2018,2735,1766,-969
2015,8,30,2,2129,2796,1862,-934
2015,8,30,3,2138,2858,1943,-915
2015,8,30,4,2142,2962,2078,-884
2015,8,30,5,2143,2886,2269,-617
2015,8,30,6,2120,2718,2166,-552
2015,8,30,7,2106,2527,2024,-503
2015,8,30,8,1694,2380,1868,-512
2015,8,30,9,1435,2114,1587,-527
2015,8,30,10,1300,2007,1662,-345
2015,8,30,11,1289,1966,1636,-330
2015,8,30,12,1278,1994,1700,-294
2015,8,30,13,1269,2077,1729,-348
2015,8,30,14,1307,2196,1781,-415
2015,8,30,15,2083,2547,1843,-704
2015,8,30,16,2043,2756,1989,-767
2015,8,30,17,1989,2909,2039,-870
2015,8,30,18,2132,3012,2062,-950
2015,8,30,19,2133,3017,1937,-1080
2015,8,30,20,2099,3015,2105,-910
2015,8,30,21,2150,3006,2095,-911
2015,8,30,22,2213,2963,2009,-954
2015,8,30,23,2230,2954,1910,-1044
2015,8,31,0,2241,3030,2089,-941
2015,8,31,1,2217,3099,2106,-993
2015,8,31,2,2233,3107,2043,-1064
2015,8,31,3,2287,3139,1983,-1156
2015,8,31,4,2287,3225,2037,-1188
2015,8,31,5,2278,3117,2163,-954
2015,8,31,6,1954,2911,1817,-1094
2015,8,31,7,1445,2568,1563,-1005
2015,8,31,8,1349,2333,1450,-883
2015,8,31,9,1234,2172,1340,-832
2015,8,31,10,1223,2165,1422,-743
2015,8,31,11,1431,2305,1407,-898
2015,8,31,12,1425,2408,1495,-913
2015,8,31,13,1414,2682,1692,-990
2015,8,31,14,1412,3004,1765,-1239
2015,8,31,15,2121,3227,2041,-1186
2015,8,31,16,2351,3358,2190,-1168
2015,8,31,17,2449,3468,2269,-1199
2015,8,31,18,2442,3531,2308,-1223
2015,8,31,19,2441,3560,2271,-1289
2015,8,31,20,2446,3576,2331,-1245
2015,8,31,21,2461,3577,2431,-1146
2015,8,31,22,2466,3551,2439,-1112
2015,8,31,23,2464,3537,2503,-1034
2015,9,1,0,2470,3589,2528,-1061
2015,9,1,1,2488,3616,2525,-1091
2015,9,1,2,2515,3606,2530,-1076
2015,9,1,3,2432,3544,2110,-1434
2015,9,1,4,2432,3596,2110,-1486
2015,9,1,5,2433,3402,2088,-1314
2015,9,1,6,2371,3084,1969,-1115
2015,9,1,7,2016,2532,1734,-798
2015,9,1,8,1332,2364,1846,-518
2015,9,1,9,1375,2298,1789,-509
2015,9,1,10,1369,2218,1712,-506
2015,9,1,11,1364,2201,1680,-521
2015,9,1,12,1365,2307,1761,-546
2015,9,1,13,1442,2563,1973,-590
2015,9,1,14,1392,2982,1922,-1060
2015,9,1,15,2327,3248,1980,-1268
2015,9,1,16,2309,3347,2162,-1185
2015,9,1,17,2317,3384,2111,-1273
2015,9,1,18,2367,3447,2256,-1191
2015,9,1,19,2354,3562,2533,-1029
2015,9,1,20,2352,3591,2525,-1066
2015,9,1,21,2357,3552,2464,-1088
2015,9,1,22,2377,3512,2500,-1012
2015,9,1,23,2406,3477,2465,-1012
2015,9,2,0,2441,3502,2517,-985
2015,9,2,1,2581,3602,2628,-974
2015,9,2,2,2609,3610,2616,-994
2015,9,2,3,2524,3609,2635,-974
2015,9,2,4,2599,3657,2689,-968
2015,9,2,5,2275,3409,2579,-830
2015,9,2,6,2253,3131,2361,-770
2015,9,2,7,2010,2892,2047,-845
2015,9,2,8,1557,2587,1752,-835
2015,9,2,9,1652,2446,1684,-762
2015,9,2,10,1642,2410,1693,-717
2015,9,2,11,1605,2451,1701,-750
2015,9,2,12,1597,2515,1683,-832
2015,9,2,13,1598,2780,1878,-902
2015,9,2,14,1616,2913,1835,-1078
2015,9,2,15,1978,3156,1925,-1231
2015,9,2,16,2172,3299,2003,-1296
2015,9,2,17,2164,3375,2096,-1279
2015,9,2,18,2151,3443,2191,-1252
2015,9,2,19,2284,3460,2354,-1106
2015,9,2,20,2305,3460,2362,-1098
2015,9,2,21,2289,3433,2246,-1187
2015,9,2,22,2270,3411,2206,-1205
2015,9,2,23,2266,3413,2123,-1290
2015,9,3,0,2264,3462,2225,-1237
2015,9,3,1,2295,3463,2319,-1144
2015,9,3,2,2318,3414,2321,-1093
2015,9,3,3,2273,3487,2391,-1096
2015,9,3,4,2302,3594,2517,-1077
2015,9,3,5,2298,3405,2465,-940
2015,9,3,6,2331,3145,2376,-769
2015,9,3,7,1925,2887,2250,-637
2015,9,3,8,1454,2452,1925,-527
2015,9,3,9,1366,2302,1801,-501
2015,9,3,10,1361,2242,1789,-453
2015,9,3,11,1354,2238,1780,-458
2015,9,3,12,1344,2249,1613,-636
2015,9,3,13,1399,2599,1848,-751
2015,9,3,14,1675,2927,1941,-986
2015,9,3,15,2002,3142,1893,-1249
2015,9,3,16,2129,3233,1826,-1407
2015,9,3,17,2214,3402,1892,-1510
2015,9,3,18,2318,3440,2033,-1407
2015,9,3,19,2239,3367,2064,-1303
2015,9,3,20,2240,3379,2120,-1259
2015,9,3,21,2317,3401,2119,-1282
2015,9,3,22,2332,3381,2217,-1164
2015,9,3,23,2339,3379,2212,-1167
2015,9,4,0,2311,3416,2242,-1174
2015,9,4,1,2405,3452,2276,-1176
2015,9,4,2,2386,3427,2268,-1159
2015,9,4,3,2275,3426,2291,-1135
2015,9,4,4,2347,3538,2336,-1202
2015,9,4,5,2146,3371,2197,-1174
2015,9,4,6,2169,3127,2082,-1045
2015,9,4,7,2019,2901,1954,-947
2015,9,4,8,1743,2748,1996,-752
2015,9,4,9,1742,2642,1917,-725
2015,9,4,10,1743,2610,1850,-760
2015,9,4,11,1819,2614,1894,-720
2015,9,4,12,1819,2668,1839,-829
2015,9,4,13,1820,2875,1881,-994
2015,9,4,14,1820,3124,1926,-1198
2015,9,4,15,1940,3275,2090,-1185
2015,9,4,16,2265,3381,2152,-1229
2015,9,4,17,2243,3423,2192,-1231
2015,9,4,18,2246,3407,2272,-1135
2015,9,4,19,2260,3415,2385,-1030
2015,9,4,20,2357,3388,2411,-977
2015,9,4,21,2427,3346,2307,-1039
2015,9,4,22,2451,3307,2248,-1059
2015,9,4,23,2449,3288,2259,-1029
2015,9,5,0,2447,3315,2273,-1042
2015,9,5,1,2445,3340,2284,-1056
2015,9,5,2,2444,3320,2076,-1244
2015,9,5,3,2405,3213,1924,-1289
2015,9,5,4,2353,3281,2144,-1137
2015,9,5,5,2257,3147,1870,-1277
2015,9,5,6,2265,2974,2048,-926
2015,9,5,7,1893,2855,1826,-1029
2015,9,5,8,1560,2701,1692,-1009
2015,9,5,9,1382,2476,1524,-952
2015,9,5,10,1308,2420,1453,-967
2015,9,5,11,1168,2351,1433,-918
2015,9,5,12,1170,2399,1518,-881
2015,9,5,13,1367,2494,1482,-1012
2015,9,5,14,1382,2599,1371,-1228
2015,9,5,15,1450,2535,1223,-1312
2015,9,5,16,1616,2733,1485,-1248
2015,9,5,17,1602,2851,1558,-1293
2015,9,5,18,1594,2872,1596,-1276
2015,9,5,19,1721,2848,1557,-1291
2015,9,5,20,1727,2789,1522,-1267
2015,9,5,21,1752,2709,1443,-1266
2015,9,5,22,1800,2621,1394,-1227
2015,9,5,23,1982,2630,1390,-1240
2015,9,6,0,2032,2602,1383,-1219
2015,9,6,1,2065,2654,1427,-1227
2015,9,6,2,2072,2735,1594,-1141
2015,9,6,3,2073,2857,1658,-1199
2015,9,6,4,2082,2942,1701,-1241
2015,9,6,5,1961,2929,1717,-1212
2015,9,6,6,1967,2880,1847,-1033
2015,9,6,7,1890,2689,1737,-952
2015,9,6,8,1477,2535,1691,-844
2015,9,6,9,1412,2404,1612,-792
2015,9,6,10,1406,2359,1589,-770
2015,9,6,11,1336,2266,1550,-716
2015,9,6,12,1324,2327,1663,-664
2015,9,6,13,1423,2510,1739,-771
2015,9,6,14,1558,2662,1720,-942
2015,9,6,15,1624,2806,1799,-1007
2015,9,6,16,1768,3002,1813,-1189
2015,9,6,17,1739,3190,1947,-1243
2015,9,6,18,1722,3243,1923,-1320
2015,9,6,19,1797,3241,1840,-1401
2015,9,6,20,1903,3232,1754,-1478
2015,9,6,21,1919,3199,1799,-1400
2015,9,6,22,1948,3200,1836,-1364
2015,9,6,23,1988,3151,1732,-1419
2015,9,7,0,2024,3139,1702,-1437
2015,9,7,1,2056,3207,1955,-1252
2015,9,7,2,2120,3248,2012,-1236
2015,9,7,3,2112,3288,2039,-1249
2015,9,7,4,2137,3342,2054,-1288
2015,9,7,5,2084,3223,2040,-1183
2015,9,7,6,2113,3053,2003,-1050
2015,9,7,7,1937,2881,2029,-852
2015,9,7,8,1572,2675,1842,-833
2015,9,7,9,1621,2574,1806,-768
2015,9,7,10,1582,2500,1805,-695
2015,9,7,11,1482,2490,1780,-710
2015,9,7,12,1480,2510,1758,-752
2015,9,7,13,1645,2610,1814,-796
2015,9,7,14,1653,2701,1763,-938
2015,9,7,15,1774,2807,1822,-985
2015,9,7,16,2029,2975,1979,-996
2015,9,7,17,2114,3151,2112,-1039
2015,9,7,18,2147,3242,2204,-1038
2015,9,7,19,2253,3269,2177,-1092
2015,9,7,20,2365,3267,2235,-1032
2015,9,7,21,2378,3254,2305,-949
2015,9,7,22,2438,3249,2352,-897
2015,9,7,23,2450,3283,2421,-862
2015,9,8,0,2464,3321,2476,-845
2015,9,8,1,2468,3333,2533,-800
2015,9,8,2,2497,3319,2526,-793
2015,9,8,3,2491,3424,2599,-825
2015,9,8,4,2486,3503,2602,-901
2015,9,8,5,2375,3325,2505,-820
2015,9,8,6,2181,3073,2436,-637
2015,9,8,7,2066,2823,2183,-640
2015,9,8,8,1520,2570,1918,-652
2015,9,8,9,1451,2421,1781,-640
2015,9,8,10,1449,2373,1743,-630
2015,9,8,11,1610,2480,1762,-718
2015,9,8,12,1660,2587,1850,-737
2015,9,8,13,1889,2789,2041,-748
2015,9,8,14,1887,3114,2146,-968
2015,9,8,15,2119,3294,2348,-946
2015,9,8,16,2241,3364,2387,-977
2015,9,8,17,2355,3404,2417,-987
2015,9,8,18,2347,3427,2420,-1007
2015,9,8,19,2369,3469,2463,-1006
2015,9,8,20,2473,3503,2466,-1037
2015,9,8,21,2465,3507,2452,-1055
2015,9,8,22,2471,3532,2427,-1105
2015,9,8,23,2468,3533,2379,-1154
2015,9,9,0,2474,3606,2490,-1116
2015,9,9,1,2498,3630,2527,-1103
2015,9,9,2,2495,3596,2476,-1120
2015,9,9,3,2485,3632,2518,-1114
2015,9,9,4,2353,3715,2603,-1112
2015,9,9,5,2225,3475,2444,-1031
2015,9,9,6,2444,3227,2524,-703
2015,9,9,7,2040,2933,2375,-558
2015,9,9,8,1801,2754,2274,-480
2015,9,9,9,1717,2585,2137,-448
2015,9,9,10,1714,2528,1942,-586
2015,9,9,11,1711,2501,1912,-589
2015,9,9,12,1718,2521,1963,-558
2015,9,9,13,2174,2837,2277,-560
2015,9,9,14,2117,3131,2245,-886
2015,9,9,15,2161,3277,2351,-926
2015,9,9,16,2400,3336,2319,-1017
2015,9,9,17,2526,3396,2447,-949
2015,9,9,18,2534,3438,2526,-912
2015,9,9,19,2630,3454,2505,-949
2015,9,9,20,2838,3529,2673,-856
2015,9,9,21,2851,3589,2749,-840
2015,9,9,22,2865,3574,2710,-864
2015,9,9,23,2860,3585,2720,-865
2015,9,10,0,2868,3592,2675,-917
2015,9,10,1,2878,3666,2873,-793
2015,9,10,2,2881,3627,2835,-792
2015,9,10,3,2867,3624,2794,-830
2015,9,10,4,2784,3668,2760,-908
2015,9,10,5,2543,3481,2572,-909
2015,9,10,6,2582,3175,2529,-646
2015,9,10,7,2276,2982,2607,-375
2015,9,10,8,2130,2696,2306,-390
2015,9,10,9,2042,2509,2140,-369
2015,9,10,10,2105,2367,2106,-261
2015,9,10,11,1928,2369,1893,-476
2015,9,10,12,2040,2462,2119,-343
2015,9,10,13,2095,2704,2321,-383
2015,9,10,14,2043,2985,2314,-671
2015,9,10,15,2143,3147,2253,-894
2015,9,10,16,2332,3200,2279,-921
2015,9,10,17,2490,3227,2403,-824
2015,9,10,18,2493,3315,2548,-767
2015,9,10,19,2660,3379,2588,-791
2015,9,10,20,2754,3425,2649,-776
2015,9,10,21,2754,3469,2737,-732
2015,9,10,22,2754,3499,2763,-736
2015,9,10,23,2753,3521,2809,-712
2015,9,11,0,2753,3553,2813,-740
2015,9,11,1,2752,3559,2837,-722
2015,9,11,2,2759,3460,2690,-770
2015,9,11,3,2752,3505,2771,-734
2015,9,11,4,2751,3534,2740,-794
2015,9,11,5,2475,3299,2606,-693
2015,9,11,6,2438,3027,2513,-514
2015,9,11,7,2247,2776,2223,-553
2015,9,11,8,2003,2569,1931,-638
2015,9,11,9,1549,2509,1793,-716
2015,9,11,10,1534,2448,1748,-700
2015,9,11,11,1534,2410,1743,-667
2015,9,11,12,1534,2468,1788,-680
2015,9,11,13,1532,2720,2133,-587
2015,9,11,14,1532,2964,2007,-957
2015,9,11,15,1532,3163,2145,-1018
2015,9,11,16,2307,3222,2176,-1046
2015,9,11,17,2358,3279,2181,-1098
2015,9,11,18,2552,3367,2270,-1097
2015,9,11,19,2756,3435,2440,-995
2015,9,11,20,2755,3513,2651,-862
2015,9,11,21,2753,3555,2728,-827
2015,9,11,22,2752,3582,2750,-832
2015,9,11,23,2751,3620,2774,-846
2015,9,12,0,2750,3647,2814,-833
2015,9,12,1,2749,3649,2821,-828
2015,9,12,2,2749,3514,2695,-819
2015,9,12,3,2759,3471,2660,-811
2015,9,12,4,2707,3477,2474,-1003
2015,9,12,5,2402,3294,2200,-1094
2015,9,12,6,2552,3123,2289,-834
2015,9,12,7,2270,2939,2259,-680
2015,9,12,8,2062,2768,2261,-507
2015,9,12,9,2012,2621,2143,-478
2015,9,12,10,1960,2535,2190,-345
2015,9,12,11,1921,2559,2095,-464
2015,9,12,12,1881,2576,2076,-500
2015,9,12,13,1881,2636,2091,-545
2015,9,12,14,1881,2742,2089,-653
2015,9,12,15,1882,2859,1984,-875
2015,9,12,16,1915,3070,2060,-1010
2015,9,12,17,2028,3171,2014,-1157
2015,9,12,18,2245,3273,2059,-1214
2015,9,12,19,2251,3351,2185,-1166
2015,9,12,20,2258,3417,2318,-1099
2015,9,12,21,2305,3444,2370,-1074
2015,9,12,22,2337,3473,2416,-1057
2015,9,12,23,2376,3508,2525,-983
2015,9,13,0,2366,3530,2548,-982
2015,9,13,1,2389,3528,2512,-1016
2015,9,13,2,2482,3487,2529,-958
2015,9,13,3,2449,3489,2522,-967
2015,9,13,4,2399,3512,2496,-1016
2015,9,13,5,2311,3381,2320,-1061
2015,9,13,6,2365,3150,2384,-766
2015,9,13,7,2196,2799,2072,-727
2015,9,13,8,1622,2612,1981,-631
2015,9,13,9,1692,2497,1827,-670
2015,9,13,10,1683,2419,1780,-639
2015,9,13,11,1596,2321,1693,-628
2015,9,13,12,1583,2327,1674,-653
2015,9,13,13,1575,2371,1732,-639
2015,9,13,14,1566,2367,1710,-657
2015,9,13,15,1563,2593,1813,-780
2015,9,13,16,2042,2813,1975,-838
2015,9,13,17,2341,3118,2204,-914
2015,9,13,18,2319,3199,2309,-890
2015,9,13,19,2415,3226,2290,-936
2015,9,13,20,2447,3213,2313,-900
2015,9,13,21,2511,3229,2467,-762
2015,9,13,22,2539,3237,2463,-774
2015,9,13,23,2551,3257,2475,-782
2015,9,14,0,2533,3277,2433,-844
2015,9,14,1,2548,3353,2618,-735
2015,9,14,2,2546,3380,2636,-744
2015,9,14,3,2488,3460,2613,-847
2015,9,14,4,2413,3512,2713,-799
2015,9,14,5,2382,3296,2528,-768
2015,9,14,6,2337,2991,2176,-815
2015,9,14,7,2105,2626,1966,-660
2015,9,14,8,1640,2467,1887,-580
2015,9,14,9,1565,2367,1778,-589
2015,9,14,10,1514,2381,1855,-526
2015,9,14,11,1613,2501,1856,-645
2015,9,14,12,1582,2637,1964,-673
2015,9,14,13,2182,2895,2141,-754
2015,9,14,14,2010,3233,2190,-1043
2015,9,14,15,2302,3380,2184,-1196
2015,9,14,16,2326,3434,2288,-1146
2015,9,14,17,2381,3445,2524,-921
2015,9,14,18,2377,3435,2541,-894
2015,9,14,19,2377,3487,2695,-792
2015,9,14,20,2525,3461,2647,-814
2015,9,14,21,2596,3454,2776,-678
2015,9,14,22,2573,3386,2592,-794
2015,9,14,23,2616,3358,2553,-805
2015,9,15,0,2598,3380,2636,-744
2015,9,15,1,2607,3482,2722,-760
2015,9,15,2,2706,3503,2625,-878
2015,9,15,3,2635,3609,2713,-896
2015,9,15,4,2625,3596,2548,-1048
2015,9,15,5,2521,3393,2420,-973
2015,9,15,6,2516,3130,2432,-698
2015,9,15,7,2225,2815,1995,-820
2015,9,15,8,1593,2540,1841,-699
2015,9,15,9,1583,2415,1676,-739
2015,9,15,10,1525,2330,1597,-733
2015,9,15,11,1556,2400,1669,-731
2015,9,15,12,1536,2491,1666,-825
2015,9,15,13,1803,2881,1863,-1018
2015,9,15,14,1679,3260,1981,-1279
2015,9,15,15,1728,3427,2005,-1422
2015,9,15,16,2108,3442,2071,-1371
2015,9,15,17,2089,3417,2011,-1406
2015,9,15,18,2071,3414,1864,-1550
2015,9,15,19,2120,3401,1948,-1453
2015,9,15,20,2127,3409,2010,-1399
2015,9,15,21,2178,3417,2008,-1409
2015,9,15,22,2228,3404,2055,-1349
2015,9,15,23,2327,3376,2048,-1328
2015,9,16,0,2322,3379,2164,-1215
2015,9,16,1,2372,3460,2272,-1188
2015,9,16,2,2372,3509,2298,-1211
2015,9,16,3,2370,3644,2443,-1201
2015,9,16,4,2368,3611,2375,-1236
2015,9,16,5,2308,3335,2101,-1234
2015,9,16,6,2375,3116,2249,-867
2015,9,16,7,2217,2899,2184,-715
2015,9,16,8,1884,2737,2036,-701
2015,9,16,9,1898,2661,2085,-576
2015,9,16,10,1897,2609,2074,-535
2015,9,16,11,1898,2607,1991,-616
2015,9,16,12,1885,2695,1960,-735
2015,9,16,13,2051,2990,2126,-864
2015,9,16,14,1947,3335,2035,-1300
2015,9,16,15,2046,3448,2018,-1430
2015,9,16,16,2079,3452,2109,-1343
2015,9,16,17,2129,3427,2084,-1343
2015,9,16,18,2118,3412,2060,-1352
2015,9,16,19,2118,3416,2140,-1276
2015,9,16,20,2328,3429,2233,-1196
2015,9,16,21,2328,3428,2252,-1176
2015,9,16,22,2330,3415,2280,-1135
2015,9,16,23,2330,3409,2279,-1130
2015,9,17,0,2330,3419,2289,-1130
2015,9,17,1,2331,3462,2290,-1172
2015,9,17,2,2342,3471,2295,-1176
2015,9,17,3,2335,3604,2402,-1202
2015,9,17,4,2343,3563,2251,-1312
2015,9,17,5,2208,3330,2030,-1300
2015,9,17,6,2347,3149,2242,-907
2015,9,17,7,2223,2899,2111,-788
2015,9,17,8,1701,2741,1943,-798
2015,9,17,9,1639,2622,1783,-839
2015,9,17,10,1639,2565,1733,-832
2015,9,17,11,1639,2559,1733,-826
2015,9,17,12,1640,2652,1814,-838
2015,9,17,13,1915,2914,2007,-907
2015,9,17,14,1755,3233,1966,-1267
2015,9,17,15,1915,3336,1846,-1490
2015,9,17,16,1904,3356,1820,-1536
2015,9,17,17,1908,3388,1707,-1681
2015,9,17,18,1914,3452,1878,-1574
2015,9,17,19,1923,3472,2031,-1441
2015,9,17,20,2043,3424,1944,-1480
2015,9,17,21,2063,3385,1814,-1571
2015,9,17,22,2088,3358,1665,-1693
2015,9,17,23,2120,3375,1585,-1790
2015,9,18,0,2153,3380,1543,-1837
2015,9,18,1,2183,3437,1685,-1752
2015,9,18,2,2208,3441,1688,-1753
2015,9,18,3,2221,3627,2166,-1461
2015,9,18,4,2116,3604,2148,-1456
2015,9,18,5,1944,3413,2129,-1284
2015,9,18,6,2076,3168,2214,-954
2015,9,18,7,2002,2866,1857,-1009
2015,9,18,8,1444,2583,1728,-855
2015,9,18,9,1427,2455,1576,-879
2015,9,18,10,1407,2390,1487,-903
2015,9,18,11,1389,2396,1504,-892
2015,9,18,12,1462,2503,1607,-896
2015,9,18,13,1978,2869,1846,-1023
2015,9,18,14,1927,3224,1989,-1235
2015,9,18,15,2094,3408,2130,-1278
2015,9,18,16,2095,3424,2048,-1376
2015,9,18,17,2123,3453,2088,-1365
2015,9,18,18,2149,3434,2086,-1348
2015,9,18,19,2157,3432,2081,-1351
2015,9,18,20,2265,3459,2283,-1176
2015,9,18,21,2271,3449,2276,-1173
2015,9,18,22,2278,3414,2274,-1140
2015,9,18,23,2287,3385,2258,-1127
2015,9,19,0,2294,3392,2254,-1138
2015,9,19,1,2300,3437,2303,-1134
2015,9,19,2,2306,3425,2301,-1124
2015,9,19,3,2313,3506,2352,-1154
2015,9,19,4,2218,3456,2192,-1264
2015,9,19,5,2149,3312,2191,-1121
2015,9,19,6,2155,3137,2281,-856
2015,9,19,7,1992,2850,2040,-810
2015,9,19,8,1636,2695,2013,-682
2015,9,19,9,1589,2524,1812,-712
2015,9,19,10,1531,2452,1764,-688
2015,9,19,11,1605,2480,1755,-725
2015,9,19,12,1600,2521,1762,-759
2015,9,19,13,1667,2615,1834,-781
2015,9,19,14,1514,2729,1810,-919
2015,9,19,15,1520,2851,1741,-1110
2015,9,19,16,1676,3050,1802,-1248
2015,9,19,17,1855,3200,1897,-1303
2015,9,19,18,1861,3271,1953,-1318
2015,9,19,19,1864,3289,1963,-1326
2015,9,19,20,1870,3259,1952,-1307
2015,9,19,21,1872,3225,1923,-1302
2015,9,19,22,1859,3177,1832,-1345
2015,9,19,23,1859,3177,1831,-1346
2015,9,20,0,1872,3150,1810,-1340
2015,9,20,1,1872,3152,1761,-1391
2015,9,20,2,1880,3178,1785,-1393
2015,9,20,3,1871,3303,1910,-1393
2015,9,20,4,1880,3295,1956,-1339
2015,9,20,5,1877,3153,1854,-1299
2015,9,20,6,1880,3046,1995,-1051
2015,9,20,7,1836,2836,1937,-899
2015,9,20,8,1649,2648,1820,-828
2015,9,20,9,1566,2530,1699,-831
2015,9,20,10,1435,2347,1538,-809
2015,9,20,11,1363,2247,1461,-786
2015,9,20,12,1356,2254,1479,-775
2015,9,20,13,1362,2378,1614,-764
2015,9,20,14,1625,2594,1726,-868
2015,9,20,15,1808,2745,1821,-924
2015,9,20,16,1864,3004,2076,-928
2015,9,20,17,1863,3153,2038,-1115
2015,9,20,18,1960,3287,2013,-1274
2015,9,20,19,1954,3346,2012,-1334
2015,9,20,20,1946,3365,2008,-1357
2015,9,20,21,1896,3312,1955,-1357
2015,9,20,22,1898,3304,2010,-1294
2015,9,20,23,1953,3312,2107,-1205
2015,9,21,0,2092,3350,2162,-1188
2015,9,21,1,2099,3407,2216,-1191
2015,9,21,2,2102,3384,2170,-1214
2015,9,21,3,2106,3524,2283,-1241
2015,9,21,4,2100,3480,2263,-1217
2015,9,21,5,1970,3341,2084,-1257
2015,9,21,6,1871,3011,1863,-1148
2015,9,21,7,1772,2633,1642,-991
2015,9,21,8,1474,2445,1504,-941
2015,9,21,9,1465,2331,1439,-892
2015,9,21,10,1440,2307,1480,-827
2015,9,21,11,1394,2306,1506,-800
2015,9,21,12,1402,2398,1531,-867
2015,9,21,13,1405,2692,1765,-927
2015,9,21,14,1370,3062,1801,-1261
2015,9,21,15,1494,3289,1846,-1443
2015,9,21,16,1737,3310,1817,-1493
2015,9,21,17,1981,3325,1801,-1524
2015,9,21,18,2043,3380,1958,-1422
2015,9,21,19,2032,3393,2052,-1341
2015,9,21,20,2157,3383,2112,-1271
2015,9,21,21,2158,3421,2296,-1125
2015,9,21,22,2158,3384,2289,-1095
2015,9,21,23,2261,3386,2348,-1038
2015,9,22,0,2262,3394,2386,-1008
2015,9,22,1,2262,3483,2385,-1098
2015,9,22,2,2262,3509,2434,-1075
2015,9,22,3,2261,3594,2437,-1157
2015,9,22,4,2261,3549,2360,-1189
2015,9,22,5,2186,3328,2222,-1106
2015,9,22,6,2260,3041,2282,-759
2015,9,22,7,2132,2811,2239,-572
2015,9,22,8,1766,2660,2087,-573
2015,9,22,9,1771,2580,2078,-502
2015,9,22,10,1773,2525,1991,-534
2015,9,22,11,1778,2500,1998,-502
2015,9,22,12,1784,2643,2094,-549
2015,9,22,13,2090,2916,2105,-811
2015,9,22,14,1853,3303,2092,-1211
2015,9,22,15,1950,3573,2242,-1331
2015,9,22,16,1991,3560,2238,-1322
2015,9,22,17,2077,3486,2205,-1281
2015,9,22,18,2075,3443,2126,-1317
2015,9,22,19,2077,3411,2249,-1162
2015,9,22,20,2083,3393,2250,-1143
2015,9,22,21,2091,3371,2235,-1136
2015,9,22,22,2098,3337,2234,-1103
2015,9,22,23,2104,3318,2228,-1090
2015,9,23,0,2209,3348,2284,-1064
2015,9,23,1,2327,3425,2403,-1022
2015,9,23,2,2397,3505,2420,-1085
2015,9,23,3,2361,3676,2484,-1192
2015,9,23,4,2373,3649,2447,-1202
2015,9,23,5,2334,3423,2319,-1104
2015,9,23,6,2294,3107,2219,-888
2015,9,23,7,2272,2870,2197,-673
2015,9,23,8,1782,2673,1934,-739
2015,9,23,9,1761,2574,1790,-784
2015,9,23,10,1757,2557,1727,-830
2015,9,23,11,1753,2575,1814,-761
2015,9,23,12,1866,2694,1935,-759
2015,9,23,13,2115,2968,1996,-972
2015,9,23,14,1962,3369,2043,-1326
2015,9,23,15,2045,3626,2188,-1438
2015,9,23,16,2087,3606,2154,-1452
2015,9,23,17,2080,3525,2084,-1441
2015,9,23,18,2079,3478,2055,-1423
2015,9,23,19,2082,3453,2078,-1375
2015,9,23,20,2195,3419,2153,-1266
2015,9,23,21,2250,3428,2272,-1156
2015,9,23,22,2251,3412,2245,-1167
2015,9,23,23,2249,3448,2349,-1099
2015,9,24,0,2294,3463,2335,-1128
2015,9,24,1,2314,3499,2382,-1117
2015,9,24,2,2308,3516,2345,-1171
2015,9,24,3,2303,3669,2463,-1206
2015,9,24,4,2299,3585,2317,-1268
2015,9,24,5,2169,3349,2168,-1181
2015,9,24,6,2217,3001,2184,-817
2015,9,24,7,2217,2822,2242,-580
2015,9,24,8,1799,2636,2017,-619
2015,9,24,9,1562,2464,1923,-541
2015,9,24,10,1557,2414,1881,-533
2015,9,24,11,1555,2426,1848,-578
2015,9,24,12,1659,2520,1949,-571
2015,9,24,13,1936,2752,2025,-727
2015,9,24,14,1866,3110,2170,-940
2015,9,24,15,1926,3275,2197,-1078
2015,9,24,16,1926,3328,2318,-1010
2015,9,24,17,1927,3277,2203,-1074
2015,9,24,18,2127,3282,2198,-1084
2015,9,24,19,2128,3337,2314,-1023
2015,9,24,20,2232,3350,2407,-943
2015,9,24,21,2234,3359,2417,-942
2015,9,24,22,2235,3319,2407,-912
2015,9,24,23,2236,3300,2410,-890
2015,9,25,0,2237,3335,2457,-878
2015,9,25,1,2239,3357,2448,-909
2015,9,25,2,2280,3405,2523,-882
2015,9,25,3,2284,3519,2483,-1036
2015,9,25,4,2291,3445,2459,-986
2015,9,25,5,2276,3208,2326,-882
2015,9,25,6,2316,2914,2281,-633
2015,9,25,7,2332,2698,2292,-406
2015,9,25,8,1755,2483,1897,-586
2015,9,25,9,1683,2371,1787,-584
2015,9,25,10,1680,2302,1735,-567
2015,9,25,11,1676,2296,1733,-563
2015,9,25,12,1737,2384,1808,-576
2015,9,25,13,1914,2591,1813,-778
2015,9,25,14,1779,2879,1742,-1137
2015,9,25,15,1831,3196,2023,-1173
2015,9,25,16,1905,3206,1970,-1236
2015,9,25,17,1937,3250,1970,-1280
2015,9,25,18,1935,3299,1982,-1317
2015,9,25,19,1984,3299,1941,-1358
2015,9,25,20,2083,3296,2023,-1273
2015,9,25,21,2081,3231,2015,-1216
2015,9,25,22,2083,3166,1991,-1175
2015,9,25,23,2089,3127,1940,-1187
2015,9,26,0,2095,3197,1933,-1264
2015,9,26,1,2152,3317,1993,-1324
2015,9,26,2,2198,3252,1751,-1501
2015,9,26,3,2202,3411,2045,-1366
2015,9,26,4,2207,3391,2126,-1265
2015,9,26,5,2108,3252,2186,-1066
2015,9,26,6,2207,3065,2389,-676
2015,9,26,7,2213,2793,2101,-692
2015,9,26,8,1754,2614,1907,-707
2015,9,26,9,1576,2510,1778,-732
2015,9,26,10,1566,2427,1722,-705
2015,9,26,11,1378,2228,1523,-705
2015,9,26,12,1378,2216,1433,-783
2015,9,26,13,1488,2285,1431,-854
2015,9,26,14,1443,2383,1442,-941
2015,9,26,15,1612,2542,1385,-1157
2015,9,26,16,1599,2810,1447,-1363
2015,9,26,17,1683,2940,1490,-1450
2015,9,26,18,1683,2987,1408,-1579
2015,9,26,19,1742,3055,1406,-1649
2015,9,26,20,1762,2990,1449,-1541
2015,9,26,21,1790,2936,1560,-1376
2015,9,26,22,1846,2896,1607,-1289
2015,9,26,23,1900,2904,1693,-1211
2015,9,27,0,2008,2941,1786,-1155
2015,9,27,1,2010,2957,1762,-1195
2015,9,27,2,2050,3068,1826,-1242
2015,9,27,3,2022,3269,2054,-1215
2015,9,27,4,2013,3248,2127,-1121
2015,9,27,5,1854,3140,2170,-970
2015,9,27,6,1970,2983,2185,-798
2015,9,27,7,1957,2854,2213,-641
2015,9,27,8,1591,2625,1847,-778
2015,9,27,9,1588,2529,1768,-761
2015,9,27,10,1583,2479,1704,-775
2015,9,27,11,1579,2456,1637,-819
2015,9,27,12,1577,2484,1606,-878
2015,9,27,13,1624,2607,1701,-906
2015,9,27,14,1738,2806,1772,-1034
2015,9,27,15,1877,3029,1948,-1081
2015,9,27,16,2054,3272,2091,-1181
2015,9,27,17,2074,3348,2189,-1159
2015,9,27,18,2124,3405,2161,-1244
2015,9,27,19,2271,3451,2143,-1308
2015,9,27,20,2219,3400,2150,-1250
2015,9,27,21,2255,3351,2127,-1224
2015,9,27,22,2254,3271,2126,-1145
2015,9,27,23,2255,3253,2220,-1033
2015,9,28,0,2407,3298,2297,-1001
2015,9,28,1,2404,3375,2319,-1056
2015,9,28,2,2400,3455,2384,-1071
2015,9,28,3,2395,3606,2520,-1086
2015,9,28,4,2407,3553,2494,-1059
2015,9,28,5,2240,3373,2243,-1130
2015,9,28,6,2304,3129,2134,-995
2015,9,28,7,2045,2910,1987,-923
2015,9,28,8,1793,2725,1782,-943
2015,9,28,9,1501,2647,1719,-928
2015,9,28,10,1475,2635,1711,-924
2015,9,28,11,1505,2675,1745,-930
2015,9,28,12,1515,2810,1897,-913
2015,9,28,13,1976,3157,2129,-1028
2015,9,28,14,1875,3550,2132,-1418
2015,9,28,15,2222,3744,2206,-1538
2015,9,28,16,2207,3729,2155,-1574
2015,9,28,17,2179,3648,2055,-1593
2015,9,28,18,2178,3598,2027,-1571
2015,9,28,19,2180,3558,2074,-1484
2015,9,28,20,2151,3538,2148,-1390
2015,9,28,21,2148,3514,2116,-1398
2015,9,28,22,2143,3488,2087,-1401
2015,9,28,23,2136,3469,2147,-1322
2015,9,29,0,2126,3505,2155,-1350
2015,9,29,1,2221,3563,2188,-1375
2015,9,29,2,2208,3619,2227,-1392
2015,9,29,3,2177,3756,2250,-1506
2015,9,29,4,2141,3657,2209,-1448
2015,9,29,5,2053,3400,2074,-1326
2015,9,29,6,2138,3114,2072,-1042
2015,9,29,7,2127,2879,2076,-803
2015,9,29,8,1757,2718,1908,-810
2015,9,29,9,1676,2639,1865,-774
2015,9,29,10,1642,2600,1848,-752
2015,9,29,11,1651,2630,1863,-767
2015,9,29,12,1817,2746,1897,-849
2015,9,29,13,2086,3041,1999,-1042
2015,9,29,14,1739,3421,1964,-1457
2015,9,29,15,1989,3613,2031,-1582
2015,9,29,16,2072,3590,2023,-1567
2015,9,29,17,2100,3516,1932,-1584
2015,9,29,18,2068,3505,2011,-1494
2015,9,29,19,2068,3475,1979,-1496
2015,9,29,20,2067,3512,2028,-1484
2015,9,29,21,2066,3511,2025,-1486
2015,9,29,22,2066,3511,2023,-1488
2015,9,29,23,2066,3509,2099,-1410
2015,9,30,0,2318,3519,2153,-1366
2015,9,30,1,2318,3563,2283,-1280
2015,9,30,2,2244,3569,2225,-1344
2015,9,30,3,2244,3719,2276,-1443
2015,9,30,4,2199,3598,2204,-1394
2015,9,30,5,2150,3340,2027,-1313
2015,9,30,6,2181,3098,2105,-993
2015,9,30,7,2019,2840,2052,-788
2015,9,30,8,1852,2695,1959,-736
2015,9,30,9,1772,2601,1896,-705
2015,9,30,10,1768,2558,1880,-678
2015,9,30,11,1765,2569,1863,-706
2015,9,30,12,1761,2675,1884,-791
2015,9,30,13,1975,2987,2073,-914
2015,9,30,14,1747,3340,2064,-1276
2015,9,30,15,1931,3512,2066,-1446
2015,9,30,16,1996,3510,1993,-1517
2015,9,30,17,1991,3525,1914,-1611
2015,9,30,18,2011,3541,1997,-1544
2015,9,30,19,2074,3504,1985,-1519
2015,9,30,20,2075,3481,2005,-1476
2015,9,30,21,2076,3456,2024,-1432
2015,9,30,22,2077,3424,2019,-1405
2015,9,30,23,2077,3434,2047,-1387
2015,10,1,0,2075,3466,2081,-1385
2015,10,1,1,2075,3519,2098,-1421
2015,10,1,2,2183,3572,2199,-1373
2015,10,1,3,2137,3736,2275,-1461
2015,10,1,4,2096,3629,2212,-1417
2015,10,1,5,1814,3341,1988,-1353
2015,10,1,6,2087,3121,2107,-1014
2015,10,1,7,1900,2869,1994,-875
2015,10,1,8,1370,2687,1617,-1070
2015,10,1,9,1327,2633,1629,-1004
2015,10,1,10,1328,2600,1634,-966
2015,10,1,11,1353,2614,1651,-963
2015,10,1,12,1354,2717,1674,-1043
2015,10,1,13,1877,3003,1850,-1153
2015,10,1,14,1867,3367,1886,-1481
2015,10,1,15,2001,3612,2044,-1568
2015,10,1,16,2060,3582,2019,-1563
2015,10,1,17,2050,3510,1945,-1565
2015,10,1,18,1993,3473,1938,-1535
2015,10,1,19,1889,3519,1927,-1592
2015,10,1,20,1889,3491,1873,-1618
2015,10,1,21,1889,3480,1896,-1584
2015,10,1,22,1882,3463,1911,-1552
2015,10,1,23,1882,3471,1912,-1559
2015,10,2,0,1874,3484,1931,-1553
2015,10,2,1,1977,3540,2008,-1532
2015,10,2,2,2003,3565,2079,-1486
2015,10,2,3,2039,3725,2149,-1576
2015,10,2,4,1964,3638,2088,-1550
2015,10,2,5,1950,3398,1960,-1438
2015,10,2,6,1909,3156,1841,-1315
2015,10,2,7,1590,2945,1705,-1240
2015,10,2,8,1408,2700,1576,-1124
2015,10,2,9,1271,2610,1554,-1056
2015,10,2,10,1258,2568,1524,-1044
2015,10,2,11,1206,2529,1487,-1042
2015,10,2,12,1296,2690,1577,-1113
2015,10,2,13,1640,2908,1714,-1194
2015,10,2,14,1644,3310,1718,-1592
2015,10,2,15,1759,3523,1729,-1794
2015,10,2,16,1814,3537,1718,-1819
2015,10,2,17,1703,3536,1698,-1838
2015,10,2,18,1741,3529,1633,-1896
2015,10,2,19,1817,3426,1599,-1827
2015,10,2,20,1868,3440,1678,-1762
2015,10,2,21,1860,3521,1614,-1907
2015,10,2,22,1627,3424,1568,-1856
2015,10,2,23,1646,3388,1575,-1813
2015,10,3,0,1653,3361,1629,-1732
2015,10,3,1,1652,3423,1626,-1797
2015,10,3,2,1639,3449,1658,-1791
2015,10,3,3,1717,3484,1783,-1701
2015,10,3,4,1691,3344,1600,-1744
2015,10,3,5,1666,3162,1592,-1570
2015,10,3,6,1645,2986,1608,-1378
2015,10,3,7,1324,2769,1488,-1281
2015,10,3,8,1138,2648,1509,-1139
2015,10,3,9,1139,2522,1344,-1178
2015,10,3,10,1043,2397,1250,-1147
2015,10,3,11,1057,2351,1173,-1178
2015,10,3,12,1078,2378,1169,-1209
2015,10,3,13,1343,2514,1216,-1298
2015,10,3,14,1212,2687,1321,-1366
2015,10,3,15,1668,3033,1621,-1412
2015,10,3,16,1809,3143,1728,-1415
2015,10,3,17,1821,3332,1887,-1445
2015,10,3,18,1816,3219,1868,-1351
2015,10,3,19,1819,3174,1856,-1318
2015,10,3,20,1820,3127,1849,-1278
2015,10,3,21,1717,3083,1764,-1319
2015,10,3,22,1714,3014,1673,-1341
2015,10,3,23,1663,3015,1678,-1337
2015,10,4,0,1659,3196,1813,-1383
2015,10,4,1,1660,3255,1816,-1439
2015,10,4,2,1645,3311,1798,-1513
2015,10,4,3,1636,3470,1877,-1593
2015,10,4,4,1633,3381,1814,-1567
2015,10,4,5,1611,3210,1591,-1619
2015,10,4,6,1619,3099,1825,-1274
2015,10,4,7,1623,2904,1754,-1150
2015,10,4,8,1557,2729,1642,-1087
2015,10,4,9,1404,2643,1619,-1024
2015,10,4,10,1406,2592,1590,-1002
2015,10,4,11,1460,2556,1544,-1012
2015,10,4,12,1594,2568,1613,-955
2015,10,4,13,1712,2671,1753,-918
2015,10,4,14,1804,2846,1798,-1048
2015,10,4,15,1929,3023,1864,-1159
2015,10,4,16,2096,3220,2133,-1087
2015,10,4,17,2224,3315,2186,-1129
2015,10,4,18,2212,3304,2172,-1132
2015,10,4,19,2204,3327,2205,-1122
2015,10,4,20,2298,3271,2175,-1096
2015,10,4,21,2311,3226,2193,-1033
2015,10,4,22,2295,3192,2164,-1028
2015,10,4,23,2278,3213,2242,-971
2015,10,5,0,2301,3292,2369,-923
2015,10,5,1,2313,3391,2423,-968
2015,10,5,2,2306,3483,2450,-1033
2015,10,5,3,2303,3644,2488,-1156
2015,10,5,4,2300,3518,2379,-1139
2015,10,5,5,2289,3193,2182,-1011
2015,10,5,6,2284,2898,2088,-810
2015,10,5,7,2001,2632,1868,-764
2015,10,5,8,1653,2464,1719,-745
2015,10,5,9,1574,2329,1636,-693
2015,10,5,10,1587,2303,1632,-671
2015,10,5,11,1588,2346,1663,-683
2015,10,5,12,1669,2548,1775,-773
2015,10,5,13,1835,2899,2044,-855
2015,10,5,14,2042,3256,2067,-1189
2015,10,5,15,2099,3471,2199,-1272
2015,10,5,16,2002,3460,2203,-1257
2015,10,5,17,2001,3403,2169,-1234
2015,10,5,18,2054,3412,2108,-1304
2015,10,5,19,1952,3386,2095,-1291
2015,10,5,20,1952,3373,2110,-1263
2015,10,5,21,1950,3364,2064,-1300
2015,10,5,22,1947,3348,2049,-1299
2015,10,5,23,1938,3347,2040,-1307
2015,10,6,0,1943,3376,2073,-1303
2015,10,6,1,2094,3408,2134,-1274
2015,10,6,2,2193,3422,2148,-1274
2015,10,6,3,2195,3496,2126,-1370
2015,10,6,4,2195,3396,2031,-1365
2015,10,6,5,2081,3212,2000,-1212
2015,10,6,6,2076,2944,2022,-922
2015,10,6,7,1903,2699,1900,-799
2015,10,6,8,1671,2546,1850,-696
2015,10,6,9,1569,2467,1775,-692
2015,10,6,10,1567,2444,1719,-725
2015,10,6,11,1565,2445,1739,-706
2015,10,6,12,1663,2550,1837,-713
2015,10,6,13,1853,2785,1824,-961
2015,10,6,14,1899,3180,1851,-1329
2015,10,6,15,2046,3367,2014,-1353
2015,10,6,16,2042,3339,1981,-1358
2015,10,6,17,2005,3326,1952,-1374
2015,10,6,18,2020,3320,1924,-1396
2015,10,6,19,1988,3315,1882,-1433
2015,10,6,20,1990,3279,1866,-1413
2015,10,6,21,1992,3255,1868,-1387
2015,10,6,22,1995,3218,1841,-1377
2015,10,6,23,1998,3210,1834,-1376
2015,10,7,0,2006,3255,1910,-1345
2015,10,7,1,2124,3344,1977,-1367
2015,10,7,2,2167,3493,2067,-1426
2015,10,7,3,2231,3584,2150,-1434
2015,10,7,4,2147,3465,2085,-1380
2015,10,7,5,1932,3258,2076,-1182
2015,10,7,6,2114,2971,2053,-918
2015,10,7,7,1838,2707,1995,-712
2015,10,7,8,1649,2545,1940,-605
2015,10,7,9,1795,2448,1837,-611
2015,10,7,10,1703,2340,1670,-670
2015,10,7,11,1690,2346,1612,-734
2015,10,7,12,1681,2431,1754,-677
2015,10,7,13,1884,2759,1878,-881
2015,10,7,14,1851,3131,1990,-1141
2015,10,7,15,1949,3352,2038,-1314
2015,10,7,16,1943,3359,1959,-1400
2015,10,7,17,2008,3377,2036,-1341
2015,10,7,18,2073,3380,2013,-1367
2015,10,7,19,2083,3355,1939,-1416
2015,10,7,20,2124,3342,1895,-1447
2015,10,7,21,2140,3340,1962,-1378
2015,10,7,22,2147,3350,2063,-1287
2015,10,7,23,2137,3353,2098,-1255
2015,10,8,0,2159,3387,2187,-1200
2015,10,8,1,2247,3466,2286,-1180
2015,10,8,2,2310,3575,2343,-1232
2015,10,8,3,2424,3609,2376,-1233
2015,10,8,4,2368,3460,2175,-1285
2015,10,8,5,2164,3333,2159,-1174
2015,10,8,6,2209,3084,2298,-786
2015,10,8,7,2023,2795,2197,-598
2015,10,8,8,1634,2543,1944,-599
2015,10,8,9,1620,2471,1797,-674
2015,10,8,10,1653,2431,1700,-731
2015,10,8,11,1648,2423,1605,-818
2015,10,8,12,1647,2507,1634,-873
2015,10,8,13,1860,2768,1765,-1003
2015,10,8,14,1891,3132,1856,-1276
2015,10,8,15,2049,3339,1936,-1403
2015,10,8,16,2053,3328,1927,-1401
2015,10,8,17,2053,3328,1922,-1406
2015,10,8,18,1977,3331,1903,-1428
2015,10,8,19,1857,3308,1894,-1414
2015,10,8,20,1857,3287,1900,-1387
2015,10,8,21,1857,3254,1889,-1365
2015,10,8,22,1857,3232,1890,-1342
2015,10,8,23,1857,3193,1844,-1349
2015,10,9,0,1857,3158,1818,-1340
2015,10,9,1,2036,3222,1887,-1335
2015,10,9,2,2036,3390,2018,-1372
2015,10,9,3,2036,3481,2095,-1386
2015,10,9,4,2036,3340,1978,-1362
2015,10,9,5,1882,3138,1941,-1197
2015,10,9,6,1962,2869,1907,-962
2015,10,9,7,1818,2640,1832,-808
2015,10,9,8,1598,2454,1767,-687
2015,10,9,9,1504,2353,1700,-653
2015,10,9,10,1592,2314,1684,-630
2015,10,9,11,1589,2381,1671,-710
2015,10,9,12,1616,2468,1701,-767
2015,10,9,13,1883,2702,1897,-805
2015,10,9,14,1939,3013,1917,-1096
2015,10,9,15,2294,3262,2173,-1089
2015,10,9,16,2304,3322,2219,-1103
2015,10,9,17,2307,3381,2272,-1109
2015,10,9,18,2355,3415,2296,-1119
2015,10,9,19,2282,3398,2285,-1113
2015,10,9,20,2250,3384,2308,-1076
2015,10,9,21,2208,3316,2261,-1055
2015,10,9,22,2209,3294,2215,-1079
2015,10,9,23,2226,3274,2214,-1060
2015,10,10,0,2239,3259,2093,-1166
2015,10,10,1,2249,3262,2042,-1220
2015,10,10,2,2258,3364,2143,-1221
2015,10,10,3,2256,3394,2193,-1201
2015,10,10,4,2247,3237,1984,-1253
2015,10,10,5,2128,3131,1973,-1158
2015,10,10,6,2108,2928,1895,-1033
2015,10,10,7,1746,2736,1699,-1037
2015,10,10,8,1555,2632,1651,-981
2015,10,10,9,1512,2564,1560,-1004
2015,10,10,10,1498,2506,1514,-992
2015,10,10,11,1390,2492,1507,-985
2015,10,10,12,1435,2517,1556,-961
2015,10,10,13,1455,2589,1623,-966
2015,10,10,14,1553,2719,1584,-1135
2015,10,10,15,1646,2895,1662,-1233
2015,10,10,16,1752,3128,1826,-1302
2015,10,10,17,1791,3315,1972,-1343
2015,10,10,18,1833,3428,2172,-1256
2015,10,10,19,1869,3366,2193,-1173
2015,10,10,20,1867,3286,2068,-1218
2015,10,10,21,1722,3223,1848,-1375
2015,10,10,22,1678,3187,1567,-1620
2015,10,10,23,1682,3155,1627,-1528
2015,10,11,0,1685,3171,1567,-1604
2015,10,11,1,1690,3247,1940,-1307
2015,10,11,2,1742,3326,1814,-1512
2015,10,11,3,1749,3396,1967,-1429
2015,10,11,4,1757,3284,1796,-1488
2015,10,11,5,1712,3143,1715,-1428
2015,10,11,6,1716,2968,1657,-1311
2015,10,11,7,1663,2484,1454,-1030
2015,10,11,8,1316,2266,1419,-847
2015,10,11,9,1197,2121,1279,-842
2015,10,11,10,1195,2079,1266,-813
2015,10,11,11,1191,2058,1263,-795
2015,10,11,12,1188,2087,1263,-824
2015,10,11,13,1242,2182,1302,-880
2015,10,11,14,1376,2429,1391,-1038
2015,10,11,15,1749,2756,1572,-1184
2015,10,11,16,1738,3113,1792,-1321
2015,10,11,17,1869,3293,1974,-1319
2015,10,11,18,1878,3265,1934,-1331
2015,10,11,19,1895,3263,1973,-1290
2015,10,11,20,1874,3187,1876,-1311
2015,10,11,21,1914,3184,1874,-1310
2015,10,11,22,1887,3165,1885,-1280
2015,10,11,23,1960,3152,2007,-1145
2015,10,12,0,2136,3244,2149,-1095
2015,10,12,1,2119,3445,2327,-1118
2015,10,12,2,2111,3612,2408,-1204
2015,10,12,3,2110,3661,2323,-1338
2015,10,12,4,2108,3543,2250,-1293
2015,10,12,5,2055,3342,2183,-1159
2015,10,12,6,1805,3064,2002,-1062
2015,10,12,7,1631,2832,1760,-1072
2015,10,12,8,1509,2716,1708,-1008
2015,10,12,9,1511,2607,1632,-975
2015,10,12,10,1604,2557,1627,-930
2015,10,12,11,1610,2566,1626,-940
2015,10,12,12,1608,2715,1774,-941
2015,10,12,13,1874,2966,1873,-1093
2015,10,12,14,1922,3316,1874,-1442
2015,10,12,15,2039,3529,1883,-1646
2015,10,12,16,2044,3564,1935,-1629
2015,10,12,17,2046,3549,1747,-1802
2015,10,12,18,2048,3626,2014,-1612
2015,10,12,19,1996,3583,1939,-1644
2015,10,12,20,1907,3620,1992,-1628
2015,10,12,21,1920,3558,1930,-1628
2015,10,12,22,1934,3525,1828,-1697
2015,10,12,23,1945,3519,1769,-1750
2015,10,13,0,1965,3561,1762,-1799
2015,10,13,1,2044,3689,1864,-1825
2015,10,13,2,2078,3832,2060,-1772
2015,10,13,3,2103,3833,2047,-1786
2015,10,13,4,2020,3662,1938,-1724
2015,10,13,5,1792,3429,1816,-1613
2015,10,13,6,1890,3180,1911,-1269
2015,10,13,7,1740,2876,1803,-1073
2015,10,13,8,1390,2563,1568,-995
2015,10,13,9,1363,2432,1434,-998
2015,10,13,10,1240,2332,1453,-879
2015,10,13,11,1216,2349,1463,-886
2015,10,13,12,1370,2557,1610,-947
2015,10,13,13,1862,2951,1897,-1054
2015,10,13,14,1663,3282,1733,-1549
2015,10,13,15,1730,3494,1743,-1751
2015,10,13,16,1786,3512,1757,-1755
2015,10,13,17,1779,3518,1741,-1777
2015,10,13,18,1776,3510,1697,-1813
2015,10,13,19,1741,3483,1665,-1818
2015,10,13,20,1740,3326,1422,-1904
2015,10,13,21,1717,3297,1412,-1885
2015,10,13,22,1702,3256,1406,-1850
2015,10,13,23,1707,3170,1380,-1790
2015,10,14,0,1742,3214,1428,-1786
2015,10,14,1,1910,3308,1529,-1779
2015,10,14,2,1982,3655,1833,-1822
2015,10,14,3,1985,3806,2002,-1804
2015,10,14,4,1983,3698,2069,-1629
2015,10,14,5,1877,3457,2020,-1437
2015,10,14,6,1991,3261,2011,-1250
2015,10,14,7,1901,3032,1951,-1081
2015,10,14,8,1498,2841,1720,-1121
2015,10,14,9,1519,2715,1634,-1081
2015,10,14,10,1510,2671,1582,-1089
2015,10,14,11,1504,2699,1599,-1100
2015,10,14,12,1681,2823,1631,-1192
2015,10,14,13,1830,3116,1796,-1320
2015,10,14,14,1760,3480,1824,-1656
2015,10,14,15,1940,3758,2018,-1740
2015,10,14,16,2011,3748,2059,-1689
2015,10,14,17,2021,3706,2056,-1650
2015,10,14,18,2021,3674,2115,-1559
2015,10,14,19,1921,3634,2097,-1537
2015,10,14,20,1910,3590,1992,-1598
2015,10,14,21,1910,3538,1909,-1629
2015,10,14,22,1911,3471,1834,-1637
2015,10,14,23,1911,3457,1840,-1617
2015,10,15,0,1912,3490,1904,-1586
2015,10,15,1,2012,3582,1931,-1651
2015,10,15,2,2015,3775,2128,-1647
2015,10,15,3,2055,3843,2182,-1661
2015,10,15,4,2063,3737,2115,-1622
2015,10,15,5,1998,3481,1938,-1543
2015,10,15,6,2066,3239,1980,-1259
2015,10,15,7,1779,2921,1920,-1001
2015,10,15,8,1859,2727,1961,-766
2015,10,15,9,1722,2653,1913,-740
2015,10,15,10,1723,2606,1858,-748
2015,10,15,11,1823,2621,1841,-780
2015,10,15,12,1857,2750,1893,-857
2015,10,15,13,2156,3053,2078,-975
2015,10,15,14,2167,3420,2044,-1376
2015,10,15,15,2181,3590,2033,-1557
2015,10,15,16,2160,3610,2022,-1588
2015,10,15,17,2156,3516,1972,-1544
2015,10,15,18,2078,3446,1949,-1497
2015,10,15,19,1980,3393,1885,-1508
2015,10,15,20,1956,3316,1833,-1483
2015,10,15,21,1955,3300,1797,-1503
2015,10,15,22,1952,3290,1780,-1510
2015,10,15,23,1936,3280,1800,-1480
2015,10,16,0,1936,3292,1808,-1484
2015,10,16,1,2040,3317,1904,-1413
2015,10,16,2,2151,3512,2125,-1387
2015,10,16,3,2170,3587,2215,-1372
2015,10,16,4,2242,3485,2160,-1325
2015,10,16,5,2087,3266,2121,-1145
2015,10,16,6,2272,3040,2219,-821
2015,10,16,7,2037,2802,1980,-822
2015,10,16,8,1702,2657,1873,-784
2015,10,16,9,1650,2557,1795,-762
2015,10,16,10,1650,2510,1772,-738
2015,10,16,11,1650,2534,1785,-749
2015,10,16,12,1699,2668,1872,-796
2015,10,16,13,1847,2945,1993,-952
2015,10,16,14,2019,3340,2197,-1143
2015,10,16,15,2290,3594,2339,-1255
2015,10,16,16,2288,3554,2251,-1303
2015,10,16,17,2286,3482,2214,-1268
2015,10,16,18,2286,3444,2192,-1252
2015,10,16,19,2287,3390,2259,-1131
2015,10,16,20,2240,3356,2261,-1095
2015,10,16,21,2201,3337,2208,-1129
2015,10,16,22,2203,3291,2206,-1085
2015,10,16,23,2195,3277,2197,-1080
2015,10,17,0,2190,3294,2213,-1081
2015,10,17,1,2236,3341,2224,-1117
2015,10,17,2,2282,3456,2286,-1170
2015,10,17,3,2279,3439,2239,-1200
2015,10,17,4,2280,3339,2193,-1146
2015,10,17,5,2181,3198,2230,-968
2015,10,17,6,2255,3014,2266,-748
2015,10,17,7,1914,2781,2126,-655
2015,10,17,8,1569,2630,1975,-655
2015,10,17,9,1514,2500,1812,-688
2015,10,17,10,1511,2465,1743,-722
2015,10,17,11,1508,2438,1710,-728
2015,10,17,12,1396,2376,1707,-669
2015,10,17,13,1587,2429,1785,-644
2015,10,17,14,1580,2595,1882,-713
2015,10,17,15,1852,2806,1991,-815
2015,10,17,16,1951,2998,1976,-1022
2015,10,17,17,2050,3171,2039,-1132
2015,10,17,18,2054,3278,2189,-1089
2015,10,17,19,2052,3179,1954,-1225
2015,10,17,20,2055,3174,2004,-1170
2015,10,17,21,1968,3130,1961,-1169
2015,10,17,22,1933,3103,1970,-1133
2015,10,17,23,1953,3076,1924,-1152
2015,10,18,0,1928,3118,1936,-1182
2015,10,18,1,1950,3174,1988,-1186
2015,10,18,2,2066,3303,2055,-1248
2015,10,18,3,2081,3276,2043,-1233
2015,10,18,4,2088,3203,2085,-1118
2015,10,18,5,2094,3070,1996,-1074
2015,10,18,6,2194,2847,1607,-1240
2015,10,18,7,1986,2692,1649,-1043
2015,10,18,8,1432,2495,1614,-881
2015,10,18,9,1400,2378,1512,-866
2015,10,18,10,1282,2249,1352,-897
2015,10,18,11,1272,2193,1415,-778
2015,10,18,12,1342,2256,1458,-798
2015,10,18,13,1334,2388,1543,-845
2015,10,18,14,1344,2531,1588,-943
2015,10,18,15,1989,2767,1962,-805
2015,10,18,16,2025,3010,2229,-781
2015,10,18,17,2029,3196,2288,-908
2015,10,18,18,2034,3263,2285,-978
2015,10,18,19,2216,3266,2318,-948
2015,10,18,20,2220,3271,2425,-846
2015,10,18,21,2322,3235,2341,-894
2015,10,18,22,2328,3199,2301,-898
2015,10,18,23,2340,3216,2337,-879
2015,10,19,0,2450,3321,2340,-981
2015,10,19,1,2440,3504,2417,-1087
2015,10,19,2,2469,3636,2470,-1166
2015,10,19,3,2465,3648,2551,-1097
2015,10,19,4,2457,3494,2515,-979
2015,10,19,5,2460,3305,2525,-780
2015,10,19,6,2352,3011,2370,-641
2015,10,19,7,1955,2769,2238,-531
2015,10,19,8,1815,2527,1972,-555
2015,10,19,9,1689,2434,1878,-556
2015,10,19,10,1700,2434,1816,-618
2015,10,19,11,1716,2457,1882,-575
2015,10,19,12,1721,2559,1990,-569
2015,10,19,13,2014,2946,2259,-687
2015,10,19,14,2336,3269,2328,-941
2015,10,19,15,2498,3524,2518,-1006
2015,10,19,16,2465,3536,2539,-997
2015,10,19,17,2387,3542,2456,-1086
2015,10,19,18,2215,3548,2451,-1097
2015,10,19,19,2143,3495,2359,-1136
2015,10,19,20,2166,3477,2405,-1072
2015,10,19,21,2109,3435,2237,-1198
2015,10,19,22,2087,3428,2231,-1197
2015,10,19,23,2118,3438,2390,-1048
2015,10,20,0,2136,3477,2406,-1071
2015,10,20,1,2319,3591,2527,-1064
2015,10,20,2,2320,3825,2694,-1131
2015,10,20,3,2318,3805,2599,-1206
2015,10,20,4,2316,3603,2436,-1167
2015,10,20,5,2119,3366,2173,-1193
2015,10,20,6,2155,3067,2040,-1027
2015,10,20,7,1970,2679,1737,-942
2015,10,20,8,1458,2518,1696,-822
2015,10,20,9,1439,2410,1566,-844
2015,10,20,10,1323,2277,1438,-839
2015,10,20,11,1310,2323,1501,-822
2015,10,20,12,1511,2559,1555,-1004
2015,10,20,13,1949,2920,1778,-1142
2015,10,20,14,1986,3315,1838,-1477
2015,10,20,15,2204,3580,2008,-1572
2015,10,20,16,2194,3516,1924,-1592
2015,10,20,17,2243,3565,2057,-1508
2015,10,20,18,2242,3559,2090,-1469
2015,10,20,19,2242,3537,2102,-1435
2015,10,20,20,2242,3527,2151,-1376
2015,10,20,21,2342,3508,2156,-1352
2015,10,20,22,2391,3456,2187,-1269
2015,10,20,23,2391,3403,2178,-1225
2015,10,21,0,2391,3450,2242,-1208
2015,10,21,1,2392,3477,2284,-1193
2015,10,21,2,2429,3696,2447,-1249
2015,10,21,3,2431,3768,2483,-1285
2015,10,21,4,2429,3657,2346,-1311
2015,10,21,5,2412,3471,2296,-1175
2015,10,21,6,2412,3229,2362,-867
2015,10,21,7,2302,2975,2218,-757
2015,10,21,8,1991,2784,2061,-723
2015,10,21,9,1944,2684,1978,-706
2015,10,21,10,1943,2657,1929,-728
2015,10,21,11,1943,2688,1990,-698
2015,10,21,12,1999,2843,2093,-750
2015,10,21,13,2316,3199,2323,-876
2015,10,21,14,2289,3574,2326,-1248
2015,10,21,15,2397,3841,2528,-1313
2015,10,21,16,2397,3797,2493,-1304
2015,10,21,17,2381,3749,2468,-1281
2015,10,21,18,2362,3710,2420,-1290
2015,10,21,19,2263,3623,2364,-1259
2015,10,21,20,2265,3593,2294,-1299
2015,10,21,21,2270,3536,2255,-1281
2015,10,21,22,2252,3505,2224,-1281
2015,10,21,23,2260,3499,2210,-1289
2015,10,22,0,2276,3564,2239,-1325
2015,10,22,1,2403,3681,2354,-1327
2015,10,22,2,2439,3861,2477,-1384
2015,10,22,3,2462,3849,2475,-1374
2015,10,22,4,2507,3733,2464,-1269
2015,10,22,5,2353,3487,2354,-1133
2015,10,22,6,2339,3265,2495,-770
2015,10,22,7,2214,2933,2274,-659
2015,10,22,8,2025,2751,2130,-621
2015,10,22,9,2017,2665,2082,-583
2015,10,22,10,1929,2639,2008,-631
2015,10,22,11,1926,2661,2031,-630
2015,10,22,12,1995,2772,2147,-625
2015,10,22,13,2177,3109,2357,-752
2015,10,22,14,2230,3532,2410,-1122
2015,10,22,15,2421,3750,2477,-1273
2015,10,22,16,2398,3720,2417,-1303
2015,10,22,17,2457,3675,2419,-1256
2015,10,22,18,2284,3615,2291,-1324
2015,10,22,19,2290,3602,2332,-1270
2015,10,22,20,2280,3551,2294,-1257
2015,10,22,21,2290,3468,2259,-1209
2015,10,22,22,2280,3413,2208,-1205
2015,10,22,23,2288,3401,2214,-1187
2015,10,23,0,2320,3439,2268,-1171
2015,10,23,1,2472,3543,2335,-1208
2015,10,23,2,2568,3774,2453,-1321
2015,10,23,3,2569,3826,2476,-1350
2015,10,23,4,2569,3765,2550,-1215
2015,10,23,5,2528,3570,2450,-1120
2015,10,23,6,2507,3336,2463,-873
2015,10,23,7,2214,3075,2322,-753
2015,10,23,8,2007,2902,2126,-776
2015,10,23,9,1945,2815,2058,-757
2015,10,23,10,1944,2788,2028,-760
2015,10,23,11,1944,2810,2028,-782
2015,10,23,12,2001,2971,2169,-802
2015,10,23,13,2350,3303,2417,-886
2015,10,23,14,2352,3711,2379,-1332
2015,10,23,15,2551,3977,2590,-1387
2015,10,23,16,2543,3910,2541,-1369
2015,10,23,17,2544,3905,2568,-1337
2015,10,23,18,2439,3791,2474,-1317
2015,10,23,19,2321,3730,2386,-1344
2015,10,23,20,2249,3675,2340,-1335
2015,10,23,21,2249,3613,2280,-1333
2015,10,23,22,2249,3547,2232,-1315
2015,10,23,23,2248,3526,2224,-1302
2015,10,24,0,2248,3560,2246,-1314
2015,10,24,1,2299,3661,2346,-1315
2015,10,24,2,2405,3846,2514,-1332
2015,10,24,3,2411,3825,2512,-1313
2015,10,24,4,2412,3688,2397,-1291
2015,10,24,5,2354,3547,2415,-1132
2015,10,24,6,2454,3355,2409,-946
2015,10,24,7,2184,3122,2271,-851
2015,10,24,8,1986,2953,2138,-815
2015,10,24,9,1990,2812,2060,-752
2015,10,24,10,1993,2734,2008,-726
2015,10,24,11,1999,2718,2000,-718
2015,10,24,12,2004,2761,2003,-758
2015,10,24,13,2098,2886,2066,-820
2015,10,24,14,1949,3056,1953,-1103
2015,10,24,15,2087,3303,2048,-1255
2015,10,24,16,2173,3548,2191,-1357
2015,10,24,17,2273,3708,2338,-1370
2015,10,24,18,2261,3767,2382,-1385
2015,10,24,19,2257,3754,2382,-1372
2015,10,24,20,2207,3715,2392,-1323
2015,10,24,21,2105,3596,2333,-1263
2015,10,24,22,2101,3487,2224,-1263
2015,10,24,23,2096,3342,2020,-1322
2015,10,25,0,2115,3376,2050,-1326
2015,10,25,1,2212,3451,2032,-1419
2015,10,25,2,2212,3662,2135,-1527
2015,10,25,3,2213,3659,2217,-1442
2015,10,25,4,2246,3591,2239,-1352
2015,10,25,5,2133,3450,2198,-1252
2015,10,25,6,2275,3327,2346,-981
2015,10,25,7,2176,3097,2289,-808
2015,10,25,8,1807,2891,2142,-749
2015,10,25,9,1815,2758,2044,-714
2015,10,25,10,1826,2667,1965,-702
2015,10,25,11,1837,2635,1967,-668
2015,10,25,12,1847,2652,1967,-685
2015,10,25,13,1876,2735,1987,-748
2015,10,25,14,1962,2908,2045,-863
2015,10,25,15,2110,3125,2172,-953
2015,10,25,16,2248,3345,2381,-964
2015,10,25,17,2362,3517,2557,-960
2015,10,25,18,2374,3561,2624,-937
2015,10,25,19,2379,3528,2616,-912
2015,10,25,20,2228,3510,2587,-923
2015,10,25,21,2167,3461,2544,-917
2015,10,25,22,2150,3440,2490,-950
2015,10,25,23,2128,3487,2463,-1024
2015,10,26,0,2104,3546,2507,-1039
2015,10,26,1,2313,3640,2234,-1406
2015,10,26,2,2413,3808,2372,-1436
2015,10,26,3,2405,3760,2514,-1246
2015,10,26,4,2412,3640,2435,-1205
2015,10,26,5,2236,3438,2253,-1185
2015,10,26,6,2232,3145,2126,-1019
2015,10,26,7,2046,2849,1913,-936
2015,10,26,8,1419,2588,1689,-899
2015,10,26,9,1419,2476,1546,-930
2015,10,26,10,1421,2458,1505,-953
2015,10,26,11,1163,2234,1267,-967
2015,10,26,12,1163,2426,1434,-992
2015,10,26,13,1739,2997,1837,-1160
2015,10,26,14,1741,3535,2100,-1435
2015,10,26,15,1963,3796,2395,-1401
2015,10,26,16,2360,3826,2421,-1405
2015,10,26,17,2358,3741,2245,-1496
2015,10,26,18,2343,3780,2359,-1421
2015,10,26,19,2258,3741,2270,-1471
2015,10,26,20,2276,3744,2297,-1447
2015,10,26,21,2226,3676,2169,-1507
2015,10,26,22,2248,3634,2136,-1498
2015,10,26,23,2271,3653,2184,-1469
2015,10,27,0,2285,3712,2268,-1444
2015,10,27,1,2288,3849,2369,-1480
2015,10,27,2,2283,4014,2533,-1481
2015,10,27,3,2258,3926,2444,-1482
2015,10,27,4,2244,3789,2427,-1362
2015,10,27,5,2112,3545,2388,-1157
2015,10,27,6,2133,3285,2303,-982
2015,10,27,7,2127,3028,2146,-882
2015,10,27,8,1593,2866,2013,-853
2015,10,27,9,1534,2775,1868,-907
2015,10,27,10,1532,2743,1820,-923
2015,10,27,11,1532,2792,1913,-879
2015,10,27,12,1964,2921,2079,-842
2015,10,27,13,2262,3228,2359,-869
2015,10,27,14,2262,3602,2375,-1227
2015,10,27,15,2429,3830,2549,-1281
2015,10,27,16,2438,3838,2567,-1271
2015,10,27,17,2443,3737,2489,-1248
2015,10,27,18,2329,3753,2488,-1265
2015,10,27,19,2259,3693,2387,-1306
2015,10,27,20,2256,3660,2409,-1251
2015,10,27,21,2248,3588,2377,-1211
2015,10,27,22,2252,3538,2348,-1190
2015,10,27,23,2228,3528,2365,-1163
2015,10,28,0,2259,3581,2489,-1092
2015,10,28,1,2254,3711,2613,-1098
2015,10,28,2,2396,3957,2660,-1297
2015,10,28,3,2400,3920,2569,-1351
2015,10,28,4,2409,3786,2451,-1335
2015,10,28,5,2253,3518,2284,-1234
2015,10,28,6,2305,3320,2440,-880
2015,10,28,7,2108,3045,2294,-751
2015,10,28,8,2020,2836,2146,-690
2015,10,28,9,1994,2722,2055,-667
2015,10,28,10,1995,2657,1975,-682
2015,10,28,11,1996,2671,1959,-712
2015,10,28,12,2098,2844,2030,-814
2015,10,28,13,2285,3135,2234,-901
2015,10,28,14,2271,3514,2322,-1192
2015,10,28,15,2417,3774,2405,-1369
2015,10,28,16,2466,3801,2421,-1380
2015,10,28,17,2466,3771,2430,-1341
2015,10,28,18,2454,3783,2460,-1323
2015,10,28,19,2289,3784,2475,-1309
2015,10,28,20,2268,3765,2380,-1385
2015,10,28,21,2273,3750,2358,-1392
2015,10,28,22,2207,3728,2372,-1356
2015,10,28,23,2217,3707,2337,-1370
2015,10,29,0,2287,3731,2402,-1329
2015,10,29,1,2360,3882,2423,-1459
2015,10,29,2,2397,4013,2546,-1467
2015,10,29,3,2422,3927,2315,-1612
2015,10,29,4,2418,3812,2300,-1512
2015,10,29,5,2295,3566,2209,-1357
2015,10,29,6,2290,3332,2333,-999
2015,10,29,7,2111,3013,2190,-823
2015,10,29,8,1921,2807,2083,-724
2015,10,29,9,1802,2707,1951,-756
2015,10,29,10,1661,2537,1787,-750
2015,10,29,11,1671,2528,1715,-813
2015,10,29,12,1833,2758,1918,-840
2015,10,29,13,1974,3082,2097,-985
2015,10,29,14,2086,3462,2213,-1249
2015,10,29,15,2188,3743,2351,-1392
2015,10,29,16,2188,3683,2233,-1450
2015,10,29,17,2192,3666,2273,-1393
2015,10,29,18,2198,3590,2128,-1462
2015,10,29,19,1935,3495,2015,-1480
2015,10,29,20,1936,3443,1949,-1494
2015,10,29,21,1936,3357,1868,-1489
2015,10,29,22,1935,3182,1878,-1304
2015,10,29,23,1933,3183,1789,-1394
2015,10,30,0,1986,3477,1935,-1542
2015,10,30,1,2201,3761,2088,-1673
2015,10,30,2,2200,3890,2205,-1685
2015,10,30,3,2209,3845,2236,-1609
2015,10,30,4,2202,3721,2119,-1602
2015,10,30,5,2084,3526,1999,-1527
2015,10,30,6,2120,3293,2067,-1226
2015,10,30,7,1871,2990,1842,-1148
2015,10,30,8,1394,2669,1604,-1065
2015,10,30,9,1158,2438,1369,-1069
2015,10,30,10,1154,2353,1328,-1025
2015,10,30,11,1151,2394,1402,-992
2015,10,30,12,1307,2636,1572,-1064
2015,10,30,13,1753,2908,1773,-1135
2015,10,30,14,1746,3279,1851,-1428
2015,10,30,15,2076,3695,2069,-1626
2015,10,30,16,2088,3561,2060,-1501
2015,10,30,17,2020,3539,2129,-1410
2015,10,30,18,1961,3505,2033,-1472
2015,10,30,19,1825,3458,1922,-1536
2015,10,30,20,1836,3465,1979,-1486
2015,10,30,21,1832,3403,2067,-1336
2015,10,30,22,1818,3455,2111,-1344
2015,10,30,23,1806,3452,2039,-1413
2015,10,31,0,1969,3533,2103,-1430
2015,10,31,1,2128,3631,2057,-1574
2015,10,31,2,2135,3721,2065,-1656
2015,10,31,3,2155,3608,1975,-1633
2015,10,31,4,2163,3486,1809,-1677
2015,10,31,5,1870,3347,1690,-1657
2015,10,31,6,1844,3222,1910,-1312
2015,10,31,7,1597,3009,1775,-1234
2015,10,31,8,1486,2852,1694,-1158
2015,10,31,9,1460,2716,1539,-1177
2015,10,31,10,1274,2512,1365,-1147
2015,10,31,11,1252,2473,1300,-1173
2015,10,31,12,1243,2479,1291,-1188
2015,10,31,13,1250,2542,1353,-1189
2015,10,31,14,1085,2473,1173,-1300
2015,10,31,15,1095,2685,1270,-1415
2015,10,31,16,1363,3094,1487,-1607
2015,10,31,17,1513,3274,1640,-1634
2015,10,31,18,1576,3395,1757,-1638
2015,10,31,19,1713,3559,1845,-1714
2015,10,31,20,1724,3538,1848,-1690
2015,10,31,21,1715,3504,1829,-1675
2015,10,31,22,1664,3552,1957,-1595
2015,10,31,23,1803,3534,1881,-1653
2015,11,1,0,1811,3543,1828,-1715
2015,11,1,1,1871,3520,1769,-1751
2015,11,1,2,1982,3525,1697,-1828
2015,11,1,3,2077,3488,1913,-1575
2015,11,1,4,2055,3395,1803,-1592
2015,11,1,5,1958,3277,1764,-1513
2015,11,1,6,2053,3171,1892,-1279
2015,11,1,7,1838,679,1892,-1281
2015,11,1,8,984,2648,1171,-1477
2015,11,1,9,981,2353,1092,-1261
2015,11,1,10,982,2237,976,-1261
2015,11,1,11,989,2191,956,-1235
2015,11,1,12,986,2203,1003,-1200
2015,11,1,13,977,2250,1042,-1208
2015,11,1,14,954,2421,1158,-1263
2015,11,1,15,931,2612,1147,-1465
2015,11,1,16,1246,2870,1282,-1588
2015,11,1,17,1324,3285,1526,-1759
2015,11,1,18,1501,3365,1614,-1751
2015,11,1,19,1633,3438,1662,-1776
2015,11,1,20,1666,3507,1712,-1795
2015,11,1,21,1688,3486,1714,-1772
2015,11,1,22,1693,3436,1709,-1727
2015,11,1,23,1686,3368,1706,-1662
2015,11,2,0,1679,3389,1672,-1717
2015,11,2,1,1914,3641,1772,-1869
2015,11,2,2,1904,3958,1879,-2079
2015,11,2,3,1895,3912,1816,-2096
2015,11,2,4,1883,3802,1717,-2085
2015,11,2,5,1872,3627,1651,-1976
2015,11,2,6,1845,3322,1566,-1756
2015,11,2,7,1867,3043,1465,-1578
2015,11,2,8,1611,2668,1246,-1422
2015,11,2,9,1034,2550,1201,-1349
2015,11,2,10,1031,2515,1233,-1282
2015,11,2,11,1171,2574,1392,-1182
2015,11,2,12,1246,2583,1362,-1221
2015,11,2,13,1366,2739,1574,-1165
2015,11,2,14,1942,3025,1846,-1179
2015,11,2,15,2070,3387,2005,-1382
2015,11,2,16,2120,3608,2039,-1569
2015,11,2,17,2117,3630,2039,-1591
2015,11,2,18,2119,3665,2009,-1656
2015,11,2,19,2067,3630,2009,-1621
2015,11,2,20,2107,3578,1907,-1671
2015,11,2,21,2192,3524,1915,-1609
2015,11,2,22,2192,3421,1800,-1621
2015,11,2,23,2192,3395,1805,-1590
2015,11,3,0,2191,3519,1944,-1575
2015,11,3,1,2216,3715,2187,-1528
2015,11,3,2,2303,4041,2551,-1490
2015,11,3,3,2304,4059,2536,-1523
2015,11,3,4,2317,3958,2504,-1454
2015,11,3,5,2282,3812,2263,-1549
2015,11,3,6,2086,3583,2119,-1464
2015,11,3,7,2179,3263,1964,-1299
2015,11,3,8,1862,2980,1831,-1149
2015,11,3,9,1740,2726,1959,-767
2015,11,3,10,1590,2609,1885,-724
2015,11,3,11,1601,2678,1875,-803
2015,11,3,12,1602,2742,1940,-802
2015,11,3,13,1756,2984,2068,-916
2015,11,3,14,1847,3310,2197,-1113
2015,11,3,15,1797,3755,2364,-1391
2015,11,3,16,2349,3893,2305,-1588
2015,11,3,17,2353,3866,2332,-1534
2015,11,3,18,2323,3807,2346,-1461
2015,11,3,19,2327,3690,2246,-1444
2015,11,3,20,2250,3648,2227,-1421
2015,11,3,21,2237,3604,2234,-1370
2015,11,3,22,2214,3562,2199,-1363
2015,11,3,23,2204,3558,2259,-1299
2015,11,4,0,2204,3578,2232,-1346
2015,11,4,1,2303,3736,2342,-1394
2015,11,4,2,2454,4127,2633,-1494
2015,11,4,3,2535,4190,2666,-1524
2015,11,4,4,2543,4142,2611,-1531
2015,11,4,5,2491,4015,2505,-1510
2015,11,4,6,2277,3755,2263,-1492
2015,11,4,7,2323,3422,2231,-1191
2015,11,4,8,2218,3191,2214,-977
2015,11,4,9,2025,3074,2230,-844
2015,11,4,10,1995,2976,2161,-815
2015,11,4,11,1995,2946,2107,-839
2015,11,4,12,1995,3001,2129,-872
2015,11,4,13,2224,3173,2233,-940
2015,11,4,14,2399,3517,2292,-1225
2015,11,4,15,2297,3949,2423,-1526
2015,11,4,16,2448,4178,2607,-1571
2015,11,4,17,2444,4100,2628,-1472
2015,11,4,18,2442,3958,2487,-1471
2015,11,4,19,2330,3883,2610,-1273
2015,11,4,20,2279,3705,2260,-1445
2015,11,4,21,2233,3630,2177,-1453
2015,11,4,22,2247,3631,2266,-1365
2015,11,4,23,2271,3637,2329,-1308
2015,11,5,0,2301,3705,2404,-1301
2015,11,5,1,2408,3904,2578,-1326
2015,11,5,2,2582,4220,2814,-1406
2015,11,5,3,2587,4193,2704,-1489
2015,11,5,4,2586,4067,2529,-1538
2015,11,5,5,2449,3925,2524,-1401
2015,11,5,6,2311,3639,2345,-1294
2015,11,5,7,2400,3364,2408,-956
2015,11,5,8,2240,3085,2147,-938
2015,11,5,9,2093,2953,2218,-735
2015,11,5,10,1915,2851,2107,-744
2015,11,5,11,1851,2825,2070,-755
2015,11,5,12,1769,2867,2061,-806
2015,11,5,13,1954,3012,2197,-815
2015,11,5,14,2307,3309,2275,-1034
2015,11,5,15,2304,3691,2277,-1414
2015,11,5,16,2450,3873,2393,-1480
2015,11,5,17,2438,3834,2347,-1487
2015,11,5,18,2439,3822,2416,-1406
2015,11,5,19,2320,3774,2292,-1482
2015,11,5,20,2321,3695,2135,-1560
2015,11,5,21,2348,3655,2098,-1557
2015,11,5,22,2355,3595,2101,-1494
2015,11,5,23,2358,3527,2049,-1478
2015,11,6,0,2374,3550,2141,-1409
2015,11,6,1,2535,3867,2384,-1483
2015,11,6,2,2760,4206,2708,-1498
2015,11,6,3,2779,4160,2596,-1564
2015,11,6,4,2763,4108,2655,-1453
2015,11,6,5,2749,3974,2611,-1363
2015,11,6,6,2671,3712,2550,-1162
2015,11,6,7,2633,3440,2605,-835
2015,11,6,8,2438,3204,2473,-731
2015,11,6,9,2213,3068,2527,-541
2015,11,6,10,2269,2995,2518,-477
2015,11,6,11,2153,2942,2474,-468
2015,11,6,12,2153,2984,2509,-475
2015,11,6,13,2358,3143,2697,-446
2015,11,6,14,2456,3414,2677,-737
2015,11,6,15,2598,3750,2596,-1154
2015,11,6,16,2418,3918,2688,-1230
2015,11,6,17,2617,4003,2698,-1305
2015,11,6,18,2613,3986,2722,-1264
2015,11,6,19,2609,3927,2708,-1219
2015,11,6,20,2446,3830,2590,-1240
2015,11,6,21,2222,3576,2454,-1122
2015,11,6,22,2511,3540,2383,-1157
2015,11,6,23,2505,3527,2449,-1078
2015,11,7,0,2449,3685,2434,-1251
2015,11,7,1,2702,3851,2565,-1286
2015,11,7,2,2737,4029,2692,-1337
2015,11,7,3,2748,3963,2658,-1305
2015,11,7,4,2746,3858,2592,-1266
2015,11,7,5,2659,3598,2462,-1136
2015,11,7,6,2450,3434,2361,-1073
2015,11,7,7,2600,3379,2550,-829
2015,11,7,8,2529,3143,2511,-632
2015,11,7,9,2256,2864,2430,-434
2015,11,7,10,2106,2739,2369,-370
2015,11,7,11,2021,2677,2304,-373
2015,11,7,12,2124,2648,2339,-309
2015,11,7,13,2317,2793,2356,-437
2015,11,7,14,2394,2930,2428,-502
2015,11,7,15,2206,2921,2201,-720
2015,11,7,16,2290,3152,2285,-867
2015,11,7,17,2450,3347,2281,-1066
2015,11,7,18,2500,3612,2402,-1210
2015,11,7,19,2594,3676,2451,-1225
2015,11,7,20,2499,3682,2443,-1239
2015,11,7,21,2501,3535,2423,-1112
2015,11,7,22,2487,3501,2404,-1097
2015,11,7,23,2477,3472,2357,-1115
2015,11,8,0,2483,3480,2365,-1115
2015,11,8,1,2556,3699,2499,-1200
2015,11,8,2,2674,3894,2700,-1194
2015,11,8,3,2662,3820,2644,-1176
2015,11,8,4,2673,3743,2449,-1294
2015,11,8,5,2576,3649,2339,-1310
2015,11,8,6,2492,3497,2270,-1227
2015,11,8,7,2685,3321,2533,-788
2015,11,8,8,2752,3115,2531,-584
2015,11,8,9,2099,2963,2344,-619
2015,11,8,10,1920,2863,2188,-675
2015,11,8,11,1873,2725,2078,-647
2015,11,8,12,1882,2675,2025,-650
2015,11,8,13,1887,2706,2052,-654
2015,11,8,14,2282,2844,2093,-751
2015,11,8,15,2376,3110,2187,-923
2015,11,8,16,2505,3288,2472,-816
2015,11,8,17,2513,3494,2572,-922
2015,11,8,18,2638,3658,2703,-955
2015,11,8,19,2662,3727,2738,-989
2015,11,8,20,2654,3715,2756,-959
2015,11,8,21,2661,3669,2705,-964
2015,11,8,22,2712,3475,2572,-903
2015,11,8,23,2729,3397,2579,-818
2015,11,9,0,2726,3443,2641,-802
2015,11,9,1,2818,3645,2822,-823
2015,11,9,2,2876,3954,3046,-908
2015,11,9,3,2887,3929,2986,-943
2015,11,9,4,2884,3848,2770,-1078
2015,11,9,5,2877,3736,2723,-1013
2015,11,9,6,2800,3561,2651,-910
2015,11,9,7,2582,3315,2497,-818
2015,11,9,8,2565,3113,2405,-708
2015,11,9,9,2310,3001,2483,-518
2015,11,9,10,2341,2887,2391,-496
2015,11,9,11,2334,2841,2387,-454
2015,11,9,12,2334,2871,2374,-497
2015,11,9,13,2337,3038,2381,-657
2015,11,9,14,2626,3371,2571,-800
2015,11,9,15,2808,3803,2716,-1087
2015,11,9,16,2834,4050,2864,-1186
2015,11,9,17,2928,4015,2889,-1126
2015,11,9,18,2904,3968,2782,-1186
2015,11,9,19,2782,3923,2667,-1256
2015,11,9,20,2685,3892,2600,-1292
2015,11,9,21,2688,3861,2505,-1356
2015,11,9,22,2680,3856,2506,-1350
2015,11,9,23,2693,3836,2581,-1255
2015,11,10,0,2727,3909,2671,-1238
2015,11,10,1,2729,4107,2783,-1324
2015,11,10,2,2831,4350,2772,-1578
2015,11,10,3,2843,4328,2748,-1580
2015,11,10,4,2845,4239,2684,-1555
2015,11,10,5,2828,4093,2658,-1435
2015,11,10,6,2647,3818,2489,-1329
2015,11,10,7,2597,3549,2526,-1023
2015,11,10,8,2398,3288,2350,-938
2015,11,10,9,2152,3078,2437,-641
2015,11,10,10,2304,3092,2384,-708
2015,11,10,11,2297,3061,2362,-699
2015,11,10,12,2388,3123,2455,-668
2015,11,10,13,2626,3262,2655,-607
2015,11,10,14,2897,3593,2794,-799
2015,11,10,15,2951,4014,2773,-1241
2015,11,10,16,3006,4232,2907,-1325
2015,11,10,17,2871,4213,2988,-1225
2015,11,10,18,2883,4122,2972,-1150
2015,11,10,19,2630,4031,2887,-1144
2015,11,10,20,2442,3931,2781,-1150
2015,11,10,21,2482,3885,2764,-1121
2015,11,10,22,2530,3866,2637,-1229
2015,11,10,23,2586,3859,2617,-1242
2015,11,11,0,2597,3920,2677,-1243
2015,11,11,1,2812,4132,2930,-1202
2015,11,11,2,2915,4348,3011,-1337
2015,11,11,3,2919,4304,2925,-1379
2015,11,11,4,2873,4188,2661,-1527
2015,11,11,5,2637,4062,2511,-1551
2015,11,11,6,2524,3690,2255,-1435
2015,11,11,7,2603,3401,2303,-1098
2015,11,11,8,2320,3142,2179,-963
2015,11,11,9,1900,2962,1865,-1097
2015,11,11,10,1805,2850,1804,-1046
2015,11,11,11,1812,2775,1754,-1021
2015,11,11,12,1828,2783,1766,-1017
2015,11,11,13,2048,3102,2050,-1052
2015,11,11,14,2245,3393,2139,-1254
2015,11,11,15,2141,3697,2149,-1548
2015,11,11,16,2419,3767,2026,-1741
2015,11,11,17,2416,3681,2037,-1644
2015,11,11,18,2305,3651,1987,-1664
2015,11,11,19,2068,3600,1960,-1640
2015,11,11,20,2170,3522,1922,-1600
2015,11,11,21,2146,3423,1828,-1595
2015,11,11,22,2117,3393,1812,-1581
2015,11,11,23,2123,3388,1803,-1585
2015,11,12,0,2136,3520,1867,-1653
2015,11,12,1,2220,4022,2104,-1918
2015,11,12,2,2407,4315,2287,-2028
2015,11,12,3,2401,4312,2249,-2063
2015,11,12,4,2395,4223,2174,-2049
2015,11,12,5,2376,4087,2180,-1907
2015,11,12,6,2303,3840,2093,-1747
2015,11,12,7,2350,3564,2129,-1435
2015,11,12,8,2289,3322,2189,-1133
2015,11,12,9,1715,3010,2103,-907
2015,11,12,10,1877,2919,2053,-866
2015,11,12,11,1887,2915,2043,-872
2015,11,12,12,1954,2963,2036,-927
2015,11,12,13,2254,3265,2252,-1013
2015,11,12,14,2590,3631,2363,-1268
2015,11,12,15,2577,4140,2584,-1556
2015,11,12,16,2690,4264,2521,-1743
2015,11,12,17,2677,4228,2556,-1672
2015,11,12,18,2666,4196,2577,-1619
2015,11,12,19,2592,4151,2530,-1621
2015,11,12,20,2455,4105,2340,-1765
2015,11,12,21,2389,4090,2370,-1720
2015,11,12,22,2421,4031,2377,-1654
2015,11,12,23,2513,4022,2465,-1557
2015,11,13,0,2568,4136,2635,-1501
2015,11,13,1,2589,4323,2764,-1559
2015,11,13,2,2686,4485,2821,-1664
2015,11,13,3,2701,4421,2805,-1616
2015,11,13,4,2706,4318,2696,-1622
2015,11,13,5,2614,4123,2355,-1768
2015,11,13,6,2396,3857,2196,-1661
2015,11,13,7,2509,3542,2278,-1264
2015,11,13,8,2425,3124,1995,-1129
2015,11,13,9,1398,2714,1585,-1129
2015,11,13,10,1306,2552,1440,-1112
2015,11,13,11,1308,2474,1411,-1063
2015,11,13,12,1306,2453,1405,-1048
2015,11,13,13,1302,2600,1488,-1112
2015,11,13,14,1756,3137,1848,-1289
2015,11,13,15,1887,3632,2049,-1583
2015,11,13,16,1938,3792,1949,-1843
2015,11,13,17,1939,3717,1937,-1780
2015,11,13,18,1944,3713,1930,-1783
2015,11,13,19,1947,3698,1974,-1724
2015,11,13,20,1827,3612,1967,-1645
2015,11,13,21,1750,3520,1980,-1540
2015,11,13,22,1752,3507,1895,-1612
2015,11,13,23,1753,3521,1897,-1624
2015,11,14,0,1755,3582,1957,-1625
2015,11,14,1,1830,3753,1929,-1824
2015,11,14,2,1930,3886,2016,-1870
2015,11,14,3,1929,3807,1929,-1878
2015,11,14,4,1927,3695,1839,-1856
2015,11,14,5,1874,3546,1755,-1791
2015,11,14,6,1870,3344,1673,-1671
2015,11,14,7,1868,3151,1727,-1424
2015,11,14,8,1865,2943,1702,-1241
2015,11,14,9,1568,2689,1570,-1119
2015,11,14,10,1518,2572,1566,-1006
2015,11,14,11,1496,2561,1657,-904
2015,11,14,12,1596,2645,1644,-1001
2015,11,14,13,1584,2706,1703,-1003
2015,11,14,14,1744,2828,1770,-1058
2015,11,14,15,1628,3032,1688,-1344
2015,11,14,16,1761,3259,1645,-1614
2015,11,14,17,1854,3513,1845,-1668
2015,11,14,18,1945,3696,1991,-1705
2015,11,14,19,1961,3757,2086,-1671
2015,11,14,20,1902,3754,2117,-1637
2015,11,14,21,1882,3727,2160,-1567
2015,11,14,22,1870,3705,2165,-1540
2015,11,14,23,1853,3688,2174,-1514
2015,11,15,0,1841,3690,2204,-1486
2015,11,15,1,1839,3887,2367,-1520
2015,11,15,2,1914,3994,2453,-1541
2015,11,15,3,1940,3891,2285,-1606
2015,11,15,4,1967,3823,2227,-1596
2015,11,15,5,1988,3719,2137,-1582
2015,11,15,6,1847,3577,2026,-1551
2015,11,15,7,1760,3385,2162,-1223
2015,11,15,8,1695,3164,1979,-1185
2015,11,15,9,1879,2972,1929,-1043
2015,11,15,10,1858,2875,1906,-969
2015,11,15,11,1870,2823,1874,-949
2015,11,15,12,1847,2833,1819,-1014
2015,11,15,13,1958,2911,1922,-989
2015,11,15,14,2093,3036,1911,-1125
2015,11,15,15,2127,3215,1832,-1383
2015,11,15,16,2141,3463,1836,-1627
2015,11,15,17,1887,3731,2120,-1611
2015,11,15,18,1943,3876,2327,-1549
2015,11,15,19,1952,3865,2325,-1540
2015,11,15,20,1962,3775,2247,-1528
2015,11,15,21,1650,3546,1827,-1719
2015,11,15,22,1656,3478,1768,-1710
2015,11,15,23,1760,3430,1743,-1687
2015,11,16,0,1758,3476,1760,-1716
2015,11,16,1,1828,3878,1967,-1911
2015,11,16,2,1935,4198,2268,-1930
2015,11,16,3,1932,4141,2226,-1915
2015,11,16,4,1935,4094,2189,-1905
2015,11,16,5,1940,3972,2088,-1884
2015,11,16,6,1846,3747,1935,-1812
2015,11,16,7,1698,3393,1820,-1573
2015,11,16,8,1516,3083,1715,-1368
2015,11,16,9,1315,2834,1598,-1236
2015,11,16,10,1313,2764,1557,-1207
2015,11,16,11,1303,2788,1582,-1206
2015,11,16,12,1345,2904,1627,-1277
2015,11,16,13,1859,3335,1955,-1380
2015,11,16,14,1984,3709,2047,-1662
2015,11,16,15,2002,4204,2217,-1987
2015,11,16,16,2048,4405,2246,-2159
2015,11,16,17,2024,4307,2186,-2121
2015,11,16,18,2019,4322,2166,-2156
2015,11,16,19,1917,4332,2138,-2194
2015,11,16,20,1841,4324,2250,-2074
2015,11,16,21,1842,4365,2321,-2044
2015,11,16,22,1831,4339,2250,-2089
2015,11,16,23,1829,4318,2105,-2213
2015,11,17,0,1934,4395,2415,-1980
2015,11,17,1,2092,4586,2669,-1917
2015,11,17,2,2120,4738,2774,-1964
2015,11,17,3,2160,4676,2795,-1881
2015,11,17,4,2201,4531,2478,-2053
2015,11,17,5,2200,4388,2298,-2090
2015,11,17,6,1976,4100,2144,-1956
2015,11,17,7,1821,3737,1891,-1846
2015,11,17,8,1635,3410,1725,-1685
2015,11,17,9,1195,2912,1530,-1382
2015,11,17,10,1156,2721,1385,-1336
2015,11,17,11,1171,2661,1455,-1206
2015,11,17,12,1183,2707,1571,-1136
2015,11,17,13,1537,3040,1729,-1311
2015,11,17,14,1696,3455,1796,-1659
2015,11,17,15,1668,3693,1661,-2032
2015,11,17,16,1768,3822,1614,-2208
2015,11,17,17,1784,3759,1508,-2251
2015,11,17,18,1721,3786,1704,-2082
2015,11,17,19,1723,3747,1644,-2103
2015,11,17,20,1669,3754,1734,-2020
2015,11,17,21,1664,3726,1772,-1954
2015,11,17,22,1633,3750,1773,-1977
2015,11,17,23,1602,3564,1522,-2042
2015,11,18,0,1604,3523,1490,-2033
2015,11,18,1,1656,3582,1462,-2120
2015,11,18,2,1895,3842,1609,-2233
2015,11,18,3,1890,3892,1772,-2120
2015,11,18,4,1886,3844,1764,-2080
2015,11,18,5,1805,3639,1716,-1923
2015,11,18,6,1684,3469,1670,-1799
2015,11,18,7,1857,3181,1626,-1555
2015,11,18,8,1671,2754,1409,-1345
2015,11,18,9,1202,2602,1319,-1283
2015,11,18,10,1196,2570,1335,-1235
2015,11,18,11,1186,2551,1298,-1253
2015,11,18,12,1177,2617,1359,-1258
2015,11,18,13,1172,2821,1491,-1330
2015,11,18,14,1371,3393,1778,-1615
2015,11,18,15,1274,3825,1806,-2019
2015,11,18,16,1613,4005,1693,-2312
2015,11,18,17,1620,3948,1592,-2356
2015,11,18,18,1651,3897,1660,-2237
2015,11,18,19,1656,3842,1657,-2185
2015,11,18,20,1585,3808,1610,-2198
2015,11,18,21,1589,3655,1472,-2183
2015,11,18,22,1431,3632,1459,-2173
2015,11,18,23,1591,3799,1535,-2264
2015,11,19,0,1592,3893,1598,-2295
2015,11,19,1,1739,4291,1845,-2446
2015,11,19,2,1787,4448,1920,-2528
2015,11,19,3,1778,4414,1902,-2512
2015,11,19,4,1764,4249,1870,-2379
2015,11,19,5,1746,4139,1914,-2225
2015,11,19,6,1704,3834,1623,-2211
2015,11,19,7,1689,3711,1819,-1892
2015,11,19,8,1675,3387,1726,-1661
2015,11,19,9,1993,3261,1951,-1310
2015,11,19,10,1963,3126,1919,-1207
2015,11,19,11,2019,3109,1937,-1172
2015,11,19,12,2025,3086,1811,-1275
2015,11,19,13,2057,3332,2065,-1267
2015,11,19,14,2171,3685,2148,-1537
2015,11,19,15,2061,4092,2115,-1977
2015,11,19,16,2220,4332,2174,-2158
2015,11,19,17,2186,4246,2043,-2203
2015,11,19,18,2199,4154,2060,-2094
2015,11,19,19,2103,4033,1871,-2162
2015,11,19,20,2081,3952,1823,-2129
2015,11,19,21,2082,3897,1864,-2033
2015,11,19,22,2034,3876,1925,-1951
2015,11,19,23,1972,3852,1927,-1925
2015,11,20,0,2072,3935,1972,-1963
2015,11,20,1,2142,4216,2177,-2039
2015,11,20,2,2220,4562,2521,-2041
2015,11,20,3,2224,4606,2577,-2029
2015,11,20,4,2224,4602,2579,-2023
2015,11,20,5,2171,4503,2503,-2000
2015,11,20,6,2091,4281,2440,-1841
2015,11,20,7,2185,3994,2566,-1428
2015,11,20,8,2132,3730,2413,-1317
2015,11,20,9,2098,3539,2167,-1372
2015,11,20,10,2088,3460,2132,-1328
2015,11,20,11,1971,3393,2091,-1302
2015,11,20,12,2073,3478,2170,-1308
2015,11,20,13,2339,3669,2274,-1395
2015,11,20,14,2662,4027,2508,-1519
2015,11,20,15,2789,4480,2584,-1896
2015,11,20,16,2788,4755,2743,-2012
2015,11,20,17,2786,4714,2740,-1974
2015,11,20,18,2786,4556,2668,-1888
2015,11,20,19,2685,4408,2506,-1902
2015,11,20,20,2560,4247,2446,-1801
2015,11,20,21,2460,4131,2299,-1832
2015,11,20,22,2350,4079,2323,-1756
2015,11,20,23,2350,4045,2303,-1742
2015,11,21,0,2351,4097,2369,-1728
2015,11,21,1,2402,4359,2542,-1817
2015,11,21,2,2602,4620,2574,-2046
2015,11,21,3,2602,4595,2567,-2028
2015,11,21,4,2642,4516,2466,-2050
2015,11,21,5,2641,4425,2393,-2032
2015,11,21,6,2441,4253,2360,-1893
2015,11,21,7,2590,4012,2412,-1600
2015,11,21,8,2270,3747,2282,-1465
2015,11,21,9,2155,3571,2319,-1252
2015,11,21,10,2142,3527,2394,-1133
2015,11,21,11,2168,3491,2399,-1092
2015,11,21,12,2160,3529,2426,-1103
2015,11,21,13,2258,3631,2504,-1127
2015,11,21,14,2410,3764,2391,-1373
2015,11,21,15,2363,4002,2377,-1625
2015,11,21,16,2441,4321,2655,-1666
2015,11,21,17,2442,4509,2694,-1815
2015,11,21,18,2441,4477,2609,-1868
2015,11,21,19,2439,4364,2520,-1844
2015,11,21,20,2437,4233,2478,-1755
2015,11,21,21,2336,4094,2310,-1784
2015,11,21,22,2335,3980,2239,-1741
2015,11,21,23,2335,3916,2166,-1750
2015,11,22,0,2334,4008,2209,-1799
2015,11,22,1,2334,4243,2424,-1819
2015,11,22,2,2509,4471,2588,-1883
2015,11,22,3,2509,4458,2593,-1865
2015,11,22,4,2509,4380,2549,-1831
2015,11,22,5,2358,4277,2382,-1895
2015,11,22,6,2258,4142,2369,-1773
2015,11,22,7,2497,3941,2352,-1589
2015,11,22,8,2397,3727,2354,-1373
2015,11,22,9,1996,3552,2175,-1377
2015,11,22,10,1996,3488,2046,-1442
2015,11,22,11,1996,3456,2010,-1446
2015,11,22,12,1995,3525,2273,-1252
2015,11,22,13,2068,3587,2306,-1281
2015,11,22,14,2394,3739,2421,-1318
2015,11,22,15,2393,3970,2492,-1478
2015,11,22,16,2543,4227,2565,-1662
2015,11,22,17,2545,4402,2548,-1854
2015,11,22,18,2545,4418,2553,-1865
2015,11,22,19,2545,4304,2491,-1813
2015,11,22,20,2493,4202,2426,-1776
2015,11,22,21,2443,4106,2327,-1779
2015,11,22,22,2443,4011,2261,-1750
2015,11,22,23,2444,3932,2181,-1751
2015,11,23,0,2445,3991,2305,-1686
2015,11,23,1,2495,4265,2510,-1755
2015,11,23,2,2546,4524,2580,-1944
2015,11,23,3,2547,4532,2584,-1948
2015,11,23,4,2547,4531,2705,-1826
2015,11,23,5,2547,4351,2551,-1800
2015,11,23,6,2548,4084,2346,-1738
2015,11,23,7,2374,3799,2334,-1465
2015,11,23,8,2326,3568,2236,-1332
2015,11,23,9,2114,3495,2307,-1188
2015,11,23,10,2115,3428,2218,-1210
2015,11,23,11,2115,3443,2205,-1238
2015,11,23,12,2113,3524,2283,-1241
2015,11,23,13,2313,3739,2340,-1399
2015,11,23,14,2492,4121,2469,-1652
2015,11,23,15,2523,4505,2451,-2054
2015,11,23,16,2558,4810,2703,-2107
2015,11,23,17,2561,4760,2805,-1955
2015,11,23,18,2566,4661,2659,-2002
2015,11,23,19,2394,4568,2603,-1965
2015,11,23,20,2344,4499,2646,-1853
2015,11,23,21,2350,4460,2717,-1743
2015,11,23,22,2357,4410,2701,-1709
2015,11,23,23,2367,4359,2664,-1695
2015,11,24,0,2389,4422,2681,-1741
2015,11,24,1,2441,4663,2833,-1830
2015,11,24,2,2585,4793,2860,-1933
2015,11,24,3,2634,4750,2868,-1882
2015,11,24,4,2672,4653,2822,-1831
2015,11,24,5,2593,4482,2727,-1755
2015,11,24,6,2583,4200,2513,-1687
2015,11,24,7,2483,3871,2426,-1445
2015,11,24,8,2482,3560,2384,-1176
2015,11,24,9,2332,3319,2215,-1104
2015,11,24,10,2261,3253,2171,-1082
2015,11,24,11,2259,3191,2067,-1124
2015,11,24,12,2307,3242,2074,-1168
2015,11,24,13,2456,3408,2245,-1163
2015,11,24,14,2658,3739,2371,-1368
2015,11,24,15,2709,4176,2333,-1843
2015,11,24,16,2775,4505,2596,-1909
2015,11,24,17,2834,4511,2530,-1981
2015,11,24,18,2744,4465,2378,-2087
2015,11,24,19,2548,4453,2401,-2052
2015,11,24,20,2544,4373,2360,-2013
2015,11,24,21,2573,4308,2314,-1994
2015,11,24,22,2600,4215,2264,-1951
2015,11,24,23,2596,4178,2239,-1939
2015,11,25,0,2603,4168,2184,-1984
2015,11,25,1,2836,4412,2373,-2039
2015,11,25,2,2926,4695,2613,-2082
2015,11,25,3,2927,4691,2579,-2112
2015,11,25,4,2881,4627,2519,-2108
2015,11,25,5,2749,4511,2420,-2091
2015,11,25,6,2541,4247,2214,-2033
2015,11,25,7,2666,3931,2368,-1563
2015,11,25,8,2641,3656,2249,-1407
2015,11,25,9,2201,3512,2319,-1193
2015,11,25,10,2201,3450,2274,-1176
2015,11,25,11,2201,3463,2287,-1176
2015,11,25,12,2202,3524,2314,-1210
2015,11,25,13,2352,3771,2478,-1293
2015,11,25,14,2452,4111,2419,-1692
2015,11,25,15,2452,4506,2293,-2213
2015,11,25,16,2491,4803,2494,-2309
2015,11,25,17,2506,4795,2476,-2319
2015,11,25,18,2438,4655,2374,-2281
2015,11,25,19,2366,4548,2319,-2229
2015,11,25,20,2370,4437,2261,-2176
2015,11,25,21,2223,4315,2150,-2165
2015,11,25,22,2224,4070,1921,-2149
2015,11,25,23,2229,4041,1871,-2170
2015,11,26,0,2220,4120,1954,-2166
2015,11,26,1,2297,4526,2158,-2368
2015,11,26,2,2363,4810,2485,-2325
2015,11,26,3,2362,4806,2538,-2268
2015,11,26,4,2358,4758,2597,-2161
2015,11,26,5,2359,4653,2518,-2135
2015,11,26,6,2299,4486,2404,-2082
2015,11,26,7,2314,4244,2655,-1589
2015,11,26,8,2298,3975,2671,-1304
2015,11,26,9,2371,3759,2516,-1243
2015,11,26,10,2360,3672,2428,-1244
2015,11,26,11,2348,3688,2484,-1204
2015,11,26,12,2220,3755,2627,-1128
2015,11,26,13,2313,3874,2703,-1171
2015,11,26,14,2404,4000,2578,-1422
2015,11,26,15,2518,4153,2443,-1710
2015,11,26,16,2559,4457,2643,-1814
2015,11,26,17,2767,4677,2818,-1859
2015,11,26,18,2759,4792,2986,-1806
2015,11,26,19,2752,4788,2998,-1790
2015,11,26,20,2744,4680,2963,-1717
2015,11,26,21,2719,4428,2717,-1711
2015,11,26,22,2619,4222,2556,-1666
2015,11,26,23,2497,4046,2417,-1629
2015,11,27,0,2413,3988,2278,-1710
2015,11,27,1,2436,4071,2344,-1727
2015,11,27,2,2436,4187,2461,-1726
2015,11,27,3,2457,4131,2463,-1668
2015,11,27,4,2470,4143,2464,-1679
2015,11,27,5,2454,4170,2490,-1680
2015,11,27,6,2304,4119,2477,-1642
2015,11,27,7,2295,3952,2422,-1530
2015,11,27,8,2280,3759,2278,-1481
2015,11,27,9,2189,3684,2338,-1346
2015,11,27,10,2092,3657,2374,-1283
2015,11,27,11,2094,3654,2390,-1264
2015,11,27,12,2161,3704,2429,-1275
2015,11,27,13,2148,3877,2496,-1381
2015,11,27,14,2285,4093,2613,-1480
2015,11,27,15,2273,4307,2572,-1735
2015,11,27,16,2315,4465,2516,-1949
2015,11,27,17,2321,4572,2554,-2018
2015,11,27,18,2321,4568,2487,-2081
2015,11,27,19,2321,4463,2460,-2003
2015,11,27,20,2321,4303,2310,-1993
2015,11,27,21,2242,4185,2231,-1954
2015,11,27,22,2242,4052,2098,-1954
2015,11,27,23,2241,3984,2005,-1979
2015,11,28,0,2387,3982,1945,-2037
2015,11,28,1,2353,4291,2213,-2078
2015,11,28,2,2389,4565,2452,-2113
2015,11,28,3,2398,4579,2547,-2032
2015,11,28,4,2399,4544,2630,-1914
2015,11,28,5,2386,4474,2574,-1900
2015,11,28,6,2194,4356,2446,-1910
2015,11,28,7,2391,4144,2495,-1649
2015,11,28,8,2243,3947,2441,-1506
2015,11,28,9,2160,3777,2322,-1455
2015,11,28,10,2163,3694,2251,-1443
2015,11,28,11,2164,3688,2240,-1448
2015,11,28,12,2160,3720,2191,-1529
2015,11,28,13,2243,3809,2297,-1512
2015,11,28,14,2470,3975,2463,-1512
2015,11,28,15,2275,4173,2328,-1845
2015,11,28,16,2438,4456,2460,-1996
2015,11,28,17,2502,4660,2512,-2148
2015,11,28,18,2413,4716,2512,-2204
2015,11,28,19,2400,4630,2469,-2161
2015,11,28,20,2236,4494,2470,-2024
2015,11,28,21,2236,4323,2369,-1954
2015,11,28,22,2229,4193,2308,-1885
2015,11,28,23,2229,4110,2277,-1833
2015,11,29,0,2229,4160,2373,-1787
2015,11,29,1,2229,4442,2492,-1950
2015,11,29,2,2404,4685,2574,-2111
2015,11,29,3,2425,4690,2568,-2122
2015,11,29,4,2438,4627,2505,-2122
2015,11,29,5,2338,4551,2457,-2094
2015,11,29,6,2213,4383,2329,-2054
2015,11,29,7,2393,4215,2510,-1705
2015,11,29,8,2229,4006,2463,-1543
2015,11,29,9,2019,3813,2300,-1513
2015,11,29,10,2019,3714,2223,-1491
2015,11,29,11,2019,3674,2187,-1487
2015,11,29,12,2019,3718,2212,-1506
2015,11,29,13,2039,3808,2290,-1518
2015,11,29,14,2124,3983,2429,-1554
2015,11,29,15,2364,4198,2632,-1566
2015,11,29,16,2509,4418,2666,-1752
2015,11,29,17,2724,4658,2805,-1853
2015,11,29,18,2820,4780,2928,-1852
2015,11,29,19,2820,4753,2927,-1826
2015,11,29,20,2820,4653,2838,-1815
2015,11,29,21,2624,4563,2732,-1831
2015,11,29,22,2450,4482,2676,-1806
2015,11,29,23,2450,4393,2569,-1824
2015,11,30,0,2450,4429,2615,-1814
2015,11,30,1,2745,4637,2813,-1824
2015,11,30,2,2920,5038,3128,-1910
2015,11,30,3,2920,5022,3152,-1870
2015,11,30,4,2920,4964,3061,-1903
2015,11,30,5,2920,4819,2908,-1911
2015,11,30,6,2586,4541,2717,-1824
2015,11,30,7,2309,4201,2603,-1598
2015,11,30,8,2138,3931,2312,-1619
2015,11,30,9,2152,3732,2275,-1457
2015,11,30,10,2152,3678,2243,-1435
2015,11,30,11,2152,3701,2262,-1439
2015,11,30,12,2250,3804,2363,-1441
2015,11,30,13,2556,4048,2617,-1431
2015,11,30,14,2756,4486,2834,-1652
2015,11,30,15,2806,4949,2886,-2063
2015,11,30,16,2806,5201,2948,-2253
2015,11,30,17,2806,5135,2854,-2281
2015,11,30,18,2710,4988,2728,-2260
2015,11,30,19,2710,4834,2790,-2044
2015,11,30,20,2600,4625,2645,-1980
2015,11,30,21,2490,4879,3020,-1859
2015,11,30,22,2490,4543,2694,-1849
2015,11,30,23,2490,4581,2738,-1843
2015,12,1,0,2504,4661,2660,-2001
2015,12,1,1,2618,4943,2891,-2052
2015,12,1,2,2748,5088,2794,-2294
2015,12,1,3,2770,5067,2810,-2257
2015,12,1,4,2780,4952,2797,-2155
2015,12,1,5,2691,4772,2686,-2086
2015,12,1,6,2698,4447,2448,-1999
2015,12,1,7,2554,4103,2401,-1702
2015,12,1,8,2299,3764,2164,-1600
2015,12,1,9,2300,3540,2251,-1289
2015,12,1,10,2300,3447,2188,-1259
2015,12,1,11,2300,3411,2146,-1265
2015,12,1,12,2300,3477,2160,-1317
2015,12,1,13,2475,3634,2280,-1354
2015,12,1,14,2758,3974,2411,-1563
2015,12,1,15,2679,4418,2585,-1833
2015,12,1,16,2854,4668,2715,-1953
2015,12,1,17,2854,4597,2679,-1918
2015,12,1,18,2758,4407,2402,-2005
2015,12,1,19,2558,4283,2235,-2048
2015,12,1,20,2433,4155,1991,-2164
2015,12,1,21,2433,3979,2058,-1921
2015,12,1,22,2433,4017,2100,-1917
2015,12,1,23,2433,3999,1972,-2027
2015,12,2,0,2433,4115,2109,-2006
2015,12,2,1,2759,4385,2460,-1925
2015,12,2,2,2856,4542,2529,-2013
2015,12,2,3,2857,4522,2522,-2000
2015,12,2,4,2809,4442,2447,-1995
2015,12,2,5,2687,4304,2074,-2230
2015,12,2,6,2387,4063,2003,-2060
2015,12,2,7,2563,3729,2019,-1710
2015,12,2,8,2563,3486,2031,-1455
2015,12,2,9,2102,3388,2238,-1150
2015,12,2,10,2142,3318,2291,-1027
2015,12,2,11,2142,3282,2286,-996
2015,12,2,12,2141,3321,2291,-1030
2015,12,2,13,2341,3481,2354,-1127
2015,12,2,14,2461,3806,2477,-1329
2015,12,2,15,2293,4180,2414,-1766
2015,12,2,16,2493,4441,2493,-1948
2015,12,2,17,2437,4410,2502,-1908
2015,12,2,18,2341,4308,2245,-2063
2015,12,2,19,2341,4233,2159,-2074
2015,12,2,20,2269,4147,2094,-2053
2015,12,2,21,2273,4049,2086,-1963
2015,12,2,22,2279,3862,2109,-1753
2015,12,2,23,2285,3848,2120,-1728
2015,12,3,0,2292,3924,2146,-1778
2015,12,3,1,2395,4158,2226,-1932
2015,12,3,2,2502,4345,2340,-2005
2015,12,3,3,2519,4314,2294,-2020
2015,12,3,4,2399,4252,2260,-1992
2015,12,3,5,2310,4115,2231,-1884
2015,12,3,6,2087,3887,2186,-1701
2015,12,3,7,2436,3546,2183,-1363
2015,12,3,8,2304,3237,1967,-1270
2015,12,3,9,1770,3016,1745,-1271
2015,12,3,10,1665,2916,1667,-1249
2015,12,3,11,1653,2886,1642,-1244
2015,12,3,12,1688,2937,1663,-1274
2015,12,3,13,1774,3085,1807,-1278
2015,12,3,14,2074,3429,1867,-1562
2015,12,3,15,2041,3821,1915,-1906
2015,12,3,16,2097,4101,2166,-1935
2015,12,3,17,2094,4076,2164,-1912
2015,12,3,18,2069,4044,2055,-1989
2015,12,3,19,2056,3950,2107,-1843
2015,12,3,20,2059,3856,2063,-1793
2015,12,3,21,1966,3869,2014,-1855
2015,12,3,22,1898,3835,2008,-1827
2015,12,3,23,1901,3834,1891,-1943
2015,12,4,0,1850,3909,1969,-1940
2015,12,4,1,2044,4140,2170,-1970
2015,12,4,2,2076,4298,2242,-2056
2015,12,4,3,2040,4274,2247,-2027
2015,12,4,4,1969,4174,2176,-1998
2015,12,4,5,1674,4052,2018,-2034
2015,12,4,6,1626,3736,1676,-2060
2015,12,4,7,1820,3482,1947,-1535
2015,12,4,8,1692,3211,1985,-1226
2015,12,4,9,1530,2861,1748,-1113
2015,12,4,10,1512,2759,1716,-1043
2015,12,4,11,1513,2683,1578,-1105
2015,12,4,12,1509,2715,1551,-1164
2015,12,4,13,1653,2898,1729,-1169
2015,12,4,14,2228,3432,2154,-1278
2015,12,4,15,1937,3775,1984,-1791
2015,12,4,16,2369,4091,2154,-1937
2015,12,4,17,2349,4093,2174,-1919
2015,12,4,18,2235,3973,2025,-1948
2015,12,4,19,2089,3848,1919,-1929
2015,12,4,20,1937,3842,1958,-1884
2015,12,4,21,1941,3573,1782,-1791
2015,12,4,22,1906,3460,1795,-1665
2015,12,4,23,1917,3408,1751,-1657
2015,12,5,0,1958,3517,1740,-1777
2015,12,5,1,2371,4068,2097,-1971
2015,12,5,2,2375,4267,2336,-1931
2015,12,5,3,2386,4225,2380,-1845
2015,12,5,4,2288,4114,2224,-1890
2015,12,5,5,2255,4005,2117,-1888
2015,12,5,6,2147,3820,1962,-1858
2015,12,5,7,2126,3626,2248,-1378
2015,12,5,8,2011,3338,2152,-1186
2015,12,5,9,1896,3111,1992,-1119
2015,12,5,10,1875,3016,1997,-1019
2015,12,5,11,1856,2960,1972,-988
2015,12,5,12,1843,2943,1938,-1005
2015,12,5,13,1836,3018,1970,-1048
2015,12,5,14,1832,3153,1968,-1185
2015,12,5,15,1738,3300,1682,-1618
2015,12,5,16,1882,3608,1920,-1688
2015,12,5,17,2022,3823,2072,-1751
2015,12,5,18,2200,3971,2162,-1809
2015,12,5,19,2299,4037,2235,-1802
2015,12,5,20,2300,4064,2299,-1765
2015,12,5,21,2299,4061,2292,-1769
2015,12,5,22,2124,4042,2312,-1730
2015,12,5,23,2126,4060,2301,-1759
2015,12,6,0,2128,4110,2319,-1791
2015,12,6,1,2231,4269,2470,-1799
2015,12,6,2,2284,4296,2435,-1861
2015,12,6,3,2288,4232,2271,-1961
2015,12,6,4,2240,4081,2071,-2010
2015,12,6,5,2092,3936,2042,-1894
2015,12,6,6,1990,3771,1989,-1782
2015,12,6,7,2049,3548,2095,-1453
2015,12,6,8,1945,3173,1808,-1365
2015,12,6,9,1648,2945,1760,-1185
2015,12,6,10,1409,2720,1699,-1021
2015,12,6,11,1411,2622,1565,-1057
2015,12,6,12,1416,2673,1741,-932
2015,12,6,13,1604,2797,1903,-894
2015,12,6,14,2034,2900,1948,-952
2015,12,6,15,2080,3087,1966,-1121
2015,12,6,16,2190,3424,2029,-1395
2015,12,6,17,2200,3638,2132,-1506
2015,12,6,18,2309,3789,2163,-1626
2015,12,6,19,2325,3788,2194,-1594
2015,12,6,20,2325,3722,2139,-1583
2015,12,6,21,2261,3612,2045,-1567
2015,12,6,22,2262,3607,1927,-1680
2015,12,6,23,2263,3621,1898,-1723
2015,12,7,0,2311,3704,2073,-1631
2015,12,7,1,2551,3955,2470,-1485
2015,12,7,2,2551,4170,2806,-1364
2015,12,7,3,2557,4175,2857,-1318
2015,12,7,4,2570,4095,2774,-1321
2015,12,7,5,2642,3933,2642,-1291
2015,12,7,6,2484,3673,2336,-1337
2015,12,7,7,2443,3391,2217,-1174
2015,12,7,8,2167,3076,2036,-1040
2015,12,7,9,2132,2916,2034,-882
2015,12,7,10,1980,2691,1851,-840
2015,12,7,11,1915,2598,1782,-816
2015,12,7,12,1902,2644,1816,-828
2015,12,7,13,2145,2970,1967,-1003
2015,12,7,14,2267,3333,2090,-1243
2015,12,7,15,1927,3763,2268,-1495
2015,12,7,16,2363,4004,2435,-1569
2015,12,7,17,2358,4037,2454,-1583
2015,12,7,18,2360,4006,2409,-1597
2015,12,7,19,2362,4036,2479,-1557
2015,12,7,20,1943,4041,2457,-1584
2015,12,7,21,1956,4017,2391,-1626
2015,12,7,22,1981,3986,2363,-1623
2015,12,7,23,2018,4023,2380,-1643
2015,12,8,0,2059,3984,2243,-1741
2015,12,8,1,2267,4175,2262,-1913
2015,12,8,2,2291,4299,2359,-1940
2015,12,8,3,2307,4347,2265,-2082
2015,12,8,4,2499,4435,2293,-2142
2015,12,8,5,2329,4214,2173,-2041
2015,12,8,6,2182,3834,2037,-1797
2015,12,8,7,2340,3485,1979,-1506
2015,12,8,8,2046,3214,1733,-1481
2015,12,8,9,1434,3007,1513,-1494
2015,12,8,10,1329,2912,1394,-1518
2015,12,8,11,1275,2865,1358,-1507
2015,12,8,12,1337,2874,1406,-1468
2015,12,8,13,1585,3130,1475,-1655
2015,12,8,14,1669,3457,1578,-1879
2015,12,8,15,1434,3830,1561,-2269
2015,12,8,16,1655,4054,1544,-2510
2015,12,8,17,1678,3869,1359,-2510
2015,12,8,18,1656,3555,1196,-2359
2015,12,8,19,1542,3552,1283,-2269
2015,12,8,20,1160,3524,1312,-2212
2015,12,8,21,1191,3572,1511,-2061
2015,12,8,22,1210,3581,1498,-2083
2015,12,8,23,1218,3542,1456,-2086
2015,12,9,0,1218,3631,1451,-2180
2015,12,9,1,1630,3998,1643,-2355
2015,12,9,2,1716,4154,1583,-2571
2015,12,9,3,1754,4238,1728,-2510
2015,12,9,4,1743,4134,1638,-2496
2015,12,9,5,1563,3908,1472,-2436
2015,12,9,6,1423,3679,1437,-2242
2015,12,9,7,1624,3404,1456,-1948
2015,12,9,8,1482,3052,1327,-1725
2015,12,9,9,1119,2708,1100,-1608
2015,12,9,10,983,2513,1022,-1491
2015,12,9,11,985,2425,1028,-1397
2015,12,9,12,985,2292,973,-1319
2015,12,9,13,1185,2446,1098,-1348
2015,12,9,14,1335,2836,1445,-1391
2015,12,9,15,1035,3227,1449,-1778
2015,12,9,16,1183,3429,1330,-2099
2015,12,9,17,1143,3451,1186,-2265
2015,12,9,18,1152,3473,1339,-2134
2015,12,9,19,1096,3476,1289,-2187
2015,12,9,20,1210,3565,1350,-2215
2015,12,9,21,1207,3496,1276,-2220
2015,12,9,22,1206,3502,1336,-2166
2015,12,9,23,1205,3346,1276,-2070
2015,12,10,0,1299,3388,1253,-2135
2015,12,10,1,1376,3701,1389,-2312
2015,12,10,2,1776,4021,1469,-2552
2015,12,10,3,1718,4218,1570,-2648
2015,12,10,4,1662,4236,1580,-2656
2015,12,10,5,1624,4123,1475,-2648
2015,12,10,6,1620,3909,1489,-2420
2015,12,10,7,1622,3658,1679,-1979
2015,12,10,8,1576,3325,1574,-1751
2015,12,10,9,1307,3095,1610,-1485
2015,12,10,10,1265,2918,1424,-1494
2015,12,10,11,1024,2597,1230,-1367
2015,12,10,12,1089,2627,1307,-1320
2015,12,10,13,1426,2962,1468,-1494
2015,12,10,14,1871,3411,1827,-1584
2015,12,10,15,1703,3830,1915,-1915
2015,12,10,16,1777,4014,1756,-2258
2015,12,10,17,1675,3983,1650,-2333
2015,12,10,18,1516,3975,1659,-2316
2015,12,10,19,1530,3978,1662,-2316
2015,12,10,20,1496,3919,1510,-2409
2015,12,10,21,1455,3783,1313,-2470
2015,12,10,22,1457,3595,1233,-2362
2015,12,10,23,1452,3552,1275,-2277
2015,12,11,0,1496,3615,1186,-2429
2015,12,11,1,1575,3902,1262,-2640
2015,12,11,2,1782,4397,1782,-2615
2015,12,11,3,1796,4464,1980,-2484
2015,12,11,4,1906,4380,1875,-2505
2015,12,11,5,1839,4198,1916,-2282
2015,12,11,6,1696,4013,1988,-2025
2015,12,11,7,1844,3672,1903,-1769
2015,12,11,8,1835,3350,1843,-1507
2015,12,11,9,1626,3141,1784,-1357
2015,12,11,10,1501,3035,1692,-1343
2015,12,11,11,1543,2983,1668,-1315
2015,12,11,12,1504,3021,1666,-1355
2015,12,11,13,1664,3182,1738,-1444
2015,12,11,14,1793,3565,1840,-1725
2015,12,11,15,1655,3965,1792,-2173
2015,12,11,16,1888,4236,1876,-2360
2015,12,11,17,1886,4223,1870,-2353
2015,12,11,18,1882,4144,1811,-2333
2015,12,11,19,1820,4098,1809,-2289
2015,12,11,20,1651,4003,1775,-2228
2015,12,11,21,1654,3928,1741,-2187
2015,12,11,22,1659,3870,1679,-2191
2015,12,11,23,1668,3869,1635,-2234
2015,12,12,0,1678,3886,1699,-2187
2015,12,12,1,1792,4085,1720,-2365
2015,12,12,2,1941,4222,1728,-2494
2015,12,12,3,1957,4163,1731,-2432
2015,12,12,4,1970,4075,1789,-2286
2015,12,12,5,1800,3975,1832,-2143
2015,12,12,6,1773,3762,1692,-2070
2015,12,12,7,1928,3554,1766,-1788
2015,12,12,8,1911,3318,1819,-1499
2015,12,12,9,1591,3100,1777,-1323
2015,12,12,10,1575,2964,1696,-1268
2015,12,12,11,1566,2886,1626,-1260
2015,12,12,12,1562,2873,1596,-1277
2015,12,12,13,1562,2882,1480,-1402
2015,12,12,14,1665,3024,1428,-1596
2015,12,12,15,1316,3046,1134,-1912
2015,12,12,16,1316,3306,1223,-2083
2015,12,12,17,1366,3629,1346,-2283
2015,12,12,18,1364,3805,1462,-2343
2015,12,12,19,1412,3919,1557,-2362
2015,12,12,20,1411,3953,1476,-2477
2015,12,12,21,1413,3970,1475,-2495
2015,12,12,22,1548,3983,1703,-2280
2015,12,12,23,1558,3910,1659,-2251
2015,12,13,0,1617,3888,1564,-2324
2015,12,13,1,1800,4098,1700,-2398
2015,12,13,2,1861,4132,1660,-2472
2015,12,13,3,1842,4005,1569,-2436
2015,12,13,4,1839,3856,1531,-2325
2015,12,13,5,1640,3554,1030,-2524
2015,12,13,6,1655,3407,1032,-2375
2015,12,13,7,1707,3239,1326,-1913
2015,12,13,8,1724,3039,1377,-1662
2015,12,13,9,1188,2959,1590,-1369
2015,12,13,10,1458,2997,1537,-1460
2015,12,13,11,1464,2932,1412,-1520
2015,12,13,12,1471,2962,1603,-1359
2015,12,13,13,1480,2991,1560,-1431
2015,12,13,14,1494,3119,1567,-1552
2015,12,13,15,1628,3294,1627,-1667
2015,12,13,16,1806,3578,1745,-1833
2015,12,13,17,1825,3805,1858,-1947
2015,12,13,18,1817,4033,2107,-1926
2015,12,13,19,1835,4075,2131,-1944
2015,12,13,20,1831,4122,2174,-1948
2015,12,13,21,1832,4125,2180,-1945
2015,12,13,22,1812,4058,2037,-2021
2015,12,13,23,1825,4012,1841,-2171
2015,12,14,0,1900,4071,1910,-2161
2015,12,14,1,2131,4317,2101,-2216
2015,12,14,2,2219,4445,2155,-2290
2015,12,14,3,2229,4441,2233,-2208
2015,12,14,4,2238,4126,2030,-2096
2015,12,14,5,2243,4056,2135,-1921
2015,12,14,6,2096,3787,1926,-1861
2015,12,14,7,2118,3606,1862,-1744
2015,12,14,8,1918,3318,1749,-1569
2015,12,14,9,1687,3164,1773,-1391
2015,12,14,10,1683,3050,1682,-1368
2015,12,14,11,1676,3029,1692,-1337
2015,12,14,12,1674,3090,1711,-1379
2015,12,14,13,2021,3316,1871,-1445
2015,12,14,14,2130,3665,1946,-1719
2015,12,14,15,1729,4099,1859,-2240
2015,12,14,16,2019,4395,1898,-2497
2015,12,14,17,2018,4343,1795,-2548
2015,12,14,18,2005,4281,1790,-2491
2015,12,14,19,1838,4238,1802,-2436
2015,12,14,20,1821,4150,1706,-2444
2015,12,14,21,1809,4078,1678,-2400
2015,12,14,22,1799,4003,1603,-2400
2015,12,14,23,1794,4034,1718,-2316
2015,12,15,0,1913,4148,1922,-2226
2015,12,15,1,2221,4512,2317,-2195
2015,12,15,2,2219,4799,2631,-2168
2015,12,15,3,2219,4834,2655,-2179
2015,12,15,4,2217,4727,2516,-2211
2015,12,15,5,2212,4555,2363,-2192
2015,12,15,6,2153,4264,2095,-2169
2015,12,15,7,2193,3995,2159,-1836
2015,12,15,8,2183,3687,2126,-1561
2015,12,15,9,1931,3551,1914,-1637
2015,12,15,10,1829,3460,1845,-1615
2015,12,15,11,1827,3410,1737,-1673
2015,12,15,12,1718,3403,1694,-1709
2015,12,15,13,1723,3655,1920,-1735
2015,12,15,14,2086,4081,2036,-2045
2015,12,15,15,1994,4494,2022,-2472
2015,12,15,16,2109,4771,2279,-2492
2015,12,15,17,2114,4714,2245,-2469
2015,12,15,18,2126,4583,2140,-2443
2015,12,15,19,1979,4573,2148,-2425
2015,12,15,20,1757,4404,1971,-2433
2015,12,15,21,1796,4406,1948,-2458
2015,12,15,22,1826,4233,1801,-2432
2015,12,15,23,1840,4281,1858,-2423
2015,12,16,0,1982,4429,1968,-2461
2015,12,16,1,1963,4777,2273,-2504
2015,12,16,2,2112,4891,2391,-2500
2015,12,16,3,2093,4878,2347,-2531
2015,12,16,4,2081,4773,2212,-2561
2015,12,16,5,1979,4524,2035,-2489
2015,12,16,6,1768,4208,1797,-2411
2015,12,16,7,1770,3948,1995,-1953
2015,12,16,8,1775,3545,1679,-1866
2015,12,16,9,1279,3098,1493,-1605
2015,12,16,10,1215,2955,1405,-1550
2015,12,16,11,1204,2895,1331,-1564
2015,12,16,12,1227,2993,1418,-1575
2015,12,16,13,1554,3190,1539,-1651
2015,12,16,14,2110,3545,1814,-1731
2015,12,16,15,1956,3972,1856,-2116
2015,12,16,16,2204,4464,2138,-2326
2015,12,16,17,2195,4538,2269,-2269
2015,12,16,18,2178,4444,2180,-2264
2015,12,16,19,2165,4348,2059,-2289
2015,12,16,20,2158,4202,1987,-2215
2015,12,16,21,2152,4168,1981,-2187
2015,12,16,22,2124,4137,1972,-2165
2015,12,16,23,2121,4137,1972,-2165
2015,12,17,0,2154,4272,2151,-2121
2015,12,17,1,2452,4660,2498,-2162
2015,12,17,2,2451,4921,2579,-2342
2015,12,17,3,2450,4945,2603,-2342
2015,12,17,4,2449,4861,2540,-2321
2015,12,17,5,2449,4738,2305,-2433
2015,12,17,6,2274,4508,2203,-2305
2015,12,17,7,2350,4144,2426,-1718
2015,12,17,8,2171,3815,2319,-1496
2015,12,17,9,1872,3498,2202,-1296
2015,12,17,10,1873,3405,2156,-1249
2015,12,17,11,1875,3384,2141,-1243
2015,12,17,12,2011,3483,2179,-1304
2015,12,17,13,2056,3626,2198,-1428
2015,12,17,14,2314,3937,2267,-1670
2015,12,17,15,2325,4314,2326,-1988
2015,12,17,16,2535,4586,2438,-2148
2015,12,17,17,2546,4594,2428,-2166
2015,12,17,18,2432,4568,2372,-2196
2015,12,17,19,2360,4553,2427,-2126
2015,12,17,20,2106,4485,2404,-2081
2015,12,17,21,2096,4479,2501,-1978
2015,12,17,22,2087,4444,2376,-2068
2015,12,17,23,2082,4436,2351,-2085
2015,12,18,0,2265,4542,2453,-2089
2015,12,18,1,2489,4804,2668,-2136
2015,12,18,2,2542,4937,2727,-2210
2015,12,18,3,2535,4882,2768,-2114
2015,12,18,4,2528,4833,2782,-2051
2015,12,18,5,2390,4691,2631,-2060
2015,12,18,6,2041,4469,2532,-1937
2015,12,18,7,2323,4121,2479,-1642
2015,12,18,8,2172,3800,2209,-1591
2015,12,18,9,1943,3523,1961,-1562
2015,12,18,10,1941,3424,1989,-1435
2015,12,18,11,1939,3339,1916,-1423
2015,12,18,12,1943,3369,1944,-1425
2015,12,18,13,1956,3520,1970,-1550
2015,12,18,14,1984,3804,1935,-1869
2015,12,18,15,1917,4187,1982,-2205
2015,12,18,16,1784,4450,2086,-2364
2015,12,18,17,1804,4224,1980,-2244
2015,12,18,18,1799,4149,1851,-2298
2015,12,18,19,1802,4097,1723,-2374
2015,12,18,20,1805,4106,1802,-2304
2015,12,18,21,1750,4124,2091,-2033
2015,12,18,22,1743,4034,1902,-2132
2015,12,18,23,1730,3970,1818,-2152
2015,12,19,0,1716,4063,1783,-2280
2015,12,19,1,1909,4395,1966,-2429
2015,12,19,2,1912,4745,2215,-2530
2015,12,19,3,1917,4693,2246,-2447
2015,12,19,4,1919,4549,2124,-2425
2015,12,19,5,1916,4293,1926,-2367
2015,12,19,6,1755,4150,1996,-2154
2015,12,19,7,1942,4042,2136,-1906
2015,12,19,8,1930,3800,2178,-1622
2015,12,19,9,1888,3574,2090,-1484
2015,12,19,10,1839,3460,2032,-1428
2015,12,19,11,1829,3382,1979,-1403
2015,12,19,12,1818,3379,1969,-1410
2015,12,19,13,1812,3461,2017,-1444
2015,12,19,14,1955,3590,1955,-1635
2015,12,19,15,1509,3720,1685,-2035
2015,12,19,16,1503,3922,1664,-2258
2015,12,19,17,1818,4273,1927,-2346
2015,12,19,18,1796,4418,2135,-2283
2015,12,19,19,1794,4366,2080,-2286
2015,12,19,20,1697,4268,1995,-2273
2015,12,19,21,1696,4175,1860,-2315
2015,12,19,22,1696,4083,1762,-2321
2015,12,19,23,1648,4018,1672,-2346
2015,12,20,0,1650,4126,1753,-2373
2015,12,20,1,1910,4242,2137,-2105
2015,12,20,2,2118,4300,2127,-2173
2015,12,20,3,2125,4174,1927,-2247
2015,12,20,4,2132,4083,1844,-2239
2015,12,20,5,2086,4013,1926,-2087
2015,12,20,6,1893,3882,1923,-1959
2015,12,20,7,2038,3788,2150,-1638
2015,12,20,8,1882,3551,2033,-1518
2015,12,20,9,1875,3461,1960,-1501
2015,12,20,10,1776,3323,1844,-1479
2015,12,20,11,1776,3246,1780,-1466
2015,12,20,12,1776,3200,1749,-1451
2015,12,20,13,1678,3223,1802,-1421
2015,12,20,14,1895,3388,1895,-1493
2015,12,20,15,1822,3573,1888,-1685
2015,12,20,16,1918,3863,2072,-1791
2015,12,20,17,2035,4090,2109,-1981
2015,12,20,18,2287,4231,2266,-1965
2015,12,20,19,2288,4214,2240,-1974
2015,12,20,20,2290,4205,2188,-2017
2015,12,20,21,2057,4216,2179,-2037
2015,12,20,22,1907,4161,2191,-1970
2015,12,20,23,1918,4184,2172,-2012
2015,12,21,0,1929,4168,2115,-2053
2015,12,21,1,2031,4454,2215,-2239
2015,12,21,2,2184,4637,2254,-2383
2015,12,21,3,2191,4616,2241,-2375
2015,12,21,4,2200,4541,2212,-2329
2015,12,21,5,2118,4437,2166,-2271
2015,12,21,6,2035,4220,2056,-2164
2015,12,21,7,2092,3878,1999,-1879
2015,12,21,8,1891,3518,1822,-1696
2015,12,21,9,1750,3282,1657,-1625
2015,12,21,10,1721,3163,1643,-1520
2015,12,21,11,1563,3149,1523,-1626
2015,12,21,12,1763,3291,1697,-1594
2015,12,21,13,2011,3503,1774,-1729
2015,12,21,14,2061,3818,1892,-1926
2015,12,21,15,1825,4122,1816,-2306
2015,12,21,16,2238,4374,2021,-2353
2015,12,21,17,2223,4553,2204,-2349
2015,12,21,18,2213,4630,2253,-2377
2015,12,21,19,2089,4641,2163,-2478
2015,12,21,20,2065,4640,2228,-2412
2015,12,21,21,2064,4618,2209,-2409
2015,12,21,22,2056,4595,2103,-2492
2015,12,21,23,2043,4597,2142,-2455
2015,12,22,0,2037,4551,1875,-2676
2015,12,22,1,2168,4758,1980,-2778
2015,12,22,2,2200,4891,2126,-2765
2015,12,22,3,2253,4855,2205,-2650
2015,12,22,4,2303,4739,2359,-2380
2015,12,22,5,2173,4576,2119,-2457
2015,12,22,6,1999,4213,1809,-2404
2015,12,22,7,2041,3949,2002,-1947
2015,12,22,8,1773,3622,1832,-1790
2015,12,22,9,1588,3442,1851,-1591
2015,12,22,10,1577,3329,1909,-1420
2015,12,22,11,1565,3272,1893,-1379
2015,12,22,12,1558,3321,1956,-1365
2015,12,22,13,2000,3568,1897,-1671
2015,12,22,14,2179,3874,2016,-1858
2015,12,22,15,2208,4189,2009,-2180
2015,12,22,16,2366,4460,2143,-2317
2015,12,22,17,2397,4542,2268,-2274
2015,12,22,18,2394,4536,2363,-2173
2015,12,22,19,2357,4467,2217,-2250
2015,12,22,20,2331,4395,2225,-2170
2015,12,22,21,2349,4344,2080,-2264
2015,12,22,22,2313,4310,2044,-2266
2015,12,22,23,2280,4163,1964,-2199
2015,12,23,0,2262,4240,2190,-2050
2015,12,23,1,2583,4656,2538,-2118
2015,12,23,2,2601,4793,2555,-2238
2015,12,23,3,2609,4781,2607,-2174
2015,12,23,4,2620,4740,2658,-2082
2015,12,23,5,2535,4614,2612,-2002
2015,12,23,6,2280,4424,2471,-1953
2015,12,23,7,2257,4158,2452,-1706
2015,12,23,8,2156,3817,2080,-1737
2015,12,23,9,2060,3674,2171,-1503
2015,12,23,10,1815,3390,2002,-1388
2015,12,23,11,1810,3262,1748,-1514
2015,12,23,12,1774,3226,1630,-1596
2015,12,23,13,1757,3422,1789,-1633
2015,12,23,14,1878,3802,2122,-1680
2015,12,23,15,1805,4042,1974,-2068
2015,12,23,16,2027,4430,2001,-2429
2015,12,23,17,2034,4549,2005,-2544
2015,12,23,18,2058,4463,2023,-2440
2015,12,23,19,2081,4468,2027,-2441
2015,12,23,20,2094,4420,1982,-2438
2015,12,23,21,2102,4408,1914,-2494
2015,12,23,22,2109,4379,1920,-2459
2015,12,23,23,2114,4398,1956,-2442
2015,12,24,0,2116,4620,2020,-2600
2015,12,24,1,2214,4823,2078,-2745
2015,12,24,2,2315,4936,2103,-2833
2015,12,24,3,2318,4854,2059,-2795
2015,12,24,4,2323,4625,2030,-2595
2015,12,24,5,2234,4496,2020,-2476
2015,12,24,6,2161,4305,1888,-2417
2015,12,24,7,2298,4163,2130,-2033
2015,12,24,8,2261,3871,2067,-1804
2015,12,24,9,1604,3464,1640,-1824
2015,12,24,10,1428,3182,1439,-1743
2015,12,24,11,1411,3157,1405,-1752
2015,12,24,12,1558,3324,1533,-1791
2015,12,24,13,1542,3412,1621,-1791
2015,12,24,14,1565,3587,1587,-2000
2015,12,24,15,1535,3835,1483,-2352
2015,12,24,16,1898,4235,1713,-2522
2015,12,24,17,2076,4365,1744,-2621
2015,12,24,18,2174,4348,1784,-2564
2015,12,24,19,2197,4361,1845,-2516
2015,12,24,20,2190,4324,1836,-2488
2015,12,24,21,2144,4226,1776,-2450
2015,12,24,22,2127,4166,1736,-2430
2015,12,24,23,2177,4165,1772,-2393
2015,12,25,0,2256,4237,1853,-2384
2015,12,25,1,2440,4520,1985,-2535
2015,12,25,2,2503,4564,2142,-2422
2015,12,25,3,2518,4455,2104,-2351
2015,12,25,4,2519,4334,2003,-2331
2015,12,25,5,2394,4104,1855,-2249
2015,12,25,6,2219,4007,1851,-2156
2015,12,25,7,2334,3866,2146,-1720
2015,12,25,8,2333,3643,1979,-1664
2015,12,25,9,1627,3558,1879,-1679
2015,12,25,10,1628,3420,1804,-1616
2015,12,25,11,1628,3354,1775,-1579
2015,12,25,12,1628,3353,1757,-1596
2015,12,25,13,1627,3435,1760,-1675
2015,12,25,14,1709,3637,1911,-1726
2015,12,25,15,1706,3618,1639,-1979
2015,12,25,16,1741,3883,1903,-1980
2015,12,25,17,1906,4081,2013,-2068
2015,12,25,18,2002,4193,2146,-2047
2015,12,25,19,2002,4346,2235,-2111
2015,12,25,20,2002,4303,2144,-2159
2015,12,25,21,2002,4142,2048,-2094
2015,12,25,22,2002,4046,1931,-2115
2015,12,25,23,2002,3925,1923,-2002
2015,12,26,0,2002,3940,1938,-2002
2015,12,26,1,2002,4224,2145,-2079
2015,12,26,2,2202,4348,2229,-2119
2015,12,26,3,2202,4307,2195,-2112
2015,12,26,4,2202,4280,2100,-2180
2015,12,26,5,2052,4238,2111,-2127
2015,12,26,6,1906,4145,2050,-2095
2015,12,26,7,1906,3965,2264,-1701
2015,12,26,8,1906,3743,1950,-1793
2015,12,26,9,1671,3543,1766,-1777
2015,12,26,10,1610,3455,1775,-1680
2015,12,26,11,1599,3422,1767,-1655
2015,12,26,12,1591,3428,1786,-1642
2015,12,26,13,1692,3504,1867,-1637
2015,12,26,14,1863,3647,1821,-1826
2015,12,26,15,1428,3717,1733,-1984
2015,12,26,16,1678,3910,1734,-2176
2015,12,26,17,2249,4170,1940,-2230
2015,12,26,18,2325,4297,2047,-2250
2015,12,26,19,2325,4376,2130,-2246
2015,12,26,20,2250,4372,2171,-2201
2015,12,26,21,2250,4315,2114,-2201
2015,12,26,22,2150,4233,2048,-2185
2015,12,26,23,2075,4168,1988,-2180
2015,12,27,0,2076,4222,1943,-2279
2015,12,27,1,2245,4396,2095,-2301
2015,12,27,2,2445,4510,2239,-2271
2015,12,27,3,2448,4604,2260,-2344
2015,12,27,4,2448,4546,2202,-2344
2015,12,27,5,2300,4449,2077,-2372
2015,12,27,6,2150,4288,2074,-2214
2015,12,27,7,2350,4055,2067,-1988
2015,12,27,8,2251,3806,1928,-1878
2015,12,27,9,1602,3589,1807,-1782
2015,12,27,10,1524,3385,1693,-1692
2015,12,27,11,1463,3330,1600,-1730
2015,12,27,12,1538,3389,1589,-1800
2015,12,27,13,1540,3446,1643,-1803
2015,12,27,14,1541,3601,1695,-1906
2015,12,27,15,1591,3789,1733,-2056
2015,12,27,16,2038,4030,1939,-2091
2015,12,27,17,2172,4219,2096,-2123
2015,12,27,18,2267,4383,2247,-2136
2015,12,27,19,2266,4511,2377,-2134
2015,12,27,20,2266,4565,2446,-2119
2015,12,27,21,2240,4619,2522,-2097
2015,12,27,22,2166,4529,2435,-2094
2015,12,27,23,2167,4424,2404,-2020
2015,12,28,0,2169,4445,2386,-2059
2015,12,28,1,2268,4574,2450,-2124
2015,12,28,2,2519,4740,2499,-2241
2015,12,28,3,2520,4719,2458,-2261
2015,12,28,4,2520,4676,2456,-2220
2015,12,28,5,2369,4547,2447,-2100
2015,12,28,6,2170,4324,2339,-1985
2015,12,28,7,2270,4023,2334,-1689
2015,12,28,8,2109,3739,2008,-1731
2015,12,28,9,2111,3464,2009,-1455
2015,12,28,10,2100,3350,1936,-1414
2015,12,28,11,2089,3331,1895,-1436
2015,12,28,12,2082,3403,1931,-1472
2015,12,28,13,2164,3617,2050,-1567
2015,12,28,14,2262,3917,2156,-1761
2015,12,28,15,2263,4189,2101,-2088
2015,12,28,16,2262,4408,2117,-2291
2015,12,28,17,2260,4568,2256,-2312
2015,12,28,18,2206,4648,2190,-2458
2015,12,28,19,2203,4659,2228,-2431
2015,12,28,20,2200,4614,2284,-2330
2015,12,28,21,2198,4536,2150,-2386
2015,12,28,22,2198,4434,2138,-2296
2015,12,28,23,2197,4384,2093,-2291
2015,12,29,0,2196,4473,2158,-2315
2015,12,29,1,2474,4699,2422,-2277
2015,12,29,2,2473,4871,2486,-2385
2015,12,29,3,2471,4811,2428,-2383
2015,12,29,4,2472,4716,2334,-2382
2015,12,29,5,2456,4593,2224,-2369
2015,12,29,6,2192,4357,2041,-2316
2015,12,29,7,2317,4049,2064,-1985
2015,12,29,8,2292,3740,2036,-1704
2015,12,29,9,2021,3569,2141,-1428
2015,12,29,10,1911,3460,2010,-1450
2015,12,29,11,1911,3454,1992,-1462
2015,12,29,12,1911,3493,2035,-1458
2015,12,29,13,2011,3654,2092,-1562
2015,12,29,14,2426,3910,2082,-1828
2015,12,29,15,2226,4195,1905,-2290
2015,12,29,16,2428,4416,1890,-2526
2015,12,29,17,2453,4515,1947,-2568
2015,12,29,18,2453,4648,2123,-2525
2015,12,29,19,2228,4643,2258,-2385
2015,12,29,20,2228,4565,2309,-2256
2015,12,29,21,2178,4475,2245,-2230
2015,12,29,22,2179,4366,1991,-2375
2015,12,29,23,2177,4235,1755,-2480
2015,12,30,0,2177,4269,1981,-2288
2015,12,30,1,2577,4591,1998,-2593
2015,12,30,2,2577,4898,2259,-2639
2015,12,30,3,2577,4910,2313,-2597
2015,12,30,4,2578,4843,2249,-2594
2015,12,30,5,2478,4744,2254,-2490
2015,12,30,6,2377,4518,2062,-2456
2015,12,30,7,2577,4257,2460,-1797
2015,12,30,8,2427,3930,2336,-1594
2015,12,30,9,2143,3767,2260,-1507
2015,12,30,10,2090,3697,2177,-1520
2015,12,30,11,2090,3685,2180,-1505
2015,12,30,12,2175,3757,2254,-1503
2015,12,30,13,2398,3948,2407,-1541
2015,12,30,14,2498,4259,2441,-1818
2015,12,30,15,2348,4582,2297,-2285
2015,12,30,16,2594,4858,2493,-2365
2015,12,30,17,2669,4955,2314,-2641
2015,12,30,18,2634,4941,2379,-2562
2015,12,30,19,2458,4821,2135,-2686
2015,12,30,20,2175,4679,1999,-2680
2015,12,30,21,2181,4564,1999,-2565
2015,12,30,22,2175,4469,2026,-2443
2015,12,30,23,2175,4380,1971,-2409
2015,12,31,0,2175,4330,1768,-2562
2015,12,31,1,2504,4589,2017,-2572
2015,12,31,2,2694,4970,2328,-2642
2015,12,31,3,2694,5014,2356,-2658
2015,12,31,4,2694,4993,2309,-2684
2015,12,31,5,2548,4907,2243,-2664
2015,12,31,6,2298,4715,2409,-2306
2015,12,31,7,2498,4415,2394,-2021
2015,12,31,8,2448,4171,2396,-1775
2015,12,31,9,2266,4002,2403,-1599
2015,12,31,10,2166,3930,2333,-1597
2015,12,31,11,2166,3926,2313,-1613
2015,12,31,12,2166,3982,2292,-1690
2015,12,31,13,2370,4140,2384,-1756
2015,12,31,14,2491,4410,2388,-2022
2015,12,31,15,2391,4689,2187,-2502
2015,12,31,16,2662,4955,2225,-2730
2015,12,31,17,2662,5047,2282,-2765
2015,12,31,18,2560,5037,2297,-2740
2015,12,31,19,2325,4947,2243,-2704
2015,12,31,20,2150,4779,2110,-2669
2015,12,31,21,2050,4628,1984,-2644
2015,12,31,22,2050,4425,1825,-2600
2015,12,31,23,2050,4207,1697,-2510
2016,1,1,0,2115,4238,1698,-2540
2016,1,1,1,2340,4712,2027,-2685
2016,1,1,2,2711,5085,2331,-2754
2016,1,1,3,2711,5030,2280,-2750
2016,1,1,4,2711,4845,2129,-2716
2016,1,1,5,2536,4581,1990,-2591
2016,1,1,6,2386,4419,2026,-2393
2016,1,1,7,2536,4200,2312,-1888
2016,1,1,8,2436,4065,2469,-1596
2016,1,1,9,1970,3931,2364,-1567
2016,1,1,10,1920,3834,2194,-1640
2016,1,1,11,1920,3802,2171,-1631
2016,1,1,12,1920,3828,2194,-1634
2016,1,1,13,1970,3911,2270,-1641
2016,1,1,14,2120,4066,2315,-1751
2016,1,1,15,2248,4263,2448,-1815
2016,1,1,16,2619,4376,2363,-2013
2016,1,1,17,2717,4492,2386,-2106
2016,1,1,18,2717,4583,2489,-2094
2016,1,1,19,2717,4573,2539,-2034
2016,1,1,20,2592,4480,2501,-1979
2016,1,1,21,2542,4329,2392,-1937
2016,1,1,22,2446,4194,2277,-1917
2016,1,1,23,2446,4070,2181,-1889
2016,1,2,0,2446,4095,2190,-1905
2016,1,2,1,2792,4361,2226,-2135
2016,1,2,2,3067,4697,2370,-2327
2016,1,2,3,3067,4694,2389,-2305
2016,1,2,4,3067,4641,2292,-2349
2016,1,2,5,2917,4566,2381,-2185
2016,1,2,6,2374,4428,2462,-1966
2016,1,2,7,2322,4179,2307,-1872
2016,1,2,8,2207,3962,2221,-1741
2016,1,2,9,1960,3789,2155,-1634
2016,1,2,10,1951,3716,2077,-1639
2016,1,2,11,1943,3737,2036,-1701
2016,1,2,12,1939,3769,2063,-1706
2016,1,2,13,1988,3860,2153,-1707
2016,1,2,14,2088,4021,2284,-1737
2016,1,2,15,2038,4232,2075,-2157
2016,1,2,16,2139,4456,2148,-2308
2016,1,2,17,2238,4666,2321,-2345
2016,1,2,18,2413,4767,2372,-2395
2016,1,2,19,2413,4739,2346,-2393
2016,1,2,20,2412,4616,2337,-2279
2016,1,2,21,2412,4461,2153,-2308
2016,1,2,22,2138,4319,2120,-2199
2016,1,2,23,2137,4227,2077,-2150
2016,1,3,0,2137,4255,2146,-2109
2016,1,3,1,2458,4477,2304,-2173
2016,1,3,2,2584,4780,2610,-2170
2016,1,3,3,2585,4795,2455,-2340
2016,1,3,4,2588,4731,2418,-2313
2016,1,3,5,2443,4656,2344,-2312
2016,1,3,6,2165,4502,2251,-2251
2016,1,3,7,2316,4278,2384,-1894
2016,1,3,8,2195,4026,2352,-1674
2016,1,3,9,1929,3853,2278,-1575
2016,1,3,10,1841,3771,2203,-1568
2016,1,3,11,1855,3739,2207,-1532
2016,1,3,12,1866,3752,2164,-1588
2016,1,3,13,1928,3826,2208,-1618
2016,1,3,14,2091,3973,2339,-1634
2016,1,3,15,2097,4183,2289,-1894
2016,1,3,16,2245,4407,2341,-2066
2016,1,3,17,2508,4636,2463,-2173
2016,1,3,18,2573,4762,2528,-2234
2016,1,3,19,2566,4785,2567,-2218
2016,1,3,20,2562,4760,2568,-2192
2016,1,3,21,2322,4753,2572,-2181
2016,1,3,22,2232,4698,2517,-2181
2016,1,3,23,2245,4611,2416,-2195
2016,1,4,0,2258,4624,2410,-2214
2016,1,4,1,2536,4788,2558,-2230
2016,1,4,2,2711,4974,2728,-2246
2016,1,4,3,2703,4844,2750,-2094
2016,1,4,4,2694,4740,2767,-1973
2016,1,4,5,2553,4670,2440,-2230
2016,1,4,6,2201,4443,2283,-2160
2016,1,4,7,2173,4087,2199,-1888
2016,1,4,8,2018,3757,1911,-1846
2016,1,4,9,1747,3599,1871,-1728
2016,1,4,10,1692,3512,1835,-1677
2016,1,4,11,1686,3483,1809,-1674
2016,1,4,12,1781,3537,1822,-1715
2016,1,4,13,2191,3713,2086,-1627
2016,1,4,14,2361,4047,2334,-1713
2016,1,4,15,2360,4451,2352,-2099
2016,1,4,16,2435,4737,2425,-2312
2016,1,4,17,2430,4773,2339,-2434
2016,1,4,18,2328,4732,2322,-2410
2016,1,4,19,2268,4689,2316,-2373
2016,1,4,20,2162,4642,2332,-2310
2016,1,4,21,2108,4634,2289,-2345
2016,1,4,22,2107,4611,2314,-2297
2016,1,4,23,2104,4562,2284,-2278
2016,1,5,0,2104,4559,2326,-2233
2016,1,5,1,2295,4767,2406,-2361
2016,1,5,2,2500,4972,2590,-2382
2016,1,5,3,2498,4901,2454,-2447
2016,1,5,4,2498,4774,2405,-2369
2016,1,5,5,2300,4621,2231,-2390
2016,1,5,6,2152,4340,2037,-2303
2016,1,5,7,2227,3986,2056,-1930
2016,1,5,8,2148,3671,1862,-1809
2016,1,5,9,1962,3059,1486,-1573
2016,1,5,10,1783,3427,1894,-1533
2016,1,5,11,1783,3402,1865,-1537
2016,1,5,12,1779,3455,2028,-1427
2016,1,5,13,2049,3632,2065,-1567
2016,1,5,14,2218,3976,2150,-1826
2016,1,5,15,2163,4386,2199,-2187
2016,1,5,16,2257,4623,2332,-2291
2016,1,5,17,2305,4615,2254,-2361
2016,1,5,18,2208,4547,2163,-2384
2016,1,5,19,2207,4503,2129,-2374
2016,1,5,20,2207,4465,2129,-2336
2016,1,5,21,2156,4414,2177,-2237
2016,1,5,22,2157,4370,2140,-2230
2016,1,5,23,2225,4341,2121,-2220
2016,1,6,0,2275,4381,2169,-2212
2016,1,6,1,2275,4575,2229,-2346
2016,1,6,2,2414,4769,2356,-2413
2016,1,6,3,2412,4734,2345,-2389
2016,1,6,4,2411,4648,2343,-2305
2016,1,6,5,2313,4477,2302,-2175
2016,1,6,6,2262,4239,2245,-1994
2016,1,6,7,2312,3926,2205,-1721
2016,1,6,8,2100,3642,2082,-1560
2016,1,6,9,1870,3522,1885,-1637
2016,1,6,10,1909,3467,1893,-1574
2016,1,6,11,1910,3441,1839,-1602
2016,1,6,12,1960,3505,1852,-1653
2016,1,6,13,2011,3716,2006,-1710
2016,1,6,14,2113,4051,2059,-1992
2016,1,6,15,1966,4490,2094,-2396
2016,1,6,16,2119,4753,2098,-2655
2016,1,6,17,2122,4685,2052,-2633
2016,1,6,18,2124,4546,1955,-2591
2016,1,6,19,2126,4454,1903,-2551
2016,1,6,20,2027,4323,1845,-2478
2016,1,6,21,2029,4205,1758,-2447
2016,1,6,22,1932,4027,1704,-2323
2016,1,6,23,1933,3990,1723,-2267
2016,1,7,0,1935,4099,1766,-2333
2016,1,7,1,2135,4399,1942,-2457
2016,1,7,2,2333,4706,2245,-2461
2016,1,7,3,2329,4734,2275,-2459
2016,1,7,4,2326,4689,2275,-2414
2016,1,7,5,2320,4575,2224,-2351
2016,1,7,6,2113,4304,2084,-2220
2016,1,7,7,2309,4006,2002,-2004
2016,1,7,8,2105,3733,1943,-1790
2016,1,7,9,1865,3539,1896,-1643
2016,1,7,10,1814,3509,1900,-1609
2016,1,7,11,1816,3495,1882,-1613
2016,1,7,12,1813,3552,1847,-1705
2016,1,7,13,1962,3726,1865,-1861
2016,1,7,14,2061,4069,1912,-2157
2016,1,7,15,2060,4507,2005,-2502
2016,1,7,16,2168,4758,2188,-2570
2016,1,7,17,2168,4699,2145,-2554
2016,1,7,18,2078,4625,2105,-2520
2016,1,7,19,2078,4565,2086,-2479
2016,1,7,20,1928,4453,2065,-2388
2016,1,7,21,1928,4450,1923,-2527
2016,1,7,22,1929,4408,1968,-2440
2016,1,7,23,1927,4377,1932,-2445
2016,1,8,0,1927,4434,1951,-2483
2016,1,8,1,2077,4600,2058,-2542
2016,1,8,2,2245,4793,2216,-2577
2016,1,8,3,2245,4754,2205,-2549
2016,1,8,4,2246,4669,2104,-2565
2016,1,8,5,2188,4564,2022,-2542
2016,1,8,6,1974,4321,1984,-2337
2016,1,8,7,2162,3998,2010,-1988
2016,1,8,8,2050,3713,1936,-1777
2016,1,8,9,1619,3533,1822,-1711
2016,1,8,10,1569,3420,1729,-1691
2016,1,8,11,1469,3329,1691,-1638
2016,1,8,12,1469,3372,1713,-1659
2016,1,8,13,1990,3637,1989,-1648
2016,1,8,14,2162,3997,2151,-1846
2016,1,8,15,2163,4423,2145,-2278
2016,1,8,16,2260,4705,2152,-2553
2016,1,8,17,2310,4687,2160,-2527
2016,1,8,18,2214,4624,2092,-2532
2016,1,8,19,2114,4557,2024,-2533
2016,1,8,20,2114,4462,1934,-2528
2016,1,8,21,1990,4346,1847,-2499
2016,1,8,22,1991,4211,1744,-2467
2016,1,8,23,1990,4130,1661,-2469
2016,1,9,0,2040,4165,1706,-2459
2016,1,9,1,2162,4450,1999,-2451
2016,1,9,2,2259,4724,2173,-2551
2016,1,9,3,2259,4723,2197,-2526
2016,1,9,4,2164,4640,2194,-2446
2016,1,9,5,2114,4512,2021,-2491
2016,1,9,6,1963,4339,1863,-2476
2016,1,9,7,2163,4122,2050,-2072
2016,1,9,8,2063,3881,2043,-1838
2016,1,9,9,1862,3689,1971,-1718
2016,1,9,10,1862,3595,1881,-1714
2016,1,9,11,1862,3588,1890,-1698
2016,1,9,12,1863,3606,1898,-1708
2016,1,9,13,1863,3694,1969,-1725
2016,1,9,14,1913,3859,2024,-1835
2016,1,9,15,1863,4062,1786,-2276
2016,1,9,16,1914,4337,1856,-2481
2016,1,9,17,1968,4552,2054,-2498
2016,1,9,18,2117,4641,2045,-2596
2016,1,9,19,2142,4621,2051,-2570
2016,1,9,20,2141,4505,2011,-2494
2016,1,9,21,2141,4373,1881,-2492
2016,1,9,22,2017,4191,1749,-2442
2016,1,9,23,2015,4082,1666,-2416
2016,1,10,0,2015,4133,1757,-2376
2016,1,10,1,2115,4355,1848,-2507
2016,1,10,2,2139,4581,2081,-2500
2016,1,10,3,2189,4563,2059,-2504
2016,1,10,4,2190,4486,1962,-2524
2016,1,10,5,2190,4336,1856,-2480
2016,1,10,6,1989,4162,1800,-2362
2016,1,10,7,2139,3950,1969,-1981
2016,1,10,8,2139,3734,1980,-1754
2016,1,10,9,1929,3561,1935,-1626
2016,1,10,10,1829,3455,1865,-1590
2016,1,10,11,1829,3405,1818,-1587
2016,1,10,12,1829,3401,1802,-1599
2016,1,10,13,1829,3490,1881,-1609
2016,1,10,14,2029,3632,1918,-1714
2016,1,10,15,1929,3839,1885,-1954
2016,1,10,16,2030,4127,1885,-2242
2016,1,10,17,2080,4404,2112,-2292
2016,1,10,18,2080,4532,2197,-2335
2016,1,10,19,2080,4375,2101,-2274
2016,1,10,20,2080,4261,1978,-2283
2016,1,10,21,2080,4118,1862,-2256
2016,1,10,22,2081,4010,1775,-2235
2016,1,10,23,2079,3930,1720,-2210
2016,1,11,0,2079,3956,1720,-2236
2016,1,11,1,2133,4233,1943,-2290
2016,1,11,2,2229,4598,2253,-2345
2016,1,11,3,2229,4660,2215,-2445
2016,1,11,4,2230,4643,2233,-2410
2016,1,11,5,2230,4552,2212,-2340
2016,1,11,6,2079,4301,2085,-2216
2016,1,11,7,2079,4010,2047,-1963
2016,1,11,8,2079,3753,2012,-1741
2016,1,11,9,1646,3581,1912,-1669
2016,1,11,10,1596,3491,1846,-1645
2016,1,11,11,1596,3516,1873,-1643
2016,1,11,12,1776,3675,1898,-1777
2016,1,11,13,1977,3895,2095,-1800
2016,1,11,14,2266,4285,2292,-1993
2016,1,11,15,2329,4743,2417,-2326
2016,1,11,16,2501,4976,2603,-2373
2016,1,11,17,2576,4902,2554,-2348
2016,1,11,18,2480,4806,2357,-2449
2016,1,11,19,2405,4772,2335,-2437
2016,1,11,20,2351,4734,2375,-2359
2016,1,11,21,2330,4703,2436,-2267
2016,1,11,22,2331,4606,2374,-2232
2016,1,11,23,2329,4496,2300,-2196
2016,1,12,0,2329,4501,2298,-2203
2016,1,12,1,2404,4713,2380,-2333
2016,1,12,2,2500,4914,2488,-2426
2016,1,12,3,2500,4842,2453,-2389
2016,1,12,4,2405,4721,2350,-2371
2016,1,12,5,2351,4575,2256,-2319
2016,1,12,6,2180,4301,2033,-2268
2016,1,12,7,2305,3934,1903,-2031
2016,1,12,8,2282,3651,1888,-1763
2016,1,12,9,1642,3511,1845,-1666
2016,1,12,10,1636,3413,1799,-1614
2016,1,12,11,1621,3376,1766,-1610
2016,1,12,12,1671,3426,1783,-1643
2016,1,12,13,1896,3594,1767,-1827
2016,1,12,14,1946,3925,1830,-2095
2016,1,12,15,1946,4302,1839,-2463
2016,1,12,16,2042,4564,2050,-2514
2016,1,12,17,2043,4465,1850,-2615
2016,1,12,18,1948,4344,1756,-2588
2016,1,12,19,1948,4317,1749,-2568
2016,1,12,20,1948,4273,1735,-2538
2016,1,12,21,1947,4273,1717,-2556
2016,1,12,22,1949,4277,1760,-2517
2016,1,12,23,1947,4275,1825,-2450
2016,1,13,0,1947,4281,1769,-2512
2016,1,13,1,2093,4477,1846,-2631
2016,1,13,2,2201,4681,2051,-2630
2016,1,13,3,2205,4626,2005,-2621
2016,1,13,4,2209,4538,1955,-2583
2016,1,13,5,2016,4377,1855,-2522
2016,1,13,6,1868,4115,1724,-2391
2016,1,13,7,1996,3801,1795,-2006
2016,1,13,8,1919,3492,1701,-1791
2016,1,13,9,1503,3244,1617,-1627
2016,1,13,10,1440,3057,1503,-1554
2016,1,13,11,1430,2995,1473,-1522
2016,1,13,12,1436,3020,1507,-1513
2016,1,13,13,1475,3162,1537,-1625
2016,1,13,14,1869,3649,1750,-1899
2016,1,13,15,1865,4037,1786,-2251
2016,1,13,16,2018,4301,1897,-2404
2016,1,13,17,2020,4300,1834,-2466
2016,1,13,18,1941,4266,1757,-2509
2016,1,13,19,1864,4263,1844,-2419
2016,1,13,20,1892,4252,1855,-2397
2016,1,13,21,1924,4235,1912,-2323
2016,1,13,22,1953,4203,1904,-2299
2016,1,13,23,1976,3969,1698,-2271
2016,1,14,0,1992,4044,1856,-2188
2016,1,14,1,2052,4223,1833,-2390
2016,1,14,2,2057,4473,1884,-2589
2016,1,14,3,2059,4462,1895,-2567
2016,1,14,4,2059,4355,1844,-2511
2016,1,14,5,2060,4223,1750,-2473
2016,1,14,6,1909,3949,1570,-2379
2016,1,14,7,2032,3698,1774,-1924
2016,1,14,8,1887,3374,1597,-1777
2016,1,14,9,1199,2987,1385,-1602
2016,1,14,10,1164,2888,1426,-1462
2016,1,14,11,1162,2853,1380,-1473
2016,1,14,12,1154,2924,1415,-1509
2016,1,14,13,1184,3173,1554,-1619
2016,1,14,14,1723,3908,1852,-2056
2016,1,14,15,1781,4370,1874,-2496
2016,1,14,16,1940,4682,2026,-2656
2016,1,14,17,1902,4588,1972,-2616
2016,1,14,18,1873,4493,1885,-2608
2016,1,14,19,1855,4361,1722,-2639
2016,1,14,20,1843,4247,1606,-2641
2016,1,14,21,1838,4167,1564,-2603
2016,1,14,22,1841,4110,1697,-2413
2016,1,14,23,1860,4045,1678,-2367
2016,1,15,0,1935,4162,1857,-2305
2016,1,15,1,1966,4388,1927,-2461
2016,1,15,2,2064,4750,2301,-2449
2016,1,15,3,2066,4780,2309,-2471
2016,1,15,4,2070,4727,2324,-2403
2016,1,15,5,1978,4621,2252,-2369
2016,1,15,6,1979,4374,2056,-2318
2016,1,15,7,1979,4088,2054,-2034
2016,1,15,8,1977,3843,2075,-1768
2016,1,15,9,1703,3647,1978,-1669
2016,1,15,10,1738,3543,1883,-1660
2016,1,15,11,1720,3533,1840,-1693
2016,1,15,12,1753,3592,1870,-1722
2016,1,15,13,1913,3760,1986,-1774
2016,1,15,14,2001,4069,2099,-1970
2016,1,15,15,2001,4486,2139,-2347
2016,1,15,16,2093,4756,2325,-2431
2016,1,15,17,2124,4704,2182,-2522
2016,1,15,18,2023,4618,2210,-2408
2016,1,15,19,2021,4563,2231,-2332
2016,1,15,20,2022,4473,2191,-2282
2016,1,15,21,2024,4446,2154,-2292
2016,1,15,22,2025,4353,2055,-2298
2016,1,15,23,2025,4305,2068,-2237
2016,1,16,0,1875,4319,2048,-2271
2016,1,16,1,2023,4441,1991,-2450
2016,1,16,2,2118,4614,2055,-2559
2016,1,16,3,2121,4569,2070,-2499
2016,1,16,4,2127,4455,2016,-2439
2016,1,16,5,1989,4324,2035,-2289
2016,1,16,6,1967,4120,2015,-2105
2016,1,16,7,2034,3875,2109,-1766
2016,1,16,8,2032,3632,2139,-1493
2016,1,16,9,1985,3413,2021,-1392
2016,1,16,10,1739,3292,1916,-1376
2016,1,16,11,1633,3217,1858,-1359
2016,1,16,12,1744,3221,1850,-1371
2016,1,16,13,1848,3270,1938,-1332
2016,1,16,14,1712,3283,1990,-1293
2016,1,16,15,1730,3433,1906,-1527
2016,1,16,16,1920,3674,2014,-1660
2016,1,16,17,2021,3845,2020,-1825
2016,1,16,18,2220,3966,2083,-1883
2016,1,16,19,2214,4026,2155,-1871
2016,1,16,20,2209,3926,2096,-1830
2016,1,16,21,2107,3842,2090,-1752
2016,1,16,22,2053,3741,2031,-1710
2016,1,16,23,2055,3690,2052,-1638
2016,1,17,0,2061,3743,2109,-1634
2016,1,17,1,2121,3849,2084,-1765
2016,1,17,2,2185,4045,2202,-1843
2016,1,17,3,2365,4044,2238,-1806
2016,1,17,4,2220,4006,2005,-2001
2016,1,17,5,2167,3921,1879,-2042
2016,1,17,6,2158,3795,1885,-1910
2016,1,17,7,2200,3635,2259,-1376
2016,1,17,8,2043,3409,2057,-1352
2016,1,17,9,1677,3257,1926,-1331
2016,1,17,10,1623,3124,1762,-1362
2016,1,17,11,1619,3044,1671,-1373
2016,1,17,12,1615,3066,1732,-1334
2016,1,17,13,1797,3115,1826,-1289
2016,1,17,14,1749,3249,1946,-1303
2016,1,17,15,1897,3279,1780,-1499
2016,1,17,16,2051,3542,1992,-1550
2016,1,17,17,2192,3801,2084,-1717
2016,1,17,18,2292,4043,2309,-1734
2016,1,17,19,2340,3997,2280,-1717
2016,1,17,20,2335,3934,2248,-1686
2016,1,17,21,2331,3899,2327,-1572
2016,1,17,22,2183,3823,2247,-1576
2016,1,17,23,2187,3818,2250,-1568
2016,1,18,0,2197,3799,2266,-1533
2016,1,18,1,2304,3909,2320,-1589
2016,1,18,2,2468,4150,2445,-1705
2016,1,18,3,2475,4242,2588,-1654
2016,1,18,4,2479,4174,2461,-1713
2016,1,18,5,2382,4044,2313,-1731
2016,1,18,6,2227,3848,2026,-1822
2016,1,18,7,2224,3610,2155,-1455
2016,1,18,8,2122,3247,1893,-1354
2016,1,18,9,1631,3079,1752,-1327
2016,1,18,10,1672,3000,1759,-1241
2016,1,18,11,1753,2945,1775,-1170
2016,1,18,12,1847,2979,1869,-1110
2016,1,18,13,1751,3275,2039,-1236
2016,1,18,14,2175,3561,2203,-1358
2016,1,18,15,2198,3825,2017,-1808
2016,1,18,16,2291,4049,2030,-2019
2016,1,18,17,2333,4149,2124,-2025
2016,1,18,18,2424,4217,2172,-2045
2016,1,18,19,2417,4245,2225,-2020
2016,1,18,20,2312,4166,2177,-1989
2016,1,18,21,2209,4107,2198,-1909
2016,1,18,22,2209,4043,2015,-2028
2016,1,18,23,2208,4039,2069,-1970
2016,1,19,0,2222,4102,2246,-1856
2016,1,19,1,2469,4197,2347,-1850
2016,1,19,2,2584,4371,2584,-1787
2016,1,19,3,2584,4357,2586,-1771
2016,1,19,4,2584,4259,2415,-1844
2016,1,19,5,2488,4120,2224,-1896
2016,1,19,6,2395,3871,2088,-1783
2016,1,19,7,2447,3591,2156,-1435
2016,1,19,8,2278,3298,2074,-1224
2016,1,19,9,1753,3089,1929,-1160
2016,1,19,10,1755,2994,1863,-1131
2016,1,19,11,1755,2933,1821,-1112
2016,1,19,12,1753,2985,1849,-1136
2016,1,19,13,1908,3207,2009,-1198
2016,1,19,14,2305,3542,2066,-1476
2016,1,19,15,2234,3990,2163,-1827
2016,1,19,16,2458,4290,2480,-1810
2016,1,19,17,2607,4279,2504,-1775
2016,1,19,18,2411,4214,2435,-1779
2016,1,19,19,2410,4162,2442,-1720
2016,1,19,20,2262,4113,2410,-1703
2016,1,19,21,2035,4075,2342,-1733
2016,1,19,22,2040,4025,2324,-1701
2016,1,19,23,2044,4000,2322,-1678
2016,1,20,0,2053,4040,2318,-1722
2016,1,20,1,2318,4296,2489,-1807
2016,1,20,2,2514,4535,2605,-1930
2016,1,20,3,2540,4514,2603,-1911
2016,1,20,4,2564,4377,2409,-1968
2016,1,20,5,2446,4146,1687,-2459
2016,1,20,6,2262,3933,1802,-2131
2016,1,20,7,2375,3619,1998,-1621
2016,1,20,8,2128,3274,1681,-1593
2016,1,20,9,1349,2827,1526,-1301
2016,1,20,10,1260,2711,1451,-1260
2016,1,20,11,1287,2676,1478,-1198
2016,1,20,12,1305,2679,1443,-1236
2016,1,20,13,1459,2865,1574,-1291
2016,1,20,14,2072,3481,1884,-1597
2016,1,20,15,2159,3883,1799,-2084
2016,1,20,16,2241,4169,2177,-1992
2016,1,20,17,2247,4105,2001,-2104
2016,1,20,18,2182,4014,1964,-2050
2016,1,20,19,2098,3946,2000,-1946
2016,1,20,20,2094,3846,1997,-1849
2016,1,20,21,2134,3804,1894,-1910
2016,1,20,22,2108,3773,1842,-1931
2016,1,20,23,2076,3740,1762,-1978
2016,1,21,0,2250,3809,1907,-1902
2016,1,21,1,2362,4021,2201,-1820
2016,1,21,2,2474,4307,2440,-1867
2016,1,21,3,2473,4317,2461,-1856
2016,1,21,4,2473,4202,2353,-1849
2016,1,21,5,2349,4094,2353,-1741
2016,1,21,6,2359,3878,2337,-1541
2016,1,21,7,2425,3572,2376,-1196
2016,1,21,8,2131,3269,2184,-1085
2016,1,21,9,1841,3076,1948,-1128
2016,1,21,10,1842,2719,1758,-961
2016,1,21,11,1484,2618,1794,-824
2016,1,21,12,1494,2666,1755,-911
2016,1,21,13,1645,2825,1968,-857
2016,1,21,14,1939,3137,2065,-1072
2016,1,21,15,1838,3542,2045,-1497
2016,1,21,16,2423,3749,2162,-1587
2016,1,21,17,2562,3706,2185,-1521
2016,1,21,18,2511,3630,2167,-1463
2016,1,21,19,2240,3575,2199,-1376
2016,1,21,20,2240,3545,2217,-1328
2016,1,21,21,2239,3459,2177,-1282
2016,1,21,22,2211,3387,2111,-1276
2016,1,21,23,2210,3335,2049,-1286
2016,1,22,0,2241,3403,2105,-1298
2016,1,22,1,2393,3559,2036,-1523
2016,1,22,2,2492,3740,2146,-1594
2016,1,22,3,2494,3720,2154,-1566
2016,1,22,4,2496,3806,1970,-1836
2016,1,22,5,2397,3824,2202,-1622
2016,1,22,6,2247,3569,2023,-1546
2016,1,22,7,2367,3331,2098,-1233
2016,1,22,8,2151,3008,1755,-1253
2016,1,22,9,1820,2806,1496,-1310
2016,1,22,10,1591,2602,1380,-1222
2016,1,22,11,1594,2571,1436,-1135
2016,1,22,12,1596,2591,1433,-1158
2016,1,22,13,1598,2795,1646,-1149
2016,1,22,14,1699,3403,2073,-1330
2016,1,22,15,2069,3778,1997,-1781
2016,1,22,16,2435,3976,2072,-1904
2016,1,22,17,2468,3924,1919,-2005
2016,1,22,18,2501,3782,1667,-2115
2016,1,22,19,2374,3778,1706,-2072
2016,1,22,20,2290,3523,1601,-1922
2016,1,22,21,2285,3431,1641,-1790
2016,1,22,22,2283,3392,1680,-1712
2016,1,22,23,2279,3363,1701,-1662
2016,1,23,0,2268,3512,1899,-1613
2016,1,23,1,2534,3843,2025,-1818
2016,1,23,2,2626,4166,2279,-1887
2016,1,23,3,2601,4176,2328,-1848
2016,1,23,4,2583,4099,2299,-1800
2016,1,23,5,2548,3991,2144,-1847
2016,1,23,6,2046,3825,2009,-1816
2016,1,23,7,2139,3624,2191,-1433
2016,1,23,8,2024,3379,2140,-1239
2016,1,23,9,1720,3187,2036,-1151
2016,1,23,10,1490,2877,1864,-1013
2016,1,23,11,1305,2711,1789,-922
2016,1,23,12,1305,2717,1813,-904
2016,1,23,13,1308,2769,1785,-984
2016,1,23,14,1661,3036,1957,-1079
2016,1,23,15,1601,3223,1838,-1385
2016,1,23,16,2094,3578,1970,-1608
2016,1,23,17,2177,3935,2049,-1886
2016,1,23,18,2288,4071,1952,-2119
2016,1,23,19,2279,4204,2280,-1924
2016,1,23,20,2273,4181,2215,-1966
2016,1,23,21,2272,4142,2166,-1976
2016,1,23,22,2224,4106,2151,-1955
2016,1,23,23,2226,4048,2178,-1870
2016,1,24,0,2278,4054,2193,-1861
2016,1,24,1,2266,4112,2193,-1919
2016,1,24,2,2326,4274,2184,-2090
2016,1,24,3,2340,4043,2056,-1987
2016,1,24,4,2353,3888,1905,-1983
2016,1,24,5,2204,3559,1804,-1755
2016,1,24,6,2183,3348,1660,-1688
2016,1,24,7,2327,3170,1899,-1271
2016,1,24,8,2166,2961,1754,-1207
2016,1,24,9,1518,2784,1686,-1098
2016,1,24,10,1529,2680,1701,-979
2016,1,24,11,1539,2609,1622,-987
2016,1,24,12,1542,2595,1605,-990
2016,1,24,13,1534,2664,1621,-1043
2016,1,24,14,1615,2816,1657,-1159
2016,1,24,15,1534,3042,1746,-1296
2016,1,24,16,1613,3329,1903,-1426
2016,1,24,17,2260,3538,1986,-1552
2016,1,24,18,2384,3873,2105,-1768
2016,1,24,19,2410,3870,2068,-1802
2016,1,24,20,2493,3786,2005,-1781
2016,1,24,21,2577,3859,1911,-1948
2016,1,24,22,2572,3768,1759,-2009
2016,1,24,23,2564,3737,1833,-1904
2016,1,25,0,2560,3728,1858,-1870
2016,1,25,1,2729,3928,2049,-1879
2016,1,25,2,2726,4292,2390,-1902
2016,1,25,3,2724,4406,2542,-1864
2016,1,25,4,2720,4354,2570,-1784
2016,1,25,5,2616,4216,2517,-1699
2016,1,25,6,2522,3995,2422,-1573
2016,1,25,7,2512,3664,2319,-1345
2016,1,25,8,2486,3265,2130,-1135
2016,1,25,9,1819,3265,2130,-9999
2016,1,25,10,1759,2680,1701,-9999
2016,1,25,11,1744,2609,1622,-9999
2016,1,25,12,1734,2595,1605,-9999
2016,1,25,13,1989,2664,1621,-9999
2016,1,25,14,2483,2816,1657,-9999
2016,1,25,15,2383,3042,1746,-9999
2016,1,25,16,2669,3329,1903,-9999
2016,1,25,17,2672,3538,1986,-9999
2016,1,25,18,2671,3873,2105,-9999
2016,1,25,19,2637,3870,2068,-9999
2016,1,25,20,2597,3786,2005,-9999
2016,1,25,21,2597,3859,1911,-9999
2016,1,25,22,2598,3768,1759,-9999
2016,1,25,23,2597,3737,1833,-9999
2016,1,26,0,2597,3728,1858,-9999
2016,1,26,1,2637,3928,2049,-9999
2016,1,26,2,2671,4292,2390,-9999
2016,1,26,3,2672,4406,2542,-9999
2016,1,26,4,2671,4354,2570,-9999
2016,1,26,5,2637,4216,2517,-9999
2016,1,26,6,2443,3995,2422,-9999
2016,1,26,7,2455,3664,2319,-9999
2016,1,26,8,2418,3265,2130,-9999
2016,1,26,9,2054,3135,2105,-1030
2016,1,26,10,2142,3075,1996,-1079
2016,1,26,11,2214,3065,1985,-1080
2016,1,26,12,2264,3092,2005,-1087
2016,1,26,13,2314,3265,2108,-1157
2016,1,26,14,2508,3656,2417,-1239
2016,1,26,15,2412,4039,2422,-1617
2016,1,26,16,2412,4263,2373,-1890
2016,1,26,17,2412,4256,2338,-1918
2016,1,26,18,2413,4160,2271,-1889
2016,1,26,19,2462,4105,2295,-1810
2016,1,26,20,2463,4053,2247,-1806
2016,1,26,21,2388,4006,2174,-1832
2016,1,26,22,2389,3910,2178,-1732
2016,1,26,23,2388,3842,2138,-1704
2016,1,27,0,2389,3864,2131,-1733
2016,1,27,1,2466,3994,2216,-1778
2016,1,27,2,2472,4229,2340,-1889
2016,1,27,3,2478,4265,2435,-1830
2016,1,27,4,2482,4209,2347,-1862
2016,1,27,5,2486,4067,2234,-1833
2016,1,27,6,2384,3817,2112,-1705
2016,1,27,7,2479,3542,2250,-1292
2016,1,27,8,2423,3216,2100,-1116
2016,1,27,9,1757,2883,1684,-1199
2016,1,27,10,1716,2827,1609,-1218
2016,1,27,11,1716,2792,1599,-1193
2016,1,27,12,1766,2825,1615,-1210
2016,1,27,13,1816,2988,1725,-1263
2016,1,27,14,1916,3367,1920,-1447
2016,1,27,15,1760,3759,1834,-1925
2016,1,27,16,2099,4075,1956,-2119
2016,1,27,17,2099,4053,1940,-2113
2016,1,27,18,1770,3934,1867,-2067
2016,1,27,19,1777,3895,1861,-2034
2016,1,27,20,1727,3840,1825,-2015
2016,1,27,21,1627,3729,1783,-1946
2016,1,27,22,1828,3671,1743,-1928
2016,1,27,23,1867,3622,1720,-1902
2016,1,28,0,1867,3691,1767,-1924
2016,1,28,1,2027,3963,1904,-2059
2016,1,28,2,2052,4261,2058,-2203
2016,1,28,3,2074,4277,2090,-2187
2016,1,28,4,2074,4193,2046,-2147
2016,1,28,5,1914,4025,1954,-2071
2016,1,28,6,1814,3825,2019,-1806
2016,1,28,7,2024,3537,2098,-1439
2016,1,28,8,1778,3262,1852,-1410
2016,1,28,9,1634,2926,1606,-1320
2016,1,28,10,1596,2788,1444,-1344
2016,1,28,11,1381,2752,1320,-1432
2016,1,28,12,1365,2759,1359,-1400
2016,1,28,13,1430,2912,1464,-1448
2016,1,28,14,1621,3210,1519,-1691
2016,1,28,15,1493,3643,1514,-2129
2016,1,28,16,1627,3878,1616,-2262
2016,1,28,17,1648,3910,1626,-2284
2016,1,28,18,1666,3842,1544,-2298
2016,1,28,19,1681,3840,1582,-2258
2016,1,28,20,1592,3749,1494,-2255
2016,1,28,21,1551,3639,1485,-2154
2016,1,28,22,1555,3474,1384,-2090
2016,1,28,23,1555,3441,1368,-2073
2016,1,29,0,1554,3501,1435,-2066
2016,1,29,1,1703,3740,1574,-2166
2016,1,29,2,1754,4082,1698,-2384
2016,1,29,3,1673,4187,1771,-2416
2016,1,29,4,1673,4144,1806,-2338
2016,1,29,5,1564,4025,1728,-2297
2016,1,29,6,1443,3785,1504,-2281
2016,1,29,7,1717,3652,1685,-1967
2016,1,29,8,1674,3246,1475,-1771
2016,1,29,9,1324,2969,1343,-1626
2016,1,29,10,1029,2713,1288,-1425
2016,1,29,11,1021,2723,1238,-1485
2016,1,29,12,1270,2945,1352,-1593
2016,1,29,13,1558,3313,1734,-1579
2016,1,29,14,1732,3555,1691,-1864
2016,1,29,15,1682,3852,1597,-2255
2016,1,29,16,1788,4270,1841,-2429
2016,1,29,17,1794,4319,1917,-2402
2016,1,29,18,1798,4308,1904,-2404
2016,1,29,19,1800,4318,1949,-2369
2016,1,29,20,1747,4253,1911,-2342
2016,1,29,21,1690,4143,1759,-2384
2016,1,29,22,1684,3846,1696,-2150
2016,1,29,23,1524,3711,1613,-2098
2016,1,30,0,1537,3591,1480,-2111
2016,1,30,1,1559,3720,1563,-2157
2016,1,30,2,1635,4015,1714,-2301
2016,1,30,3,1654,4030,1678,-2352
2016,1,30,4,1662,3969,1660,-2309
2016,1,30,5,1564,3861,1640,-2221
2016,1,30,6,1518,3700,1661,-2039
2016,1,30,7,1679,3455,1650,-1805
2016,1,30,8,1545,3134,1547,-1587
2016,1,30,9,1154,2938,1359,-1579
2016,1,30,10,1115,2843,1351,-1492
2016,1,30,11,1110,2842,1457,-1385
2016,1,30,12,1107,2865,1478,-1387
2016,1,30,13,1107,2958,1483,-1475
2016,1,30,14,1239,3054,1411,-1643
2016,1,30,15,1241,3241,1313,-1928
2016,1,30,16,1373,3572,1506,-2066
2016,1,30,17,1620,3902,1640,-2262
2016,1,30,18,1620,4115,1741,-2374
2016,1,30,19,1621,4092,1730,-2362
2016,1,30,20,1624,3989,1695,-2294
2016,1,30,21,1627,3821,1635,-2186
2016,1,30,22,1629,3583,1472,-2111
2016,1,30,23,1629,3544,1547,-1997
2016,1,31,0,1628,3589,1561,-2028
2016,1,31,1,1677,3845,1615,-2230
2016,1,31,2,1796,4300,1965,-2335
2016,1,31,3,1792,4296,1866,-2430
2016,1,31,4,1824,4241,1819,-2422
2016,1,31,5,1767,3956,1635,-2321
2016,1,31,6,1761,3766,1519,-2247
2016,1,31,7,1754,3526,1433,-2093
2016,1,31,8,1749,3286,1353,-1933
2016,1,31,9,1337,3158,1362,-1796
2016,1,31,10,1235,3020,1231,-1789
2016,1,31,11,1172,2913,1139,-1774
2016,1,31,12,1172,2924,1115,-1809
2016,1,31,13,1227,3022,1235,-1787
2016,1,31,14,1411,3151,1387,-1764
2016,1,31,15,1560,3369,1531,-1838
2016,1,31,16,1699,3816,1997,-1819
2016,1,31,17,2101,4116,2157,-1959
2016,1,31,18,2132,4249,2198,-2051
2016,1,31,19,2175,4263,2171,-2092
2016,1,31,20,2177,4259,2168,-2091
2016,1,31,21,2137,4182,2142,-2040
2016,1,31,22,2147,4139,2102,-2037
2016,1,31,23,2156,4108,2221,-1887
2016,2,1,0,2170,4118,2273,-1845
2016,2,1,1,2245,4233,2323,-1910
2016,2,1,2,2318,4492,2418,-2074
2016,2,1,3,2340,4544,2477,-2067
2016,2,1,4,2354,4475,2446,-2029
2016,2,1,5,2329,4326,2364,-1962
2016,2,1,6,2257,4070,2301,-1769
2016,2,1,7,2259,3745,2188,-1557
2016,2,1,8,2052,3322,1962,-1360
2016,2,1,9,1881,3201,1954,-1247
2016,2,1,10,1673,3143,1852,-1291
2016,2,1,11,1634,3140,1789,-1351
2016,2,1,12,1725,3216,1866,-1350
2016,2,1,13,1920,3500,2053,-1447
2016,2,1,14,2348,3864,2253,-1611
2016,2,1,15,2384,4330,2361,-1969
2016,2,1,16,2478,4606,2574,-2032
2016,2,1,17,2469,4572,2467,-2105
2016,2,1,18,2462,4474,2270,-2204
2016,2,1,19,2288,4418,2366,-2052
2016,2,1,20,2270,4375,2322,-2053
2016,2,1,21,2232,4310,2322,-1988
2016,2,1,22,2251,4184,2150,-2034
2016,2,1,23,2269,4128,2099,-2029
2016,2,2,0,2281,4125,2116,-2009
2016,2,2,1,2382,4344,2336,-2008
2016,2,2,2,2576,4670,2626,-2044
2016,2,2,3,2560,4734,2738,-1996
2016,2,2,4,2548,4628,2727,-1901
2016,2,2,5,2439,4421,2467,-1954
2016,2,2,6,2333,4131,2188,-1943
2016,2,2,7,2332,3818,2082,-1736
2016,2,2,8,2234,3388,1815,-1573
2016,2,2,9,1746,3246,1825,-1421
2016,2,2,10,1730,3183,1795,-1388
2016,2,2,11,1716,3178,1814,-1364
2016,2,2,12,1915,3240,2045,-1195
2016,2,2,13,2083,3550,2210,-1340
2016,2,2,14,2517,3957,2479,-1478
2016,2,2,15,2511,4462,2676,-1786
2016,2,2,16,2660,4741,2852,-1889
2016,2,2,17,2660,4661,2823,-1838
2016,2,2,18,2586,4488,2686,-1802
2016,2,2,19,2389,4331,2536,-1795
2016,2,2,20,2289,4179,2244,-1935
2016,2,2,21,2289,4084,2212,-1872
2016,2,2,22,2290,4023,2181,-1842
2016,2,2,23,2289,3983,2158,-1825
2016,2,3,0,2289,4025,2214,-1811
2016,2,3,1,2340,4172,2338,-1834
2016,2,3,2,2661,4522,2676,-1846
2016,2,3,3,2661,4633,2730,-1903
2016,2,3,4,2661,4560,2713,-1847
2016,2,3,5,2604,4456,2600,-1856
2016,2,3,6,2340,4185,2387,-1798
2016,2,3,7,2390,3857,2412,-1445
2016,2,3,8,2340,3580,2368,-1212
2016,2,3,9,2010,3370,2080,-1290
2016,2,3,10,1796,3290,1998,-1292
2016,2,3,11,1796,3264,1976,-1288
2016,2,3,12,1796,3310,2026,-1284
2016,2,3,13,2191,3484,2191,-1293
2016,2,3,14,2562,3848,2475,-1373
2016,2,3,15,2412,4254,2465,-1789
2016,2,3,16,2638,4530,2569,-1961
2016,2,3,17,2638,4493,2531,-1962
2016,2,3,18,2533,4404,2401,-2003
2016,2,3,19,2492,4332,2387,-1945
2016,2,3,20,2373,4276,2319,-1957
2016,2,3,21,2356,4117,2284,-1833
2016,2,3,22,2302,4100,2288,-1812
2016,2,3,23,2295,4124,2312,-1812
2016,2,4,0,2295,4205,2393,-1812
2016,2,4,1,2395,4499,2558,-1941
2016,2,4,2,2662,4702,2733,-1969
2016,2,4,3,2663,4696,2654,-2042
2016,2,4,4,2666,4575,2505,-2070
2016,2,4,5,2625,4422,2423,-1999
2016,2,4,6,2393,4129,2235,-1894
2016,2,4,7,2512,3827,2403,-1424
2016,2,4,8,2411,3514,2140,-1374
2016,2,4,9,1733,3212,2053,-1159
2016,2,4,10,1699,3134,1937,-1197
2016,2,4,11,1689,3109,1902,-1207
2016,2,4,12,1673,3132,1974,-1158
2016,2,4,13,1863,3426,2179,-1247
2016,2,4,14,2148,3809,2452,-1357
2016,2,4,15,2316,4170,2339,-1831
2016,2,4,16,2435,4463,2592,-1871
2016,2,4,17,2499,4374,2574,-1800
2016,2,4,18,2500,4252,2462,-1790
2016,2,4,19,2446,4182,2357,-1825
2016,2,4,20,2445,4128,2256,-1872
2016,2,4,21,2345,4134,2380,-1754
2016,2,4,22,2345,4061,2353,-1708
2016,2,4,23,2443,4008,2287,-1721
2016,2,5,0,2492,4075,2351,-1724
2016,2,5,1,2593,4196,2474,-1722
2016,2,5,2,2880,4485,2792,-1693
2016,2,5,3,2860,4527,2883,-1644
2016,2,5,4,2830,4436,2830,-1606
2016,2,5,5,2598,4316,2723,-1593
2016,2,5,6,2455,4081,2622,-1459
2016,2,5,7,2462,3729,2496,-1233
2016,2,5,8,2392,3426,2398,-1028
2016,2,5,9,2093,3216,2187,-1029
2016,2,5,10,2078,3121,2081,-1040
2016,2,5,11,2065,3111,2186,-925
2016,2,5,12,2120,3164,2267,-897
2016,2,5,13,2364,3354,2434,-920
2016,2,5,14,2470,3689,2475,-1214
2016,2,5,15,2465,4140,2640,-1500
2016,2,5,16,2614,4416,2729,-1687
2016,2,5,17,2613,4378,2709,-1669
2016,2,5,18,2515,4273,2534,-1739
2016,2,5,19,2495,4183,2545,-1638
2016,2,5,20,2445,4100,2494,-1606
2016,2,5,21,2447,4055,2457,-1598
2016,2,5,22,2349,3975,2452,-1523
2016,2,5,23,2301,3921,2358,-1563
2016,2,6,0,2307,3935,2396,-1539
2016,2,6,1,2318,4060,2409,-1651
2016,2,6,2,2553,4332,2620,-1712
2016,2,6,3,2529,4345,2552,-1793
2016,2,6,4,2416,4244,2511,-1733
2016,2,6,5,2360,3973,2330,-1643
2016,2,6,6,2236,3740,2110,-1630
2016,2,6,7,2460,3578,2226,-1352
2016,2,6,8,2254,3329,1997,-1332
2016,2,6,9,1698,3070,1781,-1289
2016,2,6,10,1708,2989,1849,-1140
2016,2,6,11,1719,2972,1888,-1084
2016,2,6,12,1730,2927,1818,-1109
2016,2,6,13,1729,3018,1908,-1110
2016,2,6,14,1721,3147,1886,-1261
2016,2,6,15,1701,3316,1778,-1538
2016,2,6,16,1896,3578,1818,-1760
2016,2,6,17,2000,3678,1763,-1915
2016,2,6,18,2175,3759,1906,-1853
2016,2,6,19,2163,4061,2151,-1910
2016,2,6,20,2159,4003,2094,-1909
2016,2,6,21,2158,3797,1959,-1838
2016,2,6,22,2107,3723,1811,-1912
2016,2,6,23,2102,3664,1827,-1837
2016,2,7,0,2148,3664,1860,-1804
2016,2,7,1,2308,3850,2043,-1807
2016,2,7,2,2551,4111,2466,-1645
2016,2,7,3,2550,4258,2723,-1535
2016,2,7,4,2536,4225,2690,-1535
2016,2,7,5,2465,4135,2644,-1491
2016,2,7,6,2242,4023,2657,-1366
2016,2,7,7,2466,3835,2689,-1146
2016,2,7,8,2281,3610,2577,-1033
2016,2,7,9,1995,3382,2130,-1252
2016,2,7,10,1834,3191,2035,-1156
2016,2,7,11,1834,3155,1975,-1180
2016,2,7,12,1834,3162,1970,-1192
2016,2,7,13,1833,3234,2026,-1208
2016,2,7,14,1993,3527,2159,-1368
2016,2,7,15,2014,3722,2172,-1550
2016,2,7,16,2068,3949,2368,-1581
2016,2,7,17,2068,4165,2466,-1699
2016,2,7,18,2590,4261,2599,-1662
2016,2,7,19,2690,4221,2587,-1634
2016,2,7,20,2690,4070,2415,-1655
2016,2,7,21,2690,4030,2330,-1700
2016,2,7,22,2683,3827,2320,-1507
2016,2,7,23,2661,3714,2254,-1460
2016,2,8,0,2295,3641,2215,-1426
2016,2,8,1,2278,3656,2215,-1441
2016,2,8,2,2273,4003,2409,-1594
2016,2,8,3,2268,4110,2483,-1627
2016,2,8,4,2415,4109,2482,-1627
2016,2,8,5,2415,4182,2559,-1623
2016,2,8,6,2198,3946,2408,-1538
2016,2,8,7,2148,3648,2330,-1318
2016,2,8,8,1994,3352,2067,-1285
2016,2,8,9,1827,3123,1881,-1242
2016,2,8,10,1828,3066,1832,-1234
2016,2,8,11,1828,3071,1834,-1237
2016,2,8,12,1828,3158,1901,-1257
2016,2,8,13,1907,3435,2111,-1324
2016,2,8,14,2318,3873,2464,-1409
2016,2,8,15,2414,4359,2723,-1636
2016,2,8,16,2690,4610,2893,-1717
2016,2,8,17,2690,4522,2695,-1827
2016,2,8,18,2682,4328,2586,-1742
2016,2,8,19,2464,4164,2512,-1652
2016,2,8,20,2395,4002,2392,-1610
2016,2,8,21,2203,3896,2285,-1611
2016,2,8,22,2199,3763,2185,-1578
2016,2,8,23,2193,3689,2135,-1554
2016,2,9,0,2193,3661,2116,-1545
2016,2,9,1,2194,3741,2125,-1616
2016,2,9,2,2411,4055,2288,-1767
2016,2,9,3,2412,4300,2500,-1800
2016,2,9,4,2413,4239,2545,-1694
2016,2,9,5,2413,4136,2456,-1680
2016,2,9,6,2217,3916,2299,-1617
2016,2,9,7,2367,3638,2268,-1370
2016,2,9,8,2273,3367,2044,-1323
2016,2,9,9,2050,3217,2131,-1086
2016,2,9,10,2052,3148,2080,-1068
2016,2,9,11,2053,3152,2082,-1070
2016,2,9,12,2053,3201,2130,-1071
2016,2,9,13,2272,3378,2301,-1077
2016,2,9,14,2619,3767,2541,-1226
2016,2,9,15,2567,4216,2632,-1584
2016,2,9,16,2843,4482,2874,-1608
2016,2,9,17,2841,4410,2816,-1594
2016,2,9,18,2610,4283,2716,-1567
2016,2,9,19,2370,4152,2550,-1602
2016,2,9,20,2202,3997,2395,-1602
2016,2,9,21,2082,3860,2277,-1583
2016,2,9,22,2082,3766,2194,-1572
2016,2,9,23,2082,3666,2118,-1548
2016,2,10,0,2179,3658,2119,-1539
2016,2,10,1,2196,3781,2208,-1573
2016,2,10,2,2582,4101,2492,-1609
2016,2,10,3,2632,4223,2616,-1607
2016,2,10,4,2532,4155,2549,-1606
2016,2,10,5,2532,4039,2441,-1598
2016,2,10,6,2367,3830,2258,-1572
2016,2,10,7,2517,3553,2384,-1169
2016,2,10,8,2270,3282,2183,-1099
2016,2,10,9,2211,3142,2186,-956
2016,2,10,10,2211,3085,2146,-939
2016,2,10,11,2211,3071,2129,-942
2016,2,10,12,2371,3127,2174,-953
2016,2,10,13,2371,3270,2196,-1074
2016,2,10,14,2600,3589,2316,-1273
2016,2,10,15,2600,4003,2410,-1593
2016,2,10,16,2700,4250,2635,-1615
2016,2,10,17,2700,4190,2626,-1564
2016,2,10,18,2440,4152,2638,-1514
2016,2,10,19,2362,4147,2653,-1494
2016,2,10,20,2362,4125,2667,-1458
2016,2,10,21,2364,4047,2520,-1527
2016,2,10,22,2367,3943,2409,-1534
2016,2,10,23,2367,3887,2373,-1514
2016,2,11,0,2368,3899,2384,-1515
2016,2,11,1,2440,3978,2427,-1551
2016,2,11,2,2708,4208,2628,-1580
2016,2,11,3,2710,4283,2767,-1516
2016,2,11,4,2712,4198,2622,-1576
2016,2,11,5,2563,4075,2424,-1651
2016,2,11,6,2562,3859,2339,-1520
2016,2,11,7,2499,3577,2211,-1366
2016,2,11,8,2316,3343,2188,-1155
2016,2,11,9,1752,3158,1897,-1261
2016,2,11,10,1728,3091,1840,-1251
2016,2,11,11,1700,3062,1831,-1231
2016,2,11,12,1727,3107,1887,-1220
2016,2,11,13,1811,3256,1919,-1337
2016,2,11,14,1974,3562,1989,-1573
2016,2,11,15,1975,3960,2103,-1857
2016,2,11,16,2076,4191,2164,-2027
2016,2,11,17,2077,4118,2048,-2070
2016,2,11,18,2028,4074,2057,-2017
2016,2,11,19,2030,4035,2035,-2000
2016,2,11,20,1832,3966,2000,-1966
2016,2,11,21,1832,3922,1960,-1962
2016,2,11,22,1833,3869,1922,-1947
2016,2,11,23,1829,3863,1910,-1953
2016,2,12,0,1825,3877,1909,-1968
2016,2,12,1,2023,3985,1962,-2023
2016,2,12,2,2072,4206,2101,-2105
2016,2,12,3,2071,4243,2151,-2092
2016,2,12,4,2070,4122,2106,-2016
2016,2,12,5,1920,3981,2082,-1899
2016,2,12,6,1920,3740,1908,-1832
2016,2,12,7,2020,3520,2024,-1496
2016,2,12,8,1970,3290,2107,-1183
2016,2,12,9,1876,3096,1961,-1135
2016,2,12,10,1818,2966,1898,-1068
2016,2,12,11,1818,2911,1849,-1062
2016,2,12,12,1818,2919,1845,-1074
2016,2,12,13,1867,2990,1737,-1253
2016,2,12,14,1967,3245,1649,-1596
2016,2,12,15,1868,3639,1713,-1926
2016,2,12,16,2019,3915,1963,-1952
2016,2,12,17,2021,3933,1968,-1965
2016,2,12,18,1973,3936,1955,-1981
2016,2,12,19,1915,3989,2030,-1959
2016,2,12,20,1752,3914,1994,-1920
2016,2,12,21,1663,3813,1916,-1897
2016,2,12,22,1561,3673,1852,-1821
2016,2,12,23,1572,3630,1783,-1847
2016,2,13,0,1580,3614,1721,-1893
2016,2,13,1,1680,3686,1737,-1949
2016,2,13,2,1683,3895,1803,-2092
2016,2,13,3,1725,4018,1850,-2168
2016,2,13,4,1736,3983,1911,-2072
2016,2,13,5,1642,3866,1843,-2023
2016,2,13,6,1652,3706,1798,-1908
2016,2,13,7,1765,3535,1939,-1596
2016,2,13,8,1676,3274,1724,-1550
2016,2,13,9,1537,3050,1696,-1354
2016,2,13,10,1477,2998,1752,-1246
2016,2,13,11,1367,2855,1665,-1190
2016,2,13,12,1377,2873,1705,-1168
2016,2,13,13,1473,2897,1641,-1256
2016,2,13,14,1501,3080,1765,-1315
2016,2,13,15,1482,3079,1469,-1610
2016,2,13,16,1652,3330,1555,-1775
2016,2,13,17,1825,3704,1803,-1901
2016,2,13,18,1833,3959,1918,-2041
2016,2,13,19,1882,4032,1952,-2080
2016,2,13,20,1875,4037,1995,-2042
2016,2,13,21,1857,3924,1799,-2125
2016,2,13,22,1778,3939,1816,-2123
2016,2,13,23,1743,3922,1813,-2109
2016,2,14,0,1812,3975,1930,-2045
2016,2,14,1,1801,4049,2084,-1965
2016,2,14,2,1883,4173,2092,-2081
2016,2,14,3,1864,4191,2087,-2104
2016,2,14,4,1847,4098,2056,-2042
2016,2,14,5,1835,3952,1928,-2024
2016,2,14,6,1738,3783,1882,-1901
2016,2,14,7,1857,3473,1780,-1693
2016,2,14,8,1816,3190,1753,-1437
2016,2,14,9,1242,2989,1676,-1313
2016,2,14,10,1123,2721,1532,-1189
2016,2,14,11,1055,2574,1440,-1134
2016,2,14,12,1069,2565,1451,-1114
2016,2,14,13,1068,2588,1430,-1158
2016,2,14,14,1055,2700,1492,-1208
2016,2,14,15,1294,2867,1457,-1410
2016,2,14,16,1537,3355,1793,-1562
2016,2,14,17,1515,3553,1763,-1790
2016,2,14,18,1657,3692,1819,-1873
2016,2,14,19,1765,3727,1834,-1893
2016,2,14,20,1670,3732,1871,-1861
2016,2,14,21,1703,3725,1885,-1840
2016,2,14,22,1730,3665,1900,-1765
2016,2,14,23,1750,3595,1805,-1790
2016,2,15,0,1764,3610,1842,-1768
2016,2,15,1,1886,3685,1893,-1792
2016,2,15,2,1889,3799,1828,-1971
2016,2,15,3,1890,3842,1859,-1983
2016,2,15,4,1887,3754,1839,-1915
2016,2,15,5,1877,3650,1835,-1815
2016,2,15,6,1753,3466,1756,-1710
2016,2,15,7,1696,3279,1819,-1460
2016,2,15,8,1508,2953,1595,-1358
2016,2,15,9,1357,2797,1614,-1183
2016,2,15,10,1458,2791,1585,-1206
2016,2,15,11,1457,2735,1536,-1199
2016,2,15,12,1459,2775,1572,-1203
2016,2,15,13,1662,2898,1602,-1296
2016,2,15,14,1764,3098,1637,-1461
2016,2,15,15,1568,3301,1439,-1862
2016,2,15,16,1768,3471,1320,-2151
2016,2,15,17,1760,3623,1472,-2151
2016,2,15,18,1752,3781,1563,-2218
2016,2,15,19,1643,3858,1604,-2254
2016,2,15,20,1633,3878,1546,-2332
2016,2,15,21,1580,3911,1598,-2313
2016,2,15,22,1575,3848,1529,-2319
2016,2,15,23,1620,3848,1618,-2230
2016,2,16,0,1618,3839,1633,-2206
2016,2,16,1,1722,3860,1526,-2334
2016,2,16,2,1730,4054,1549,-2505
2016,2,16,3,1740,4108,1563,-2545
2016,2,16,4,1745,3945,1448,-2497
2016,2,16,5,1646,3783,1497,-2286
2016,2,16,6,1647,3604,1598,-2006
2016,2,16,7,1750,3312,1599,-1713
2016,2,16,8,1656,3138,1788,-1350
2016,2,16,9,1364,2926,1673,-1253
2016,2,16,10,1360,2808,1636,-1172
2016,2,16,11,1360,2769,1606,-1163
2016,2,16,12,1387,2797,1614,-1183
2016,2,16,13,1481,2910,1599,-1311
2016,2,16,14,1767,3210,1682,-1528
2016,2,16,15,1594,3569,1741,-1828
2016,2,16,16,1854,3706,1644,-2062
2016,2,16,17,1699,3789,1684,-2105
2016,2,16,18,1699,3790,1730,-2060
2016,2,16,19,1849,3725,1625,-2100
2016,2,16,20,1754,3607,1564,-2043
2016,2,16,21,1818,3507,1514,-1993
2016,2,16,22,1851,3486,1558,-1928
2016,2,16,23,1830,3450,1550,-1900
2016,2,17,0,1812,3494,1623,-1871
2016,2,17,1,1796,3570,1630,-1940
2016,2,17,2,2071,3898,1919,-1979
2016,2,17,3,2050,4040,2031,-2009
2016,2,17,4,2035,3978,2027,-1951
2016,2,17,5,2016,3866,2033,-1833
2016,2,17,6,1795,3654,2001,-1653
2016,2,17,7,1876,3360,1979,-1381
2016,2,17,8,1766,3117,1965,-1152
2016,2,17,9,1543,3117,1965,-9999
2016,2,17,10,1532,2808,1636,-9999
2016,2,17,11,1539,2769,1606,-9999
2016,2,17,12,1571,2797,1614,-9999
2016,2,17,13,1733,2910,1599,-9999
2016,2,17,14,1993,3210,1682,-9999
2016,2,17,15,1806,3569,1741,-9999
2016,2,17,16,2030,3706,1644,-9999
2016,2,17,17,2046,3789,1684,-9999
2016,2,17,18,2065,3790,1730,-9999
2016,2,17,19,1906,3725,1625,-9999
2016,2,17,20,1666,3607,1564,-9999
2016,2,17,21,1619,3507,1514,-9999
2016,2,17,22,1538,3486,1558,-9999
2016,2,17,23,1525,3450,1550,-9999
2016,2,18,0,1518,3494,1623,-9999
2016,2,18,1,1764,3570,1630,-9999
2016,2,18,2,1908,3898,1919,-9999
2016,2,18,3,1948,4040,2031,-9999
2016,2,18,4,1941,3978,2027,-9999
2016,2,18,5,1886,3866,2033,-9999
2016,2,18,6,1859,3654,2001,-9999
2016,2,18,7,1907,3360,1979,-9999
2016,2,18,8,1944,3117,1965,-9999
2016,2,18,9,1567,3044,1586,-1458
2016,2,18,10,1498,2897,1453,-1444
2016,2,18,11,1479,2824,1313,-1511
2016,2,18,12,1492,2850,1341,-1509
2016,2,18,13,1493,2984,1430,-1554
2016,2,18,14,1796,3362,1503,-1859
2016,2,18,15,1733,3773,1633,-2140
2016,2,18,16,1871,4058,1879,-2179
2016,2,18,17,1848,4006,1739,-2267
2016,2,18,18,1852,3887,1700,-2187
2016,2,18,19,1662,3817,1656,-2161
2016,2,18,20,1521,3779,1591,-2188
2016,2,18,21,1534,3658,1578,-2080
2016,2,18,22,1547,3698,1642,-2056
2016,2,18,23,1579,3766,1915,-1851
2016,2,19,0,1613,3786,1879,-1907
2016,2,19,1,1791,3904,1972,-1932
2016,2,19,2,1956,4133,1792,-2341
2016,2,19,3,2000,4360,2137,-2223
2016,2,19,4,1996,4196,1899,-2297
2016,2,19,5,1839,4113,1868,-2245
2016,2,19,6,1829,3965,1890,-2075
2016,2,19,7,1915,3645,1813,-1832
2016,2,19,8,1760,3361,1725,-1636
2016,2,19,9,1323,3033,1447,-1586
2016,2,19,10,1300,2973,1454,-1519
2016,2,19,11,1281,2932,1508,-1424
2016,2,19,12,1315,2977,1554,-1423
2016,2,19,13,1777,3280,1816,-1464
2016,2,19,14,1931,3582,1859,-1723
2016,2,19,15,1890,3873,1668,-2205
2016,2,19,16,1837,4143,1813,-2330
2016,2,19,17,1882,4161,1811,-2350
2016,2,19,18,1882,4128,1774,-2354
2016,2,19,19,1877,4133,1820,-2313
2016,2,19,20,1765,4087,1801,-2286
2016,2,19,21,1738,4093,1808,-2285
2016,2,19,22,1647,4097,1811,-2286
2016,2,19,23,1732,4071,1764,-2307
2016,2,20,0,1532,4028,1520,-2508
2016,2,20,1,1652,4190,1827,-2363
2016,2,20,2,1612,4242,1560,-2682
2016,2,20,3,1612,4338,1682,-2656
2016,2,20,4,1669,4268,1742,-2526
2016,2,20,5,1572,4155,1788,-2367
2016,2,20,6,1538,3961,1696,-2265
2016,2,20,7,1686,3738,1762,-1976
2016,2,20,8,1384,3432,1772,-1660
2016,2,20,9,1333,3237,1650,-1587
2016,2,20,10,1216,3127,1578,-1549
2016,2,20,11,1197,3100,1595,-1505
2016,2,20,12,1178,3110,1597,-1513
2016,2,20,13,1162,3191,1598,-1593
2016,2,20,14,1453,3494,1745,-1749
2016,2,20,15,1231,3701,1730,-1971
2016,2,20,16,1298,3608,1371,-2237
2016,2,20,17,1376,3775,1376,-2399
2016,2,20,18,1360,4064,1536,-2528
2016,2,20,19,1452,3951,1434,-2517
2016,2,20,20,1451,3551,1122,-2429
2016,2,20,21,1372,3401,1034,-2367
2016,2,20,22,1359,3201,957,-2244
2016,2,20,23,1348,3155,959,-2196
2016,2,21,0,1440,3161,1126,-2035
2016,2,21,1,1596,3446,1364,-2082
2016,2,21,2,1722,3788,1637,-2151
2016,2,21,3,1746,4118,1856,-2262
2016,2,21,4,1741,4105,1767,-2338
2016,2,21,5,1782,4054,1745,-2309
2016,2,21,6,1876,3938,1875,-2063
2016,2,21,7,1961,3776,1937,-1839
2016,2,21,8,1962,3550,1872,-1678
2016,2,21,9,1809,3386,2031,-1355
2016,2,21,10,1686,3242,2036,-1206
2016,2,21,11,1760,3228,2057,-1171
2016,2,21,12,1793,3228,2050,-1178
2016,2,21,13,1844,3329,1980,-1349
2016,2,21,14,1900,3469,2069,-1400
2016,2,21,15,1899,3658,2093,-1565
2016,2,21,16,1972,3862,2132,-1730
2016,2,21,17,2019,4046,2116,-1930
2016,2,21,18,2115,4138,2139,-1999
2016,2,21,19,2111,4113,2061,-2052
2016,2,21,20,2109,4115,2131,-1984
2016,2,21,21,2108,4117,2188,-1929
2016,2,21,22,1964,3995,2092,-1903
2016,2,21,23,1979,3911,2058,-1853
2016,2,22,0,2002,3877,2057,-1820
2016,2,22,1,2034,3889,2025,-1864
2016,2,22,2,2067,4036,2049,-1987
2016,2,22,3,2044,4243,2289,-1954
2016,2,22,4,2076,4167,2260,-1907
2016,2,22,5,2097,4039,2100,-1939
2016,2,22,6,1888,3827,1983,-1844
2016,2,22,7,1992,3549,1931,-1618
2016,2,22,8,1739,3207,1708,-1499
2016,2,22,9,1762,3046,1617,-1429
2016,2,22,10,1623,2910,1564,-1346
2016,2,22,11,1615,2916,1628,-1288
2016,2,22,12,1681,3011,1588,-1423
2016,2,22,13,1667,3227,1743,-1484
2016,2,22,14,1975,3582,1934,-1648
2016,2,22,15,1886,4030,2087,-1943
2016,2,22,16,2122,4316,2256,-2060
2016,2,22,17,2120,4256,2221,-2035
2016,2,22,18,2118,4154,2102,-2052
2016,2,22,19,1825,4054,1999,-2055
2016,2,22,20,1766,3961,1890,-2071
2016,2,22,21,1746,3914,1874,-2040
2016,2,22,22,1720,3825,1870,-1955
2016,2,22,23,1689,3731,1884,-1847
2016,2,23,0,1671,3712,1908,-1804
2016,2,23,1,1971,3790,2035,-1755
2016,2,23,2,2253,4030,2347,-1683
2016,2,23,3,2256,4296,2516,-1780
2016,2,23,4,2249,4306,2589,-1717
2016,2,23,5,2232,4210,2531,-1679
2016,2,23,6,2060,3985,2319,-1666
2016,2,23,7,2093,3701,2297,-1404
2016,2,23,8,2078,3440,2269,-1171
2016,2,23,9,2033,3290,2124,-1166
2016,2,23,10,2029,3204,2027,-1177
2016,2,23,11,2025,3205,2010,-1195
2016,2,23,12,2026,3298,2065,-1233
2016,2,23,13,2362,3486,2076,-1410
2016,2,23,14,2443,3840,2262,-1578
2016,2,23,15,2449,4329,2346,-1983
2016,2,23,16,2454,4559,2542,-2017
2016,2,23,17,2457,4437,2439,-1998
2016,2,23,18,2359,4219,2256,-1963
2016,2,23,19,2119,4041,2075,-1966
2016,2,23,20,1969,3891,2017,-1874
2016,2,23,21,1825,3739,1808,-1931
2016,2,23,22,1825,3641,1785,-1856
2016,2,23,23,1827,3592,1856,-1736
2016,2,24,0,1822,3626,1959,-1667
2016,2,24,1,1914,3715,2006,-1709
2016,2,24,2,2192,3961,2011,-1950
2016,2,24,3,2238,4182,2189,-1993
2016,2,24,4,2238,4162,2285,-1877
2016,2,24,5,2231,4043,2293,-1750
2016,2,24,6,2162,3823,2254,-1569
2016,2,24,7,2243,3520,2249,-1271
2016,2,24,8,2144,3253,2202,-1051
2016,2,24,9,2116,3113,2186,-927
2016,2,24,10,2052,3058,2195,-863
2016,2,24,11,2047,3094,2217,-877
2016,2,24,12,2050,3096,2228,-868
2016,2,24,13,2232,3316,2275,-1041
2016,2,24,14,2514,3669,2433,-1236
2016,2,24,15,2393,4099,2572,-1527
2016,2,24,16,2543,4284,2566,-1718
2016,2,24,17,2592,4259,2468,-1791
2016,2,24,18,2395,4168,2387,-1781
2016,2,24,19,2374,4024,2284,-1740
2016,2,24,20,2224,3885,2124,-1761
2016,2,24,21,2174,3810,2058,-1752
2016,2,24,22,2124,3736,2069,-1667
2016,2,24,23,2113,3679,2047,-1632
2016,2,25,0,2174,3683,2038,-1645
2016,2,25,1,2174,3749,2007,-1742
2016,2,25,2,2392,3952,2144,-1808
2016,2,25,3,2492,4167,2369,-1798
2016,2,25,4,2492,4144,2376,-1768
2016,2,25,5,2486,4039,2386,-1653
2016,2,25,6,2321,3843,2326,-1517
2016,2,25,7,2457,3561,2301,-1260
2016,2,25,8,2325,3306,2237,-1069
2016,2,25,9,2036,3306,2237,-9999
2016,2,25,10,1985,3058,2195,-9999
2016,2,25,11,1980,3094,2217,-9999
2016,2,25,12,2030,3096,2228,-9999
2016,2,25,13,2164,3316,2275,-9999
2016,2,25,14,2536,3669,2433,-9999
2016,2,25,15,2461,4099,2572,-9999
2016,2,25,16,2576,4284,2566,-9999
2016,2,25,17,2576,4259,2468,-9999
2016,2,25,18,2479,4168,2387,-9999
2016,2,25,19,2464,4024,2284,-9999
2016,2,25,20,2255,3885,2124,-9999
2016,2,25,21,2155,3810,2058,-9999
2016,2,25,22,2105,3736,2069,-9999
2016,2,25,23,2105,3679,2047,-9999
2016,2,26,0,2105,3683,2038,-9999
2016,2,26,1,2205,3749,2007,-9999
2016,2,26,2,2364,3952,2144,-9999
2016,2,26,3,2461,4167,2369,-9999
2016,2,26,4,2476,4144,2376,-9999
2016,2,26,5,2470,4039,2386,-9999
2016,2,26,6,2196,3843,2326,-9999
2016,2,26,7,2382,3561,2301,-9999
2016,2,26,8,2219,3306,2237,-9999
2016,2,26,9,1749,3096,1798,-1298
2016,2,26,10,1748,3038,1735,-1303
2016,2,26,11,1743,3018,1698,-1320
2016,2,26,12,1743,3068,1737,-1331
2016,2,26,13,1943,3278,1878,-1400
2016,2,26,14,2078,3621,2046,-1575
2016,2,26,15,2078,4023,2081,-1942
2016,2,26,16,2173,4219,2236,-1983
2016,2,26,17,2174,4115,2135,-1980
2016,2,26,18,1917,4007,2079,-1928
2016,2,26,19,1797,3911,1907,-2004
2016,2,26,20,1797,3810,1881,-1929
2016,2,26,21,1797,3765,1859,-1906
2016,2,26,22,1798,3730,1843,-1887
2016,2,26,23,1798,3722,1827,-1895
2016,2,27,0,1799,3762,1864,-1898
2016,2,27,1,1799,3878,1889,-1989
2016,2,27,2,1798,4039,1961,-2078
2016,2,27,3,2044,4092,2047,-2045
2016,2,27,4,2048,3982,2023,-1959
2016,2,27,5,2046,3864,1965,-1899
2016,2,27,6,2037,3592,1366,-2226
2016,2,27,7,2028,3481,1705,-1776
2016,2,27,8,1924,3287,1754,-1533
2016,2,27,9,1606,3114,1742,-1372
2016,2,27,10,1528,2975,1613,-1362
2016,2,27,11,1381,2916,1517,-1399
2016,2,27,12,1311,2900,1461,-1439
2016,2,27,13,1354,2964,1496,-1468
2016,2,27,14,1374,3058,1548,-1510
2016,2,27,15,1022,3009,1337,-1672
2016,2,27,16,1108,3211,1343,-1868
2016,2,27,17,1128,3476,1485,-1991
2016,2,27,18,1483,3783,1610,-2173
2016,2,27,19,1532,3789,1613,-2176
2016,2,27,20,1532,3732,1579,-2153
2016,2,27,21,1533,3593,1497,-2096
2016,2,27,22,1405,3455,1458,-1997
2016,2,27,23,1324,3326,1424,-1902
2016,2,28,0,1319,3315,1417,-1898
2016,2,28,1,1520,3500,1566,-1934
2016,2,28,2,1622,3695,1600,-2095
2016,2,28,3,1747,3869,1665,-2204
2016,2,28,4,1722,3871,1716,-2155
2016,2,28,5,1684,3803,1671,-2132
2016,2,28,6,1642,3623,1462,-2161
2016,2,28,7,1604,3464,1515,-1949
2016,2,28,8,1571,3289,1572,-1717
2016,2,28,9,1495,3138,1546,-1592
2016,2,28,10,1332,3048,1475,-1573
2016,2,28,11,1312,2996,1439,-1557
2016,2,28,12,1300,2964,1379,-1585
2016,2,28,13,1290,3028,1398,-1630
2016,2,28,14,1427,3139,1432,-1707
2016,2,28,15,1427,3118,1094,-2024
2016,2,28,16,1429,3361,1282,-2079
2016,2,28,17,1430,3579,1327,-2252
2016,2,28,18,1437,3856,1530,-2326
2016,2,28,19,1457,3880,1630,-2250
2016,2,28,20,1498,3870,1698,-2172
2016,2,28,21,1447,3855,1637,-2218
2016,2,28,22,1493,3675,1476,-2199
2016,2,28,23,1354,3651,1546,-2105
2016,2,29,0,1370,3650,1419,-2231
2016,2,29,1,1380,3756,1485,-2271
2016,2,29,2,1385,3922,1541,-2381
2016,2,29,3,1562,4098,1557,-2541
2016,2,29,4,1562,4090,1633,-2457
2016,2,29,5,1567,3953,1555,-2398
2016,2,29,6,1573,3575,1329,-2246
2016,2,29,7,1380,3247,1262,-1985
2016,2,29,8,1434,2945,1218,-1727
2016,2,29,9,993,2769,1215,-1554
2016,2,29,10,940,2680,1162,-1518
2016,2,29,11,942,2682,1180,-1502
2016,2,29,12,978,2745,1291,-1454
2016,2,29,13,1313,3034,1488,-1546
2016,2,29,14,1804,3659,1791,-1868
2016,2,29,15,1979,4150,2070,-2080
2016,2,29,16,2250,4303,2175,-2128
2016,2,29,17,2219,4252,2178,-2074
2016,2,29,18,2118,4123,2188,-1935
2016,2,29,19,2090,3987,2035,-1952
2016,2,29,20,2070,3838,1882,-1956
2016,2,29,21,2013,3626,1782,-1844
2016,2,29,22,1995,3587,1774,-1813
2016,2,29,23,1993,3561,1814,-1747
2016,3,1,0,2009,3588,1919,-1669
2016,3,1,1,2193,3687,1928,-1759
2016,3,1,2,2437,3917,2101,-1816
2016,3,1,3,2430,4142,2308,-1834
2016,3,1,4,2425,4110,2310,-1800
2016,3,1,5,2423,3991,2426,-1565
2016,3,1,6,2257,3745,2290,-1455
2016,3,1,7,2247,3430,1852,-1578
2016,3,1,8,2039,3159,1707,-1452
2016,3,1,9,1649,2950,1540,-1410
2016,3,1,10,1612,2867,1482,-1385
2016,3,1,11,1603,2849,1465,-1384
2016,3,1,12,1520,2817,1429,-1388
2016,3,1,13,1521,3016,1564,-1452
2016,3,1,14,2064,3377,1919,-1458
2016,3,1,15,2014,3823,1964,-1859
2016,3,1,16,2064,4054,2045,-2009
2016,3,1,17,2144,4029,2036,-1993
2016,3,1,18,1954,3983,1858,-2125
2016,3,1,19,1904,3962,1833,-2129
2016,3,1,20,1807,3957,1977,-1980
2016,3,1,21,1807,3877,1926,-1951
2016,3,1,22,1727,3806,1779,-2027
2016,3,1,23,1692,3769,1719,-2050
2016,3,2,0,1700,3699,1730,-1969
2016,3,2,1,1728,3759,1719,-2040
2016,3,2,2,1941,3907,1734,-2173
2016,3,2,3,2005,4092,1709,-2383
2016,3,2,4,2063,3810,1548,-2262
2016,3,2,5,2002,3869,1502,-2367
2016,3,2,6,1850,3632,1380,-2252
2016,3,2,7,1900,3429,1603,-1826
2016,3,2,8,1847,2907,1271,-1636
2016,3,2,9,1189,2769,1241,-1528
2016,3,2,10,1190,2709,1231,-1478
2016,3,2,11,1192,2630,1163,-1467
2016,3,2,12,1194,2624,1186,-1438
2016,3,2,13,1185,2797,1281,-1516
2016,3,2,14,1415,3127,1309,-1818
2016,3,2,15,1223,3775,1531,-2244
2016,3,2,16,1507,4057,1659,-2398
2016,3,2,17,1468,4017,1596,-2421
2016,3,2,18,1442,3934,1573,-2361
2016,3,2,19,1424,3835,1491,-2344
2016,3,2,20,1409,3614,1389,-2225
2016,3,2,21,1396,3596,1402,-2194
2016,3,2,22,1391,3752,1561,-2191
2016,3,2,23,1386,3722,1565,-2157
2016,3,3,0,1410,3765,1626,-2139
2016,3,3,1,1494,3883,1695,-2188
2016,3,3,2,1684,4070,1833,-2237
2016,3,3,3,1683,4185,1875,-2310
2016,3,3,4,1683,4127,1831,-2296
2016,3,3,5,1683,3988,1808,-2180
2016,3,3,6,1574,3696,1564,-2132
2016,3,3,7,1661,3373,1534,-1839
2016,3,3,8,1579,3115,1422,-1693
2016,3,3,9,1388,2978,1408,-1570
2016,3,3,10,1333,2855,1372,-1483
2016,3,3,11,1114,2599,1341,-1258
2016,3,3,12,1175,2597,1258,-1339
2016,3,3,13,1144,2734,1284,-1450
2016,3,3,14,1338,3053,1365,-1688
2016,3,3,15,1330,3490,1393,-2097
2016,3,3,16,1741,3834,1609,-2225
2016,3,3,17,1735,3989,1897,-2092
2016,3,3,18,1660,3943,1789,-2154
2016,3,3,19,1503,3906,1710,-2196
2016,3,3,20,1520,3831,1672,-2159
2016,3,3,21,1537,3750,1683,-2067
2016,3,3,22,1546,3647,1679,-1968
2016,3,3,23,1548,3610,1691,-1919
2016,3,4,0,1539,3586,1537,-2049
2016,3,4,1,1607,3629,1541,-2088
2016,3,4,2,1792,3826,1617,-2209
2016,3,4,3,1874,4078,1884,-2194
2016,3,4,4,1865,4127,1998,-2129
2016,3,4,5,1854,4046,2001,-2045
2016,3,4,6,1835,3853,1861,-1992
2016,3,4,7,1811,3586,1819,-1767
2016,3,4,8,1719,3324,1664,-1660
2016,3,4,9,1370,3045,1508,-1537
2016,3,4,10,1363,2979,1474,-1505
2016,3,4,11,1359,2961,1445,-1516
2016,3,4,12,1360,3018,1522,-1496
2016,3,4,13,1516,3316,1669,-1647
2016,3,4,14,1704,3649,1805,-1844
2016,3,4,15,1655,4015,1679,-2336
2016,3,4,16,1756,4254,1878,-2376
2016,3,4,17,1756,4229,1891,-2338
2016,3,4,18,1638,4103,1818,-2285
2016,3,4,19,1586,4016,1709,-2307
2016,3,4,20,1536,3978,1679,-2299
2016,3,4,21,1536,3937,1661,-2276
2016,3,4,22,1536,3905,1683,-2222
2016,3,4,23,1536,3913,1720,-2193
2016,3,5,0,1537,3943,1726,-2217
2016,3,5,1,1537,4013,1728,-2285
2016,3,5,2,1756,4146,1809,-2337
2016,3,5,3,1757,4199,1821,-2378
2016,3,5,4,1758,4094,1759,-2335
2016,3,5,5,1709,3987,1735,-2252
2016,3,5,6,1703,3742,1520,-2222
2016,3,5,7,1732,3501,1381,-2120
2016,3,5,8,1664,3249,1350,-1899
2016,3,5,9,1350,3089,1276,-1813
2016,3,5,10,1293,3076,1445,-1631
2016,3,5,11,1272,3041,1490,-1551
2016,3,5,12,1253,3016,1480,-1536
2016,3,5,13,1274,3036,1487,-1549
2016,3,5,14,1285,3054,1250,-1804
2016,3,5,15,1229,3249,1293,-1956
2016,3,5,16,1213,3486,1432,-2054
2016,3,5,17,1296,3541,1380,-2161
2016,3,5,18,1418,3665,1468,-2197
2016,3,5,19,1445,3538,1330,-2208
2016,3,5,20,1430,3561,1396,-2165
2016,3,5,21,1423,3413,1297,-2116
2016,3,5,22,1402,3382,1385,-1997
2016,3,5,23,1415,3193,1275,-1918
2016,3,6,0,1435,3172,1263,-1909
2016,3,6,1,1454,3248,1304,-1944
2016,3,6,2,1494,3575,1481,-2094
2016,3,6,3,1500,3705,1463,-2242
2016,3,6,4,1494,3639,1471,-2168
2016,3,6,5,1484,3500,1428,-2072
2016,3,6,6,1442,3339,1366,-1973
2016,3,6,7,1451,3207,1387,-1820
2016,3,6,8,1437,3018,1350,-1668
2016,3,6,9,1108,2803,1374,-1429
2016,3,6,10,1046,2685,1299,-1386
2016,3,6,11,1086,2614,1299,-1315
2016,3,6,12,1060,2487,1290,-1197
2016,3,6,13,1097,2489,1333,-1156
2016,3,6,14,1406,2560,1172,-1388
2016,3,6,15,1399,2683,1200,-1483
2016,3,6,16,1385,2879,1191,-1688
2016,3,6,17,1520,3116,1256,-1860
2016,3,6,18,1657,3243,1262,-1981
2016,3,6,19,1653,3349,1316,-2033
2016,3,6,20,1648,3282,1227,-2055
2016,3,6,21,1640,3325,1289,-2036
2016,3,6,22,1686,3268,1256,-2012
2016,3,6,23,1675,3164,1179,-1985
2016,3,7,0,1798,3150,1199,-1951
2016,3,7,1,1872,3361,1441,-1920
2016,3,7,2,2050,3889,1918,-1971
2016,3,7,3,2040,4102,2035,-2067
2016,3,7,4,2034,4103,2086,-2017
2016,3,7,5,2027,3999,2024,-1975
2016,3,7,6,2015,3764,1859,-1905
2016,3,7,7,1862,3465,1675,-1790
2016,3,7,8,1747,3207,1560,-1647
2016,3,7,9,1535,3033,1381,-1652
2016,3,7,10,1504,2929,1293,-1636
2016,3,7,11,1342,2798,1211,-1587
2016,3,7,12,1333,2828,1165,-1663
2016,3,7,13,1340,2954,1370,-1584
2016,3,7,14,1581,3573,1831,-1742
2016,3,7,15,1714,4034,1887,-2147
2016,3,7,16,1719,4288,1980,-2308
2016,3,7,17,1728,4282,1997,-2285
2016,3,7,18,1636,4239,1840,-2399
2016,3,7,19,1640,4169,1829,-2340
2016,3,7,20,1602,4105,1868,-2237
2016,3,7,21,1550,3993,1776,-2217
2016,3,7,22,1553,3950,1870,-2080
2016,3,7,23,1567,3861,1819,-2042
2016,3,8,0,1592,3882,1894,-1988
2016,3,8,1,1631,3914,1892,-2022
2016,3,8,2,1749,4066,1938,-2128
2016,3,8,3,1937,4334,2012,-2322
2016,3,8,4,1972,4342,2066,-2276
2016,3,8,5,1850,4200,1935,-2265
2016,3,8,6,1726,3956,1882,-2074
2016,3,8,7,1807,3631,1863,-1768
2016,3,8,8,1689,2986,1434,-1552
2016,3,8,9,1098,2811,1288,-1523
2016,3,8,10,1063,2777,1287,-1490
2016,3,8,11,1024,2723,1254,-1469
2016,3,8,12,990,2768,1235,-1533
2016,3,8,13,1198,3027,1433,-1594
2016,3,8,14,1684,3618,1729,-1889
2016,3,8,15,1664,4203,1868,-2335
2016,3,8,16,1726,4378,2033,-2345
2016,3,8,17,1711,4296,1891,-2405
2016,3,8,18,1585,4173,1685,-2488
2016,3,8,19,1531,4120,1636,-2484
2016,3,8,20,1481,4005,1592,-2413
2016,3,8,21,1483,3927,1572,-2355
2016,3,8,22,1486,3848,1561,-2287
2016,3,8,23,1489,3815,1593,-2222
2016,3,9,0,1492,3842,1625,-2217
2016,3,9,1,1546,3959,1747,-2212
2016,3,9,2,1793,4125,1826,-2299
2016,3,9,3,1797,4318,1844,-2474
2016,3,9,4,1798,4321,1909,-2412
2016,3,9,5,1801,4212,1870,-2342
2016,3,9,6,1580,3938,1688,-2250
2016,3,9,7,1663,3638,1758,-1880
2016,3,9,8,1659,3376,1697,-1679
2016,3,9,9,1480,3210,1650,-1560
2016,3,9,10,1410,3152,1608,-1544
2016,3,9,11,1394,3131,1539,-1592
2016,3,9,12,1436,3173,1533,-1640
2016,3,9,13,1529,3349,1594,-1755
2016,3,9,14,1714,3672,1690,-1982
2016,3,9,15,1714,4070,1685,-2385
2016,3,9,16,1714,4274,1831,-2443
2016,3,9,17,1714,4229,1828,-2401
2016,3,9,18,1715,4147,1760,-2387
2016,3,9,19,1692,4076,1708,-2368
2016,3,9,20,1594,4029,1681,-2348
2016,3,9,21,1555,4046,1705,-2341
2016,3,9,22,1558,4067,1735,-2332
2016,3,9,23,1562,4098,1777,-2321
2016,3,10,0,1567,4149,1786,-2363
2016,3,10,1,1572,4266,1816,-2450
2016,3,10,2,1723,4425,1766,-2659
2016,3,10,3,1805,4504,1866,-2638
2016,3,10,4,1808,4409,1857,-2552
2016,3,10,5,1708,4189,1609,-2580
2016,3,10,6,1643,3855,1384,-2471
2016,3,10,7,1715,3516,1500,-2016
2016,3,10,8,1471,3301,1575,-1726
2016,3,10,9,1185,2848,1263,-1585
2016,3,10,10,1073,2588,1143,-1445
2016,3,10,11,1112,2569,1173,-1396
2016,3,10,12,1165,2534,1140,-1394
2016,3,10,13,1211,2624,1166,-1458
2016,3,10,14,1584,3143,1446,-1697
2016,3,10,15,1596,3621,1421,-2200
2016,3,10,16,1775,3801,1767,-2034
2016,3,10,17,1765,3746,1658,-2088
2016,3,10,18,1752,3616,1681,-1935
2016,3,10,19,1698,3360,1469,-1891
2016,3,10,20,1683,3351,1407,-1944
2016,3,10,21,1677,3336,1412,-1924
2016,3,10,22,1677,3346,1402,-1944
2016,3,10,23,1678,3351,1414,-1937
2016,3,11,0,1681,3421,1447,-1974
2016,3,11,1,1674,3521,1420,-2101
2016,3,11,2,1814,3965,1722,-2243
2016,3,11,3,1918,4219,1994,-2225
2016,3,11,4,1889,4241,1943,-2298
2016,3,11,5,1864,4176,1935,-2241
2016,3,11,6,1828,3950,1802,-2148
2016,3,11,7,1786,3673,1869,-1804
2016,3,11,8,1718,3414,1703,-1711
2016,3,11,9,1419,3290,1534,-1756
2016,3,11,10,1287,3201,1451,-1750
2016,3,11,11,1223,3152,1368,-1784
2016,3,11,12,1216,3229,1399,-1830
2016,3,11,13,1410,3458,1450,-2008
2016,3,11,14,1455,3754,1545,-2209
2016,3,11,15,1458,4169,1554,-2615
2016,3,11,16,1462,4333,1623,-2710
2016,3,11,17,1469,4320,1754,-2566
2016,3,11,18,1477,4183,1696,-2487
2016,3,11,19,1440,3989,1569,-2420
2016,3,11,20,1411,3875,1546,-2329
2016,3,11,21,1408,3928,1665,-2263
2016,3,11,22,1402,3962,1724,-2238
2016,3,11,23,1397,3958,1709,-2249
2016,3,12,0,1392,3962,1615,-2347
2016,3,12,1,1390,3982,1405,-2577
2016,3,12,2,1414,4071,1577,-2494
2016,3,12,3,1531,4196,1671,-2525
2016,3,12,4,1533,4110,1593,-2517
2016,3,12,5,1535,3967,1511,-2456
2016,3,12,6,1426,3814,1565,-2249
2016,3,12,7,1506,3564,1461,-2103
2016,3,12,8,1487,3344,1502,-1842
2016,3,12,9,1439,3170,1484,-1686
2016,3,12,10,1179,2948,1413,-1535
2016,3,12,11,1186,2873,1378,-1495
2016,3,12,12,1096,2717,1273,-1444
2016,3,12,13,1105,2806,1349,-1457
2016,3,12,14,958,2818,1226,-1592
2016,3,12,15,962,3017,1234,-1783
2016,3,12,16,969,3324,1232,-2092
2016,3,12,17,1390,3655,1390,-2265
2016,3,12,18,1451,3865,1499,-2366
2016,3,12,19,1481,3872,1486,-2386
2016,3,12,20,1516,3392,1101,-2291
2016,3,12,21,1500,3381,1327,-2054
2016,3,12,22,1478,3282,1309,-1973
2016,3,12,23,1490,3262,1333,-1929
2016,3,13,0,1490,3320,1427,-1893
2016,3,13,1,1486,3384,1450,-1934
2016,3,13,2,1482,3512,1375,-2137
2016,3,13,3,1516,3664,1363,-2301
2016,3,13,4,1506,3683,1382,-2301
2016,3,13,5,1545,3579,1333,-2246
2016,3,13,6,1533,3404,1147,-2257
2016,3,13,7,1620,3222,1301,-1921
2016,3,13,8,1509,3167,1455,-1712
2016,3,13,9,1323,3230,1619,-1611
2016,3,13,10,1323,3182,1528,-1654
2016,3,13,11,1298,3143,1396,-1747
2016,3,13,12,1277,3192,1475,-1717
2016,3,13,13,1411,3265,1407,-1858
2016,3,13,14,1296,3424,1376,-2048
2016,3,13,15,1383,3641,1456,-2185
2016,3,13,16,1421,3823,1477,-2346
2016,3,13,17,1469,4015,1575,-2440
2016,3,13,18,1477,4140,1613,-2527
2016,3,13,19,1434,4182,1608,-2574
2016,3,13,20,1436,4132,1603,-2529
2016,3,13,21,1390,3970,1458,-2512
2016,3,13,22,1391,3795,1341,-2454
2016,3,13,23,1364,3280,992,-2288
2016,3,14,0,1369,3040,1019,-2021
2016,3,14,1,1429,3146,1165,-1981
2016,3,14,2,1593,3265,1310,-1955
2016,3,14,3,1625,3627,1436,-2191
2016,3,14,4,1681,3592,1429,-2163
2016,3,14,5,1576,3470,1458,-2012
2016,3,14,6,1655,3509,1566,-1943
2016,3,14,7,1535,3267,1540,-1727
2016,3,14,8,1340,3040,1585,-1455
2016,3,14,9,1348,3009,1474,-1535
2016,3,14,10,1226,2905,1404,-1501
2016,3,14,11,1103,2814,1359,-1455
2016,3,14,12,1266,3164,1446,-1718
2016,3,14,13,1680,3548,1499,-2049
2016,3,14,14,1681,3960,1558,-2402
2016,3,14,15,1674,4324,1824,-2500
2016,3,14,16,1674,4315,1781,-2534
2016,3,14,17,1674,4247,1701,-2546
2016,3,14,18,1634,4279,1766,-2513
2016,3,14,19,1636,4269,1739,-2530
2016,3,14,20,1639,4196,1653,-2543
2016,3,14,21,1642,4156,1615,-2541
2016,3,14,22,1642,4046,1514,-2532
2016,3,14,23,1641,3986,1473,-2513
2016,3,15,0,1640,4040,1542,-2498
2016,3,15,1,1641,4238,1757,-2481
2016,3,15,2,1682,4295,1779,-2516
2016,3,15,3,1684,4432,1910,-2522
2016,3,15,4,1683,4395,1904,-2491
2016,3,15,5,1682,4160,1824,-2336
2016,3,15,6,1482,3852,1816,-2036
2016,3,15,7,1482,3520,1619,-1901
2016,3,15,8,1427,3386,1735,-1651
2016,3,15,9,1425,3287,1650,-1637
2016,3,15,10,1424,3241,1606,-1635
2016,3,15,11,1425,3267,1593,-1674
2016,3,15,12,1527,3453,1702,-1751
2016,3,15,13,1629,3797,1836,-1961
2016,3,15,14,1626,4214,1826,-2388
2016,3,15,15,1627,4479,1910,-2569
2016,3,15,16,1626,4446,1957,-2489
2016,3,15,17,1580,4358,1940,-2418
2016,3,15,18,1477,4242,1747,-2495
2016,3,15,19,1473,4124,1642,-2482
2016,3,15,20,1468,4000,1598,-2402
2016,3,15,21,1466,3943,1584,-2359
2016,3,15,22,1467,3893,1614,-2279
2016,3,15,23,1470,3839,1612,-2227
2016,3,16,0,1475,3821,1571,-2250
2016,3,16,1,1479,3890,1571,-2319
2016,3,16,2,1624,3987,1586,-2401
2016,3,16,3,1624,4214,1864,-2350
2016,3,16,4,1571,4224,1933,-2291
2016,3,16,5,1566,4019,1778,-2241
2016,3,16,6,1610,3733,1867,-1866
2016,3,16,7,1525,3410,1782,-1628
2016,3,16,8,1594,3218,1706,-1512
2016,3,16,9,1428,2966,1620,-1346
2016,3,16,10,1388,2865,1543,-1322
2016,3,16,11,1450,3092,1670,-1422
2016,3,16,12,1529,3326,1709,-1617
2016,3,16,13,1813,3650,1814,-1836
2016,3,16,14,1792,4134,2033,-2101
2016,3,16,15,2010,4389,2132,-2257
2016,3,16,16,2024,4356,2120,-2236
2016,3,16,17,2011,4218,2043,-2175
2016,3,16,18,1862,4087,1928,-2159
2016,3,16,19,1622,3975,1785,-2190
2016,3,16,20,1624,3933,1762,-2171
2016,3,16,21,1633,3832,1716,-2116
2016,3,16,22,1647,3697,1584,-2113
2016,3,16,23,1661,3628,1560,-2068
2016,3,17,0,1667,3604,1613,-1991
2016,3,17,1,1825,3716,1814,-1902
2016,3,17,2,1964,3832,1901,-1931
2016,3,17,3,1964,4079,2110,-1969
2016,3,17,4,1945,4174,2213,-1961
2016,3,17,5,1933,4011,2066,-1945
2016,3,17,6,1900,3695,1840,-1855
2016,3,17,7,1848,3435,1813,-1622
2016,3,17,8,1542,3260,1637,-1623
2016,3,17,9,1525,3190,1545,-1645
2016,3,17,10,1514,3217,1658,-1559
2016,3,17,11,1559,3287,1672,-1615
2016,3,17,12,1767,3502,1809,-1693
2016,3,17,13,1941,3836,1957,-1879
2016,3,17,14,1953,4328,2069,-2259
2016,3,17,15,1979,4640,2313,-2327
2016,3,17,16,2000,4526,2264,-2262
2016,3,17,17,1978,4358,2155,-2203
2016,3,17,18,1811,4174,2138,-2036
2016,3,17,19,1780,3998,1963,-2035
2016,3,17,20,1601,3823,1669,-2154
2016,3,17,21,1519,3808,1702,-2106
2016,3,17,22,1512,3705,1634,-2071
2016,3,17,23,1457,3636,1597,-2039
2016,3,18,0,1453,3645,1664,-1981
2016,3,18,1,1498,3694,1664,-2030
2016,3,18,2,1655,3769,1615,-2154
2016,3,18,3,1698,3978,1633,-2345
2016,3,18,4,1703,4066,1641,-2425
2016,3,18,5,1617,3908,1703,-2205
2016,3,18,6,1697,3605,1633,-1972
2016,3,18,7,1615,3293,1554,-1739
2016,3,18,8,1390,3128,1459,-1669
2016,3,18,9,1396,3063,1397,-1666
2016,3,18,10,1402,3068,1397,-1671
2016,3,18,11,1418,3124,1433,-1691
2016,3,18,12,1609,3279,1555,-1724
2016,3,18,13,1864,3614,1710,-1904
2016,3,18,14,1869,4061,1792,-2269
2016,3,18,15,1874,4293,1885,-2408
2016,3,18,16,1878,4236,1875,-2361
2016,3,18,17,1762,4065,1689,-2376
2016,3,18,18,1565,3910,1525,-2385
2016,3,18,19,1434,3756,1464,-2292
2016,3,18,20,1433,3609,1448,-2161
2016,3,18,21,1427,3554,1572,-1982
2016,3,18,22,1417,3236,1269,-1967
2016,3,18,23,1403,3100,1332,-1768
2016,3,19,0,1383,3189,1376,-1813
2016,3,19,1,1364,3365,1550,-1815
2016,3,19,2,1391,3441,1532,-1909
2016,3,19,3,1383,3553,1465,-2088
2016,3,19,4,1386,3674,1626,-2048
2016,3,19,5,1395,3540,1586,-1954
2016,3,19,6,1612,3363,1663,-1700
2016,3,19,7,1620,3128,1612,-1516
2016,3,19,8,1337,2961,1601,-1360
2016,3,19,9,1314,2877,1533,-1344
2016,3,19,10,1316,2829,1505,-1324
2016,3,19,11,1320,2838,1483,-1355
2016,3,19,12,1324,2890,1496,-1394
2016,3,19,13,1376,3011,1472,-1539
2016,3,19,14,1330,3190,1415,-1775
2016,3,19,15,1373,3434,1489,-1945
2016,3,19,16,1537,3637,1552,-2085
2016,3,19,17,1530,3725,1624,-2101
2016,3,19,18,1521,3698,1636,-2062
2016,3,19,19,1514,3608,1599,-2009
2016,3,19,20,1510,3462,1488,-1974
2016,3,19,21,1354,3299,1428,-1871
2016,3,19,22,1229,3078,1279,-1799
2016,3,19,23,1217,3020,1232,-1788
2016,3,20,0,1303,3037,1229,-1808
2016,3,20,1,1292,3203,1335,-1868
2016,3,20,2,1283,3300,1313,-1987
2016,3,20,3,1377,3422,1391,-2031
2016,3,20,4,1372,3455,1426,-2029
2016,3,20,5,1369,3339,1354,-1985
2016,3,20,6,1522,3162,1438,-1724
2016,3,20,7,1517,2952,1481,-1471
2016,3,20,8,1361,2806,1470,-1336
2016,3,20,9,1364,2698,1438,-1260
2016,3,20,10,1323,2649,1424,-1225
2016,3,20,11,1361,2658,1429,-1229
2016,3,20,12,1357,2666,1408,-1258
2016,3,20,13,1354,2744,1405,-1339
2016,3,20,14,1298,2895,1398,-1497
2016,3,20,15,1291,3131,1467,-1664
2016,3,20,16,1331,3361,1537,-1824
2016,3,20,17,1434,3503,1528,-1975
2016,3,20,18,1476,3501,1539,-1962
2016,3,20,19,1468,3501,1573,-1928
2016,3,20,20,1464,3507,1574,-1933
2016,3,20,21,1411,3483,1568,-1915
2016,3,20,22,1408,3417,1496,-1921
2016,3,20,23,1406,3340,1474,-1866
2016,3,21,0,1406,3330,1329,-2001
2016,3,21,1,1458,3413,1371,-2042
2016,3,21,2,1464,3414,1250,-2164
2016,3,21,3,1470,3554,1423,-2131
2016,3,21,4,1481,3604,1494,-2110
2016,3,21,5,1404,3387,1365,-2022
2016,3,21,6,1535,3199,1382,-1817
2016,3,21,7,1360,3011,1529,-1482
2016,3,21,8,1387,2812,1416,-1396
2016,3,21,9,1335,2650,1263,-1387
2016,3,21,10,1350,2588,1218,-1370
2016,3,21,11,1352,2649,1239,-1410
2016,3,21,12,1435,2896,1371,-1525
2016,3,21,13,1531,3201,1496,-1705
2016,3,21,14,1569,3610,1671,-1939
2016,3,21,15,1706,3926,1882,-2044
2016,3,21,16,1668,3881,1808,-2073
2016,3,21,17,1557,3839,1722,-2117
2016,3,21,18,1536,3833,1742,-2091
2016,3,21,19,1527,3770,1661,-2109
2016,3,21,20,1530,3714,1555,-2159
2016,3,21,21,1541,3652,1471,-2181
2016,3,21,22,1549,3621,1522,-2099
2016,3,21,23,1554,3621,1528,-2093
2016,3,22,0,1565,3634,1516,-2118
2016,3,22,1,1585,3703,1517,-2186
2016,3,22,2,1615,3805,1686,-2119
2016,3,22,3,1647,3956,1787,-2169
2016,3,22,4,1554,3884,1765,-2119
2016,3,22,5,1480,3657,1670,-1987
2016,3,22,6,1571,3273,1387,-1886
2016,3,22,7,1470,3057,1437,-1620
2016,3,22,8,1333,2874,1395,-1479
2016,3,22,9,1053,2508,1021,-1487
2016,3,22,10,979,2418,965,-1453
2016,3,22,11,970,2499,1080,-1419
2016,3,22,12,1190,2782,1228,-1554
2016,3,22,13,1466,3302,1454,-1848
2016,3,22,14,1570,3753,1515,-2238
2016,3,22,15,1561,3982,1576,-2406
2016,3,22,16,1561,3994,1619,-2375
2016,3,22,17,1561,3902,1617,-2285
2016,3,22,18,1436,3794,1534,-2260
2016,3,22,19,1436,3670,1438,-2232
2016,3,22,20,1436,3519,1363,-2156
2016,3,22,21,1436,3325,1282,-2043
2016,3,22,22,1436,3250,1258,-1992
2016,3,22,23,1436,3197,1192,-2005
2016,3,23,0,1436,3261,1245,-2016
2016,3,23,1,1436,3435,1329,-2106
2016,3,23,2,1461,3652,1493,-2159
2016,3,23,3,1461,3811,1573,-2238
2016,3,23,4,1461,3876,1606,-2270
2016,3,23,5,1461,3652,1497,-2155
2016,3,23,6,1461,3370,1503,-1867
2016,3,23,7,1285,3008,1392,-1616
2016,3,23,8,1091,2580,1132,-1448
2016,3,23,9,992,2472,1059,-1413
2016,3,23,10,992,2429,1019,-1410
2016,3,23,11,993,2460,1032,-1428
2016,3,23,12,1123,2741,1250,-1491
2016,3,23,13,1474,3269,1487,-1782
2016,3,23,14,1384,3691,1473,-2218
2016,3,23,15,1475,3954,1539,-2415
2016,3,23,16,1474,3945,1511,-2434
2016,3,23,17,1471,3903,1533,-2370
2016,3,23,18,1420,3818,1463,-2355
2016,3,23,19,1350,3857,1436,-2421
2016,3,23,20,1317,3815,1376,-2439
2016,3,23,21,1282,3773,1338,-2435
2016,3,23,22,1250,3727,1284,-2443
2016,3,23,23,1224,3725,1232,-2493
2016,3,24,0,1215,3799,1271,-2528
2016,3,24,1,1271,3891,1384,-2507
2016,3,24,2,1386,3965,1489,-2476
2016,3,24,3,1416,4036,1631,-2405
2016,3,24,4,1444,4015,1642,-2373
2016,3,24,5,1462,3810,1599,-2211
2016,3,24,6,1462,3498,1550,-1948
2016,3,24,7,1377,3220,1579,-1641
2016,3,24,8,1436,2977,1385,-1592
2016,3,24,9,1121,2754,1184,-1570
2016,3,24,10,1038,2571,1051,-1520
2016,3,24,11,1046,2565,1011,-1554
2016,3,24,12,1049,2778,1192,-1586
2016,3,24,13,1477,3325,1417,-1908
2016,3,24,14,1385,3777,1418,-2359
2016,3,24,15,1475,4044,1461,-2583
2016,3,24,16,1476,3962,1429,-2533
2016,3,24,17,1477,3833,1320,-2513
2016,3,24,18,1440,3751,1340,-2411
2016,3,24,19,1390,3452,1101,-2351
2016,3,24,20,1311,3368,1127,-2241
2016,3,24,21,1308,3274,1131,-2143
2016,3,24,22,1308,3230,1133,-2097
2016,3,24,23,1307,3257,1088,-2169
2016,3,25,0,1307,3328,1170,-2158
2016,3,25,1,1307,3489,1276,-2213
2016,3,25,2,1397,3661,1345,-2316
2016,3,25,3,1476,3815,1416,-2399
2016,3,25,4,1478,3890,1515,-2375
2016,3,25,5,1480,3699,1449,-2250
2016,3,25,6,1482,3395,1441,-1954
2016,3,25,7,1393,2999,1262,-1737
2016,3,25,8,953,2702,1121,-1581
2016,3,25,9,903,2587,1060,-1527
2016,3,25,10,902,2579,1115,-1464
2016,3,25,11,899,2590,1111,-1479
2016,3,25,12,1144,2922,1305,-1617
2016,3,25,13,1316,3293,1347,-1946
2016,3,25,14,912,3639,1287,-2352
2016,3,25,15,1407,3993,1424,-2569
2016,3,25,16,1368,3977,1402,-2575
2016,3,25,17,1327,3872,1278,-2594
2016,3,25,18,1289,3797,1302,-2495
2016,3,25,19,1262,3626,1175,-2451
2016,3,25,20,1245,3571,1227,-2344
2016,3,25,21,1240,3471,1191,-2280
2016,3,25,22,1245,3385,1172,-2213
2016,3,25,23,1260,3343,1196,-2147
2016,3,26,0,1282,3332,1211,-2121
2016,3,26,1,1303,3374,1225,-2149
2016,3,26,2,1319,3453,1272,-2181
2016,3,26,3,1319,3547,1221,-2326
2016,3,26,4,1311,3698,1339,-2359
2016,3,26,5,1213,3615,1310,-2305
2016,3,26,6,1288,3402,1230,-2172
2016,3,26,7,1240,3186,1253,-1933
2016,3,26,8,1186,3043,1274,-1769
2016,3,26,9,1184,2979,1307,-1672
2016,3,26,10,1185,2920,1223,-1697
2016,3,26,11,1189,2922,1232,-1690
2016,3,26,12,1203,3011,1289,-1722
2016,3,26,13,1291,3112,1189,-1923
2016,3,26,14,1152,3307,1100,-2207
2016,3,26,15,1277,3591,1213,-2378
2016,3,26,16,1254,3822,1297,-2525
2016,3,26,17,1239,3815,1241,-2574
2016,3,26,18,1231,3645,1152,-2493
2016,3,26,19,1227,3507,1120,-2387
2016,3,26,20,1140,3332,1088,-2244
2016,3,26,21,1141,3239,1166,-2073
2016,3,26,22,1093,2935,952,-1983
2016,3,26,23,1095,2865,899,-1966
2016,3,27,0,1097,2883,889,-1994
2016,3,27,1,1100,3046,979,-2067
2016,3,27,2,1154,3149,1036,-2113
2016,3,27,3,1157,3505,1312,-2193
2016,3,27,4,1160,3556,1329,-2227
2016,3,27,5,1160,3411,1215,-2196
2016,3,27,6,1245,3264,1359,-1905
2016,3,27,7,1244,3043,1325,-1718
2016,3,27,8,1191,2876,1280,-1596
2016,3,27,9,1186,2699,1069,-1630
2016,3,27,10,845,2354,827,-1527
2016,3,27,11,845,2320,780,-1540
2016,3,27,12,863,2263,497,-1766
2016,3,27,13,898,2477,791,-1686
2016,3,27,14,755,2687,898,-1789
2016,3,27,15,1211,2936,1042,-1894
2016,3,27,16,1361,3176,1146,-2030
2016,3,27,17,1392,3301,1154,-2147
2016,3,27,18,1403,3319,1136,-2183
2016,3,27,19,1303,3261,1089,-2172
2016,3,27,20,1278,3185,1051,-2134
2016,3,27,21,1278,3081,1046,-2035
2016,3,27,22,1253,2998,986,-2012
2016,3,27,23,1252,2995,1102,-1893
2016,3,28,0,1252,2988,1040,-1948
2016,3,28,1,1352,3085,1125,-1960
2016,3,28,2,1401,3269,1306,-1963
2016,3,28,3,1451,3512,1496,-2016
2016,3,28,4,1451,3802,1643,-2159
2016,3,28,5,1301,3601,1444,-2157
2016,3,28,6,1477,3176,1394,-1782
2016,3,28,7,1402,2916,1309,-1607
2016,3,28,8,888,2676,1174,-1502
2016,3,28,9,889,2622,1119,-1503
2016,3,28,10,889,2648,1119,-1529
2016,3,28,11,929,2696,1132,-1564
2016,3,28,12,1202,2952,1205,-1747
2016,3,28,13,1566,3503,1538,-1965
2016,3,28,14,1687,3916,1495,-2421
2016,3,28,15,1904,4182,1730,-2452
2016,3,28,16,1848,4170,1761,-2409
2016,3,28,17,1793,4096,1706,-2390
2016,3,28,18,1748,3991,1617,-2374
2016,3,28,19,1651,3858,1572,-2286
2016,3,28,20,1644,3851,1660,-2191
2016,3,28,21,1644,3772,1725,-2047
2016,3,28,22,1645,3650,1603,-2047
2016,3,28,23,1645,3549,1533,-2016
2016,3,29,0,1654,3538,1521,-2017
2016,3,29,1,1751,3596,1630,-1966
2016,3,29,2,1915,3681,1736,-1945
2016,3,29,3,1939,3816,1808,-2008
2016,3,29,4,1942,3926,1914,-2012
2016,3,29,5,1883,3705,1787,-1918
2016,3,29,6,1881,3480,1802,-1678
2016,3,29,7,1784,3237,1829,-1408
2016,3,29,8,1484,3013,1632,-1381
2016,3,29,9,1269,2770,1533,-1237
2016,3,29,10,1298,2777,1599,-1178
2016,3,29,11,1318,2834,1669,-1165
2016,3,29,12,1334,3185,1786,-1399
2016,3,29,13,2014,3588,2093,-1495
2016,3,29,14,2021,4068,2256,-1812
2016,3,29,15,2024,4276,2326,-1950
2016,3,29,16,2025,4180,2217,-1963
2016,3,29,17,1948,3998,2030,-1968
2016,3,29,18,1870,3829,1903,-1926
2016,3,29,19,1560,3685,1745,-1940
2016,3,29,20,1390,3486,1537,-1949
2016,3,29,21,1378,3122,1219,-1903
2016,3,29,22,1317,3068,1248,-1820
2016,3,29,23,1310,2992,1158,-1834
2016,3,30,0,1307,2987,1136,-1851
2016,3,30,1,1298,3137,1252,-1885
2016,3,30,2,1530,3234,1290,-1944
2016,3,30,3,1613,3370,1301,-2069
2016,3,30,4,1617,3731,1679,-2052
2016,3,30,5,1547,3578,1705,-1873
2016,3,30,6,1639,3284,1553,-1731
2016,3,30,7,1547,3045,1537,-1508
2016,3,30,8,1443,2911,1645,-1266
2016,3,30,9,1482,2825,1734,-1091
2016,3,30,10,1483,2782,1729,-1053
2016,3,30,11,1520,2886,1894,-992
2016,3,30,12,1680,3061,2013,-1048
2016,3,30,13,2069,3395,2235,-1160
2016,3,30,14,2055,3811,2361,-1450
2016,3,30,15,2518,4017,2531,-1486
2016,3,30,16,2509,3922,2498,-1424
2016,3,30,17,2428,3760,2290,-1470
2016,3,30,18,2144,3656,2166,-1490
2016,3,30,19,1995,3566,2146,-1420
2016,3,30,20,1993,3474,2104,-1370
2016,3,30,21,1917,3396,2049,-1347
2016,3,30,22,1916,3364,2029,-1335
2016,3,30,23,1916,3334,1990,-1344
2016,3,31,0,1916,3334,1972,-1362
2016,3,31,1,1916,3373,1975,-1398
2016,3,31,2,2173,3413,2077,-1336
2016,3,31,3,2174,3497,2100,-1397
2016,3,31,4,2176,3623,2165,-1458
2016,3,31,5,2127,3377,1984,-1393
2016,3,31,6,2128,3062,2022,-1040
2016,3,31,7,1993,2743,1804,-939
2016,3,31,8,1528,2556,1566,-990
2016,3,31,9,1525,2457,1501,-956
2016,3,31,10,1351,2435,1454,-981
2016,3,31,11,1350,2452,1423,-1029
2016,3,31,12,1599,2627,1524,-1103
2016,3,31,13,1993,2947,1883,-1064
2016,3,31,14,1993,3358,2028,-1330
2016,3,31,15,2148,3568,2086,-1482
2016,3,31,16,2148,3546,2069,-1477
2016,3,31,17,2116,3437,1986,-1451
2016,3,31,18,2037,3326,1954,-1372
2016,3,31,19,1886,3299,1951,-1348
2016,3,31,20,1886,3237,1907,-1330
2016,3,31,21,1886,3216,1844,-1372
2016,3,31,22,1886,3152,1765,-1387
2016,3,31,23,1886,3132,1755,-1377
2016,4,1,0,1886,3121,1800,-1321
2016,4,1,1,1886,3106,1681,-1425
2016,4,1,2,2013,3105,1736,-1369
2016,4,1,3,2013,3222,1932,-1290
2016,4,1,4,2015,3381,2078,-1303
2016,4,1,5,1968,3187,1963,-1224
2016,4,1,6,1976,2915,1951,-964
2016,4,1,7,1796,2604,1671,-933
2016,4,1,8,1250,2383,1408,-975
2016,4,1,9,1191,2350,1371,-979
2016,4,1,10,1189,2307,1337,-970
2016,4,1,11,1188,2328,1355,-973
2016,4,1,12,1286,2476,1450,-1026
2016,4,1,13,1574,2791,1635,-1156
2016,4,1,14,1573,3177,1607,-1570
2016,4,1,15,1670,3433,1698,-1735
2016,4,1,16,1698,3449,1697,-1752
2016,4,1,17,1732,3383,1604,-1779
2016,4,1,18,1514,3344,1547,-1797
2016,4,1,19,1505,3338,1414,-1924
2016,4,1,20,1432,3295,1372,-1923
2016,4,1,21,1433,3264,1362,-1902
2016,4,1,22,1434,3297,1436,-1861
2016,4,1,23,1435,3308,1457,-1851
2016,4,2,0,1386,3288,1412,-1876
2016,4,2,1,1389,3324,1464,-1860
2016,4,2,2,1453,3294,1461,-1833
2016,4,2,3,1561,3313,1452,-1861
2016,4,2,4,1571,3435,1539,-1896
2016,4,2,5,1489,3303,1473,-1830
2016,4,2,6,1577,3098,1543,-1555
2016,4,2,7,1485,2909,1603,-1306
2016,4,2,8,1447,2727,1465,-1262
2016,4,2,9,1246,2646,1349,-1297
2016,4,2,10,1228,2591,1297,-1294
2016,4,2,11,1252,2578,1285,-1293
2016,4,2,12,1273,2608,1323,-1285
2016,4,2,13,1284,2703,1305,-1398
2016,4,2,14,1184,2859,1256,-1603
2016,4,2,15,1285,3088,1345,-1743
2016,4,2,16,1371,3376,1557,-1819
2016,4,2,17,1398,3447,1537,-1910
2016,4,2,18,1420,3405,1474,-1931
2016,4,2,19,1359,3294,1359,-1935
2016,4,2,20,1264,3113,1198,-1915
2016,4,2,21,1215,2992,1097,-1895
2016,4,2,22,1219,2696,957,-1739
2016,4,2,23,1226,2640,880,-1760
2016,4,3,0,1235,2647,911,-1736
2016,4,3,1,1240,2710,1000,-1710
2016,4,3,2,1292,2781,1062,-1719
2016,4,3,3,1293,2991,1280,-1711
2016,4,3,4,1293,3106,1384,-1722
2016,4,3,5,1293,2908,1222,-1686
2016,4,3,6,1293,2888,1352,-1536
2016,4,3,7,1292,2610,1169,-1441
2016,4,3,8,964,2482,1092,-1390
2016,4,3,9,939,2388,1006,-1382
2016,4,3,10,896,2381,963,-1418
2016,4,3,11,980,2483,1030,-1453
2016,4,3,12,1104,2606,1077,-1529
2016,4,3,13,1164,2777,1267,-1510
2016,4,3,14,943,2859,1039,-1820
2016,4,3,15,1083,3086,1108,-1978
2016,4,3,16,1082,3301,1231,-2070
2016,4,3,17,1181,3329,1197,-2132
2016,4,3,18,1181,3279,1149,-2130
2016,4,3,19,1182,3201,1087,-2114
2016,4,3,20,1083,3136,1072,-2064
2016,4,3,21,1085,3087,1087,-2000
2016,4,3,22,1087,3079,1182,-1897
2016,4,3,23,1089,3081,1219,-1862
2016,4,4,0,1091,3135,1276,-1859
2016,4,4,1,1192,3252,1395,-1857
2016,4,4,2,1283,3287,1376,-1911
2016,4,4,3,1285,3365,1336,-2029
2016,4,4,4,1286,3457,1410,-2047
2016,4,4,5,1247,3296,1369,-1927
2016,4,4,6,1293,3041,1361,-1680
2016,4,4,7,1306,2807,1320,-1487
2016,4,4,8,1253,2632,1235,-1397
2016,4,4,9,1049,2466,1150,-1316
2016,4,4,10,1015,2359,1221,-1138
2016,4,4,11,898,2299,1297,-1002
2016,4,4,12,1135,2544,1433,-1111
2016,4,4,13,1406,2840,1352,-1488
2016,4,4,14,1459,3202,1468,-1734
2016,4,4,15,1597,3498,1718,-1780
2016,4,4,16,1595,3592,1772,-1820
2016,4,4,17,1595,3567,1675,-1892
2016,4,4,18,1545,3571,1668,-1903
2016,4,4,19,1545,3547,1665,-1882
2016,4,4,20,1404,3499,1630,-1869
2016,4,4,21,1404,3380,1461,-1919
2016,4,4,22,1404,3326,1394,-1932
2016,4,4,23,1404,3191,1419,-1772
2016,4,5,0,1404,3121,1340,-1781
2016,4,5,1,1455,3361,1510,-1851
2016,4,5,2,1544,3444,1507,-1937
2016,4,5,3,1544,3489,1524,-1965
2016,4,5,4,1544,3621,1675,-1946
2016,4,5,5,1453,3454,1537,-1917
2016,4,5,6,1543,3192,1523,-1669
2016,4,5,7,1503,2737,1325,-1412
2016,4,5,8,913,2525,1227,-1298
2016,4,5,9,914,2441,1186,-1255
2016,4,5,10,914,2408,1204,-1204
2016,4,5,11,914,2459,1261,-1198
2016,4,5,12,964,2604,1260,-1344
2016,4,5,13,1456,3169,1543,-1626
2016,4,5,14,1535,3485,1480,-2005
2016,4,5,15,1535,3715,1665,-2050
2016,4,5,16,1535,3754,1677,-2077
2016,4,5,17,1535,3698,1631,-2067
2016,4,5,18,1535,3643,1616,-2027
2016,4,5,19,1454,3576,1619,-1957
2016,4,5,20,1452,3509,1556,-1953
2016,4,5,21,1450,3531,1566,-1965
2016,4,5,22,1449,3466,1603,-1863
2016,4,5,23,1448,3476,1725,-1751
2016,4,6,0,1448,3480,1657,-1823
2016,4,6,1,1527,3556,1608,-1948
2016,4,6,2,1527,3571,1621,-1950
2016,4,6,3,1526,3597,1675,-1922
2016,4,6,4,1525,3716,1847,-1869
2016,4,6,5,1521,3543,1640,-1903
2016,4,6,6,1507,3289,1611,-1678
2016,4,6,7,1487,3004,1529,-1475
2016,4,6,8,1124,2662,1365,-1297
2016,4,6,9,953,2493,1293,-1200
2016,4,6,10,1262,2677,1325,-1352
2016,4,6,11,1247,2765,1458,-1307
2016,4,6,12,1346,2978,1601,-1377
2016,4,6,13,1540,3233,1592,-1641
2016,4,6,14,1670,3604,1703,-1901
2016,4,6,15,1720,3758,1769,-1989
2016,4,6,16,1714,3797,1835,-1962
2016,4,6,17,1709,3706,1790,-1916
2016,4,6,18,1517,3594,1729,-1865
2016,4,6,19,1358,3517,1640,-1877
2016,4,6,20,1340,3429,1507,-1922
2016,4,6,21,1385,3324,1497,-1827
2016,4,6,22,1384,3262,1423,-1839
2016,4,6,23,1382,3262,1465,-1797
2016,4,7,0,1436,3345,1567,-1778
2016,4,7,1,1509,3364,1547,-1817
2016,4,7,2,1507,3360,1533,-1827
2016,4,7,3,1633,3386,1486,-1900
2016,4,7,4,1632,3531,1581,-1950
2016,4,7,5,1542,3318,1454,-1864
2016,4,7,6,1633,3024,1405,-1619
2016,4,7,7,1503,2816,1492,-1324
2016,4,7,8,1486,2721,1577,-1144
2016,4,7,9,1447,2641,1552,-1089
2016,4,7,10,1472,2521,1512,-1009
2016,4,7,11,1232,2317,1514,-803
2016,4,7,12,1461,2529,1630,-899
2016,4,7,13,1975,3015,1866,-1149
2016,4,7,14,2196,3331,1966,-1365
2016,4,7,15,2325,3498,2114,-1384
2016,4,7,16,2329,3519,2133,-1386
2016,4,7,17,2337,3488,2121,-1367
2016,4,7,18,2204,3457,2036,-1421
2016,4,7,19,2129,3429,2051,-1378
2016,4,7,20,2133,3407,2051,-1356
2016,4,7,21,2131,3387,2012,-1375
2016,4,7,22,2129,3378,1973,-1405
2016,4,7,23,2126,3356,2013,-1343
2016,4,8,0,2122,3361,1976,-1385
2016,4,8,1,2191,3391,1981,-1410
2016,4,8,2,2188,3390,2039,-1351
2016,4,8,3,2187,3402,2018,-1384
2016,4,8,4,2189,3490,2057,-1433
2016,4,8,5,2195,3339,1913,-1426
2016,4,8,6,2125,3082,1851,-1231
2016,4,8,7,2072,2645,1639,-1006
2016,4,8,8,1252,2404,1372,-1032
2016,4,8,9,1372,2380,1295,-1085
2016,4,8,10,1362,2333,1295,-1038
2016,4,8,11,1353,2335,1290,-1045
2016,4,8,12,1347,2422,1357,-1065
2016,4,8,13,1579,2631,1514,-1117
2016,4,8,14,1717,2892,1547,-1345
2016,4,8,15,1985,3112,1687,-1425
2016,4,8,16,1981,3210,1651,-1559
2016,4,8,17,1977,3273,1796,-1477
2016,4,8,18,1970,3294,1898,-1396
2016,4,8,19,1870,3351,1807,-1544
2016,4,8,20,1867,3367,1850,-1517
2016,4,8,21,1865,3349,1901,-1448
2016,4,8,22,1864,3283,1860,-1423
2016,4,8,23,1865,3277,1866,-1411
2016,4,9,0,1866,3275,1859,-1416
2016,4,9,1,1968,3276,1862,-1414
2016,4,9,2,1991,3216,1860,-1356
2016,4,9,3,2016,3176,1873,-1303
2016,4,9,4,2045,3278,1955,-1323
2016,4,9,5,1821,3157,1795,-1362
2016,4,9,6,1789,2968,1672,-1296
2016,4,9,7,1628,2762,1631,-1131
2016,4,9,8,1115,2522,1455,-1067
2016,4,9,9,1083,2399,1374,-1025
2016,4,9,10,1095,2333,1240,-1093
2016,4,9,11,1105,2309,1136,-1173
2016,4,9,12,1108,2319,1125,-1194
2016,4,9,13,946,2284,1087,-1197
2016,4,9,14,929,2354,967,-1387
2016,4,9,15,887,2611,1040,-1571
2016,4,9,16,1090,2982,1128,-1854
2016,4,9,17,1230,3193,1266,-1927
2016,4,9,18,1187,3190,1276,-1914
2016,4,9,19,1169,3152,1292,-1860
2016,4,9,20,1167,3085,1255,-1830
2016,4,9,21,1056,3014,1253,-1761
2016,4,9,22,1059,2954,1251,-1703
2016,4,9,23,1064,2918,1227,-1691
2016,4,10,0,1093,2918,1140,-1778
2016,4,10,1,1273,2977,1184,-1793
2016,4,10,2,1279,2979,1207,-1772
2016,4,10,3,1279,3011,1239,-1772
2016,4,10,4,1276,3139,1306,-1833
2016,4,10,5,1270,3095,1364,-1731
2016,4,10,6,1261,3101,1470,-1631
2016,4,10,7,1258,2744,1251,-1493
2016,4,10,8,808,2405,963,-1442
2016,4,10,9,761,2233,829,-1404
2016,4,10,10,605,2112,736,-1376
2016,4,10,11,605,2059,595,-1464
2016,4,10,12,605,2096,617,-1479
2016,4,10,13,961,2226,747,-1479
2016,4,10,14,937,2329,635,-1694
2016,4,10,15,1032,2577,845,-1732
2016,4,10,16,1260,2841,1050,-1791
2016,4,10,17,1329,3137,1284,-1853
2016,4,10,18,1333,3096,1212,-1884
2016,4,10,19,1336,3135,1266,-1869
2016,4,10,20,1337,3146,1293,-1853
2016,4,10,21,1271,3134,1326,-1808
2016,4,10,22,1268,3095,1346,-1749
2016,4,10,23,1265,3124,1359,-1765
2016,4,11,0,1264,3163,1383,-1780
2016,4,11,1,1309,3237,1411,-1826
2016,4,11,2,1372,3287,1418,-1869
2016,4,11,3,1374,3362,1443,-1919
2016,4,11,4,1375,3507,1544,-1963
2016,4,11,5,1375,3241,1450,-1791
2016,4,11,6,1330,2973,1385,-1588
2016,4,11,7,1264,2695,1274,-1421
2016,4,11,8,909,2379,1149,-1230
2016,4,11,9,910,2290,1158,-1132
2016,4,11,10,1006,2265,1297,-968
2016,4,11,11,980,2277,1305,-972
2016,4,11,12,1109,2374,1351,-1023
2016,4,11,13,1550,2687,1479,-1208
2016,4,11,14,1558,3202,1467,-1735
2016,4,11,15,1856,3335,1595,-1740
2016,4,11,16,1866,3323,1669,-1654
2016,4,11,17,1858,3343,1684,-1659
2016,4,11,18,1628,3268,1605,-1663
2016,4,11,19,1505,3216,1532,-1684
2016,4,11,20,1493,3168,1443,-1725
2016,4,11,21,1487,3128,1458,-1670
2016,4,11,22,1490,3082,1477,-1605
2016,4,11,23,1499,3070,1442,-1628
2016,4,12,0,1515,3085,1412,-1673
2016,4,12,1,1583,3143,1365,-1778
2016,4,12,2,1666,3187,1360,-1827
2016,4,12,3,1798,3289,1522,-1767
2016,4,12,4,1839,3320,1526,-1794
2016,4,12,5,1867,3154,1517,-1637
2016,4,12,6,1430,2862,1321,-1541
2016,4,12,7,1178,2582,1162,-1420
2016,4,12,8,1173,2386,1040,-1346
2016,4,12,9,1170,2344,1170,-1174
2016,4,12,10,1162,2333,1266,-1067
2016,4,12,11,1158,2362,1285,-1077
2016,4,12,12,1158,2574,1363,-1211
2016,4,12,13,1158,2994,1414,-1580
2016,4,12,14,1424,3405,1587,-1818
2016,4,12,15,1592,3637,1643,-1994
2016,4,12,16,1592,3675,1657,-2018
2016,4,12,17,1511,3520,1515,-2005
2016,4,12,18,1503,3440,1517,-1923
2016,4,12,19,1397,3322,1476,-1846
2016,4,12,20,1365,3298,1447,-1851
2016,4,12,21,1340,3449,1595,-1854
2016,4,12,22,1324,3444,1522,-1922
2016,4,12,23,1323,3482,1556,-1926
2016,4,13,0,1331,3576,1627,-1949
2016,4,13,1,1329,3687,1586,-2101
2016,4,13,2,1486,3754,1797,-1957
2016,4,13,3,1473,3793,1713,-2080
2016,4,13,4,1458,3756,1677,-2079
2016,4,13,5,1453,3527,1673,-1854
2016,4,13,6,1118,3222,1586,-1636
2016,4,13,7,1111,2707,1256,-1451
2016,4,13,8,1076,2540,1226,-1314
2016,4,13,9,1065,2466,1181,-1285
2016,4,13,10,1058,2406,1143,-1263
2016,4,13,11,1052,2455,1213,-1242
2016,4,13,12,1088,2617,1263,-1354
2016,4,13,13,1305,2887,1334,-1553
2016,4,13,14,1671,3277,1423,-1854
2016,4,13,15,1702,3694,1663,-2031
2016,4,13,16,1678,3683,1717,-1966
2016,4,13,17,1656,3533,1526,-2007
2016,4,13,18,1545,3446,1386,-2060
2016,4,13,19,1538,3412,1420,-1992
2016,4,13,20,1493,3278,1260,-2018
2016,4,13,21,1501,3244,1317,-1927
2016,4,13,22,1518,3224,1461,-1763
2016,4,13,23,1525,3211,1418,-1793
2016,4,14,0,1563,3170,1390,-1780
2016,4,14,1,1600,3217,1363,-1854
2016,4,14,2,1678,3405,1494,-1911
2016,4,14,3,1667,3529,1718,-1811
2016,4,14,4,1662,3674,1863,-1811
2016,4,14,5,1661,3492,1726,-1766
2016,4,14,6,1656,3237,1735,-1502
2016,4,14,7,1382,2682,1413,-1269
2016,4,14,8,1050,2512,1133,-1379
2016,4,14,9,988,2433,1057,-1376
2016,4,14,10,982,2408,1030,-1378
2016,4,14,11,986,2438,1066,-1372
2016,4,14,12,1079,2647,1130,-1517
2016,4,14,13,1296,2994,1400,-1594
2016,4,14,14,1405,3462,1566,-1896
2016,4,14,15,1405,3652,1582,-2070
2016,4,14,16,1479,3647,1565,-2082
2016,4,14,17,1294,3571,1500,-2071
2016,4,14,18,1291,3445,1436,-2009
2016,4,14,19,1289,3408,1467,-1941
2016,4,14,20,1196,3345,1310,-2035
2016,4,14,21,1198,3299,1251,-2048
2016,4,14,22,1203,3181,1191,-1990
2016,4,14,23,1215,3150,1234,-1916
2016,4,15,0,1226,3221,1285,-1936
2016,4,15,1,1244,3305,1404,-1901
2016,4,15,2,1349,3303,1327,-1976
2016,4,15,3,1449,3349,1458,-1891
2016,4,15,4,1474,3488,1546,-1942
2016,4,15,5,1411,3352,1468,-1884
2016,4,15,6,1202,3055,1353,-1702
2016,4,15,7,1196,2598,988,-1610
2016,4,15,8,968,2447,969,-1478
2016,4,15,9,985,2367,953,-1414
2016,4,15,10,992,2316,895,-1421
2016,4,15,11,991,2352,928,-1424
2016,4,15,12,981,2463,891,-1572
2016,4,15,13,967,2787,937,-1850
2016,4,15,14,1080,3275,1095,-2180
2016,4,15,15,1283,3486,1321,-2165
2016,4,15,16,1271,3505,1313,-2192
2016,4,15,17,1259,3364,1161,-2203
2016,4,15,18,1173,3319,1144,-2175
2016,4,15,19,1088,3284,1073,-2211
2016,4,15,20,1097,3253,1059,-2194
2016,4,15,21,1113,3195,1039,-2156
2016,4,15,22,1132,3125,1078,-2047
2016,4,15,23,1154,3101,1064,-2037
2016,4,16,0,1175,3092,1072,-2020
2016,4,16,1,1190,3113,1099,-2014
2016,4,16,2,1325,3107,1119,-1988
2016,4,16,3,1328,3137,1149,-1988
2016,4,16,4,1368,3317,1269,-2048
2016,4,16,5,1368,3223,1214,-2009
2016,4,16,6,1147,2958,1156,-1802
2016,4,16,7,1118,2626,1006,-1620
2016,4,16,8,999,2467,1009,-1458
2016,4,16,9,957,2386,947,-1439
2016,4,16,10,918,2403,998,-1405
2016,4,16,11,1017,2526,1051,-1475
2016,4,16,12,997,2664,1116,-1548
2016,4,16,13,1032,2817,1176,-1641
2016,4,16,14,1110,3015,1186,-1829
2016,4,16,15,1109,3274,1357,-1917
2016,4,16,16,1196,3388,1382,-2006
2016,4,16,17,1196,3470,1400,-2070
2016,4,16,18,1196,3331,1273,-2058
2016,4,16,19,1155,3246,1282,-1964
2016,4,16,20,1075,2998,1122,-1876
2016,4,16,21,1029,2843,1014,-1829
2016,4,16,22,1030,2753,972,-1781
2016,4,16,23,1030,2724,967,-1757
2016,4,17,0,1029,2738,998,-1740
2016,4,17,1,1029,2776,1005,-1771
2016,4,17,2,1029,2802,1016,-1786
2016,4,17,3,1109,2896,1022,-1874
2016,4,17,4,1155,3185,1243,-1942
2016,4,17,5,1155,3109,1187,-1922
2016,4,17,6,1150,2959,1187,-1772
2016,4,17,7,1095,2603,1042,-1561
2016,4,17,8,918,2370,951,-1419
2016,4,17,9,909,2277,940,-1337
2016,4,17,10,903,2245,939,-1306
2016,4,17,11,899,2243,975,-1268
2016,4,17,12,901,2286,996,-1290
2016,4,17,13,907,2384,931,-1453
2016,4,17,14,912,2533,963,-1570
2016,4,17,15,924,2710,981,-1729
2016,4,17,16,978,2865,1040,-1825
2016,4,17,17,985,3007,1192,-1815
2016,4,17,18,991,2991,1153,-1838
2016,4,17,19,995,2862,1059,-1803
2016,4,17,20,995,2834,1048,-1786
2016,4,17,21,993,2793,1029,-1764
2016,4,17,22,992,2773,1033,-1740
2016,4,17,23,991,2782,1045,-1737
2016,4,18,0,992,2839,1035,-1804
2016,4,18,1,1120,2969,1088,-1881
2016,4,18,2,1230,3086,1160,-1926
2016,4,18,3,1228,3189,1175,-2014
2016,4,18,4,1230,3404,1310,-2094
2016,4,18,5,1238,3280,1273,-2007
2016,4,18,6,1120,3002,1273,-1729
2016,4,18,7,998,2574,1103,-1471
2016,4,18,8,997,2312,965,-1347
2016,4,18,9,950,2167,904,-1263
2016,4,18,10,958,2140,939,-1201
2016,4,18,11,969,2135,922,-1213
2016,4,18,12,1003,2253,934,-1319
2016,4,18,13,1032,2663,1102,-1561
2016,4,18,14,1059,2968,1063,-1905
2016,4,18,15,1208,3220,1186,-2034
2016,4,18,16,1334,3299,1236,-2063
2016,4,18,17,1332,3297,1204,-2093
2016,4,18,18,1329,3347,1293,-2054
2016,4,18,19,1321,3374,1311,-2063
2016,4,18,20,1311,3417,1294,-2123
2016,4,18,21,1297,3443,1364,-2079
2016,4,18,22,1283,3469,1396,-2073
2016,4,18,23,1271,3502,1434,-2068
2016,4,19,0,1347,3558,1498,-2060
2016,4,19,1,1338,3617,1532,-2085
2016,4,19,2,1331,3615,1505,-2110
2016,4,19,3,1325,3594,1466,-2128
2016,4,19,4,1320,3652,1507,-2145
2016,4,19,5,1316,3471,1445,-2026
2016,4,19,6,1308,3145,1343,-1802
2016,4,19,7,1040,2633,1146,-1487
2016,4,19,8,974,2313,975,-1338
2016,4,19,9,973,2202,1012,-1190
2016,4,19,10,972,2162,1029,-1133
2016,4,19,11,971,2133,990,-1143
2016,4,19,12,975,2215,1031,-1184
2016,4,19,13,1070,2444,1118,-1326
2016,4,19,14,1295,2936,1328,-1608
2016,4,19,15,1405,3149,1378,-1771
2016,4,19,16,1485,3229,1407,-1822
2016,4,19,17,1486,3256,1403,-1853
2016,4,19,18,1486,3303,1427,-1876
2016,4,19,19,1486,3350,1433,-1917
2016,4,19,20,1486,3399,1491,-1908
2016,4,19,21,1486,3441,1496,-1945
2016,4,19,22,1511,3489,1515,-1974
2016,4,19,23,1511,3501,1544,-1957
2016,4,20,0,1598,3534,1601,-1933
2016,4,20,1,1598,3565,1654,-1911
2016,4,20,2,1598,3602,1660,-1942
2016,4,20,3,1598,3557,1628,-1929
2016,4,20,4,1598,3554,1655,-1899
2016,4,20,5,1608,3384,1513,-1871
2016,4,20,6,1478,3074,1478,-1596
2016,4,20,7,1138,2532,1181,-1351
2016,4,20,8,1086,2320,1141,-1179
2016,4,20,9,1086,2209,1151,-1058
2016,4,20,10,1086,2142,1108,-1034
2016,4,20,11,1085,2146,1145,-1001
2016,4,20,12,1085,2221,1165,-1056
2016,4,20,13,1256,2523,1301,-1222
2016,4,20,14,1511,2709,1278,-1431
2016,4,20,15,1517,3136,1425,-1711
2016,4,20,16,1520,3219,1430,-1789
2016,4,20,17,1525,3256,1413,-1843
2016,4,20,18,1519,3317,1435,-1882
2016,4,20,19,1524,3357,1528,-1829
2016,4,20,20,1525,3388,1546,-1842
2016,4,20,21,1525,3406,1552,-1854
2016,4,20,22,1622,3437,1615,-1822
2016,4,20,23,1622,3474,1662,-1812
2016,4,21,0,1621,3509,1680,-1829
2016,4,21,1,1699,3531,1652,-1879
2016,4,21,2,1695,3504,1649,-1855
2016,4,21,3,1691,3453,1637,-1816
2016,4,21,4,1607,3519,1667,-1852
2016,4,21,5,1606,3260,1485,-1775
2016,4,21,6,1350,2792,1242,-1550
2016,4,21,7,1349,2490,1106,-1384
2016,4,21,8,842,2303,1074,-1229
2016,4,21,9,849,2190,1055,-1135
2016,4,21,10,850,2145,1089,-1056
2016,4,21,11,852,2157,1034,-1123
2016,4,21,12,846,2229,983,-1246
2016,4,21,13,997,2439,1051,-1388
2016,4,21,14,1314,2871,1258,-1613
2016,4,21,15,1441,3112,1279,-1833
2016,4,21,16,1440,3130,1260,-1870
2016,4,21,17,1439,2968,1067,-1901
2016,4,21,18,1359,3003,1128,-1875
2016,4,21,19,1359,3200,1307,-1893
2016,4,21,20,1361,3275,1389,-1886
2016,4,21,21,1365,3278,1426,-1852
2016,4,21,22,1372,3286,1422,-1864
2016,4,21,23,1383,3282,1435,-1847
2016,4,22,0,1394,3314,1448,-1866
2016,4,22,1,1473,3350,1467,-1883
2016,4,22,2,1469,3360,1487,-1873
2016,4,22,3,1458,3370,1512,-1858
2016,4,22,4,1451,3461,1623,-1838
2016,4,22,5,1368,3346,1499,-1847
2016,4,22,6,1106,3038,1343,-1695
2016,4,22,7,1106,2477,1132,-1345
2016,4,22,8,1031,2283,1128,-1155
2016,4,22,9,992,2198,1089,-1109
2016,4,22,10,992,2142,995,-1147
2016,4,22,11,992,2137,931,-1206
2016,4,22,12,993,2177,888,-1289
2016,4,22,13,994,2404,1015,-1389
2016,4,22,14,994,2774,1054,-1720
2016,4,22,15,1254,2941,1103,-1838
2016,4,22,16,1253,3120,1210,-1910
2016,4,22,17,1252,3145,1165,-1980
2016,4,22,18,1251,3162,1195,-1967
2016,4,22,19,1253,3170,1260,-1910
2016,4,22,20,1258,3154,1275,-1879
2016,4,22,21,1268,3091,1272,-1819
2016,4,22,22,1027,3105,1287,-1818
2016,4,22,23,1192,3082,1307,-1775
2016,4,23,0,1109,2880,1051,-1829
2016,4,23,1,1157,2892,1035,-1857
2016,4,23,2,1199,2876,1044,-1832
2016,4,23,3,1223,2856,1073,-1783
2016,4,23,4,1232,2889,1083,-1806
2016,4,23,5,1237,2801,1104,-1697
2016,4,23,6,1240,2628,1110,-1518
2016,4,23,7,1244,2405,1107,-1298
2016,4,23,8,1041,2225,1027,-1198
2016,4,23,9,1042,2161,1147,-1014
2016,4,23,10,1037,2111,1143,-968
2016,4,23,11,1035,2081,1091,-990
2016,4,23,12,1034,2106,1070,-1036
2016,4,23,13,1033,2180,1062,-1118
2016,4,23,14,1033,2292,1026,-1266
2016,4,23,15,1073,2519,1103,-1416
2016,4,23,16,1074,2723,1133,-1590
2016,4,23,17,1075,2830,1128,-1702
2016,4,23,18,1076,2857,1178,-1679
2016,4,23,19,1077,2797,1133,-1664
2016,4,23,20,1078,2789,1171,-1618
2016,4,23,21,1078,2714,1139,-1575
2016,4,23,22,1078,2652,1098,-1554
2016,4,23,23,1078,2628,1100,-1528
2016,4,24,0,1078,2642,1153,-1489
2016,4,24,1,1078,2721,1227,-1494
2016,4,24,2,1077,2735,1256,-1479
2016,4,24,3,1077,2768,1268,-1500
2016,4,24,4,1077,2831,1269,-1562
2016,4,24,5,1078,2753,1231,-1522
2016,4,24,6,1078,2577,1181,-1396
2016,4,24,7,1078,2377,1135,-1242
2016,4,24,8,1038,2224,1152,-1072
2016,4,24,9,1039,2134,1148,-986
2016,4,24,10,1039,2085,1152,-933
2016,4,24,11,1039,2074,1155,-919
2016,4,24,12,1041,2089,1146,-943
2016,4,24,13,1043,2165,1138,-1027
2016,4,24,14,1046,2272,1115,-1157
2016,4,24,15,1098,2487,1175,-1312
2016,4,24,16,1098,2717,1205,-1512
2016,4,24,17,1098,2868,1245,-1623
2016,4,24,18,1098,2933,1202,-1731
2016,4,24,19,1098,2963,1166,-1797
2016,4,24,20,1098,2984,1157,-1827
2016,4,24,21,1098,2916,976,-1940
2016,4,24,22,1098,2848,884,-1964
2016,4,24,23,1098,2791,811,-1980
2016,4,25,0,1098,2863,977,-1886
2016,4,25,1,1098,2971,955,-2016
2016,4,25,2,1098,2990,914,-2076
2016,4,25,3,1098,3115,1035,-2080
2016,4,25,4,1098,3377,1178,-2199
2016,4,25,5,1098,3276,1154,-2122
2016,4,25,6,1098,2843,995,-1848
2016,4,25,7,1098,2513,978,-1535
2016,4,25,8,1060,2358,918,-1440
2016,4,25,9,1049,2269,851,-1418
2016,4,25,10,1037,2253,852,-1401
2016,4,25,11,1026,2292,853,-1439
2016,4,25,12,1131,2467,974,-1493
2016,4,25,13,1146,2895,1119,-1776
2016,4,25,14,1422,3359,1241,-2118
2016,4,25,15,1438,3558,1258,-2300
2016,4,25,16,1430,3563,1281,-2282
2016,4,25,17,1419,3489,1286,-2203
2016,4,25,18,1414,3457,1333,-2124
2016,4,25,19,1305,3384,1324,-2060
2016,4,25,20,1212,3337,1363,-1974
2016,4,25,21,1244,3327,1398,-1929
2016,4,25,22,1250,3263,1439,-1824
2016,4,25,23,1253,3047,1315,-1732
2016,4,26,0,1255,2998,1301,-1697
2016,4,26,1,1255,3039,1288,-1751
2016,4,26,2,1255,3062,1254,-1808
2016,4,26,3,1385,3204,1360,-1844
2016,4,26,4,1385,3348,1426,-1922
2016,4,26,5,1385,3243,1411,-1832
2016,4,26,6,1255,3015,1420,-1595
2016,4,26,7,1255,2586,1185,-1401
2016,4,26,8,1119,2435,1108,-1327
2016,4,26,9,1083,2371,1049,-1322
2016,4,26,10,1054,2357,995,-1362
2016,4,26,11,1089,2450,1066,-1384
2016,4,26,12,1035,2643,1115,-1528
2016,4,26,13,1214,3113,1278,-1835
2016,4,26,14,1190,3252,1066,-2186
2016,4,26,15,1267,3643,1277,-2366
2016,4,26,16,1254,3586,1238,-2348
2016,4,26,17,1246,3381,1148,-2233
2016,4,26,18,1154,3289,1130,-2159
2016,4,26,19,1152,3193,1060,-2133
2016,4,26,20,1153,3245,1154,-2091
2016,4,26,21,1155,3240,1214,-2026
2016,4,26,22,1158,3203,1216,-1987
2016,4,26,23,1162,3174,1213,-1961
2016,4,27,0,1255,3221,1217,-2004
2016,4,27,1,1304,3342,1322,-2020
2016,4,27,2,1318,3377,1399,-1978
2016,4,27,3,1329,3414,1391,-2023
2016,4,27,4,1341,3513,1439,-2074
2016,4,27,5,1349,3366,1421,-1945
2016,4,27,6,1349,3087,1413,-1674
2016,4,27,7,1046,2777,1343,-1434
2016,4,27,8,1072,2479,1070,-1409
2016,4,27,9,955,2298,925,-1373
2016,4,27,10,950,2273,947,-1326
2016,4,27,11,941,2293,939,-1354
2016,4,27,12,925,2411,914,-1497
2016,4,27,13,924,2908,1167,-1741
2016,4,27,14,896,3052,1023,-2029
2016,4,27,15,1074,3352,1157,-2195
2016,4,27,16,1196,3422,1215,-2207
2016,4,27,17,1193,3224,1051,-2173
2016,4,27,18,1193,3182,1056,-2126
2016,4,27,19,1063,3213,1126,-2087
2016,4,27,20,1063,3174,1097,-2077
2016,4,27,21,1063,3153,1115,-2038
2016,4,27,22,1063,3119,1078,-2041
2016,4,27,23,1063,3108,1071,-2037
2016,4,28,0,1062,3114,1072,-2042
2016,4,28,1,1065,3171,1088,-2083
2016,4,28,2,1073,3179,1109,-2070
2016,4,28,3,1214,3212,1136,-2076
2016,4,28,4,1224,3418,1262,-2156
2016,4,28,5,1229,3321,1234,-2087
2016,4,28,6,1009,3060,1246,-1814
2016,4,28,7,1007,2779,1218,-1561
2016,4,28,8,932,2391,1057,-1334
2016,4,28,9,1028,2397,1102,-1295
2016,4,28,10,1023,2360,1090,-1270
2016,4,28,11,1017,2379,1086,-1293
2016,4,28,12,1169,2612,1122,-1490
2016,4,28,13,1197,2894,1163,-1731
2016,4,28,14,1156,3134,1080,-2054
2016,4,28,15,1191,3475,1238,-2237
2016,4,28,16,1196,3488,1267,-2221
2016,4,28,17,1203,3335,1173,-2162
2016,4,28,18,1240,3318,1203,-2115
2016,4,28,19,1138,3223,1173,-2050
2016,4,28,20,1142,3142,1169,-1973
2016,4,28,21,1163,3153,1176,-1977
2016,4,28,22,1052,3031,1148,-1883
2016,4,28,23,1170,2967,1160,-1807
2016,4,29,0,1227,3021,1207,-1814
2016,4,29,1,1065,3195,1189,-2006
2016,4,29,2,1076,3087,1115,-1972
2016,4,29,3,1183,3107,1184,-1923
2016,4,29,4,1190,3140,1159,-1981
2016,4,29,5,1191,3025,1129,-1896
2016,4,29,6,1221,2910,1316,-1594
2016,4,29,7,1134,2548,1204,-1344
2016,4,29,8,1275,2567,1328,-1239
2016,4,29,9,1201,2436,1203,-1233
2016,4,29,10,1201,2395,1172,-1223
2016,4,29,11,1049,2271,1050,-1221
2016,4,29,12,1042,2454,1085,-1369
2016,4,29,13,1029,2871,1229,-1642
2016,4,29,14,1011,3200,1162,-2038
2016,4,29,15,1062,3455,1214,-2241
2016,4,29,16,1053,3546,1267,-2279
2016,4,29,17,979,3500,1251,-2249
2016,4,29,18,1001,3487,1210,-2277
2016,4,29,19,1012,3442,1194,-2248
2016,4,29,20,1041,3398,1252,-2146
2016,4,29,21,1066,3329,1247,-2082
2016,4,29,22,1078,3253,1221,-2032
2016,4,29,23,1082,3190,1243,-1947
2016,4,30,0,1083,3042,1229,-1813
2016,4,30,1,1083,3048,1261,-1787
2016,4,30,2,1082,3018,1252,-1766
2016,4,30,3,1080,2994,1179,-1815
2016,4,30,4,1077,3065,1164,-1901
2016,4,30,5,1069,3009,1138,-1871
2016,4,30,6,1058,3104,1466,-1638
2016,4,30,7,1045,2880,1393,-1487
2016,4,30,8,1352,2684,1298,-1386
2016,4,30,9,1278,2526,1140,-1386
2016,4,30,10,1297,2575,1312,-1263
2016,4,30,11,1247,2516,1122,-1394
2016,4,30,12,1019,2410,989,-1421
2016,4,30,13,1191,2551,988,-1563
2016,4,30,14,1161,2608,917,-1691
2016,4,30,15,1134,2792,890,-1902
2016,4,30,16,1109,3133,1101,-2032
2016,4,30,17,1093,3183,1088,-2095
2016,4,30,18,1086,3158,1096,-2062
2016,4,30,19,1084,3080,1049,-2031
2016,4,30,20,1083,3051,1127,-1924
2016,4,30,21,1083,2990,1133,-1857
2016,4,30,22,1083,2921,1139,-1782
2016,4,30,23,1083,2853,1080,-1773
2016,5,1,0,1083,2869,1144,-1725
2016,5,1,1,1085,2984,1185,-1799
2016,5,1,2,1089,3007,1216,-1791
2016,5,1,3,1134,3035,1213,-1822
2016,5,1,4,1133,3073,1151,-1922
2016,5,1,5,1133,3153,1332,-1821
2016,5,1,6,1137,2882,1256,-1626
2016,5,1,7,1150,2668,1214,-1454
2016,5,1,8,1166,2561,1159,-1402
2016,5,1,9,1161,2461,1123,-1338
2016,5,1,10,1125,2367,1085,-1282
2016,5,1,11,1109,2346,1080,-1266
2016,5,1,12,1147,2405,1115,-1290
2016,5,1,13,1179,2544,1189,-1355
2016,5,1,14,984,2674,1213,-1461
2016,5,1,15,1246,2877,1321,-1556
2016,5,1,16,1246,3028,1531,-1497
2016,5,1,17,1289,3104,1568,-1536
2016,5,1,18,1291,3086,1460,-1626
2016,5,1,19,1295,3059,1485,-1574
2016,5,1,20,1297,3029,1477,-1552
2016,5,1,21,1257,3009,1483,-1526
2016,5,1,22,1267,2858,1328,-1530
2016,5,1,23,1337,2884,1359,-1525
2016,5,2,0,1413,3088,1530,-1558
2016,5,2,1,1507,3220,1662,-1558
2016,5,2,2,1475,3337,1813,-1524
2016,5,2,3,1498,3303,1801,-1502
2016,5,2,4,1472,3304,1783,-1521
2016,5,2,5,1450,3244,1753,-1491
2016,5,2,6,1441,2937,1543,-1394
2016,5,2,7,1387,2707,1380,-1327
2016,5,2,8,1208,2449,1224,-1225
2016,5,2,9,1005,2175,1072,-1103
2016,5,2,10,1005,2116,1035,-1081
2016,5,2,11,1006,2124,1051,-1073
2016,5,2,12,1090,2227,1114,-1113
2016,5,2,13,1362,2660,1324,-1336
2016,5,2,14,1426,2729,1149,-1580
2016,5,2,15,1487,3182,1448,-1734
2016,5,2,16,1511,3264,1435,-1829
2016,5,2,17,1507,3309,1450,-1859
2016,5,2,18,1504,3368,1499,-1869
2016,5,2,19,1500,3406,1550,-1856
2016,5,2,20,1494,3493,1615,-1878
2016,5,2,21,1492,3540,1662,-1878
2016,5,2,22,1487,3569,1731,-1838
2016,5,2,23,1528,3600,1781,-1819
2016,5,3,0,1525,3626,1777,-1849
2016,5,3,1,1562,3667,1821,-1846
2016,5,3,2,1559,3617,1780,-1837
2016,5,3,3,1556,3554,1742,-1812
2016,5,3,4,1555,3564,1707,-1857
2016,5,3,5,1517,3325,1621,-1704
2016,5,3,6,1518,3146,1626,-1520
2016,5,3,7,1474,2749,1452,-1297
2016,5,3,8,1120,2608,1532,-1076
2016,5,3,9,1171,2313,1372,-941
2016,5,3,10,1054,2219,1275,-944
2016,5,3,11,1059,2175,1256,-919
2016,5,3,12,1183,2246,1314,-932
2016,5,3,13,1131,2601,1447,-1154
2016,5,3,14,1169,2866,1475,-1391
2016,5,3,15,1439,3138,1563,-1575
2016,5,3,16,1486,3214,1598,-1616
2016,5,3,17,1539,3228,1593,-1635
2016,5,3,18,1531,3275,1635,-1640
2016,5,3,19,1569,3308,1674,-1634
2016,5,3,20,1717,3379,1737,-1642
2016,5,3,21,1790,3401,1813,-1588
2016,5,3,22,1789,3400,1822,-1578
2016,5,3,23,1763,3401,1816,-1585
2016,5,4,0,1768,3409,1777,-1632
2016,5,4,1,1775,3406,1747,-1659
2016,5,4,2,1802,3372,1760,-1612
2016,5,4,3,1789,3303,1778,-1525
2016,5,4,4,1629,3356,1797,-1559
2016,5,4,5,1476,3182,1657,-1525
2016,5,4,6,1419,2918,1692,-1226
2016,5,4,7,1304,2534,1524,-1010
2016,5,4,8,1167,2216,1401,-815
2016,5,4,9,1171,2116,1345,-771
2016,5,4,10,1150,2080,1284,-796
2016,5,4,11,1120,2084,1285,-799
2016,5,4,12,1344,2339,1409,-930
2016,5,4,13,1301,2657,1674,-983
2016,5,4,14,1326,2907,1566,-1341
2016,5,4,15,1309,3109,1512,-1597
2016,5,4,16,1372,3148,1556,-1592
2016,5,4,17,1419,3174,1557,-1617
2016,5,4,18,1413,3191,1555,-1636
2016,5,4,19,1450,3166,1546,-1620
2016,5,4,20,1518,3148,1554,-1594
2016,5,4,21,1518,3123,1562,-1561
2016,5,4,22,1522,3113,1551,-1562
2016,5,4,23,1538,3118,1614,-1504
2016,5,5,0,1552,3162,1623,-1539
2016,5,5,1,1559,3237,1619,-1618
2016,5,5,2,1559,3280,1617,-1663
2016,5,5,3,1550,3290,1540,-1750
2016,5,5,4,1546,3346,1600,-1746
2016,5,5,5,1548,3265,1627,-1638
2016,5,5,6,1592,2713,1253,-1460
2016,5,5,7,1602,2480,1412,-1068
2016,5,5,8,1160,2310,1305,-1005
2016,5,5,9,1141,2234,1223,-1011
2016,5,5,10,1131,2198,1174,-1024
2016,5,5,11,1112,2213,1179,-1034
2016,5,5,12,1370,2491,1359,-1132
2016,5,5,13,1359,2806,1556,-1250
2016,5,5,14,1259,3066,1471,-1595
2016,5,5,15,1385,3283,1649,-1634
2016,5,5,16,1517,3268,1550,-1718
2016,5,5,17,1516,3247,1547,-1700
2016,5,5,18,1515,3241,1516,-1725
2016,5,5,19,1516,3238,1575,-1663
2016,5,5,20,1516,3225,1581,-1644
2016,5,5,21,1516,3182,1607,-1575
2016,5,5,22,1608,3147,1641,-1506
2016,5,5,23,1641,3097,1607,-1490
2016,5,6,0,1553,3079,1585,-1494
2016,5,6,1,1612,3091,1547,-1544
2016,5,6,2,1625,3085,1596,-1489
2016,5,6,3,1639,3073,1617,-1456
2016,5,6,4,1658,3121,1643,-1478
2016,5,6,5,1667,3100,1600,-1500
2016,5,6,6,1678,2829,1583,-1246
2016,5,6,7,1512,2563,1523,-1040
2016,5,6,8,1199,2255,1264,-991
2016,5,6,9,1172,2155,1245,-910
2016,5,6,10,1186,2114,1281,-833
2016,5,6,11,1199,2133,1287,-846
2016,5,6,12,1212,2218,1295,-923
2016,5,6,13,1214,2559,1417,-1142
2016,5,6,14,1258,2831,1381,-1450
2016,5,6,15,1468,3024,1404,-1620
2016,5,6,16,1468,3051,1458,-1593
2016,5,6,17,1466,3054,1478,-1576
2016,5,6,18,1463,3076,1537,-1539
2016,5,6,19,1459,3079,1615,-1464
2016,5,6,20,1452,3087,1583,-1504
2016,5,6,21,1439,3090,1606,-1484
2016,5,6,22,1423,3076,1578,-1498
2016,5,6,23,1403,3095,1582,-1513
2016,5,7,0,1421,3095,1469,-1626
2016,5,7,1,1428,3115,1469,-1646
2016,5,7,2,1394,3057,1441,-1616
2016,5,7,3,1369,3013,1432,-1581
2016,5,7,4,1353,3002,1406,-1596
2016,5,7,5,1346,2980,1300,-1680
2016,5,7,6,1354,2791,1396,-1395
2016,5,7,7,1127,2558,1258,-1300
2016,5,7,8,1025,2358,1175,-1183
2016,5,7,9,925,2169,1038,-1131
2016,5,7,10,947,2075,982,-1093
2016,5,7,11,943,2053,985,-1068
2016,5,7,12,882,2066,966,-1100
2016,5,7,13,871,2124,969,-1155
2016,5,7,14,895,2146,735,-1411
2016,5,7,15,877,2369,760,-1609
2016,5,7,16,862,2603,882,-1721
2016,5,7,17,985,2824,1025,-1799
2016,5,7,18,978,2898,1054,-1844
2016,5,7,19,975,2911,1030,-1881
2016,5,7,20,975,2908,1072,-1836
2016,5,7,21,975,2913,1063,-1850
2016,5,7,22,976,2919,1057,-1862
2016,5,7,23,1006,2943,1125,-1818
2016,5,8,0,1055,2994,1152,-1842
2016,5,8,1,1110,2996,1210,-1786
2016,5,8,2,1171,2960,1227,-1733
2016,5,8,3,1205,2853,1143,-1710
2016,5,8,4,1221,2859,1124,-1735
2016,5,8,5,1230,2801,1052,-1749
2016,5,8,6,1233,2775,1279,-1496
2016,5,8,7,1103,2473,1215,-1258
2016,5,8,8,985,2220,1147,-1073
2016,5,8,9,983,2116,1175,-941
2016,5,8,10,980,2032,1133,-899
2016,5,8,11,973,2003,1105,-898
2016,5,8,12,972,1992,983,-1009
2016,5,8,13,999,2048,1053,-995
2016,5,8,14,977,2111,958,-1153
2016,5,8,15,1005,2343,1209,-1134
2016,5,8,16,1008,2568,1276,-1292
2016,5,8,17,1039,2703,1225,-1478
2016,5,8,18,1059,2766,1249,-1517
2016,5,8,19,1059,2762,1240,-1522
2016,5,8,20,1099,2703,1097,-1606
2016,5,8,21,1099,2618,985,-1633
2016,5,8,22,1098,2545,913,-1632
2016,5,8,23,1097,2536,952,-1584
2016,5,9,0,1061,2620,1127,-1493
2016,5,9,1,1191,2672,1130,-1542
2016,5,9,2,1192,2745,1282,-1463
2016,5,9,3,1233,2784,1245,-1539
2016,5,9,4,1234,2863,1269,-1594
2016,5,9,5,1234,2824,1269,-1555
2016,5,9,6,1234,2607,1272,-1335
2016,5,9,7,1104,2356,1196,-1160
2016,5,9,8,1051,2195,1188,-1007
2016,5,9,9,1011,2106,1109,-997
2016,5,9,10,1010,2086,1070,-1016
2016,5,9,11,1006,2108,1075,-1033
2016,5,9,12,1008,2236,1064,-1172
2016,5,9,13,1009,2502,1077,-1425
2016,5,9,14,1020,2789,1041,-1748
2016,5,9,15,1147,2968,1048,-1920
2016,5,9,16,1184,2996,1032,-1964
2016,5,9,17,1251,3005,1212,-1793
2016,5,9,18,1312,3007,1269,-1738
2016,5,9,19,1301,2972,1252,-1720
2016,5,9,20,1283,2931,1221,-1710
2016,5,9,21,1313,2917,1194,-1723
2016,5,9,22,1318,2983,1451,-1532
2016,5,9,23,1425,2931,1433,-1498
2016,5,10,0,1437,2994,1492,-1502
2016,5,10,1,1451,3026,1460,-1566
2016,5,10,2,1462,3048,1459,-1589
2016,5,10,3,1458,3128,1486,-1642
2016,5,10,4,1447,3185,1421,-1764
2016,5,10,5,1431,3154,1412,-1742
2016,5,10,6,1582,2900,1476,-1424
2016,5,10,7,1570,2619,1487,-1132
2016,5,10,8,1177,2326,1270,-1056
2016,5,10,9,1172,2239,1174,-1065
2016,5,10,10,1165,2188,1120,-1068
2016,5,10,11,1159,2200,1132,-1068
2016,5,10,12,1154,2350,1247,-1103
2016,5,10,13,1514,2722,1482,-1240
2016,5,10,14,1540,3037,1424,-1613
2016,5,10,15,1590,3209,1549,-1660
2016,5,10,16,1617,3193,1556,-1637
2016,5,10,17,1531,3162,1524,-1638
2016,5,10,18,1532,3148,1510,-1638
2016,5,10,19,1532,3163,1532,-1631
2016,5,10,20,1491,3172,1509,-1663
2016,5,10,21,1577,3179,1551,-1628
2016,5,10,22,1577,3171,1574,-1597
2016,5,10,23,1576,3173,1569,-1604
2016,5,11,0,1576,3202,1590,-1612
2016,5,11,1,1618,3250,1622,-1628
2016,5,11,2,1603,3216,1628,-1588
2016,5,11,3,1609,3201,1606,-1595
2016,5,11,4,1634,3201,1563,-1638
2016,5,11,5,1601,3151,1510,-1641
2016,5,11,6,1665,2886,1671,-1215
2016,5,11,7,1439,2596,1465,-1131
2016,5,11,8,1154,2320,1328,-992
2016,5,11,9,1155,2203,1242,-961
2016,5,11,10,1154,2165,1202,-963
2016,5,11,11,1153,2180,1196,-984
2016,5,11,12,1149,2280,1217,-1063
2016,5,11,13,1144,2487,1232,-1255
2016,5,11,14,1155,2765,1188,-1577
2016,5,11,15,1413,3091,1372,-1719
2016,5,11,16,1452,3143,1408,-1735
2016,5,11,17,1454,3163,1406,-1757
2016,5,11,18,1456,3184,1413,-1771
2016,5,11,19,1458,3216,1486,-1730
2016,5,11,20,1460,3247,1531,-1716
2016,5,11,21,1460,3308,1584,-1724
2016,5,11,22,1459,3318,1580,-1738
2016,5,11,23,1457,3363,1596,-1767
2016,5,12,0,1456,3438,1643,-1795
2016,5,12,1,1457,3485,1641,-1844
2016,5,12,2,1459,3454,1665,-1789
2016,5,12,3,1463,3397,1641,-1756
2016,5,12,4,1469,3383,1615,-1768
2016,5,12,5,1478,3246,1522,-1724
2016,5,12,6,1496,2987,1503,-1484
2016,5,12,7,1347,2639,1152,-1487
2016,5,12,8,1137,2441,1116,-1325
2016,5,12,9,1124,2338,1091,-1247
2016,5,12,10,1078,2248,1052,-1196
2016,5,12,11,1093,2250,1031,-1219
2016,5,12,12,1167,2388,1080,-1308
2016,5,12,13,1161,2573,1057,-1516
2016,5,12,14,1140,2859,1053,-1806
2016,5,12,15,1149,3071,1066,-2005
2016,5,12,16,1121,3137,1173,-1964
2016,5,12,17,1088,3157,1211,-1946
2016,5,12,18,1066,3170,1084,-2086
2016,5,12,19,1053,3182,1050,-2132
2016,5,12,20,1047,3208,1035,-2173
2016,5,12,21,1044,3229,1039,-2190
2016,5,12,22,1047,3319,1114,-2205
2016,5,12,23,1054,3355,1146,-2209
2016,5,13,0,1147,3406,1140,-2266
2016,5,13,1,1232,3256,1114,-2142
2016,5,13,2,1325,3125,1094,-2031
2016,5,13,3,1322,3120,1118,-2002
2016,5,13,4,1314,3106,1160,-1946
2016,5,13,5,1308,3044,1150,-1894
2016,5,13,6,1010,2772,1151,-1621
2016,5,13,7,916,2540,1133,-1407
2016,5,13,8,775,2227,962,-1265
2016,5,13,9,800,2074,993,-1081
2016,5,13,10,836,2021,1005,-1016
2016,5,13,11,880,2055,1064,-991
2016,5,13,12,915,2136,1134,-1002
2016,5,13,13,1071,2424,1254,-1170
2016,5,13,14,1085,2669,1189,-1480
2016,5,13,15,1136,2915,1298,-1617
2016,5,13,16,1157,2946,1356,-1590
2016,5,13,17,1187,3009,1342,-1667
2016,5,13,18,1248,3069,1465,-1604
2016,5,13,19,1241,3101,1482,-1619
2016,5,13,20,1242,3072,1464,-1608
2016,5,13,21,1250,3020,1481,-1539
2016,5,13,22,1283,3023,1528,-1495
2016,5,13,23,1315,3053,1500,-1553
2016,5,14,0,1307,3092,1492,-1600
2016,5,14,1,1304,3082,1497,-1585
2016,5,14,2,1303,2987,1399,-1588
2016,5,14,3,1270,2904,1274,-1630
2016,5,14,4,1288,2880,1291,-1589
2016,5,14,5,1304,2855,1336,-1519
2016,5,14,6,1327,2621,1355,-1266
2016,5,14,7,1157,2410,1304,-1106
2016,5,14,8,884,2198,1173,-1025
2016,5,14,9,873,2055,1073,-982
2016,5,14,10,884,1956,1018,-938
2016,5,14,11,893,1921,1020,-901
2016,5,14,12,898,1973,1121,-852
2016,5,14,13,902,1931,831,-1100
2016,5,14,14,872,2055,939,-1116
2016,5,14,15,873,2196,981,-1215
2016,5,14,16,1059,2429,1056,-1373
2016,5,14,17,1069,2608,1180,-1428
2016,5,14,18,1068,2681,1295,-1386
2016,5,14,19,1065,2703,1362,-1341
2016,5,14,20,1059,2704,1283,-1421
2016,5,14,21,1050,2639,1058,-1581
2016,5,14,22,1038,2623,1011,-1612
2016,5,14,23,1024,2614,1051,-1563
2016,5,15,0,1086,2634,1113,-1521
2016,5,15,1,1047,2652,1041,-1611
2016,5,15,2,1006,2656,885,-1771
2016,5,15,3,964,2663,1061,-1602
2016,5,15,4,947,2673,990,-1683
2016,5,15,5,932,2641,1091,-1550
2016,5,15,6,927,2484,1157,-1327
2016,5,15,7,837,2283,982,-1301
2016,5,15,8,601,2099,830,-1269
2016,5,15,9,604,1991,794,-1197
2016,5,15,10,606,1941,820,-1121
2016,5,15,11,606,1904,772,-1132
2016,5,15,12,607,1915,759,-1156
2016,5,15,13,602,1940,688,-1252
2016,5,15,14,598,2048,747,-1301
2016,5,15,15,709,2233,795,-1438
2016,5,15,16,800,2457,831,-1626
2016,5,15,17,972,2633,847,-1786
2016,5,15,18,1078,2729,915,-1814
2016,5,15,19,1079,2760,956,-1804
2016,5,15,20,1079,2767,909,-1858
2016,5,15,21,981,2740,897,-1843
2016,5,15,22,982,2741,919,-1822
2016,5,15,23,990,2733,860,-1873
2016,5,16,0,1006,2784,928,-1856
2016,5,16,1,1125,2918,1129,-1789
2016,5,16,2,1160,2859,1155,-1704
2016,5,16,3,1186,2874,1277,-1597
2016,5,16,4,1199,2899,1271,-1628
2016,5,16,5,1196,2778,1241,-1537
2016,5,16,6,1188,2512,1262,-1250
2016,5,16,7,1028,2276,1090,-1186
2016,5,16,8,997,2127,1119,-1008
2016,5,16,9,999,2049,1182,-867
2016,5,16,10,992,2020,1159,-861
2016,5,16,11,982,1992,1010,-982
2016,5,16,12,997,2106,1024,-1082
2016,5,16,13,1115,2376,1123,-1253
2016,5,16,14,1102,2688,1167,-1521
2016,5,16,15,1213,2915,1368,-1547
2016,5,16,16,1351,2969,1534,-1435
2016,5,16,17,1342,2961,1566,-1395
2016,5,16,18,1343,2962,1498,-1464
2016,5,16,19,1316,2945,1477,-1468
2016,5,16,20,1320,2916,1462,-1454
2016,5,16,21,1312,2894,1491,-1403
2016,5,16,22,1354,2858,1466,-1392
2016,5,16,23,1378,2844,1451,-1393
2016,5,17,0,1433,2862,1468,-1394
2016,5,17,1,1445,2909,1518,-1391
2016,5,17,2,1462,2913,1564,-1349
2016,5,17,3,1353,2902,1509,-1393
2016,5,17,4,1334,2927,1497,-1430
2016,5,17,5,1335,2864,1480,-1384
2016,5,17,6,1262,2622,1300,-1322
2016,5,17,7,1202,2355,1127,-1228
2016,5,17,8,1043,2230,1180,-1050
2016,5,17,9,1024,2144,1159,-985
2016,5,17,10,1012,2114,1129,-985
2016,5,17,11,1004,2140,1155,-985
2016,5,17,12,999,2215,1096,-1119
2016,5,17,13,996,2434,1097,-1337
2016,5,17,14,1242,2750,1277,-1473
2016,5,17,15,1370,2915,1338,-1577
2016,5,17,16,1370,2915,1338,-1577
2016,5,17,17,1371,2917,1310,-1607
2016,5,17,18,1274,2915,1295,-1620
2016,5,17,19,1276,2933,1313,-1620
2016,5,17,20,1279,2929,1339,-1590
2016,5,17,21,1284,2929,1342,-1587
2016,5,17,22,1292,2920,1353,-1567
2016,5,17,23,1306,2922,1361,-1561
2016,5,18,0,1330,2924,1382,-1542
2016,5,18,1,1459,2954,1430,-1524
2016,5,18,2,1496,2933,1434,-1499
2016,5,18,3,1428,2967,1566,-1401
2016,5,18,4,1444,2980,1542,-1438
2016,5,18,5,1412,2983,1518,-1465
2016,5,18,6,1401,2733,1495,-1238
2016,5,18,7,1308,2453,1409,-1044
2016,5,18,8,1318,2247,1297,-950
2016,5,18,9,1254,2147,1218,-929
2016,5,18,10,1002,2104,1075,-1029
2016,5,18,11,1031,2120,1102,-1018
2016,5,18,12,1090,2212,1166,-1046
2016,5,18,13,1172,2371,1145,-1226
2016,5,18,14,1168,2676,1244,-1432
2016,5,18,15,1287,2912,1436,-1476
2016,5,18,16,1298,2961,1415,-1546
2016,5,18,17,1322,2974,1424,-1550
2016,5,18,18,1452,3005,1462,-1543
2016,5,18,19,1283,3006,1466,-1540
2016,5,18,20,1214,2995,1401,-1594
2016,5,18,21,1232,2986,1499,-1487
2016,5,18,22,1267,2914,1389,-1525
2016,5,18,23,1280,2967,1398,-1569
2016,5,19,0,1187,3001,1398,-1603
2016,5,19,1,1270,3031,1433,-1598
2016,5,19,2,1269,3008,1496,-1512
2016,5,19,3,1267,2963,1421,-1542
2016,5,19,4,1265,3028,1489,-1539
2016,5,19,5,1208,2941,1276,-1665
2016,5,19,6,1285,2762,1485,-1277
2016,5,19,7,1160,2431,1266,-1165
2016,5,19,8,1007,2278,1299,-979
2016,5,19,9,1006,2156,1185,-971
2016,5,19,10,1006,2114,1160,-954
2016,5,19,11,1006,2117,1116,-1003
2016,5,19,12,1006,2201,1095,-1106
2016,5,19,13,1232,2484,1255,-1229
2016,5,19,14,1109,2783,1220,-1563
2016,5,19,15,1186,3033,1309,-1724
2016,5,19,16,1189,3069,1296,-1773
2016,5,19,17,1116,3056,1291,-1765
2016,5,19,18,1116,3076,1329,-1747
2016,5,19,19,1191,3076,1278,-1798
2016,5,19,20,1175,3051,1237,-1814
2016,5,19,21,1157,3022,1229,-1793
2016,5,19,22,1140,3040,1266,-1774
2016,5,19,23,1120,3008,1259,-1749
2016,5,20,0,1197,2993,1235,-1758
2016,5,20,1,1310,3033,1290,-1743
2016,5,20,2,1432,3058,1348,-1710
2016,5,20,3,1522,3158,1549,-1609
2016,5,20,4,1504,3188,1580,-1608
2016,5,20,5,1473,3131,1534,-1597
2016,5,20,6,1439,2878,1435,-1443
2016,5,20,7,1306,2662,1396,-1266
2016,5,20,8,1027,2292,990,-1302
2016,5,20,9,1020,2190,931,-1259
2016,5,20,10,1013,2153,876,-1277
2016,5,20,11,1040,2112,812,-1300
2016,5,20,12,1182,2211,986,-1225
2016,5,20,13,1414,2529,1386,-1143
2016,5,20,14,1563,2834,1467,-1367
2016,5,20,15,1681,3031,1675,-1356
2016,5,20,16,1687,3109,1758,-1351
2016,5,20,17,1697,3062,1746,-1316
2016,5,20,18,1709,3041,1751,-1290
2016,5,20,19,1622,3034,1684,-1350
2016,5,20,20,1630,3015,1686,-1329
2016,5,20,21,1599,2987,1657,-1330
2016,5,20,22,1597,2966,1657,-1309
2016,5,20,23,1593,2940,1639,-1301
2016,5,21,0,1585,2881,1640,-1241
2016,5,21,1,1576,2885,1584,-1301
2016,5,21,2,1567,2831,1522,-1309
2016,5,21,3,1564,2824,1443,-1381
2016,5,21,4,1569,2841,1538,-1303
2016,5,21,5,1580,2864,1541,-1323
2016,5,21,6,1596,2670,1602,-1068
2016,5,21,7,1218,2457,1431,-1026
2016,5,21,8,1256,2228,1315,-913
2016,5,21,9,1211,2084,1209,-875
2016,5,21,10,1174,2022,1220,-802
2016,5,21,11,1196,1952,1194,-758
2016,5,21,12,1221,2001,1222,-779
2016,5,21,13,1243,2117,1254,-863
2016,5,21,14,1012,2163,1042,-1121
2016,5,21,15,1001,2368,1011,-1357
2016,5,21,16,1053,2671,1147,-1524
2016,5,21,17,1132,2771,1268,-1503
2016,5,21,18,1124,2846,1321,-1525
2016,5,21,19,1132,2845,1263,-1582
2016,5,21,20,1151,2831,1297,-1534
2016,5,21,21,1079,2766,1118,-1648
2016,5,21,22,1107,2703,892,-1811
2016,5,21,23,886,2650,594,-2056
2016,5,22,0,911,2726,848,-1878
2016,5,22,1,925,2747,914,-1833
2016,5,22,2,931,2808,1089,-1719
2016,5,22,3,933,2681,813,-1868
2016,5,22,4,933,2757,965,-1792
2016,5,22,5,934,2753,1022,-1731
2016,5,22,6,1035,2591,1081,-1510
2016,5,22,7,935,2364,1002,-1362
2016,5,22,8,808,2227,1057,-1170
2016,5,22,9,808,2088,974,-1114
2016,5,22,10,808,2055,1015,-1040
2016,5,22,11,808,2032,1020,-1012
2016,5,22,12,807,2053,1028,-1025
2016,5,22,13,807,2096,1001,-1095
2016,5,22,14,807,2102,764,-1338
2016,5,22,15,807,2318,863,-1455
2016,5,22,16,932,2500,886,-1614
2016,5,22,17,983,2625,908,-1717
2016,5,22,18,1078,2651,946,-1705
2016,5,22,19,1076,2670,1017,-1653
2016,5,22,20,1024,2682,1068,-1614
2016,5,22,21,927,2650,1096,-1554
2016,5,22,22,928,2629,1099,-1530
2016,5,22,23,931,2597,1065,-1532
2016,5,23,0,933,2623,1005,-1618
2016,5,23,1,1003,2723,1028,-1695
2016,5,23,2,1100,2728,984,-1744
2016,5,23,3,1099,2740,1099,-1641
2016,5,23,4,1128,2805,1138,-1667
2016,5,23,5,1127,2785,1096,-1689
2016,5,23,6,1130,2563,1035,-1528
2016,5,23,7,1033,2249,830,-1419
2016,5,23,8,905,2129,966,-1163
2016,5,23,9,856,2074,1036,-1038
2016,5,23,10,832,2034,1042,-992
2016,5,23,11,832,2035,1013,-1022
2016,5,23,12,886,2151,1065,-1086
2016,5,23,13,938,2417,1156,-1261
2016,5,23,14,891,2701,1102,-1599
2016,5,23,15,993,2907,1188,-1719
2016,5,23,16,1032,2914,1064,-1850
2016,5,23,17,1031,2942,1064,-1878
2016,5,23,18,1031,2958,1097,-1861
2016,5,23,19,1031,2937,1062,-1875
2016,5,23,20,1031,2973,1057,-1916
2016,5,23,21,1031,3010,1165,-1845
2016,5,23,22,1030,2902,1140,-1762
2016,5,23,23,1028,2866,1165,-1701
2016,5,24,0,1026,2910,1241,-1669
2016,5,24,1,1123,2970,1337,-1633
2016,5,24,2,1124,2970,1361,-1609
2016,5,24,3,1127,2948,1371,-1577
2016,5,24,4,1126,2960,1384,-1576
2016,5,24,5,1122,3022,1551,-1471
2016,5,24,6,1116,2757,1451,-1306
2016,5,24,7,1005,2502,1358,-1144
2016,5,24,8,915,2243,1079,-1164
2016,5,24,9,895,2166,1106,-1060
2016,5,24,10,877,2127,1084,-1043
2016,5,24,11,863,2130,1073,-1057
2016,5,24,12,851,2229,1114,-1115
2016,5,24,13,933,2436,1121,-1315
2016,5,24,14,936,2660,957,-1703
2016,5,24,15,1034,2886,1094,-1792
2016,5,24,16,1167,3019,1294,-1725
2016,5,24,17,1212,2991,1283,-1708
2016,5,24,18,1212,2996,1283,-1713
2016,5,24,19,1212,2972,1337,-1635
2016,5,24,20,1212,2980,1336,-1644
2016,5,24,21,1117,2939,1254,-1685
2016,5,24,22,1126,2905,1243,-1662
2016,5,24,23,1147,2886,1231,-1655
2016,5,25,0,1177,2932,1266,-1666
2016,5,25,1,1250,2993,1285,-1708
2016,5,25,2,1285,2958,1341,-1617
2016,5,25,3,1308,2933,1308,-1625
2016,5,25,4,1317,2963,1307,-1656
2016,5,25,5,1308,2992,1347,-1645
2016,5,25,6,1294,2789,1348,-1441
2016,5,25,7,1186,2485,1232,-1253
2016,5,25,8,1100,2319,1255,-1064
2016,5,25,9,1093,2230,1292,-938
2016,5,25,10,976,2178,1102,-1076
2016,5,25,11,900,2167,1045,-1122
2016,5,25,12,898,2231,1060,-1171
2016,5,25,13,892,2495,1072,-1423
2016,5,25,14,927,2791,1059,-1732
2016,5,25,15,1000,3150,1345,-1805
2016,5,25,16,994,3232,1391,-1841
2016,5,25,17,991,3205,1348,-1857
2016,5,25,18,1093,3131,1319,-1812
2016,5,25,19,1037,3141,1330,-1811
2016,5,25,20,1072,3226,1437,-1789
2016,5,25,21,1112,3222,1459,-1763
2016,5,25,22,1098,3196,1469,-1727
2016,5,25,23,1115,3179,1462,-1717
2016,5,26,0,1122,3158,1396,-1762
2016,5,26,1,1123,3184,1399,-1785
2016,5,26,2,1123,3204,1480,-1724
2016,5,26,3,1169,3118,1440,-1678
2016,5,26,4,1168,3015,1351,-1664
2016,5,26,5,1167,3019,1244,-1775
2016,5,26,6,1171,2783,1209,-1574
2016,5,26,7,1074,2473,1055,-1418
2016,5,26,8,963,2248,998,-1250
2016,5,26,9,936,2136,893,-1243
2016,5,26,10,933,2124,838,-1286
2016,5,26,11,930,2128,833,-1295
2016,5,26,12,925,2195,828,-1367
2016,5,26,13,1042,2507,1044,-1463
2016,5,26,14,1051,2811,1067,-1744
2016,5,26,15,1029,3153,1166,-1987
2016,5,26,16,1010,3208,1160,-2048
2016,5,26,17,1003,3199,1111,-2088
2016,5,26,18,1015,3205,1114,-2091
2016,5,26,19,1041,3177,1101,-2076
2016,5,26,20,1056,3136,1110,-2026
2016,5,26,21,1073,3089,1107,-1982
2016,5,26,22,1078,3061,1182,-1879
2016,5,26,23,1078,3038,1217,-1821
2016,5,27,0,1087,2955,1171,-1784
2016,5,27,1,1086,3001,1169,-1832
2016,5,27,2,1084,3017,1222,-1795
2016,5,27,3,1082,3010,1249,-1761
2016,5,27,4,1080,3020,1202,-1818
2016,5,27,5,1078,2996,1163,-1833
2016,5,27,6,1080,2794,1295,-1499
2016,5,27,7,1080,2528,1191,-1337
2016,5,27,8,954,2337,1135,-1202
2016,5,27,9,955,2246,1150,-1096
2016,5,27,10,957,2215,1185,-1030
2016,5,27,11,959,2243,1220,-1023
2016,5,27,12,960,2327,1192,-1135
2016,5,27,13,1037,2532,1149,-1383
2016,5,27,14,1078,2797,1060,-1737
2016,5,27,15,1079,3101,1191,-1910
2016,5,27,16,1180,3175,1274,-1901
2016,5,27,17,1180,3139,1268,-1871
2016,5,27,18,1178,3087,1250,-1837
2016,5,27,19,1176,3064,1221,-1843
2016,5,27,20,1075,3054,1297,-1757
2016,5,27,21,1075,3024,1329,-1695
2016,5,27,22,1077,2882,1210,-1672
2016,5,27,23,1079,2864,1228,-1636
2016,5,28,0,1080,2853,1213,-1640
2016,5,28,1,1080,2889,1270,-1619
2016,5,28,2,1080,2977,1393,-1584
2016,5,28,3,1080,2940,1385,-1555
2016,5,28,4,1080,2965,1361,-1604
2016,5,28,5,1080,3054,1453,-1601
2016,5,28,6,1083,2900,1490,-1410
2016,5,28,7,1083,2589,1341,-1248
2016,5,28,8,1090,2346,1272,-1074
2016,5,28,9,1040,2183,1137,-1046
2016,5,28,10,1038,2140,1146,-994
2016,5,28,11,1033,2125,1135,-990
2016,5,28,12,1022,2177,1138,-1039
2016,5,28,13,1000,2335,1161,-1174
2016,5,28,14,1015,2397,924,-1473
2016,5,28,15,986,2562,965,-1597
2016,5,28,16,961,2882,1121,-1761
2016,5,28,17,945,3004,1135,-1869
2016,5,28,18,932,3013,1129,-1884
2016,5,28,19,923,3019,1135,-1884
2016,5,28,20,914,2882,1017,-1865
2016,5,28,21,916,2923,1119,-1804
2016,5,28,22,930,2891,1134,-1757
2016,5,28,23,957,2859,1149,-1710
2016,5,29,0,989,2861,1144,-1717
2016,5,29,1,1012,2934,1246,-1688
2016,5,29,2,1110,2934,1291,-1643
2016,5,29,3,1137,2939,1343,-1596
2016,5,29,4,1148,2998,1342,-1656
2016,5,29,5,1191,3009,1422,-1587
2016,5,29,6,1438,2854,1444,-1410
2016,5,29,7,1446,2668,1479,-1189
2016,5,29,8,1254,2500,1273,-1227
2016,5,29,9,1252,2412,1277,-1135
2016,5,29,10,1245,2330,1241,-1089
2016,5,29,11,1150,2264,1201,-1063
2016,5,29,12,1153,2244,1215,-1029
2016,5,29,13,1156,2145,1098,-1047
2016,5,29,14,1138,2192,1021,-1171
2016,5,29,15,1098,2352,1028,-1324
2016,5,29,16,1097,2561,1100,-1461
2016,5,29,17,1162,2697,1204,-1493
2016,5,29,18,1164,2743,1174,-1569
2016,5,29,19,1165,2738,1182,-1556
2016,5,29,20,1165,2687,1119,-1568
2016,5,29,21,1166,2592,1074,-1518
2016,5,29,22,1167,2592,1195,-1397
2016,5,29,23,1168,2562,1190,-1372
2016,5,30,0,1169,2575,1212,-1363
2016,5,30,1,1300,2565,1105,-1460
2016,5,30,2,1408,2561,1080,-1481
2016,5,30,3,1413,2664,1179,-1485
2016,5,30,4,1422,2678,1238,-1440
2016,5,30,5,1510,2756,1229,-1527
2016,5,30,6,1588,2754,1422,-1332
2016,5,30,7,1650,2537,1277,-1260
2016,5,30,8,1200,2347,1084,-1263
2016,5,30,9,1135,2288,996,-1292
2016,5,30,10,1114,2233,939,-1294
2016,5,30,11,1092,2206,848,-1358
2016,5,30,12,1072,2220,752,-1468
2016,5,30,13,1043,2303,783,-1520
2016,5,30,14,1166,2474,967,-1507
2016,5,30,15,1218,2667,1188,-1479
2016,5,30,16,1333,2693,1141,-1552
2016,5,30,17,1447,2834,1320,-1514
2016,5,30,18,1681,2908,1678,-1230
2016,5,30,19,1774,2917,1798,-1119
2016,5,30,20,1787,2915,1776,-1139
2016,5,30,21,1700,2848,1731,-1117
2016,5,30,22,1700,2812,1757,-1055
2016,5,30,23,1700,2856,1867,-989
2016,5,31,0,1787,2888,1920,-968
2016,5,31,1,1787,2974,1971,-1003
2016,5,31,2,1790,3016,2043,-973
2016,5,31,3,1796,2990,2011,-979
2016,5,31,4,1805,3042,2086,-956
2016,5,31,5,1818,3098,2187,-911
2016,5,31,6,1824,2820,1852,-968
2016,5,31,7,1617,2533,1452,-1081
2016,5,31,8,1407,2368,1368,-1000
2016,5,31,9,1329,2195,1315,-880
2016,5,31,10,1324,2129,1295,-834
2016,5,31,11,1437,2134,1338,-796
2016,5,31,12,1526,2253,1438,-815
2016,5,31,13,1586,2534,1554,-980
2016,5,31,14,1587,2842,1582,-1260
2016,5,31,15,1815,3052,1789,-1263
2016,5,31,16,1859,3155,1912,-1243
2016,5,31,17,1923,3197,1929,-1268
2016,5,31,18,1931,3246,1952,-1294
2016,5,31,19,1931,3269,1963,-1306
2016,5,31,20,1993,3296,1965,-1331
2016,5,31,21,1991,3313,1994,-1319
2016,5,31,22,2039,3320,2026,-1294
2016,5,31,23,2071,3350,2067,-1283
2016,6,1,0,2145,3343,2077,-1266
2016,6,1,1,2165,3379,2153,-1226
2016,6,1,2,2101,3367,2145,-1222
2016,6,1,3,2105,3301,2081,-1220
2016,6,1,4,2050,3253,1988,-1265
2016,6,1,5,2048,3249,2027,-1222
2016,6,1,6,2027,2971,1934,-1037
2016,6,1,7,1604,2644,1530,-1114
2016,6,1,8,1470,2406,1426,-980
2016,6,1,9,1417,2293,1371,-922
2016,6,1,10,1387,2229,1367,-862
2016,6,1,11,1399,2215,1361,-854
2016,6,1,12,1442,2283,1435,-848
2016,6,1,13,1433,2435,1514,-921
2016,6,1,14,1434,2687,1467,-1220
2016,6,1,15,1570,2974,1660,-1314
2016,6,1,16,1582,3145,1775,-1370
2016,6,1,17,1676,3162,1785,-1377
2016,6,1,18,1684,3593,2222,-1371
2016,6,1,19,1692,3514,2122,-1392
2016,6,1,20,1696,3293,1927,-1366
2016,6,1,21,1708,3312,1950,-1362
2016,6,1,22,1739,3334,1986,-1348
2016,6,1,23,1650,3325,1933,-1392
2016,6,2,0,1703,3332,1911,-1421
2016,6,2,1,1745,3345,1952,-1393
2016,6,2,2,1768,3295,1964,-1331
2016,6,2,3,1643,3172,1739,-1433
2016,6,2,4,1583,3206,1716,-1490
2016,6,2,5,1456,3151,1732,-1419
2016,6,2,6,1455,2875,1623,-1252
2016,6,2,7,1455,2568,1479,-1089
2016,6,2,8,1306,2302,1380,-922
2016,6,2,9,1298,2187,1369,-818
2016,6,2,10,1272,2155,1326,-829
2016,6,2,11,1228,2142,1343,-799
2016,6,2,12,1215,2220,1371,-849
2016,6,2,13,1249,2470,1336,-1134
2016,6,2,14,1252,2667,1221,-1446
2016,6,2,15,1436,3007,1466,-1541
2016,6,2,16,1498,3120,1622,-1498
2016,6,2,17,1503,3009,1331,-1678
2016,6,2,18,1507,3076,1364,-1712
2016,6,2,19,1585,3042,1247,-1795
2016,6,2,20,1593,3058,1245,-1813
2016,6,2,21,1600,3032,1215,-1817
2016,6,2,22,1603,2896,1197,-1699
2016,6,2,23,1729,2872,1223,-1649
2016,6,3,0,1729,2904,1340,-1564
2016,6,3,1,1811,2943,1389,-1554
2016,6,3,2,1811,2916,1424,-1492
2016,6,3,3,1812,2926,1516,-1410
2016,6,3,4,1813,3061,1697,-1364
2016,6,3,5,1813,3092,1789,-1303
2016,6,3,6,1813,2904,1842,-1062
2016,6,3,7,1743,2554,1661,-893
2016,6,3,8,1439,2281,1560,-721
2016,6,3,9,1406,2106,1374,-732
2016,6,3,10,1402,2076,1399,-677
2016,6,3,11,1370,2044,1378,-666
2016,6,3,12,1348,2179,1464,-715
2016,6,3,13,1536,2495,1670,-825
2016,6,3,14,1554,2727,1545,-1182
2016,6,3,15,1574,2975,1645,-1330
2016,6,3,16,1720,3153,1745,-1408
2016,6,3,17,1760,3195,1754,-1441
2016,6,3,18,1765,3253,1773,-1480
2016,6,3,19,1763,3305,1870,-1435
2016,6,3,20,1961,3319,1912,-1407
2016,6,3,21,1960,3365,1926,-1439
2016,6,3,22,1960,3384,2049,-1335
2016,6,3,23,1960,3418,2165,-1253
2016,6,4,0,1960,3461,2272,-1189
2016,6,4,1,1960,3470,2339,-1131
2016,6,4,2,1990,3424,2333,-1091
2016,6,4,3,2055,3317,2199,-1118
2016,6,4,4,2145,3273,2111,-1162
2016,6,4,5,2198,3255,2097,-1158
2016,6,4,6,2198,3118,2320,-798
2016,6,4,7,1998,2835,2135,-700
2016,6,4,8,1693,2555,1916,-639
2016,6,4,9,1694,2403,1782,-621
2016,6,4,10,1588,2324,1716,-608
2016,6,4,11,1589,2246,1638,-608
2016,6,4,12,1609,2271,1655,-616
2016,6,4,13,1725,2254,1658,-596
2016,6,4,14,1680,2310,1474,-836
2016,6,4,15,1681,2470,1454,-1016
2016,6,4,16,2027,2713,1617,-1096
2016,6,4,17,2027,3049,1817,-1232
2016,6,4,18,2059,3221,1889,-1332
2016,6,4,19,2058,3276,1942,-1334
2016,6,4,20,2155,3395,2037,-1358
2016,6,4,21,2154,3406,2064,-1342
2016,6,4,22,2154,3435,2111,-1324
2016,6,4,23,2153,3480,2167,-1313
2016,6,5,0,2152,3536,2228,-1308
2016,6,5,1,2151,3573,2356,-1217
2016,6,5,2,2151,3578,2395,-1183
2016,6,5,3,2151,3527,2340,-1187
2016,6,5,4,2151,3471,2275,-1196
2016,6,5,5,2150,3447,2254,-1193
2016,6,5,6,2151,3301,2311,-990
2016,6,5,7,2151,3083,2238,-845
2016,6,5,8,1753,2694,1803,-891
2016,6,5,9,1642,2492,1636,-856
2016,6,5,10,1644,2360,1539,-821
2016,6,5,11,1640,2284,1476,-808
2016,6,5,12,1641,2252,1448,-804
2016,6,5,13,1642,2209,1412,-797
2016,6,5,14,1542,2154,1230,-924
2016,6,5,15,1767,2412,1383,-1029
2016,6,5,16,1922,2774,1557,-1217
2016,6,5,17,2085,3057,1863,-1194
2016,6,5,18,2127,3329,2039,-1290
2016,6,5,19,2133,3482,2142,-1340
2016,6,5,20,2157,3590,2273,-1317
2016,6,5,21,2159,3651,2369,-1282
2016,6,5,22,2159,3687,2358,-1329
2016,6,5,23,2346,3757,2419,-1338
2016,6,6,0,2360,3831,2425,-1406
2016,6,6,1,2384,3896,2487,-1409
2016,6,6,2,2382,3919,2509,-1410
2016,6,6,3,2383,3894,2517,-1377
2016,6,6,4,2383,3847,2585,-1262
2016,6,6,5,2329,3782,2537,-1245
2016,6,6,6,2347,3534,2502,-1032
2016,6,6,7,2158,3149,2198,-951
2016,6,6,8,1776,2933,2130,-803
2016,6,6,9,1609,2658,1858,-800
2016,6,6,10,1613,2548,1789,-759
2016,6,6,11,1619,2486,1723,-763
2016,6,6,12,1601,2514,1751,-763
2016,6,6,13,1856,2686,1851,-835
2016,6,6,14,1906,2952,1827,-1125
2016,6,6,15,1933,3380,2079,-1301
2016,6,6,16,2096,3539,2181,-1358
2016,6,6,17,2096,3643,2328,-1315
2016,6,6,18,2097,3747,2499,-1248
2016,6,6,19,2152,3817,2575,-1242
2016,6,6,20,2357,3872,2582,-1290
2016,6,6,21,2366,3924,2586,-1338
2016,6,6,22,2377,3950,2549,-1401
2016,6,6,23,2391,3983,2580,-1403
2016,6,7,0,2407,4012,2618,-1394
2016,6,7,1,2424,4013,2568,-1445
2016,6,7,2,2438,3968,2617,-1351
2016,6,7,3,2450,3880,2671,-1209
2016,6,7,4,2460,3772,2709,-1063
2016,6,7,5,2467,3686,2627,-1059
2016,6,7,6,2272,3395,2484,-911
2016,6,7,7,2174,2927,2092,-835
2016,6,7,8,1744,2667,2001,-666
2016,6,7,9,1709,2529,1929,-600
2016,6,7,10,1694,2430,1859,-571
2016,6,7,11,1548,2300,1720,-580
2016,6,7,12,1535,2326,1716,-610
2016,6,7,13,1656,2543,1881,-662
2016,6,7,14,1650,2823,1782,-1041
2016,6,7,15,1686,3197,1994,-1203
2016,6,7,16,2188,3330,2240,-1090
2016,6,7,17,2185,3411,2330,-1081
2016,6,7,18,2186,3506,2395,-1111
2016,6,7,19,2194,3571,2444,-1127
2016,6,7,20,2455,3627,2453,-1174
2016,6,7,21,2470,3695,2509,-1186
2016,6,7,22,2487,3757,2560,-1197
2016,6,7,23,2504,3829,2550,-1279
2016,6,8,0,2522,3880,2548,-1332
2016,6,8,1,2537,3881,2521,-1360
2016,6,8,2,2547,3762,2432,-1330
2016,6,8,3,2552,3689,2379,-1310
2016,6,8,4,2556,3584,2337,-1247
2016,6,8,5,2306,3511,2331,-1180
2016,6,8,6,2309,3257,2254,-1003
2016,6,8,7,2311,2939,2111,-828
2016,6,8,8,1652,2613,1947,-666
2016,6,8,9,1653,2470,1845,-625
2016,6,8,10,1599,2383,1715,-668
2016,6,8,11,1602,2305,1645,-660
2016,6,8,12,1609,2372,1651,-721
2016,6,8,13,1708,2523,1685,-838
2016,6,8,14,1884,2751,1662,-1089
2016,6,8,15,2022,3035,1966,-1069
2016,6,8,16,2027,3130,2090,-1040
2016,6,8,17,2030,3187,2131,-1056
2016,6,8,18,2126,3262,2107,-1155
2016,6,8,19,2128,3329,2085,-1244
2016,6,8,20,2235,3352,2006,-1346
2016,6,8,21,2250,3345,2012,-1333
2016,6,8,22,2274,3147,1941,-1206
2016,6,8,23,2299,3041,1884,-1157
2016,6,9,0,2321,3091,1934,-1157
2016,6,9,1,2340,3151,1944,-1207
2016,6,9,2,2348,3127,1969,-1158
2016,6,9,3,2358,3247,2133,-1114
2016,6,9,4,2150,3129,1984,-1145
2016,6,9,5,2156,3122,1951,-1171
2016,6,9,6,1705,2753,1872,-881
2016,6,9,7,1708,2412,1636,-776
2016,6,9,8,1480,2211,1618,-593
2016,6,9,9,1602,2238,1657,-581
2016,6,9,10,1595,2165,1535,-630
2016,6,9,11,1463,2058,1449,-609
2016,6,9,12,1455,2125,1507,-618
2016,6,9,13,1487,2301,1556,-745
2016,6,9,14,1469,2603,1464,-1139
2016,6,9,15,1446,2847,1567,-1280
2016,6,9,16,1829,3086,1660,-1426
2016,6,9,17,2000,3142,1749,-1393
2016,6,9,18,1972,3153,1783,-1370
2016,6,9,19,2002,3157,1839,-1318
2016,6,9,20,1990,3152,1825,-1327
2016,6,9,21,1907,3132,1850,-1282
2016,6,9,22,1915,3030,1869,-1161
2016,6,9,23,1930,3022,1822,-1200
2016,6,10,0,1950,3015,1826,-1189
2016,6,10,1,1966,3046,1828,-1218
2016,6,10,2,1980,3118,1951,-1167
2016,6,10,3,1990,3125,1951,-1174
2016,6,10,4,1995,3147,2004,-1143
2016,6,10,5,2003,3140,2036,-1104
2016,6,10,6,2002,2929,2027,-902
2016,6,10,7,1992,2680,1978,-702
2016,6,10,8,1598,2498,1710,-788
2016,6,10,9,1601,2393,1678,-715
2016,6,10,10,1599,2354,1706,-648
2016,6,10,11,1594,2354,1711,-643
2016,6,10,12,1585,2388,1637,-751
2016,6,10,13,1573,2550,1808,-742
2016,6,10,14,1616,2764,1743,-1021
2016,6,10,15,1906,3009,1861,-1148
2016,6,10,16,1895,3093,1907,-1186
2016,6,10,17,1886,3136,1977,-1159
2016,6,10,18,1967,3133,1948,-1185
2016,6,10,19,1959,3115,1929,-1186
2016,6,10,20,1954,3122,1962,-1160
2016,6,10,21,1953,3098,1916,-1182
2016,6,10,22,1957,3111,2108,-1003
2016,6,10,23,1968,3079,2054,-1025
2016,6,11,0,1984,3071,2027,-1044
2016,6,11,1,2005,3086,2032,-1054
2016,6,11,2,2028,3015,1976,-1039
2016,6,11,3,1970,2928,1903,-1025
2016,6,11,4,1987,2944,1888,-1056
2016,6,11,5,1997,3002,1857,-1145
2016,6,11,6,1999,2885,2033,-852
2016,6,11,7,1657,2613,1805,-808
2016,6,11,8,1378,2459,1611,-848
2016,6,11,9,1171,2363,1407,-956
2016,6,11,10,1147,2355,1465,-890
2016,6,11,11,1132,2286,1337,-949
2016,6,11,12,1118,2357,1453,-904
2016,6,11,13,1102,2395,1429,-966
2016,6,11,14,1089,2457,1318,-1139
2016,6,11,15,1077,2682,1428,-1254
2016,6,11,16,1117,2813,1309,-1504
2016,6,11,17,1107,2957,1357,-1600
2016,6,11,18,1196,2984,1371,-1613
2016,6,11,19,1195,2969,1392,-1577
2016,6,11,20,1196,2967,1449,-1518
2016,6,11,21,1200,2925,1455,-1470
2016,6,11,22,1210,2877,1445,-1432
2016,6,11,23,1224,2868,1489,-1379
2016,6,12,0,1241,2894,1564,-1330
2016,6,12,1,1349,2932,1612,-1320
2016,6,12,2,1365,2905,1574,-1331
2016,6,12,3,1375,2887,1583,-1304
2016,6,12,4,1380,2874,1542,-1332
2016,6,12,5,1383,2907,1537,-1370
2016,6,12,6,1382,2845,1586,-1259
2016,6,12,7,1380,2636,1560,-1076
2016,6,12,8,1287,2443,1528,-915
2016,6,12,9,1202,2376,1480,-896
2016,6,12,10,1219,2336,1428,-908
2016,6,12,11,1258,2262,1350,-912
2016,6,12,12,1254,2321,1398,-923
2016,6,12,13,1422,2383,1422,-961
2016,6,12,14,1487,2447,1456,-991
2016,6,12,15,1541,2658,1642,-1016
2016,6,12,16,1650,2912,1836,-1076
2016,6,12,17,1828,3028,1931,-1097
2016,6,12,18,1826,3108,2012,-1096
2016,6,12,19,1827,3102,2038,-1064
2016,6,12,20,1834,3058,2048,-1010
2016,6,12,21,1806,3013,2011,-1002
2016,6,12,22,1823,2966,1979,-987
2016,6,12,23,1844,2959,1969,-990
2016,6,13,0,1867,3002,1999,-1003
2016,6,13,1,1932,3074,2041,-1033
2016,6,13,2,1956,3145,2060,-1085
2016,6,13,3,1976,3225,2155,-1070
2016,6,13,4,1987,3233,2176,-1057
2016,6,13,5,1952,3208,2135,-1073
2016,6,13,6,1807,3028,1962,-1066
2016,6,13,7,1581,2764,1746,-1018
2016,6,13,8,1728,2615,1790,-825
2016,6,13,9,1714,2504,1699,-805
2016,6,13,10,1696,2458,1660,-798
2016,6,13,11,1682,2469,1645,-824
2016,6,13,12,1707,2567,1766,-801
2016,6,13,13,1733,2681,1600,-1081
2016,6,13,14,1724,2958,1587,-1371
2016,6,13,15,1524,3212,1783,-1429
2016,6,13,16,1623,3282,1788,-1494
2016,6,13,17,1636,3329,1669,-1660
2016,6,13,18,1648,3364,1722,-1642
2016,6,13,19,1665,3395,1746,-1649
2016,6,13,20,1686,3404,1798,-1606
2016,6,13,21,1705,3370,1774,-1596
2016,6,13,22,1626,3323,1646,-1677
2016,6,13,23,1638,3301,1616,-1685
2016,6,14,0,1645,3281,1572,-1709
2016,6,14,1,1745,3354,1725,-1629
2016,6,14,2,1747,3351,1771,-1580
2016,6,14,3,1748,3307,1733,-1574
2016,6,14,4,1748,3260,1686,-1574
2016,6,14,5,1748,3262,1724,-1538
2016,6,14,6,1598,3030,1613,-1417
2016,6,14,7,1597,2764,1517,-1247
2016,6,14,8,1468,2608,1538,-1070
2016,6,14,9,1420,2493,1475,-1018
2016,6,14,10,1410,2440,1420,-1020
2016,6,14,11,1396,2457,1439,-1018
2016,6,14,12,1421,2590,1517,-1073
2016,6,14,13,1414,2805,1553,-1252
2016,6,14,14,1388,3068,1443,-1625
2016,6,14,15,1375,3303,1465,-1838
2016,6,14,16,1373,3342,1423,-1919
2016,6,14,17,1364,3462,1426,-2036
2016,6,14,18,1360,3371,1448,-1923
2016,6,14,19,1360,3410,1479,-1931
2016,6,14,20,1364,3396,1485,-1911
2016,6,14,21,1368,3355,1492,-1863
2016,6,14,22,1374,3306,1435,-1871
2016,6,14,23,1381,3295,1426,-1869
2016,6,15,0,1390,3287,1420,-1867
2016,6,15,1,1398,3331,1458,-1873
2016,6,15,2,1501,3291,1470,-1821
2016,6,15,3,1503,3362,1712,-1650
2016,6,15,4,1507,3382,1797,-1585
2016,6,15,5,1513,3365,1768,-1597
2016,6,15,6,1520,3159,1703,-1456
2016,6,15,7,1529,2886,1600,-1286
2016,6,15,8,1375,2733,1597,-1136
2016,6,15,9,1411,2631,1569,-1062
2016,6,15,10,1482,2548,1506,-1042
2016,6,15,11,1653,2544,1554,-990
2016,6,15,12,1887,2704,1779,-925
2016,6,15,13,1970,2941,1904,-1037
2016,6,15,14,1875,3250,1940,-1310
2016,6,15,15,1983,3460,2097,-1363
2016,6,15,16,1966,3473,2200,-1273
2016,6,15,17,2047,3434,2205,-1229
2016,6,15,18,2033,3400,2176,-1224
2016,6,15,19,2022,3361,2171,-1190
2016,6,15,20,2015,3337,2139,-1198
2016,6,15,21,2011,3317,2123,-1194
2016,6,15,22,2009,3291,2059,-1232
2016,6,15,23,2009,3271,2043,-1228
2016,6,16,0,2012,3284,2000,-1284
2016,6,16,1,2018,3317,2031,-1286
2016,6,16,2,2026,3271,2030,-1241
2016,6,16,3,2031,3268,2015,-1253
2016,6,16,4,2037,3284,1999,-1285
2016,6,16,5,2044,3282,1984,-1298
2016,6,16,6,2051,3095,2079,-1016
2016,6,16,7,1965,2829,1876,-953
2016,6,16,8,1685,2656,1822,-834
2016,6,16,9,1665,2592,1857,-735
2016,6,16,10,1669,2545,1866,-679
2016,6,16,11,1669,2547,1874,-673
2016,6,16,12,1664,2628,1813,-815
2016,6,16,13,1756,2845,1933,-912
2016,6,16,14,1621,3083,1813,-1270
2016,6,16,15,1791,3258,1907,-1351
2016,6,16,16,1784,3300,1820,-1480
2016,6,16,17,1779,3308,1809,-1499
2016,6,16,18,1872,3315,1846,-1469
2016,6,16,19,1870,3311,1891,-1420
2016,6,16,20,1870,3304,1869,-1435
2016,6,16,21,1936,3295,1944,-1351
2016,6,16,22,1946,3221,2002,-1219
2016,6,16,23,1966,3211,2003,-1208
2016,6,17,0,1977,3261,1982,-1279
2016,6,17,1,1991,3324,2035,-1289
2016,6,17,2,2003,3263,2008,-1255
2016,6,17,3,2017,3202,2043,-1159
2016,6,17,4,2029,3208,2084,-1124
2016,6,17,5,2035,3259,2116,-1143
2016,6,17,6,2035,3092,2224,-868
2016,6,17,7,2033,2800,2068,-732
2016,6,17,8,1560,2640,1944,-696
2016,6,17,9,1494,2564,1884,-680
2016,6,17,10,1478,2510,1844,-666
2016,6,17,11,1700,2521,1848,-673
2016,6,17,12,1741,2587,1793,-794
2016,6,17,13,1887,2753,1840,-913
2016,6,17,14,1808,2993,1838,-1155
2016,6,17,15,1988,3194,1931,-1263
2016,6,17,16,1991,3280,1959,-1321
2016,6,17,17,2042,3305,1936,-1369
2016,6,17,18,2047,3323,1908,-1415
2016,6,17,19,2050,3289,1863,-1426
2016,6,17,20,2098,3255,1836,-1419
2016,6,17,21,2100,3283,1945,-1338
2016,6,17,22,2030,3242,1900,-1342
2016,6,17,23,2049,3230,1933,-1297
2016,6,18,0,2047,3281,1999,-1282
2016,6,18,1,1943,3273,2003,-1270
2016,6,18,2,1920,3214,1968,-1246
2016,6,18,3,1868,3148,1870,-1278
2016,6,18,4,1862,3162,1869,-1293
2016,6,18,5,1847,3152,1701,-1451
2016,6,18,6,1912,3037,1859,-1178
2016,6,18,7,1779,2849,1928,-921
2016,6,18,8,1680,2679,1852,-827
2016,6,18,9,1551,2569,1748,-821
2016,6,18,10,1552,2513,1689,-824
2016,6,18,11,1527,2498,1670,-828
2016,6,18,12,1546,2414,1378,-1036
2016,6,18,13,1490,2428,1381,-1047
2016,6,18,14,1425,2463,1205,-1258
2016,6,18,15,1445,2745,1407,-1338
2016,6,18,16,1423,3022,1597,-1425
2016,6,18,17,1472,3137,1672,-1465
2016,6,18,18,1420,3171,1722,-1449
2016,6,18,19,1437,3199,1783,-1416
2016,6,18,20,1434,3162,1771,-1391
2016,6,18,21,1433,3022,1520,-1502
2016,6,18,22,1426,2977,1361,-1616
2016,6,18,23,1429,2949,1344,-1605
2016,6,19,0,1435,2934,1294,-1640
2016,6,19,1,1458,2963,1351,-1612
2016,6,19,2,1463,2948,1318,-1630
2016,6,19,3,1489,2953,1409,-1544
2016,6,19,4,1490,2974,1480,-1494
2016,6,19,5,1492,3017,1533,-1484
2016,6,19,6,1691,2961,1588,-1373
2016,6,19,7,1642,2684,1472,-1212
2016,6,19,8,1423,2574,1608,-966
2016,6,19,9,1325,2488,1631,-857
2016,6,19,10,1324,2415,1564,-851
2016,6,19,11,1320,2401,1529,-872
2016,6,19,12,1309,2456,1578,-878
2016,6,19,13,1305,2547,1634,-913
2016,6,19,14,1297,2677,1600,-1077
2016,6,19,15,1422,2809,1600,-1209
2016,6,19,16,1610,2978,1645,-1333
2016,6,19,17,1715,3068,1775,-1293
2016,6,19,18,1823,3098,1798,-1300
2016,6,19,19,1836,3085,1809,-1276
2016,6,19,20,1877,3057,1796,-1261
2016,6,19,21,1874,3009,1821,-1188
2016,6,19,22,1872,2990,1841,-1149
2016,6,19,23,1872,2985,1845,-1140
2016,6,20,0,1884,3027,1857,-1170
2016,6,20,1,1981,3081,1971,-1110
2016,6,20,2,1981,3092,1983,-1109
2016,6,20,3,1981,3066,1986,-1080
2016,6,20,4,1981,3034,1904,-1130
2016,6,20,5,1981,3085,1885,-1200
2016,6,20,6,1980,2984,1965,-1019
2016,6,20,7,1872,2704,1797,-907
2016,6,20,8,1564,2525,1656,-869
2016,6,20,9,1567,2377,1522,-855
2016,6,20,10,1571,2329,1487,-842
2016,6,20,11,1574,2336,1494,-842
2016,6,20,12,1578,2430,1554,-876
2016,6,20,13,1901,2633,1803,-830
2016,6,20,14,1903,2871,1769,-1102
2016,6,20,15,2128,3145,2057,-1088
2016,6,20,16,2174,3250,2142,-1108
2016,6,20,17,2208,3329,2169,-1160
2016,6,20,18,2232,3378,2065,-1313
2016,6,20,19,2370,3404,2050,-1354
2016,6,20,20,2468,3423,2065,-1358
2016,6,20,21,2467,3410,2085,-1325
2016,6,20,22,2464,3387,2072,-1315
2016,6,20,23,2460,3393,1993,-1400
2016,6,21,0,2456,3411,1861,-1550
2016,6,21,1,2450,3427,1800,-1627
2016,6,21,2,2443,3398,1731,-1667
2016,6,21,3,2436,3369,1809,-1560
2016,6,21,4,2316,3367,1870,-1497
2016,6,21,5,2297,3345,1877,-1468
2016,6,21,6,2282,3072,1767,-1305
2016,6,21,7,2006,2771,1741,-1030
2016,6,21,8,1438,2617,1647,-970
2016,6,21,9,1432,2420,1388,-1032
2016,6,21,10,1447,2333,1337,-996
2016,6,21,11,1454,2360,1391,-969
2016,6,21,12,1457,2459,1412,-1047
2016,6,21,13,1558,2631,1454,-1177
2016,6,21,14,1433,2869,1533,-1336
2016,6,21,15,1482,3038,1390,-1648
2016,6,21,16,1535,3168,1442,-1726
2016,6,21,17,1602,3178,1400,-1778
2016,6,21,18,1583,3258,1404,-1854
2016,6,21,19,1566,3311,1444,-1867
2016,6,21,20,1585,3265,1540,-1725
2016,6,21,21,1704,3277,1675,-1602
2016,6,21,22,1790,3331,1826,-1505
2016,6,21,23,1780,3316,1967,-1349
2016,6,22,0,1823,3355,2013,-1342
2016,6,22,1,1826,3382,2058,-1324
2016,6,22,2,1830,3372,2115,-1257
2016,6,22,3,1834,3314,2044,-1270
2016,6,22,4,1834,3279,2031,-1248
2016,6,22,5,1833,3273,2018,-1255
2016,6,22,6,1828,3099,2116,-983
2016,6,22,7,1821,2824,2043,-781
2016,6,22,8,1215,2612,1299,-1313
2016,6,22,9,1095,2521,1196,-1325
2016,6,22,10,1087,2393,1012,-1381
2016,6,22,11,1074,2388,1005,-1383
2016,6,22,12,1056,2421,914,-1507
2016,6,22,13,1113,2594,994,-1600
2016,6,22,14,989,2757,853,-1904
2016,6,22,15,1103,3028,1022,-2006
2016,6,22,16,1098,3140,1068,-2072
2016,6,22,17,1196,3238,1130,-2108
2016,6,22,18,1198,3286,1209,-2077
2016,6,22,19,1242,3311,1214,-2097
2016,6,22,20,1339,3359,1317,-2042
2016,6,22,21,1342,3383,1345,-2038
2016,6,22,22,1430,3364,1340,-2024
2016,6,22,23,1442,3365,1341,-2024
2016,6,23,0,1461,3410,1342,-2068
2016,6,23,1,1486,3455,1369,-2086
2016,6,23,2,1564,3385,1258,-2127
2016,6,23,3,1590,3320,1242,-2078
2016,6,23,4,1514,3309,1291,-2018
2016,6,23,5,1430,3288,1329,-1959
2016,6,23,6,1542,3069,1339,-1730
2016,6,23,7,1242,2757,1117,-1640
2016,6,23,8,1223,2608,1182,-1426
2016,6,23,9,1140,2404,1079,-1325
2016,6,23,10,1143,2331,1013,-1318
2016,6,23,11,1147,2326,1114,-1212
2016,6,23,12,1144,2381,1142,-1239
2016,6,23,13,1190,2575,1264,-1311
2016,6,23,14,1109,2741,1181,-1560
2016,6,23,15,1153,2997,1275,-1722
2016,6,23,16,1222,3157,1333,-1824
2016,6,23,17,1224,3259,1364,-1895
2016,6,23,18,1305,3311,1355,-1956
2016,6,23,19,1293,3340,1307,-2033
2016,6,23,20,1286,3356,1264,-2092
2016,6,23,21,1292,3358,1268,-2090
2016,6,23,22,1249,3267,1156,-2111
2016,6,23,23,1262,3269,1179,-2090
2016,6,24,0,1379,3254,1181,-2073
2016,6,24,1,1477,3306,1255,-2051
2016,6,24,2,1498,3222,1256,-1966
2016,6,24,3,1518,3157,1331,-1826
2016,6,24,4,1537,3221,1526,-1695
2016,6,24,5,1552,3178,1492,-1686
2016,6,24,6,1565,3019,1509,-1510
2016,6,24,7,1285,2771,1498,-1273
2016,6,24,8,1145,2525,1332,-1193
2016,6,24,9,1128,2405,1308,-1097
2016,6,24,10,1132,2306,1215,-1091
2016,6,24,11,1134,2293,1203,-1090
2016,6,24,12,1124,2363,1235,-1128
2016,6,24,13,1225,2538,1306,-1232
2016,6,24,14,1119,2687,1233,-1454
2016,6,24,15,1298,2959,1388,-1571
2016,6,24,16,1348,3113,1470,-1643
2016,6,24,17,1344,3198,1501,-1697
2016,6,24,18,1382,3214,1519,-1695
2016,6,24,19,1427,3213,1550,-1663
2016,6,24,20,1428,3213,1558,-1655
2016,6,24,21,1490,3177,1542,-1635
2016,6,24,22,1489,3138,1498,-1640
2016,6,24,23,1488,3110,1591,-1519
2016,6,25,0,1486,3098,1633,-1465
2016,6,25,1,1485,3094,1650,-1444
2016,6,25,2,1481,3036,1606,-1430
2016,6,25,3,1474,2993,1609,-1384
2016,6,25,4,1464,2995,1648,-1347
2016,6,25,5,1452,3051,1764,-1287
2016,6,25,6,1483,2895,1718,-1177
2016,6,25,7,1214,2695,1670,-1025
2016,6,25,8,1078,2437,1361,-1076
2016,6,25,9,1033,2396,1338,-1058
2016,6,25,10,1007,2306,1268,-1038
2016,6,25,11,976,2328,1285,-1043
2016,6,25,12,973,2358,1306,-1052
2016,6,25,13,1014,2376,1238,-1138
2016,6,25,14,792,2429,1077,-1352
2016,6,25,15,880,2638,1173,-1465
2016,6,25,16,897,2824,1162,-1662
2016,6,25,17,1077,2940,1218,-1722
2016,6,25,18,1075,3007,1205,-1802
2016,6,25,19,1105,3005,1203,-1802
2016,6,25,20,1184,2995,1241,-1754
2016,6,25,21,1224,2978,1372,-1606
2016,6,25,22,1278,2956,1372,-1584
2016,6,25,23,1266,2977,1391,-1586
2016,6,26,0,1197,2995,1373,-1622
2016,6,26,1,1228,3030,1359,-1671
2016,6,26,2,1234,3025,1319,-1706
2016,6,26,3,1238,2989,1309,-1681
2016,6,26,4,1267,2909,1243,-1667
2016,6,26,5,1257,2928,1296,-1633
2016,6,26,6,1370,2877,1538,-1340
2016,6,26,7,1365,2700,1625,-1076
2016,6,26,8,1344,2513,1499,-1014
2016,6,26,9,1259,2387,1358,-1029
2016,6,26,10,1211,2296,1282,-1014
2016,6,26,11,1179,2267,1258,-1009
2016,6,26,12,1158,2264,1232,-1032
2016,6,26,13,1178,2268,1226,-1042
2016,6,26,14,1030,2335,1141,-1194
2016,6,26,15,953,2420,952,-1468
2016,6,26,16,986,2620,959,-1661
2016,6,26,17,1049,2808,1068,-1740
2016,6,26,18,1114,2932,1164,-1768
2016,6,26,19,1208,2978,1221,-1757
2016,6,26,20,1257,3001,1226,-1775
2016,6,26,21,1135,3013,1223,-1790
2016,6,26,22,1134,3029,1231,-1798
2016,6,26,23,1123,3081,1262,-1819
2016,6,27,0,1152,3174,1356,-1818
2016,6,27,1,1211,3273,1435,-1838
2016,6,27,2,1235,3293,1433,-1860
2016,6,27,3,1121,3251,1409,-1842
2016,6,27,4,1098,3200,1301,-1899
2016,6,27,5,1098,3203,1380,-1823
2016,6,27,6,1100,3072,1560,-1512
2016,6,27,7,1102,2796,1496,-1300
2016,6,27,8,1497,2677,1436,-1241
2016,6,27,9,1254,2540,1293,-1247
2016,6,27,10,1144,2450,1250,-1200
2016,6,27,11,1280,2395,1263,-1132
2016,6,27,12,1509,2366,1242,-1124
2016,6,27,13,1658,2486,1304,-1182
2016,6,27,14,1682,2734,1469,-1265
2016,6,27,15,1979,3073,1878,-1195
2016,6,27,16,2013,3257,2054,-1203
2016,6,27,17,2166,3396,2226,-1170
2016,6,27,18,2201,3478,2334,-1144
2016,6,27,19,2259,3557,2400,-1157
2016,6,27,20,2473,3623,2448,-1175
2016,6,27,21,2470,3678,2517,-1161
2016,6,27,22,2466,3724,2538,-1186
2016,6,27,23,2463,3766,2473,-1293
2016,6,28,0,2461,3834,2503,-1331
2016,6,28,1,2461,3866,2411,-1455
2016,6,28,2,2461,3804,2479,-1325
2016,6,28,3,2461,3732,2472,-1260
2016,6,28,4,2436,3660,2489,-1171
2016,6,28,5,2399,3582,2384,-1198
2016,6,28,6,2067,3351,2181,-1170
2016,6,28,7,1833,3037,2007,-1030
2016,6,28,8,1826,2737,1763,-974
2016,6,28,9,1691,2593,1736,-857
2016,6,28,10,1683,2524,1743,-781
2016,6,28,11,1674,2496,1726,-770
2016,6,28,12,1666,2560,1734,-826
2016,6,28,13,1866,2669,1708,-961
2016,6,28,14,1762,2818,1651,-1167
2016,6,28,15,1966,3064,1732,-1332
2016,6,28,16,1994,3206,1790,-1416
2016,6,28,17,2075,3287,1900,-1387
2016,6,28,18,2075,3343,2075,-1268
2016,6,28,19,2216,3387,2138,-1249
2016,6,28,20,2273,3409,2313,-1096
2016,6,28,21,2273,3435,2449,-986
2016,6,28,22,2239,3499,2542,-957
2016,6,28,23,2277,3538,2576,-962
2016,6,29,0,2285,3587,2577,-1010
2016,6,29,1,2337,3641,2524,-1117
2016,6,29,2,2344,3627,2481,-1146
2016,6,29,3,2350,3566,2339,-1227
2016,6,29,4,2404,3464,2107,-1357
2016,6,29,5,2367,3439,2232,-1207
2016,6,29,6,2416,3232,2257,-975
2016,6,29,7,2308,2901,2118,-783
2016,6,29,8,1936,2751,2136,-615
2016,6,29,9,1924,2613,2085,-528
2016,6,29,10,1910,2549,2028,-521
2016,6,29,11,1771,2501,1826,-675
2016,6,29,12,1759,2545,1737,-808
2016,6,29,13,1825,2720,1826,-894
2016,6,29,14,1741,2860,1704,-1156
2016,6,29,15,1813,3053,1804,-1249
2016,6,29,16,2010,3203,1866,-1337
2016,6,29,17,2025,3297,1844,-1453
2016,6,29,18,2022,3373,1925,-1448
2016,6,29,19,2111,3409,2054,-1355
2016,6,29,20,2141,3441,2094,-1347
2016,6,29,21,2145,3434,2087,-1347
2016,6,29,22,2156,3417,2042,-1375
2016,6,29,23,2174,3458,2098,-1360
2016,6,30,0,2196,3495,2117,-1378
2016,6,30,1,2220,3552,2186,-1366
2016,6,30,2,2244,3553,2163,-1390
2016,6,30,3,2263,3506,2152,-1354
2016,6,30,4,2281,3458,2093,-1365
2016,6,30,5,2269,3445,2213,-1232
2016,6,30,6,2300,3230,2175,-1055
2016,6,30,7,2212,2985,2073,-912
2016,6,30,8,1756,2767,1797,-970
2016,6,30,9,1743,2634,1885,-749
2016,6,30,10,1805,2532,1894,-638
2016,6,30,11,1828,2498,1882,-616
2016,6,30,12,1861,2586,1995,-591
2016,6,30,13,1915,2726,1938,-788
2016,6,30,14,1799,2901,1871,-1030
2016,6,30,15,1862,3116,1841,-1275
2016,6,30,16,1894,3264,1968,-1296
2016,6,30,17,1890,3298,1810,-1488
2016,6,30,18,1879,3374,1857,-1517
2016,6,30,19,1955,3391,1893,-1498
2016,6,30,20,1961,3404,1851,-1553
2016,6,30,21,1941,3431,1878,-1553
2016,6,30,22,1965,3436,1938,-1498
2016,6,30,23,1952,3413,1981,-1432
2016,7,1,0,1981,3441,2135,-1306
2016,7,1,1,2166,3476,2251,-1225
2016,7,1,2,2211,3477,2363,-1114
2016,7,1,3,2223,3441,2326,-1115
2016,7,1,4,2225,3470,2373,-1097
2016,7,1,5,2187,3482,2383,-1099
2016,7,1,6,2176,3316,2302,-1014
2016,7,1,7,2066,3046,2292,-754
2016,7,1,8,1509,2824,1894,-930
2016,7,1,9,1423,2701,1751,-950
2016,7,1,10,1328,2646,1679,-967
2016,7,1,11,1302,2627,1619,-1008
2016,7,1,12,1252,2671,1648,-1023
2016,7,1,13,1234,2778,1643,-1135
2016,7,1,14,1220,2869,1388,-1481
2016,7,1,15,1372,3150,1589,-1561
2016,7,1,16,1415,3289,1666,-1623
2016,7,1,17,1410,3367,1666,-1701
2016,7,1,18,1411,3406,1621,-1785
2016,7,1,19,1390,3443,1534,-1909
2016,7,1,20,1533,3445,1575,-1870
2016,7,1,21,1546,3327,1621,-1706
2016,7,1,22,1626,3359,1843,-1516
2016,7,1,23,1703,3498,1910,-1588
2016,7,2,0,1723,3557,2015,-1542
2016,7,2,1,1738,3546,2022,-1524
2016,7,2,2,1749,3462,2003,-1459
2016,7,2,3,1754,3404,1941,-1463
2016,7,2,4,1757,3355,1915,-1440
2016,7,2,5,1755,3339,1838,-1501
2016,7,2,6,1751,3272,2041,-1231
2016,7,2,7,1747,3026,1913,-1113
2016,7,2,8,1531,2715,1681,-1034
2016,7,2,9,1520,2658,1640,-1018
2016,7,2,10,1131,2628,1509,-1119
2016,7,2,11,1114,2512,1250,-1262
2016,7,2,12,1098,2496,1213,-1283
2016,7,2,13,1084,2516,1201,-1315
2016,7,2,14,1019,2527,1097,-1430
2016,7,2,15,1053,2752,1282,-1470
2016,7,2,16,1213,2973,1316,-1657
2016,7,2,17,1218,3102,1256,-1846
2016,7,2,18,1259,3219,1325,-1894
2016,7,2,19,1380,3271,1330,-1941
2016,7,2,20,1410,3308,1387,-1921
2016,7,2,21,1445,3292,1420,-1872
2016,7,2,22,1478,3249,1391,-1858
2016,7,2,23,1503,3325,1550,-1775
2016,7,3,0,1611,3328,1557,-1771
2016,7,3,1,1615,3398,1625,-1773
2016,7,3,2,1611,3406,1696,-1710
2016,7,3,3,1604,3342,1650,-1692
2016,7,3,4,1648,3277,1685,-1592
2016,7,3,5,1593,3273,1696,-1577
2016,7,3,6,1640,3189,1745,-1444
2016,7,3,7,1635,2979,1732,-1247
2016,7,3,8,1306,2772,1600,-1172
2016,7,3,9,1201,2585,1437,-1148
2016,7,3,10,1194,2511,1427,-1084
2016,7,3,11,1183,2487,1440,-1047
2016,7,3,12,1176,2487,1452,-1035
2016,7,3,13,1173,2491,1405,-1086
2016,7,3,14,1175,2535,1416,-1119
2016,7,3,15,1177,2719,1586,-1133
2016,7,3,16,1282,2896,1545,-1351
2016,7,3,17,1485,3085,1681,-1404
2016,7,3,18,1539,3165,1671,-1494
2016,7,3,19,1544,3206,1677,-1529
2016,7,3,20,1645,3231,1786,-1445
2016,7,3,21,1653,3195,1767,-1428
2016,7,3,22,1659,3184,1761,-1423
2016,7,3,23,1663,3187,1772,-1415
2016,7,4,0,1764,3173,1747,-1426
2016,7,4,1,1762,3186,1705,-1481
2016,7,4,2,1756,3204,1699,-1505
2016,7,4,3,1748,3172,1708,-1464
2016,7,4,4,1742,3138,1693,-1445
2016,7,4,5,1737,3190,1772,-1418
2016,7,4,6,1734,3120,1781,-1339
2016,7,4,7,1538,2917,1610,-1307
2016,7,4,8,1340,2808,1740,-1068
2016,7,4,9,1261,2689,1733,-956
2016,7,4,10,1207,2630,1723,-907
2016,7,4,11,1204,2598,1649,-949
2016,7,4,12,1205,2592,1558,-1034
2016,7,4,13,1209,2613,1557,-1056
2016,7,4,14,1188,2601,1474,-1127
2016,7,4,15,1193,2778,1588,-1190
2016,7,4,16,1247,2947,1563,-1384
2016,7,4,17,1449,3121,1570,-1551
2016,7,4,18,1552,3302,1741,-1561
2016,7,4,19,1556,3318,1649,-1669
2016,7,4,20,1561,3318,1628,-1690
2016,7,4,21,1567,3263,1542,-1721
2016,7,4,22,1572,3193,1494,-1699
2016,7,4,23,1765,3186,1531,-1655
2016,7,5,0,1766,3184,1658,-1526
2016,7,5,1,1765,3170,1627,-1543
2016,7,5,2,1762,3114,1602,-1512
2016,7,5,3,1756,3043,1563,-1480
2016,7,5,4,1749,3005,1538,-1467
2016,7,5,5,1643,3066,1657,-1409
2016,7,5,6,1636,2997,1756,-1241
2016,7,5,7,1535,2947,1791,-1156
2016,7,5,8,1186,2782,1708,-1074
2016,7,5,9,1175,2635,1608,-1027
2016,7,5,10,1158,2612,1561,-1051
2016,7,5,11,1135,2576,1429,-1147
2016,7,5,12,1105,2612,1326,-1286
2016,7,5,13,1224,2783,1388,-1395
2016,7,5,14,1258,2961,1387,-1574
2016,7,5,15,1241,3098,1293,-1805
2016,7,5,16,1403,3233,1349,-1884
2016,7,5,17,1568,3327,1550,-1777
2016,7,5,18,1853,3407,1735,-1672
2016,7,5,19,2009,3436,1869,-1567
2016,7,5,20,2061,3452,2066,-1386
2016,7,5,21,2064,3447,2121,-1326
2016,7,5,22,2072,3386,2108,-1278
2016,7,5,23,2085,3318,2067,-1251
2016,7,6,0,2104,3329,2049,-1280
2016,7,6,1,2127,3366,2137,-1229
2016,7,6,2,2148,3397,2193,-1204
2016,7,6,3,2162,3423,2221,-1202
2016,7,6,4,2067,3413,2086,-1327
2016,7,6,5,2012,3393,2033,-1360
2016,7,6,6,2051,3243,2164,-1079
2016,7,6,7,2037,2935,1882,-1053
2016,7,6,8,1896,2800,2076,-724
2016,7,6,9,1837,2675,1978,-697
2016,7,6,10,1798,2626,1904,-722
2016,7,6,11,1598,2620,1771,-849
2016,7,6,12,1586,2684,1754,-930
2016,7,6,13,1675,2839,1762,-1077
2016,7,6,14,1564,3032,1724,-1308
2016,7,6,15,1821,3203,1661,-1542
2016,7,6,16,1823,3318,1765,-1553
2016,7,6,17,1868,3381,1842,-1539
2016,7,6,18,1916,3493,1981,-1512
2016,7,6,19,1970,3519,2039,-1480
2016,7,6,20,2144,3552,2192,-1360
2016,7,6,21,2145,3581,2309,-1272
2016,7,6,22,2149,3598,2340,-1258
2016,7,6,23,2156,3595,2312,-1283
2016,7,7,0,2167,3632,2319,-1313
2016,7,7,1,2181,3679,2323,-1356
2016,7,7,2,2194,3681,2355,-1326
2016,7,7,3,2199,3628,2324,-1304
2016,7,7,4,2194,3575,2306,-1269
2016,7,7,5,2188,3564,2221,-1343
2016,7,7,6,2181,3363,2146,-1217
2016,7,7,7,2024,3072,2039,-1033
2016,7,7,8,1814,2845,1969,-876
2016,7,7,9,1618,2716,1854,-862
2016,7,7,10,1619,2673,1829,-844
2016,7,7,11,1619,2654,1779,-875
2016,7,7,12,1643,2713,1780,-933
2016,7,7,13,1836,2886,1913,-973
2016,7,7,14,1832,3075,1899,-1176
2016,7,7,15,2079,3285,1982,-1303
2016,7,7,16,2078,3364,1981,-1383
2016,7,7,17,2077,3425,2066,-1359
2016,7,7,18,2078,3539,2081,-1458
2016,7,7,19,2080,3576,2089,-1487
2016,7,7,20,2182,3586,2277,-1309
2016,7,7,21,2192,3595,2386,-1209
2016,7,7,22,2201,3550,2268,-1282
2016,7,7,23,2214,3531,2240,-1291
2016,7,8,0,2230,3530,2167,-1363
2016,7,8,1,2247,3548,2128,-1420
2016,7,8,2,2267,3537,2141,-1396
2016,7,8,3,2284,3454,2165,-1289
2016,7,8,4,2295,3408,2151,-1257
2016,7,8,5,2153,3400,2205,-1195
2016,7,8,6,2154,3273,2286,-987
2016,7,8,7,2063,3026,1938,-1088
2016,7,8,8,2061,2860,2017,-843
2016,7,8,9,1963,2745,2021,-724
2016,7,8,10,1960,2669,1998,-671
2016,7,8,11,1955,2653,2004,-649
2016,7,8,12,2020,2697,2079,-618
2016,7,8,13,2248,2839,2123,-716
2016,7,8,14,1868,2972,1963,-1009
2016,7,8,15,1853,3182,1986,-1196
2016,7,8,16,2085,3372,2119,-1253
2016,7,8,17,2067,3424,2065,-1359
2016,7,8,18,2050,3475,2102,-1373
2016,7,8,19,2137,3485,2152,-1333
2016,7,8,20,2225,3504,2153,-1351
2016,7,8,21,2220,3561,2338,-1223
2016,7,8,22,2317,3523,2324,-1199
2016,7,8,23,2319,3517,2362,-1155
2016,7,9,0,2324,3536,2406,-1130
2016,7,9,1,2331,3550,2439,-1111
2016,7,9,2,2342,3474,2373,-1101
2016,7,9,3,2355,3381,2233,-1148
2016,7,9,4,2169,3401,2179,-1222
2016,7,9,5,2178,3393,2200,-1193
2016,7,9,6,2190,3242,2276,-966
2016,7,9,7,2105,3002,2351,-651
2016,7,9,8,2046,2861,2211,-650
2016,7,9,9,1759,2661,1787,-874
2016,7,9,10,1614,2532,1557,-975
2016,7,9,11,1600,2546,1606,-940
2016,7,9,12,1513,2551,1666,-885
2016,7,9,13,1515,2537,1463,-1074
2016,7,9,14,1363,2614,1492,-1122
2016,7,9,15,1407,2780,1522,-1258
2016,7,9,16,1599,2984,1600,-1384
2016,7,9,17,1586,3180,1651,-1529
2016,7,9,18,1570,3281,1750,-1531
2016,7,9,19,1552,3340,1782,-1558
2016,7,9,20,1634,3325,1796,-1529
2016,7,9,21,1624,3310,1836,-1474
2016,7,9,22,1621,3271,1823,-1448
2016,7,9,23,1624,3241,1728,-1513
2016,7,10,0,1634,3201,1566,-1635
2016,7,10,1,1754,3209,1491,-1718
2016,7,10,2,1780,3202,1549,-1653
2016,7,10,3,1808,3215,1727,-1488
2016,7,10,4,1733,3210,1749,-1461
2016,7,10,5,1747,3257,1885,-1372
2016,7,10,6,1754,3144,1917,-1227
2016,7,10,7,1755,2860,1759,-1101
2016,7,10,8,1470,2680,1689,-991
2016,7,10,9,1268,2525,1603,-922
2016,7,10,10,1213,2389,1445,-944
2016,7,10,11,1205,2360,1372,-988
2016,7,10,12,1122,2321,1273,-1048
2016,7,10,13,1112,2341,1279,-1062
2016,7,10,14,1103,2445,1312,-1133
2016,7,10,15,1296,2549,1229,-1320
2016,7,10,16,1464,2796,1429,-1367
2016,7,10,17,1510,2965,1529,-1436
2016,7,10,18,1509,3083,1559,-1524
2016,7,10,19,1516,3097,1480,-1617
2016,7,10,20,1623,3083,1474,-1609
2016,7,10,21,1648,3078,1463,-1615
2016,7,10,22,1681,3018,1475,-1543
2016,7,10,23,1716,3044,1624,-1420
2016,7,11,0,1750,3121,1759,-1362
2016,7,11,1,1777,3180,1819,-1361
2016,7,11,2,1791,3173,1825,-1348
2016,7,11,3,1794,3102,1680,-1422
2016,7,11,4,1695,3058,1450,-1608
2016,7,11,5,1693,3093,1406,-1687
2016,7,11,6,1592,2912,1287,-1625
2016,7,11,7,1394,2726,1432,-1294
2016,7,11,8,1404,2536,1382,-1154
2016,7,11,9,1402,2390,1302,-1088
2016,7,11,10,1447,2366,1319,-1047
2016,7,11,11,1439,2393,1369,-1024
2016,7,11,12,1485,2513,1552,-961
2016,7,11,13,1475,2699,1613,-1086
2016,7,11,14,1464,2862,1510,-1352
2016,7,11,15,1549,3078,1514,-1564
2016,7,11,16,1619,3279,1699,-1580
2016,7,11,17,1594,3424,1818,-1606
2016,7,11,18,1568,3476,1825,-1651
2016,7,11,19,1647,3497,1786,-1711
2016,7,11,20,1731,3522,1825,-1697
2016,7,11,21,1743,3499,1912,-1587
2016,7,11,22,1845,3485,2010,-1475
2016,7,11,23,1996,3506,2122,-1384
2016,7,12,0,2011,3533,2190,-1343
2016,7,12,1,2027,3576,2266,-1310
2016,7,12,2,2039,3532,2256,-1276
2016,7,12,3,2040,3472,2241,-1231
2016,7,12,4,2037,3456,2311,-1145
2016,7,12,5,2027,3453,2290,-1163
2016,7,12,6,2007,3276,2296,-980
2016,7,12,7,1892,2975,2074,-901
2016,7,12,8,1967,2799,1930,-869
2016,7,12,9,1864,2691,1966,-725
2016,7,12,10,1778,2604,1856,-748
2016,7,12,11,1812,2569,1811,-758
2016,7,12,12,1826,2622,1925,-697
2016,7,12,13,2012,2772,1928,-844
2016,7,12,14,1801,2950,1891,-1059
2016,7,12,15,1843,3151,1907,-1244
2016,7,12,16,1884,3248,1951,-1297
2016,7,12,17,1883,3324,1931,-1393
2016,7,12,18,1892,3379,1783,-1596
2016,7,12,19,2016,3435,1854,-1581
2016,7,12,20,2116,3495,1981,-1514
2016,7,12,21,2123,3510,2076,-1434
2016,7,12,22,2133,3516,2138,-1378
2016,7,12,23,2154,3509,2221,-1288
2016,7,13,0,2165,3480,2176,-1304
2016,7,13,1,2171,3540,2260,-1280
2016,7,13,2,2140,3508,2273,-1235
2016,7,13,3,2111,3467,2297,-1170
2016,7,13,4,2048,3424,2291,-1133
2016,7,13,5,1952,3433,2341,-1092
2016,7,13,6,2149,3215,2252,-963
2016,7,13,7,1897,2932,1954,-978
2016,7,13,8,1962,2752,2079,-673
2016,7,13,9,1952,2623,1955,-668
2016,7,13,10,1936,2537,1898,-639
2016,7,13,11,1915,2532,1887,-645
2016,7,13,12,1890,2586,1958,-628
2016,7,13,13,1917,2726,2007,-719
2016,7,13,14,1899,2889,1834,-1055
2016,7,13,15,1886,3119,1858,-1261
2016,7,13,16,1994,3300,2034,-1266
2016,7,13,17,2070,3364,2209,-1155
2016,7,13,18,2131,3437,2321,-1116
2016,7,13,19,2219,3458,2405,-1053
2016,7,13,20,2377,3500,2463,-1037
2016,7,13,21,2510,3521,2489,-1032
2016,7,13,22,2512,3520,2525,-995
2016,7,13,23,2527,3537,2544,-993
2016,7,14,0,2547,3568,2556,-1012
2016,7,14,1,2568,3606,2557,-1049
2016,7,14,2,2583,3585,2550,-1035
2016,7,14,3,2591,3547,2545,-1002
2016,7,14,4,2593,3491,2524,-967
2016,7,14,5,2588,3481,2567,-914
2016,7,14,6,2580,3309,2669,-640
2016,7,14,7,2571,3022,2576,-446
2016,7,14,8,2280,2822,2475,-347
2016,7,14,9,2169,2666,2339,-327
2016,7,14,10,2156,2569,2201,-368
2016,7,14,11,2162,2534,2174,-360
2016,7,14,12,2226,2596,2223,-373
2016,7,14,13,2264,2730,2300,-430
2016,7,14,14,2168,2928,2231,-697
2016,7,14,15,2316,3163,2281,-882
2016,7,14,16,2323,3331,2346,-985
2016,7,14,17,2376,3398,2502,-896
2016,7,14,18,2383,3453,2510,-943
2016,7,14,19,2387,3502,2546,-956
2016,7,14,20,2508,3536,2575,-961
2016,7,14,21,2521,3587,2661,-926
2016,7,14,22,2550,3599,2682,-917
2016,7,14,23,2589,3632,2737,-895
2016,7,15,0,2632,3660,2769,-891
2016,7,15,1,2672,3664,2744,-920
2016,7,15,2,2703,3596,2728,-868
2016,7,15,3,2754,3533,2745,-788
2016,7,15,4,2644,3503,2542,-961
2016,7,15,5,2567,3489,2543,-946
2016,7,15,6,2617,3321,2774,-547
2016,7,15,7,2562,3058,2680,-378
2016,7,15,8,1936,2870,2309,-561
2016,7,15,9,1925,2708,2149,-559
2016,7,15,10,1907,2615,1993,-622
2016,7,15,11,1882,2610,2061,-549
2016,7,15,12,1854,2658,2099,-559
2016,7,15,13,1924,2775,2116,-659
2016,7,15,14,1795,2879,1865,-1014
2016,7,15,15,1896,3110,2012,-1098
2016,7,15,16,2085,3273,2157,-1116
2016,7,15,17,2184,3370,2198,-1172
2016,7,15,18,2315,3473,2205,-1268
2016,7,15,19,2362,3513,2209,-1304
2016,7,15,20,2411,3534,2358,-1176
2016,7,15,21,2465,3538,2436,-1102
2016,7,15,22,2474,3536,2486,-1050
2016,7,15,23,2489,3541,2512,-1029
2016,7,16,0,2508,3589,2573,-1016
2016,7,16,1,2527,3602,2644,-958
2016,7,16,2,2539,3558,2665,-893
2016,7,16,3,2544,3457,2587,-870
2016,7,16,4,2544,3407,2515,-892
2016,7,16,5,2539,3439,2533,-906
2016,7,16,6,2526,3294,2655,-639
2016,7,16,7,2285,3047,2542,-505
2016,7,16,8,2074,2843,2282,-561
2016,7,16,9,1889,2748,2179,-569
2016,7,16,10,1666,2647,1904,-743
2016,7,16,11,1633,2590,1821,-769
2016,7,16,12,1623,2623,1890,-733
2016,7,16,13,1670,2619,1780,-839
2016,7,16,14,1664,2642,1684,-958
2016,7,16,15,1805,2811,1728,-1083
2016,7,16,16,1800,3002,1759,-1243
2016,7,16,17,2077,3163,1772,-1391
2016,7,16,18,2127,3278,1888,-1390
2016,7,16,19,2122,3301,1901,-1400
2016,7,16,20,2165,3290,1987,-1303
2016,7,16,21,2174,3292,2040,-1252
2016,7,16,22,2170,3278,2102,-1176
2016,7,16,23,2224,3274,2085,-1189
2016,7,17,0,2228,3288,2132,-1156
2016,7,17,1,2233,3329,2177,-1152
2016,7,17,2,2234,3343,2225,-1118
2016,7,17,3,2233,3337,2300,-1037
2016,7,17,4,2198,3316,2307,-1009
2016,7,17,5,2194,3358,2361,-997
2016,7,17,6,2192,3245,2424,-821
2016,7,17,7,2191,3028,2290,-738
2016,7,17,8,1722,2851,2004,-847
2016,7,17,9,1530,2724,1910,-814
2016,7,17,10,1525,2644,1884,-760
2016,7,17,11,1526,2600,1879,-721
2016,7,17,12,1529,2579,1860,-719
2016,7,17,13,1584,2553,1778,-775
2016,7,17,14,1586,2549,1699,-850
2016,7,17,15,1594,2683,1709,-974
2016,7,17,16,1929,2903,1922,-981
2016,7,17,17,2181,3065,2079,-986
2016,7,17,18,2327,3151,2199,-952
2016,7,17,19,2382,3211,2269,-942
2016,7,17,20,2505,3221,2287,-934
2016,7,17,21,2500,3276,2327,-949
2016,7,17,22,2496,3336,2319,-1017
2016,7,17,23,2493,3370,2450,-920
2016,7,18,0,2489,3406,2479,-927
2016,7,18,1,2485,3551,2596,-955
2016,7,18,2,2482,3485,2421,-1064
2016,7,18,3,2478,3526,2296,-1230
2016,7,18,4,2444,3510,2457,-1053
2016,7,18,5,2443,3527,2523,-1004
2016,7,18,6,2442,3322,2534,-788
2016,7,18,7,2317,3071,2318,-753
2016,7,18,8,1630,2866,2047,-819
2016,7,18,9,1629,2737,1980,-757
2016,7,18,10,1633,2659,1955,-704
2016,7,18,11,1634,2651,1966,-685
2016,7,18,12,1634,2713,1978,-735
2016,7,18,13,1782,2842,2024,-818
2016,7,18,14,1968,3044,2117,-927
2016,7,18,15,2141,3239,2259,-980
2016,7,18,16,2189,3384,2385,-999
2016,7,18,17,2272,3471,2377,-1094
2016,7,18,18,2328,3563,2303,-1260
2016,7,18,19,2373,3531,2228,-1303
2016,7,18,20,2445,3595,2357,-1238
2016,7,18,21,2500,3597,2377,-1220
2016,7,18,22,2509,3564,2304,-1260
2016,7,18,23,2544,3547,2374,-1173
2016,7,19,0,2566,3546,2468,-1078
2016,7,19,1,2593,3571,2559,-1012
2016,7,19,2,2575,3570,2573,-997
2016,7,19,3,2605,3531,2568,-963
2016,7,19,4,2524,3533,2665,-868
2016,7,19,5,2490,3526,2658,-868
2016,7,19,6,2496,3300,2617,-683
2016,7,19,7,2446,3025,2298,-727
2016,7,19,8,2118,2818,2344,-474
2016,7,19,9,2007,2695,2214,-481
2016,7,19,10,2003,2610,2146,-464
2016,7,19,11,1995,2579,2061,-518
2016,7,19,12,2067,2609,1946,-663
2016,7,19,13,2078,2802,2037,-765
2016,7,19,14,2246,3057,2243,-814
2016,7,19,15,2273,3239,2278,-961
2016,7,19,16,2319,3375,2270,-1105
2016,7,19,17,2417,3479,2461,-1018
2016,7,19,18,2526,3568,2600,-968
2016,7,19,19,2746,3600,2696,-904
2016,7,19,20,2757,3613,2779,-834
2016,7,19,21,2758,3616,2787,-829
2016,7,19,22,2773,3620,2776,-844
2016,7,19,23,2779,3621,2748,-873
2016,7,20,0,2788,3660,2624,-1036
2016,7,20,1,2800,3699,2715,-984
2016,7,20,2,2812,3690,2780,-910
2016,7,20,3,2821,3633,2773,-860
2016,7,20,4,2797,3559,2750,-809
2016,7,20,5,2552,3561,2721,-840
2016,7,20,6,2605,3361,2644,-717
2016,7,20,7,2547,3060,2475,-585
2016,7,20,8,2245,2842,2237,-605
2016,7,20,9,1966,2725,2107,-618
2016,7,20,10,1859,2663,2070,-593
2016,7,20,11,1849,2654,2051,-603
2016,7,20,12,1839,2726,2130,-596
2016,7,20,13,1942,2814,2107,-707
2016,7,20,14,1935,3009,2077,-932
2016,7,20,15,2183,3230,2135,-1095
2016,7,20,16,2330,3390,2251,-1139
2016,7,20,17,2421,3505,2381,-1124
2016,7,20,18,2532,3610,2526,-1084
2016,7,20,19,2766,3643,2626,-1017
2016,7,20,20,2868,3712,2785,-927
2016,7,20,21,2866,3776,2852,-924
2016,7,20,22,2816,3783,2827,-956
2016,7,20,23,2816,3824,2889,-935
2016,7,21,0,2817,3855,2877,-978
2016,7,21,1,2818,3899,2961,-938
2016,7,21,2,2818,3864,2899,-965
2016,7,21,3,2816,3799,2793,-1006
2016,7,21,4,2839,3734,2787,-947
2016,7,21,5,2563,3692,2779,-913
2016,7,21,6,2481,3465,2725,-740
2016,7,21,7,2426,3155,2530,-625
2016,7,21,8,2326,2944,2443,-501
2016,7,21,9,2214,2811,2310,-501
2016,7,21,10,2164,2696,2228,-468
2016,7,21,11,2164,2669,2207,-462
2016,7,21,12,2164,2744,2268,-476
2016,7,21,13,2354,2894,2371,-523
2016,7,21,14,2254,2986,2066,-920
2016,7,21,15,2317,3233,2258,-975
2016,7,21,16,2468,3366,2396,-970
2016,7,21,17,2712,3219,2421,-798
2016,7,21,18,2717,3295,2456,-839
2016,7,21,19,2821,3262,2290,-972
2016,7,21,20,2921,3328,2179,-1149
2016,7,21,21,2921,3379,2403,-976
2016,7,21,22,2922,3504,2643,-861
2016,7,21,23,2926,3571,2707,-864
2016,7,22,0,2942,3613,2723,-890
2016,7,22,1,2966,3603,2672,-931
2016,7,22,2,2971,3501,2610,-891
2016,7,22,3,3001,3368,2628,-740
2016,7,22,4,2749,3336,2529,-807
2016,7,22,5,2649,3299,2549,-750
2016,7,22,6,2758,3117,2562,-555
2016,7,22,7,2561,2860,2295,-565
2016,7,22,8,2086,2727,2112,-615
2016,7,22,9,1912,2547,1986,-561
2016,7,22,10,1883,2477,1958,-519
2016,7,22,11,1885,2495,2019,-476
2016,7,22,12,1804,2603,2138,-465
2016,7,22,13,2045,2700,2256,-444
2016,7,22,14,1952,2861,2257,-604
2016,7,22,15,2173,3038,2395,-643
2016,7,22,16,2296,3168,2417,-751
2016,7,22,17,2160,3266,2435,-831
2016,7,22,18,2560,3367,2509,-858
2016,7,22,19,2587,3385,2490,-895
2016,7,22,20,2625,3389,2472,-917
2016,7,22,21,2621,3415,2527,-888
2016,7,22,22,2673,3392,2539,-853
2016,7,22,23,2677,3288,2519,-769
2016,7,23,0,2684,3253,2414,-839
2016,7,23,1,2688,3276,2455,-821
2016,7,23,2,2691,3241,2500,-741
2016,7,23,3,2689,3027,2440,-587
2016,7,23,4,2630,2976,2259,-717
2016,7,23,5,2622,2997,2292,-705
2016,7,23,6,2611,2890,2403,-487
2016,7,23,7,2578,2637,2315,-322
2016,7,23,8,1849,2427,2126,-301
2016,7,23,9,1693,2262,1811,-451
2016,7,23,10,1685,2191,1770,-421
2016,7,23,11,1682,2200,1750,-450
2016,7,23,12,1673,2265,1812,-453
2016,7,23,13,1679,2346,1847,-499
2016,7,23,14,1677,2387,1726,-661
2016,7,23,15,1547,2563,1762,-801
2016,7,23,16,1724,2779,1935,-844
2016,7,23,17,1989,2967,2134,-833
2016,7,23,18,2033,3045,2194,-851
2016,7,23,19,2129,3127,2430,-697
2016,7,23,20,2235,3089,2373,-716
2016,7,23,21,2264,3061,2442,-619
2016,7,23,22,2267,3044,2454,-590
2016,7,23,23,2275,3044,2456,-588
2016,7,24,0,2290,3078,2467,-611
2016,7,24,1,2307,3112,2477,-635
2016,7,24,2,2325,3130,2516,-614
2016,7,24,3,2336,3130,2544,-586
2016,7,24,4,2289,3086,2561,-525
2016,7,24,5,2286,3128,2519,-609
2016,7,24,6,2277,2995,2517,-478
2016,7,24,7,2440,2807,2465,-342
2016,7,24,8,1582,2622,1942,-680
2016,7,24,9,1589,2495,1861,-634
2016,7,24,10,1599,2438,1865,-573
2016,7,24,11,1631,2422,1891,-531
2016,7,24,12,1694,2372,1897,-475
2016,7,24,13,1693,2363,1926,-437
2016,7,24,14,1728,2419,1867,-552
2016,7,24,15,2063,2566,1952,-614
2016,7,24,16,2217,2749,2142,-607
2016,7,24,17,2417,2898,2262,-636
2016,7,24,18,2568,2911,2318,-593
2016,7,24,19,2592,3093,2432,-661
2016,7,24,20,2837,3137,2500,-637
2016,7,24,21,2838,3181,2529,-652
2016,7,24,22,2838,3255,2630,-625
2016,7,24,23,2839,3328,2679,-649
2016,7,25,0,2839,3443,2679,-764
2016,7,25,1,2839,3540,2790,-750
2016,7,25,2,2840,3587,2826,-761
2016,7,25,3,2839,3575,2823,-752
2016,7,25,4,2839,3532,2860,-672
2016,7,25,5,2838,3506,2827,-679
2016,7,25,6,2837,3344,2783,-561
2016,7,25,7,2467,3067,2491,-576
2016,7,25,8,2131,2857,2193,-664
2016,7,25,9,2081,2737,2076,-661
2016,7,25,10,2081,2623,1996,-627
2016,7,25,11,2081,2599,1945,-654
2016,7,25,12,2081,2656,1995,-661
2016,7,25,13,2374,2829,2213,-616
2016,7,25,14,2271,2945,1949,-996
2016,7,25,15,2355,3182,2126,-1056
2016,7,25,16,2355,3363,2266,-1097
2016,7,25,17,2406,3528,2403,-1125
2016,7,25,18,2406,3588,2417,-1171
2016,7,25,19,2759,3614,2611,-1003
2016,7,25,20,2804,3701,2715,-986
2016,7,25,21,2804,3759,2748,-1011
2016,7,25,22,2805,3785,2628,-1157
2016,7,25,23,2810,3879,2852,-1027
2016,7,26,0,2822,3923,2789,-1134
2016,7,26,1,2835,3972,2784,-1188
2016,7,26,2,2853,3925,2739,-1186
2016,7,26,3,2871,3842,2880,-962
2016,7,26,4,2635,3761,2919,-842
2016,7,26,5,2639,3679,2739,-940
2016,7,26,6,2635,3397,2646,-751
2016,7,26,7,2580,3048,2331,-717
2016,7,26,8,2076,2842,2055,-787
2016,7,26,9,1900,2688,1969,-719
2016,7,26,10,1836,2612,1987,-625
2016,7,26,11,1872,2517,1842,-675
2016,7,26,12,1903,2589,1886,-703
2016,7,26,13,1887,2743,1913,-830
2016,7,26,14,1776,2890,1831,-1059
2016,7,26,15,1765,3130,1957,-1173
2016,7,26,16,2281,3260,2166,-1094
2016,7,26,17,2475,3338,2201,-1137
2016,7,26,18,2471,3388,2288,-1100
2016,7,26,19,2521,3413,2497,-916
2016,7,26,20,2630,3450,2630,-820
2016,7,26,21,2643,3491,2722,-769
2016,7,26,22,2662,3542,2767,-775
2016,7,26,23,2762,3582,2843,-739
2016,7,27,0,2812,3663,2870,-793
2016,7,27,1,2829,3719,2925,-794
2016,7,27,2,2837,3715,2916,-799
2016,7,27,3,2839,3645,2947,-698
2016,7,27,4,2799,3586,2928,-658
2016,7,27,5,2785,3537,2763,-774
2016,7,27,6,2794,3283,2824,-459
2016,7,27,7,2500,2995,2586,-409
2016,7,27,8,2370,2764,2350,-414
2016,7,27,9,2191,2582,2162,-420
2016,7,27,10,2126,2479,2040,-439
2016,7,27,11,2113,2483,2062,-421
2016,7,27,12,2150,2535,2074,-461
2016,7,27,13,2295,2715,2189,-526
2016,7,27,14,2138,2832,1747,-1085
2016,7,27,15,2187,3125,1922,-1203
2016,7,27,16,2264,3290,2037,-1253
2016,7,27,17,2470,3412,2111,-1301
2016,7,27,18,2617,3518,2212,-1306
2016,7,27,19,2740,3593,2378,-1215
2016,7,27,20,2803,3669,2593,-1076
2016,7,27,21,2806,3720,2724,-996
2016,7,27,22,2815,3785,2760,-1025
2016,7,27,23,2829,3838,2784,-1054
2016,7,28,0,2846,3915,2847,-1068
2016,7,28,1,2860,3955,2849,-1106
2016,7,28,2,2866,3907,2839,-1068
2016,7,28,3,2869,3815,2791,-1024
2016,7,28,4,2868,3721,2776,-945
2016,7,28,5,2860,3688,2705,-983
2016,7,28,6,2851,3434,2783,-651
2016,7,28,7,2637,3094,2658,-436
2016,7,28,8,2199,2879,2410,-469
2016,7,28,9,2207,2699,2254,-445
2016,7,28,10,2196,2592,2146,-446
2016,7,28,11,2195,2565,2127,-438
2016,7,28,12,2193,2615,2142,-473
2016,7,28,13,2269,2797,2394,-403
2016,7,28,14,2169,2891,2143,-748
2016,7,28,15,2291,3149,2211,-938
2016,7,28,16,2294,3332,2218,-1114
2016,7,28,17,2394,3496,2332,-1164
2016,7,28,18,2414,3615,2442,-1173
2016,7,28,19,2615,3707,2594,-1113
2016,7,28,20,2690,3786,2718,-1068
2016,7,28,21,2767,3834,2762,-1072
2016,7,28,22,2767,3898,2735,-1163
2016,7,28,23,2771,3955,2759,-1196
2016,7,29,0,2783,4023,2777,-1246
2016,7,29,1,2798,4069,2781,-1288
2016,7,29,2,2804,4013,2770,-1243
2016,7,29,3,2815,3901,2703,-1198
2016,7,29,4,2817,3830,2767,-1063
2016,7,29,5,2813,3772,2742,-1030
2016,7,29,6,2812,3521,2775,-746
2016,7,29,7,2807,3196,2724,-472
2016,7,29,8,2652,2959,2643,-316
2016,7,29,9,2404,2840,2567,-273
2016,7,29,10,2234,2729,2273,-456
2016,7,29,11,2188,2674,2171,-503
2016,7,29,12,2177,2715,2191,-524
2016,7,29,13,2341,2824,2317,-507
2016,7,29,14,2180,2895,2080,-815
2016,7,29,15,2195,3200,2292,-908
2016,7,29,16,2440,3426,2360,-1066
2016,7,29,17,2494,3649,2500,-1149
2016,7,29,18,2598,3729,2548,-1181
2016,7,29,19,2904,3760,2696,-1064
2016,7,29,20,2909,3843,2790,-1053
2016,7,29,21,2917,3921,2775,-1146
2016,7,29,22,2936,3967,2773,-1194
2016,7,29,23,2963,4008,2789,-1219
2016,7,30,0,2998,4048,2836,-1212
2016,7,30,1,3035,4056,2859,-1197
2016,7,30,2,3061,3951,2841,-1110
2016,7,30,3,3013,3836,2763,-1073
2016,7,30,4,2829,3735,2669,-1066
2016,7,30,5,2835,3665,2656,-1009
2016,7,30,6,2842,3466,2771,-695
2016,7,30,7,2605,3160,2544,-616
2016,7,30,8,1976,2943,2383,-560
2016,7,30,9,1974,2781,2302,-479
2016,7,30,10,1728,2603,1828,-775
2016,7,30,11,1643,2507,1697,-810
2016,7,30,12,1655,2467,1650,-817
2016,7,30,13,1742,2534,1766,-768
2016,7,30,14,1584,2545,1676,-869
2016,7,30,15,1629,2687,1700,-987
2016,7,30,16,1579,2869,1717,-1152
2016,7,30,17,1833,3007,1734,-1273
2016,7,30,18,1846,3124,1859,-1265
2016,7,30,19,2009,3152,1851,-1301
2016,7,30,20,2109,3172,1844,-1328
2016,7,30,21,2138,3239,2016,-1223
2016,7,30,22,2212,3271,2058,-1213
2016,7,30,23,2274,3312,2114,-1198
2016,7,31,0,2281,3355,2105,-1250
2016,7,31,1,2284,3391,2118,-1273
2016,7,31,2,2284,3381,2163,-1218
2016,7,31,3,2281,3319,2150,-1169
2016,7,31,4,2277,3258,2092,-1166
2016,7,31,5,2269,3265,2080,-1185
2016,7,31,6,2255,3110,2251,-859
2016,7,31,7,2138,2884,2170,-714
2016,7,31,8,1660,2651,1919,-732
2016,7,31,9,1636,2501,1844,-657
2016,7,31,10,1509,2400,1737,-663
2016,7,31,11,1480,2355,1672,-683
2016,7,31,12,1447,2387,1603,-784
2016,7,31,13,1517,2444,1628,-816
2016,7,31,14,1394,2482,1603,-879
2016,7,31,15,1522,2568,1496,-1072
2016,7,31,16,1535,2742,1486,-1256
2016,7,31,17,1850,2932,1628,-1304
2016,7,31,18,1916,3016,1760,-1256
2016,7,31,19,2072,3057,1994,-1063
2016,7,31,20,2264,3124,2275,-849
2016,7,31,21,2320,3143,2394,-749
2016,7,31,22,2381,3120,2426,-694
2016,7,31,23,2402,3200,2625,-575
2016,8,1,0,2430,3274,2602,-672
2016,8,1,1,2460,3355,2685,-670
2016,8,1,2,2478,3368,2635,-733
2016,8,1,3,2486,3350,2648,-702
2016,8,1,4,2482,3302,2581,-721
2016,8,1,5,2469,3321,2549,-772
2016,8,1,6,2456,3105,2519,-586
2016,8,1,7,2438,2849,2441,-408
2016,8,1,8,2046,2667,2073,-594
2016,8,1,9,1894,2548,1953,-595
2016,8,1,10,1970,2455,1899,-556
2016,8,1,11,1953,2441,1848,-593
2016,8,1,12,1980,2519,1840,-679
2016,8,1,13,2162,2720,2015,-705
2016,8,1,14,1953,2844,1971,-873
2016,8,1,15,2091,3031,1931,-1100
2016,8,1,16,2141,3129,1961,-1168
2016,8,1,17,2274,3212,2088,-1124
2016,8,1,18,2314,3269,2264,-1005
2016,8,1,19,2548,3287,2414,-873
2016,8,1,20,2658,3347,2581,-766
2016,8,1,21,2665,3404,2742,-662
2016,8,1,22,2738,3462,2755,-707
2016,8,1,23,2738,3512,2880,-632
2016,8,2,0,2745,3557,2890,-667
2016,8,2,1,2701,3630,2932,-698
2016,8,2,2,2701,3607,2920,-687
2016,8,2,3,2643,3532,2835,-697
2016,8,2,4,2571,3477,2794,-683
2016,8,2,5,2389,3415,2734,-681
2016,8,2,6,2454,3164,2547,-617
2016,8,2,7,2111,2903,2300,-603
2016,8,2,8,2032,2688,2019,-669
2016,8,2,9,2102,2569,2019,-550
2016,8,2,10,1881,2532,1879,-653
2016,8,2,11,1530,2525,1771,-754
2016,8,2,12,1610,2569,1732,-837
2016,8,2,13,1664,2784,1883,-901
2016,8,2,14,1766,2979,1969,-1010
2016,8,2,15,1933,3098,1976,-1122
2016,8,2,16,2090,3107,2005,-1102
2016,8,2,17,2105,3174,2011,-1163
2016,8,2,18,2114,3234,2035,-1199
2016,8,2,19,2119,3283,2141,-1142
2016,8,2,20,2121,3292,2227,-1065
2016,8,2,21,2121,3318,2251,-1067
2016,8,2,22,2221,3345,2210,-1135
2016,8,2,23,2320,3386,2200,-1186
2016,8,3,0,2320,3448,2185,-1263
2016,8,3,1,2319,3489,2245,-1244
2016,8,3,2,2317,3487,2250,-1237
2016,8,3,3,2315,3435,2208,-1227
2016,8,3,4,2312,3435,2283,-1152
2016,8,3,5,2307,3417,2424,-993
2016,8,3,6,2303,3187,2376,-811
2016,8,3,7,1883,2925,2087,-838
2016,8,3,8,1829,2728,2011,-717
2016,8,3,9,1719,2628,1943,-685
2016,8,3,10,1909,2569,1876,-693
2016,8,3,11,1710,2538,1816,-722
2016,8,3,12,1829,2597,1804,-793
2016,8,3,13,2107,2813,1981,-832
2016,8,3,14,2136,3000,1988,-1012
2016,8,3,15,2307,3184,2072,-1112
2016,8,3,16,2351,3309,2119,-1190
2016,8,3,17,2470,3402,2039,-1363
2016,8,3,18,2562,3480,2132,-1348
2016,8,3,19,2721,3524,2377,-1147
2016,8,3,20,2925,3573,2604,-969
2016,8,3,21,2982,3613,2712,-901
2016,8,3,22,2963,3640,2755,-885
2016,8,3,23,2874,3649,2616,-1033
2016,8,4,0,2919,3697,2653,-1044
2016,8,4,1,2954,3733,2672,-1061
2016,8,4,2,2923,3696,2678,-1018
2016,8,4,3,2842,3645,2631,-1014
2016,8,4,4,2952,3626,2729,-897
2016,8,4,5,2952,3594,2681,-913
2016,8,4,6,2902,3353,2550,-803
2016,8,4,7,2383,3057,2230,-827
2016,8,4,8,2372,2847,2282,-565
2016,8,4,9,2187,2718,2126,-592
2016,8,4,10,2091,2658,2043,-615
2016,8,4,11,2079,2629,2004,-625
2016,8,4,12,2209,2706,2049,-657
2016,8,4,13,2356,2888,2105,-783
2016,8,4,14,1989,3039,2049,-990
2016,8,4,15,2204,3244,2071,-1173
2016,8,4,16,2353,3408,2110,-1298
2016,8,4,17,2489,3503,2208,-1295
2016,8,4,18,2673,3587,2313,-1274
2016,8,4,19,2782,3653,2455,-1198
2016,8,4,20,2830,3707,2517,-1190
2016,8,4,21,2873,3761,2641,-1120
2016,8,4,22,2711,3784,2541,-1243
2016,8,4,23,2756,3872,2636,-1236
2016,8,5,0,2817,3883,2626,-1257
2016,8,5,1,2835,3899,2655,-1244
2016,8,5,2,2796,3858,2640,-1218
2016,8,5,3,2728,3742,2633,-1109
2016,8,5,4,2847,3679,2666,-1013
2016,8,5,5,2815,3559,2603,-956
2016,8,5,6,2991,3235,2522,-713
2016,8,5,7,2608,2916,2254,-662
2016,8,5,8,2409,2716,2301,-415
2016,8,5,9,2352,2580,2218,-362
2016,8,5,10,2278,2499,2156,-343
2016,8,5,11,2246,2473,2108,-365
2016,8,5,12,2286,2527,2054,-473
2016,8,5,13,2411,2644,2068,-576
2016,8,5,14,1950,2777,2048,-729
2016,8,5,15,2141,3044,2295,-749
2016,8,5,16,2290,3178,2273,-905
2016,8,5,17,2409,3323,2316,-1007
2016,8,5,18,2479,3437,2467,-970
2016,8,5,19,2527,3498,2532,-966
2016,8,5,20,2542,3526,2570,-956
2016,8,5,21,2630,3552,2676,-876
2016,8,5,22,2630,3573,2692,-881
2016,8,5,23,2644,3576,2666,-910
2016,8,6,0,2647,3598,2695,-903
2016,8,6,1,2648,3598,2545,-1053
2016,8,6,2,2709,3522,2620,-902
2016,8,6,3,2601,3404,2552,-852
2016,8,6,4,2493,3340,2735,-605
2016,8,6,5,2338,3309,2719,-590
2016,8,6,6,2623,3122,2732,-390
2016,8,6,7,2192,2875,2636,-239
2016,8,6,8,2045,2640,2274,-366
2016,8,6,9,1891,2461,2052,-409
2016,8,6,10,1816,2358,1960,-398
2016,8,6,11,1792,2283,1985,-298
2016,8,6,12,1885,2359,2077,-282
2016,8,6,13,1944,2418,2083,-335
2016,8,6,14,1483,2431,1819,-612
2016,8,6,15,1625,2594,1865,-729
2016,8,6,16,1871,2888,2123,-765
2016,8,6,17,2114,2959,2163,-796
2016,8,6,18,2246,3082,2290,-792
2016,8,6,19,2320,3121,2336,-785
2016,8,6,20,2478,3110,2373,-737
2016,8,6,21,2630,3088,2365,-723
2016,8,6,22,2663,3050,2419,-631
2016,8,6,23,2720,3059,2516,-543
2016,8,7,0,2768,3082,2571,-511
2016,8,7,1,2821,3126,2644,-482
2016,8,7,2,2839,3111,2680,-431
2016,8,7,3,2805,3077,2579,-498
2016,8,7,4,2761,3078,2557,-521
2016,8,7,5,2778,3106,2582,-524
2016,8,7,6,3073,2964,2712,-252
2016,8,7,7,2723,2740,2583,-157
2016,8,7,8,2422,2495,2413,-82
2016,8,7,9,1971,2393,2241,-152
2016,8,7,10,1742,2250,1970,-280
2016,8,7,11,1542,2227,1788,-439
2016,8,7,12,1563,2260,1706,-554
2016,8,7,13,1566,2324,1779,-545
2016,8,7,14,1383,2315,1644,-671
2016,8,7,15,1595,2478,1559,-919
2016,8,7,16,1867,2708,1686,-1022
2016,8,7,17,2035,2865,1813,-1052
2016,8,7,18,2136,2983,1908,-1075
2016,8,7,19,2178,3066,1959,-1107
2016,8,7,20,2199,3137,2078,-1059
2016,8,7,21,2195,3094,2203,-891
2016,8,7,22,2277,3095,2340,-755
2016,8,7,23,2469,3107,2493,-614
2016,8,8,0,2490,3156,2448,-708
2016,8,8,1,2548,3206,2434,-772
2016,8,8,2,2497,3238,2389,-849
2016,8,8,3,2468,3236,2383,-853
2016,8,8,4,2403,3281,2506,-775
2016,8,8,5,2367,3228,2485,-743
2016,8,8,6,2438,3040,2481,-559
2016,8,8,7,2065,2752,2105,-647
2016,8,8,8,2055,2609,2114,-495
2016,8,8,9,1931,2505,2117,-388
2016,8,8,10,1899,2452,2072,-380
2016,8,8,11,1959,2432,2060,-372
2016,8,8,12,2196,2511,2221,-290
2016,8,8,13,2465,2693,2252,-441
2016,8,8,14,2009,2814,2119,-695
2016,8,8,15,2248,3054,2224,-830
2016,8,8,16,2348,3192,2286,-906
2016,8,8,17,2447,3278,2328,-950
2016,8,8,18,2529,3387,2439,-948
2016,8,8,19,2497,3417,2413,-1004
2016,8,8,20,2559,3431,2397,-1034
2016,8,8,21,2555,3443,2420,-1023
2016,8,8,22,2544,3347,2345,-1002
2016,8,8,23,2566,3410,2402,-1008
2016,8,9,0,2566,3428,2396,-1032
2016,8,9,1,2570,3488,2511,-977
2016,8,9,2,2576,3433,2524,-909
2016,8,9,3,2560,3344,2422,-922
2016,8,9,4,2526,3423,2480,-943
2016,8,9,5,2532,3343,2403,-940
2016,8,9,6,2608,3139,2399,-740
2016,8,9,7,2450,2877,2315,-562
2016,8,9,8,1628,2682,1846,-836
2016,8,9,9,1687,2643,1932,-711
2016,8,9,10,1751,2562,1961,-601
2016,8,9,11,1657,2571,1896,-675
2016,8,9,12,1684,2666,1947,-719
2016,8,9,13,1845,2831,2049,-782
2016,8,9,14,1634,3030,2006,-1024
2016,8,9,15,1820,3232,2119,-1113
2016,8,9,16,1920,3351,2243,-1108
2016,8,9,17,2019,3412,2295,-1117
2016,8,9,18,2089,3436,2218,-1218
2016,8,9,19,2279,3495,2432,-1063
2016,8,9,20,2448,3491,2473,-1018
2016,8,9,21,2469,3540,2646,-894
2016,8,9,22,2497,3516,2635,-881
2016,8,9,23,2502,3527,2689,-838
2016,8,10,0,2549,3500,2687,-813
2016,8,10,1,2602,3504,2713,-791
2016,8,10,2,2594,3456,2661,-795
2016,8,10,3,2559,3470,2516,-954
2016,8,10,4,2560,3566,2642,-924
2016,8,10,5,2488,3512,2662,-850
2016,8,10,6,2526,3267,2590,-677
2016,8,10,7,2126,3008,2254,-754
2016,8,10,8,1825,2778,1887,-891
2016,8,10,9,1575,2698,1860,-838
2016,8,10,10,1465,2596,1676,-920
2016,8,10,11,1445,2596,1686,-910
2016,8,10,12,1445,2672,1714,-958
2016,8,10,13,1651,2891,1891,-1000
2016,8,10,14,1634,3038,1838,-1200
2016,8,10,15,1934,3199,1980,-1219
2016,8,10,16,1975,3377,2095,-1282
2016,8,10,17,2016,3463,2159,-1304
2016,8,10,18,2059,3527,2294,-1233
2016,8,10,19,2541,3570,2495,-1075
2016,8,10,20,2684,3613,2651,-962
2016,8,10,21,2722,3609,2628,-981
2016,8,10,22,2736,3592,2584,-1008
2016,8,10,23,2771,3629,2596,-1033
2016,8,11,0,2808,3588,2433,-1155
2016,8,11,1,2830,3609,2403,-1206
2016,8,11,2,2812,3568,2355,-1213
2016,8,11,3,2771,3562,2505,-1057
2016,8,11,4,2793,3573,2573,-1000
2016,8,11,5,2723,3570,2651,-919
2016,8,11,6,2526,3328,2528,-800
2016,8,11,7,2195,3048,2303,-745
2016,8,11,8,2007,2824,2029,-795
2016,8,11,9,1804,2714,1924,-790
2016,8,11,10,1719,2659,1869,-790
2016,8,11,11,1701,2646,1850,-796
2016,8,11,12,1889,2699,1879,-820
2016,8,11,13,2050,2870,1928,-942
2016,8,11,14,1714,3041,1938,-1103
2016,8,11,15,1848,3201,1856,-1345
2016,8,11,16,1972,3391,1989,-1402
2016,8,11,17,2066,3477,2191,-1286
2016,8,11,18,2162,3564,2267,-1297
2016,8,11,19,2236,3474,2259,-1215
2016,8,11,20,2325,3671,2446,-1225
2016,8,11,21,2481,3737,2630,-1107
2016,8,11,22,2508,3787,2689,-1098
2016,8,11,23,2456,3835,2690,-1145
2016,8,12,0,2508,3899,2712,-1187
2016,8,12,1,2538,3921,2773,-1148
2016,8,12,2,2481,3908,2759,-1149
2016,8,12,3,2413,3832,2761,-1071
2016,8,12,4,2543,3806,2789,-1017
2016,8,12,5,2472,3732,2791,-941
2016,8,12,6,2633,3459,2768,-691
2016,8,12,7,2218,3128,2534,-594
2016,8,12,8,2103,2888,2111,-777
2016,8,12,9,1867,2752,1950,-802
2016,8,12,10,1796,2671,1878,-793
2016,8,12,11,1769,2624,1835,-789
2016,8,12,12,1805,2700,1871,-829
2016,8,12,13,1932,2866,1974,-892
2016,8,12,14,1801,3001,1939,-1062
2016,8,12,15,2094,3251,2108,-1143
2016,8,12,16,2210,3436,2391,-1045
2016,8,12,17,2329,3540,2567,-973
2016,8,12,18,2543,3625,2660,-965
2016,8,12,19,2734,3768,2793,-975
2016,8,12,20,2721,3852,2791,-1061
2016,8,12,21,2745,3939,2839,-1100
2016,8,12,22,2711,3994,2864,-1130
2016,8,12,23,2745,4034,2871,-1163
2016,8,13,0,2774,4093,2857,-1236
2016,8,13,1,2801,4154,2955,-1199
2016,8,13,2,2805,4042,2896,-1146
2016,8,13,3,2785,3902,2793,-1109
2016,8,13,4,2816,3893,2699,-1194
2016,8,13,5,2762,3838,2839,-999
2016,8,13,6,2801,3600,2874,-726
2016,8,13,7,2423,3299,2520,-779
2016,8,13,8,1970,3038,1991,-1047
2016,8,13,9,1695,2866,1832,-1034
2016,8,13,10,1536,2764,1731,-1033
2016,8,13,11,1490,2699,1655,-1044
2016,8,13,12,1485,2686,1648,-1038
2016,8,13,13,1518,2735,1689,-1046
2016,8,13,14,1633,2766,1700,-1066
2016,8,13,15,1804,2927,1812,-1115
2016,8,13,16,2034,3272,2078,-1194
2016,8,13,17,2189,3481,2290,-1191
2016,8,13,18,2324,3637,2434,-1203
2016,8,13,19,2466,3737,2512,-1225
2016,8,13,20,2520,3776,2576,-1200
2016,8,13,21,2571,3847,2621,-1226
2016,8,13,22,2613,3882,2640,-1242
2016,8,13,23,2671,3942,2752,-1190
2016,8,14,0,2710,3970,2835,-1135
2016,8,14,1,2690,3913,2708,-1205
2016,8,14,2,2647,3856,2682,-1174
2016,8,14,3,2624,3792,2743,-1049
2016,8,14,4,2656,3799,2713,-1086
2016,8,14,5,2647,3740,2683,-1057
2016,8,14,6,2519,3524,2597,-927
2016,8,14,7,2271,3259,2426,-833
2016,8,14,8,1992,3016,2200,-816
2016,8,14,9,1896,2786,2033,-753
2016,8,14,10,1800,2665,1942,-723
2016,8,14,11,1686,2605,1857,-748
2016,8,14,12,1717,2572,1794,-778
2016,8,14,13,1730,2580,1768,-812
2016,8,14,14,1635,2612,1765,-847
2016,8,14,15,1776,2747,1798,-949
2016,8,14,16,1994,2980,2044,-936
2016,8,14,17,2174,3187,2216,-971
2016,8,14,18,2305,3346,2355,-991
2016,8,14,19,2462,3443,2544,-899
2016,8,14,20,2479,3496,2541,-955
2016,8,14,21,2543,3556,2589,-967
2016,8,14,22,2591,3634,2746,-888
2016,8,14,23,2664,3692,2837,-855
2016,8,15,0,2714,3758,2842,-916
2016,8,15,1,2782,3783,2875,-908
2016,8,15,2,2777,3687,2860,-827
2016,8,15,3,2750,3570,2792,-778
2016,8,15,4,2903,3561,2888,-673
2016,8,15,5,2835,3393,2714,-679
2016,8,15,6,2659,3207,2653,-554
2016,8,15,7,2325,2913,2437,-476
2016,8,15,8,1845,2716,2116,-600
2016,8,15,9,1544,2619,2009,-610
2016,8,15,10,1518,2533,1935,-598
2016,8,15,11,1511,2453,1746,-707
2016,8,15,12,1565,2508,1708,-800
2016,8,15,13,1929,2712,1837,-875
2016,8,15,14,1972,2924,2001,-923
2016,8,15,15,2313,3105,2201,-904
2016,8,15,16,2474,3269,2420,-849
2016,8,15,17,2612,3396,2424,-972
2016,8,15,18,2641,3515,2519,-996
2016,8,15,19,2651,3640,2715,-925
2016,8,15,20,2551,3685,2619,-1066
2016,8,15,21,2620,3775,2668,-1107
2016,8,15,22,2677,3825,2701,-1124
2016,8,15,23,2729,3882,2712,-1170
2016,8,16,0,2771,3937,2723,-1214
2016,8,16,1,2783,3983,2733,-1250
2016,8,16,2,2709,3943,2747,-1196
2016,8,16,3,2642,3878,2722,-1156
2016,8,16,4,2774,3869,2778,-1091
2016,8,16,5,2782,3754,2797,-957
2016,8,16,6,2759,3434,2691,-743
2016,8,16,7,2454,3137,2476,-661
2016,8,16,8,1885,2852,1963,-889
2016,8,16,9,1743,2735,1870,-865
2016,8,16,10,1656,2662,1815,-847
2016,8,16,11,1639,2630,1778,-852
2016,8,16,12,1678,2682,1752,-930
2016,8,16,13,1939,2876,1843,-1033
2016,8,16,14,2049,3117,1986,-1131
2016,8,16,15,2282,3309,2217,-1092
2016,8,16,16,2407,3425,2301,-1124
2016,8,16,17,2485,3525,2370,-1155
2016,8,16,18,2595,3597,2537,-1060
2016,8,16,19,2620,3666,2590,-1076
2016,8,16,20,2638,3735,2597,-1138
2016,8,16,21,2649,3807,2615,-1192
2016,8,16,22,2703,3863,2720,-1143
2016,8,16,23,2656,3914,2736,-1178
2016,8,17,0,2700,3987,2785,-1202
2016,8,17,1,2721,4043,2810,-1233
2016,8,17,2,2767,3968,2836,-1132
2016,8,17,3,2736,3834,2859,-975
2016,8,17,4,2797,3818,2843,-975
2016,8,17,5,2693,3773,2848,-925
2016,8,17,6,2610,3474,2706,-768
2016,8,17,7,2302,3198,2453,-745
2016,8,17,8,2014,2964,2149,-815
2016,8,17,9,1770,2801,1986,-815
2016,8,17,10,1696,2679,1901,-778
2016,8,17,11,1670,2583,1704,-879
2016,8,17,12,1691,2634,1689,-945
2016,8,17,13,1851,2822,1759,-1063
2016,8,17,14,1921,3005,1797,-1208
2016,8,17,15,2122,3255,2006,-1249
2016,8,17,16,2224,3430,2163,-1267
2016,8,17,17,2340,3557,2259,-1298
2016,8,17,18,2547,3638,2386,-1252
2016,8,17,19,2611,3692,2512,-1180
2016,8,17,20,2646,3773,2618,-1155
2016,8,17,21,2716,3823,2661,-1162
2016,8,17,22,2793,3866,2774,-1092
2016,8,17,23,2683,3919,2692,-1227
2016,8,18,0,2730,3963,2726,-1237
2016,8,18,1,2750,4004,2773,-1231
2016,8,18,2,2694,3961,2757,-1204
2016,8,18,3,2710,3866,2674,-1192
2016,8,18,4,2681,3876,2701,-1175
2016,8,18,5,2655,3776,2710,-1066
2016,8,18,6,2791,3485,2714,-771
2016,8,18,7,2384,3200,2384,-816
2016,8,18,8,1890,2886,1973,-913
2016,8,18,9,1766,2704,1828,-876
2016,8,18,10,1687,2636,1784,-852
2016,8,18,11,1684,2624,1771,-853
2016,8,18,12,1742,2714,1767,-947
2016,8,18,13,1909,2933,1884,-1049
2016,8,18,14,1991,3124,1960,-1164
2016,8,18,15,2303,3372,2150,-1222
2016,8,18,16,2465,3540,2360,-1180
2016,8,18,17,2585,3602,2456,-1146
2016,8,18,18,2715,3699,2553,-1146
2016,8,18,19,2796,3854,2696,-1158
2016,8,18,20,2933,3937,2743,-1194
2016,8,18,21,3042,4039,2848,-1191
2016,8,18,22,3075,4101,2899,-1202
2016,8,18,23,3120,4153,2904,-1249
2016,8,19,0,3118,4122,2816,-1306
2016,8,19,1,3129,4128,2794,-1334
2016,8,19,2,3130,3966,2736,-1230
2016,8,19,3,3055,3889,2732,-1157
2016,8,19,4,2986,3829,2611,-1218
2016,8,19,5,2825,3811,2713,-1098
2016,8,19,6,2699,3552,2736,-816
2016,8,19,7,2596,3302,2546,-756
2016,8,19,8,1940,3023,2386,-637
2016,8,19,9,1907,2875,2353,-522
2016,8,19,10,1775,2781,2259,-522
2016,8,19,11,1770,2675,2065,-610
2016,8,19,12,1780,2751,2090,-661
2016,8,19,13,1980,2960,2148,-812
2016,8,19,14,1838,3101,2045,-1056
2016,8,19,15,1855,3240,1911,-1329
2016,8,19,16,2046,3544,2183,-1361
2016,8,19,17,2214,3695,2233,-1462
2016,8,19,18,2541,3862,2514,-1348
2016,8,19,19,2822,4005,2744,-1261
2016,8,19,20,2820,4093,2820,-1273
2016,8,19,21,2872,4206,2820,-1386
2016,8,19,22,2868,4249,2694,-1555
2016,8,19,23,2898,4263,2624,-1639
2016,8,20,0,2860,4318,2635,-1683
2016,8,20,1,2845,4261,2507,-1754
2016,8,20,2,2816,4163,2471,-1692
2016,8,20,3,2779,4033,2433,-1600
2016,8,20,4,2894,3972,2600,-1372
2016,8,20,5,2748,3857,2582,-1275
2016,8,20,6,2976,3637,2693,-944
2016,8,20,7,2574,3247,2487,-760
2016,8,20,8,2313,3038,2341,-697
2016,8,20,9,2134,2867,2205,-662
2016,8,20,10,2003,2759,2151,-608
2016,8,20,11,1871,2726,2124,-602
2016,8,20,12,1860,2719,2100,-619
2016,8,20,13,1975,2745,2021,-724
2016,8,20,14,1846,2777,1945,-832
2016,8,20,15,1904,2956,2070,-886
2016,8,20,16,1942,3152,2012,-1140
2016,8,20,17,2168,3397,2143,-1254
2016,8,20,18,2310,3576,2283,-1293
2016,8,20,19,2413,3670,2401,-1269
2016,8,20,20,2453,3780,2450,-1330
2016,8,20,21,2636,3855,2601,-1254
2016,8,20,22,2713,3904,2700,-1204
2016,8,20,23,2691,3934,2666,-1268
2016,8,21,0,2748,4026,2687,-1339
2016,8,21,1,2677,3978,2637,-1341
2016,8,21,2,2628,3894,2580,-1314
2016,8,21,3,2629,3830,2583,-1247
2016,8,21,4,2722,3763,2695,-1068
2016,8,21,5,2707,3681,2688,-993
2016,8,21,6,2799,3472,2788,-684
2016,8,21,7,2401,3148,2431,-717
2016,8,21,8,2188,2959,2259,-700
2016,8,21,9,2088,2781,2205,-576
2016,8,21,10,1929,2661,2070,-591
2016,8,21,11,1751,2650,2057,-593
2016,8,21,12,1775,2706,2135,-571
2016,8,21,13,1750,2662,2058,-604
2016,8,21,14,1694,2735,2129,-606
2016,8,21,15,1750,2883,2133,-750
2016,8,21,16,1888,3077,2244,-833
2016,8,21,17,2005,3103,2082,-1021
2016,8,21,18,2074,3134,2019,-1115
2016,8,21,19,2106,3160,2048,-1112
2016,8,21,20,2263,3327,2421,-906
2016,8,21,21,2404,3328,2521,-807
2016,8,21,22,2426,3367,2586,-781
2016,8,21,23,2466,3415,2655,-760
2016,8,22,0,2545,3471,2761,-710
2016,8,22,1,2625,3447,2546,-901
2016,8,22,2,2654,3422,2482,-940
2016,8,22,3,2644,3437,2443,-994
2016,8,22,4,2631,3516,2514,-1002
2016,8,22,5,2509,3399,2428,-971
2016,8,22,6,2331,3149,2304,-845
2016,8,22,7,2052,2894,2051,-843
2016,8,22,8,1445,2740,1828,-912
2016,8,22,9,1431,2661,1841,-820
2016,8,22,10,1434,2618,1873,-745
2016,8,22,11,1450,2643,1917,-726
2016,8,22,12,1465,2723,2000,-723
2016,8,22,13,1472,2881,2036,-845
2016,8,22,14,1443,3056,2039,-1017
2016,8,22,15,1484,3268,2179,-1089
2016,8,22,16,1724,3367,2300,-1067
2016,8,22,17,2034,3438,2341,-1097
2016,8,22,18,2326,3487,2432,-1055
2016,8,22,19,2488,3539,2557,-982
2016,8,22,20,2529,3586,2658,-928
2016,8,22,21,2577,3539,2626,-913
2016,8,22,22,2619,3573,2675,-898
2016,8,22,23,2685,3570,2786,-784
2016,8,23,0,2811,3607,2812,-795
2016,8,23,1,2904,3682,2915,-767
2016,8,23,2,2941,3624,2902,-722
2016,8,23,3,2942,3574,2915,-659
2016,8,23,4,2986,3645,2965,-680
2016,8,23,5,2893,3523,2942,-581
2016,8,23,6,2769,3242,2693,-549
2016,8,23,7,2397,2913,2356,-557
2016,8,23,8,1993,2665,2110,-555
2016,8,23,9,1840,2544,1986,-558
2016,8,23,10,1798,2488,1872,-616
2016,8,23,11,1802,2489,1835,-654
2016,8,23,12,1868,2623,1958,-665
2016,8,23,13,2049,2907,2188,-719
2016,8,23,14,1902,3068,2130,-938
2016,8,23,15,2100,3276,2317,-959
2016,8,23,16,2223,3399,2413,-986
2016,8,23,17,2315,3470,2449,-1021
2016,8,23,18,2514,3550,2532,-1018
2016,8,23,19,2683,3599,2646,-953
2016,8,23,20,2640,3594,2552,-1042
2016,8,23,21,2684,3638,2595,-1043
2016,8,23,22,2703,3686,2652,-1034
2016,8,23,23,2728,3686,2655,-1031
2016,8,24,0,2767,3774,2736,-1038
2016,8,24,1,2800,3820,2804,-1016
2016,8,24,2,2768,3785,2771,-1014
2016,8,24,3,2709,3695,2726,-969
2016,8,24,4,2810,3716,2841,-875
2016,8,24,5,2742,3537,2739,-798
2016,8,24,6,2824,3287,2807,-480
2016,8,24,7,2423,2919,2503,-416
2016,8,24,8,2029,2667,2190,-477
2016,8,24,9,1916,2552,2076,-476
2016,8,24,10,1914,2556,1969,-587
2016,8,24,11,1896,2559,1997,-562
2016,8,24,12,1953,2614,1991,-623
2016,8,24,13,2106,2705,2099,-606
2016,8,24,14,1902,2863,2104,-759
2016,8,24,15,2108,3029,2275,-754
2016,8,24,16,2179,3151,2213,-938
2016,8,24,17,2289,3289,2314,-975
2016,8,24,18,2393,3408,2360,-1048
2016,8,24,19,2490,3495,2394,-1101
2016,8,24,20,2684,3599,2449,-1150
2016,8,24,21,2844,3697,2596,-1101
2016,8,24,22,2882,3736,2657,-1079
2016,8,24,23,2909,3820,2745,-1075
2016,8,25,0,2949,3871,2758,-1113
2016,8,25,1,2960,3949,2835,-1114
2016,8,25,2,2901,3830,2723,-1107
2016,8,25,3,2841,3770,2680,-1090
2016,8,25,4,2817,3775,2735,-1040
2016,8,25,5,2609,3570,2528,-1042
2016,8,25,6,2686,3300,2609,-691
2016,8,25,7,2389,2991,2368,-623
2016,8,25,8,2033,2700,2025,-675
2016,8,25,9,1887,2574,1846,-728
2016,8,25,10,1809,2505,1807,-698
2016,8,25,11,1742,2474,1803,-671
2016,8,25,12,1827,2544,1826,-718
2016,8,25,13,1977,2768,1964,-804
2016,8,25,14,1798,2910,1831,-1079
2016,8,25,15,2004,3081,2040,-1041
2016,8,25,16,2054,3222,2066,-1156
2016,8,25,17,2180,3394,2192,-1202
2016,8,25,18,2313,3568,2307,-1261
2016,8,25,19,2325,3651,2333,-1318
2016,8,25,20,2523,3773,2402,-1371
2016,8,25,21,2712,3878,2577,-1301
2016,8,25,22,2703,3949,2569,-1380
2016,8,25,23,2707,4026,2611,-1415
2016,8,26,0,2712,4067,2588,-1479
2016,8,26,1,2707,4080,2590,-1490
2016,8,26,2,2677,4014,2558,-1456
2016,8,26,3,2751,3875,2575,-1300
2016,8,26,4,2686,3850,2645,-1205
2016,8,26,5,2560,3644,2459,-1185
2016,8,26,6,2650,3355,2479,-876
2016,8,26,7,2344,3073,2333,-740
2016,8,26,8,1978,2784,2092,-692
2016,8,26,9,1847,2620,1928,-692
2016,8,26,10,1677,2570,1796,-774
2016,8,26,11,1626,2527,1772,-755
2016,8,26,12,1817,2588,1772,-816
2016,8,26,13,1944,2764,1941,-823
2016,8,26,14,1966,2963,2119,-844
2016,8,26,15,2144,3091,2131,-960
2016,8,26,16,2349,3274,2292,-982
2016,8,26,17,2480,3447,2419,-1028
2016,8,26,18,2502,3616,2449,-1167
2016,8,26,19,2700,3723,2586,-1137
2016,8,26,20,2700,3840,2611,-1229
2016,8,26,21,2798,3927,2691,-1236
2016,8,26,22,2804,3993,2711,-1282
2016,8,26,23,2790,4052,2721,-1331
2016,8,27,0,2792,4099,2691,-1408
2016,8,27,1,2794,4047,2658,-1389
2016,8,27,2,2817,3939,2674,-1265
2016,8,27,3,2830,3852,2731,-1121
2016,8,27,4,2752,3833,2828,-1005
2016,8,27,5,2635,3731,2633,-1098
2016,8,27,6,2545,3511,2534,-977
2016,8,27,7,2256,3190,2238,-952
2016,8,27,8,2030,2962,2138,-824
2016,8,27,9,1866,2885,2069,-816
2016,8,27,10,1752,2789,2057,-732
2016,8,27,11,1657,2781,2126,-655
2016,8,27,12,1596,2774,2101,-673
2016,8,27,13,1594,2793,2057,-736
2016,8,27,14,1579,2790,2000,-790
2016,8,27,15,1618,2933,1944,-989
2016,8,27,16,1775,3162,2021,-1141
2016,8,27,17,1935,3296,2095,-1201
2016,8,27,18,1827,3347,2052,-1295
2016,8,27,19,1853,3354,2000,-1354
2016,8,27,20,1873,3356,2026,-1330
2016,8,27,21,1882,3344,2100,-1244
2016,8,27,22,1900,3320,2114,-1206
2016,8,27,23,2023,3304,2103,-1201
2016,8,28,0,2175,3309,2124,-1185
2016,8,28,1,2194,3327,2158,-1169
2016,8,28,2,2173,3294,2157,-1137
2016,8,28,3,2140,3289,2202,-1087
2016,8,28,4,2190,3384,2328,-1056
2016,8,28,5,2014,3320,2249,-1071
2016,8,28,6,1757,3063,1867,-1196
2016,8,28,7,1575,2800,1614,-1186
2016,8,28,8,1676,2715,1760,-955
2016,8,28,9,1553,2598,1726,-872
2016,8,28,10,1500,2528,1593,-935
2016,8,28,11,1474,2489,1518,-971
2016,8,28,12,1443,2500,1533,-967
2016,8,28,13,1408,2605,1600,-1005
2016,8,28,14,1452,2677,1658,-1019
2016,8,28,15,1632,2791,1791,-1000
2016,8,28,16,1843,2993,2032,-961
2016,8,28,17,2086,3056,2078,-978
2016,8,28,18,2191,3142,2165,-977
2016,8,28,19,2269,3200,2323,-877
2016,8,28,20,2341,3283,2469,-814
2016,8,28,21,2395,3286,2527,-759
2016,8,28,22,2448,3301,2527,-774
2016,8,28,23,2631,3328,2690,-638
2016,8,29,0,2842,3374,2875,-499
2016,8,29,1,2954,3439,2909,-530
2016,8,29,2,2984,3435,2880,-555
2016,8,29,3,3006,3447,2891,-556
2016,8,29,4,3051,3518,2945,-573
2016,8,29,5,2855,3385,2782,-603
2016,8,29,6,2502,3145,2518,-627
2016,8,29,7,2256,2916,2216,-700
2016,8,29,8,1724,2740,2058,-682
2016,8,29,9,1656,2598,1869,-729
2016,8,29,10,1652,2523,1806,-717
2016,8,29,11,1669,2513,1799,-714
2016,8,29,12,1739,2598,1890,-708
2016,8,29,13,1903,2803,2057,-746
2016,8,29,14,1765,3015,2092,-923
2016,8,29,15,1938,3185,2175,-1010
2016,8,29,16,2053,3313,2234,-1079
2016,8,29,17,2269,3429,2316,-1113
2016,8,29,18,2349,3510,2349,-1161
2016,8,29,19,2423,3572,2396,-1176
2016,8,29,20,2621,3637,2568,-1069
2016,8,29,21,2771,3688,2682,-1006
2016,8,29,22,2797,3733,2769,-964
2016,8,29,23,2829,3778,2800,-978
2016,8,30,0,2838,3814,2843,-971
2016,8,30,1,2845,3828,2897,-931
2016,8,30,2,2798,3777,2893,-884
2016,8,30,3,2749,3716,2805,-911
2016,8,30,4,2740,3731,2707,-1024
2016,8,30,5,2511,3514,2695,-819
2016,8,30,6,2623,3201,2587,-614
2016,8,30,7,2191,2948,2232,-716
2016,8,30,8,1754,2677,2060,-617
2016,8,30,9,1642,2505,1832,-673
2016,8,30,10,1616,2469,1806,-663
2016,8,30,11,1590,2465,1781,-684
2016,8,30,12,1601,2505,1685,-820
2016,8,30,13,1846,2838,2039,-799
2016,8,30,14,1833,3024,2015,-1009
2016,8,30,15,2009,3231,2155,-1076
2016,8,30,16,2065,3343,2224,-1119
2016,8,30,17,2162,3372,2143,-1229
2016,8,30,18,2239,3430,2140,-1290
2016,8,30,19,2303,3461,2222,-1239
2016,8,30,20,2475,3502,2464,-1038
2016,8,30,21,2613,3507,2600,-907
2016,8,30,22,2638,3486,2598,-888
2016,8,30,23,2610,3470,2515,-955
2016,8,31,0,2566,3494,2477,-1017
2016,8,31,1,2526,3501,2508,-993
2016,8,31,2,2439,3460,2384,-1076
2016,8,31,3,2378,3498,2368,-1130
2016,8,31,4,2411,3590,2524,-1066
2016,8,31,5,2203,3420,2409,-1011
2016,8,31,6,2171,3182,2352,-830
2016,8,31,7,1908,2902,2152,-750
2016,8,31,8,1790,2714,1944,-770
2016,8,31,9,1666,2617,1897,-720
2016,8,31,10,1639,2558,1823,-735
2016,8,31,11,1626,2521,1736,-785
2016,8,31,12,1687,2613,1834,-779
2016,8,31,13,1894,2858,2086,-772
2016,8,31,14,1892,3074,2044,-1030
2016,8,31,15,2103,3279,2201,-1078
2016,8,31,16,2136,3337,2134,-1203
2016,8,31,17,2239,3437,2304,-1133
2016,8,31,18,2333,3482,2416,-1066
2016,8,31,19,2394,3524,2486,-1038
2016,8,31,20,2534,3559,2586,-973
2016,8,31,21,2677,3557,2685,-872
2016,8,31,22,2667,3540,2682,-858
2016,8,31,23,2669,3538,2660,-878
2016,9,1,0,2667,3521,2636,-885
2016,9,1,1,2690,3513,2641,-872
2016,9,1,2,2641,3505,2653,-852
2016,9,1,3,2572,3506,2659,-847
2016,9,1,4,2497,3581,2710,-871
2016,9,1,5,2390,3358,2508,-850
2016,9,1,6,2286,3065,2321,-744
2016,9,1,7,1995,2826,1898,-928
2016,9,1,8,1444,2629,1692,-937
2016,9,1,9,1304,2545,1582,-963
2016,9,1,10,1303,2503,1543,-960
2016,9,1,11,1379,2564,1616,-948
2016,9,1,12,1374,2653,1665,-988
2016,9,1,13,1366,2828,1651,-1177
2016,9,1,14,1345,3125,1758,-1367
2016,9,1,15,1687,3269,1798,-1471
2016,9,1,16,1777,3322,1992,-1330
2016,9,1,17,1876,3312,1911,-1401
2016,9,1,18,1971,3363,1879,-1484
2016,9,1,19,2027,3408,1977,-1431
2016,9,1,20,2198,3444,2169,-1275
2016,9,1,21,2352,3467,2326,-1141
2016,9,1,22,2365,3448,2353,-1095
2016,9,1,23,2369,3398,2320,-1078
2016,9,2,0,2409,3414,2347,-1067
2016,9,2,1,2468,3435,2466,-969
2016,9,2,2,2495,3489,2552,-937
2016,9,2,3,2500,3507,2374,-1133
2016,9,2,4,2478,3560,2441,-1119
2016,9,2,5,2202,3408,2268,-1140
2016,9,2,6,2183,3155,2167,-988
2016,9,2,7,1903,2902,2068,-834
2016,9,2,8,1708,2704,1947,-757
2016,9,2,9,1618,2613,1748,-865
2016,9,2,10,1574,2576,1670,-906
2016,9,2,11,1558,2562,1640,-922
2016,9,2,12,1613,2629,1721,-908
2016,9,2,13,1789,2772,1881,-891
2016,9,2,14,1661,2939,1814,-1125
2016,9,2,15,1786,3190,2002,-1188
2016,9,2,16,1803,3333,2070,-1263
2016,9,2,17,1816,3408,1993,-1415
2016,9,2,18,1804,3407,1883,-1524
2016,9,2,19,1779,3410,1849,-1561
2016,9,2,20,1891,3391,1991,-1400
2016,9,2,21,2015,3385,2079,-1306
2016,9,2,22,1997,3370,2087,-1283
2016,9,2,23,2009,3341,2132,-1209
2016,9,3,0,2029,3307,2111,-1196
2016,9,3,1,2100,3309,2137,-1172
2016,9,3,2,2125,3265,2085,-1180
2016,9,3,3,2113,3271,2161,-1110
2016,9,3,4,2166,3364,2247,-1117
2016,9,3,5,2074,3211,2183,-1028
2016,9,3,6,2131,3065,2165,-900
2016,9,3,7,1817,2873,1984,-889
2016,9,3,8,1203,2615,1513,-1102
2016,9,3,9,1151,2535,1389,-1146
2016,9,3,10,1092,2454,1369,-1085
2016,9,3,11,1092,2474,1387,-1087
2016,9,3,12,1127,2506,1394,-1112
2016,9,3,13,1186,2612,1601,-1011
2016,9,3,14,1187,2637,1355,-1282
2016,9,3,15,1368,2791,1510,-1281
2016,9,3,16,1254,2897,1330,-1567
2016,9,3,17,1404,3055,1371,-1684
2016,9,3,18,1492,3089,1353,-1736
2016,9,3,19,1530,3162,1647,-1515
2016,9,3,20,1537,3085,1589,-1496
2016,9,3,21,1525,3034,1552,-1482
2016,9,3,22,1518,3067,1713,-1354
2016,9,3,23,1524,3067,1708,-1359
2016,9,4,0,1541,3094,1709,-1385
2016,9,4,1,1565,3149,1761,-1388
2016,9,4,2,1587,3194,1787,-1407
2016,9,4,3,1582,3168,1798,-1370
2016,9,4,4,1594,3269,1906,-1363
2016,9,4,5,1519,3170,1891,-1279
2016,9,4,6,1615,3018,1832,-1186
2016,9,4,7,1490,2820,1626,-1194
2016,9,4,8,1460,2681,1510,-1171
2016,9,4,9,1362,2601,1396,-1205
2016,9,4,10,1309,2528,1328,-1200
2016,9,4,11,1285,2496,1296,-1200
2016,9,4,12,1285,2518,1305,-1213
2016,9,4,13,1300,2564,1384,-1180
2016,9,4,14,1060,2653,1382,-1271
2016,9,4,15,1194,2734,1363,-1371
2016,9,4,16,945,2873,1176,-1697
2016,9,4,17,1055,3045,1335,-1710
2016,9,4,18,1111,3082,1324,-1758
2016,9,4,19,1145,3031,1319,-1712
2016,9,4,20,1172,3043,1359,-1684
2016,9,4,21,1193,2998,1346,-1652
2016,9,4,22,1194,3003,1379,-1624
2016,9,4,23,1200,2976,1335,-1641
2016,9,5,0,1223,2993,1327,-1666
2016,9,5,1,1262,2989,1335,-1654
2016,9,5,2,1282,2991,1272,-1719
2016,9,5,3,1252,3155,1630,-1525
2016,9,5,4,1238,3287,1767,-1520
2016,9,5,5,1130,3163,1583,-1580
2016,9,5,6,1370,3014,1571,-1443
2016,9,5,7,1127,2829,1524,-1305
2016,9,5,8,1610,2697,1753,-944
2016,9,5,9,1581,2605,1766,-839
2016,9,5,10,1490,2488,1499,-989
2016,9,5,11,1532,2480,1618,-862
2016,9,5,12,1527,2501,1717,-784
2016,9,5,13,1342,2572,1671,-901
2016,9,5,14,1389,2673,1623,-1050
2016,9,5,15,1447,2718,1586,-1132
2016,9,5,16,1331,2874,1626,-1248
2016,9,5,17,1480,3043,1691,-1352
2016,9,5,18,1596,3164,1754,-1410
2016,9,5,19,1925,3202,1890,-1312
2016,9,5,20,2008,3188,1998,-1190
2016,9,5,21,2067,3194,2123,-1071
2016,9,5,22,2094,3169,2169,-1000
2016,9,5,23,2127,3159,2164,-995
2016,9,6,0,2174,3192,2177,-1015
2016,9,6,1,2233,3332,2372,-960
2016,9,6,2,2282,3368,2432,-936
2016,9,6,3,2320,3468,2473,-995
2016,9,6,4,2320,3470,2508,-962
2016,9,6,5,2158,3281,2404,-877
2016,9,6,6,2124,3039,2316,-723
2016,9,6,7,1878,2740,2178,-562
2016,9,6,8,1719,2559,1956,-603
2016,9,6,9,1640,2516,1920,-596
2016,9,6,10,1555,2444,1753,-691
2016,9,6,11,1504,2431,1735,-696
2016,9,6,12,1600,2528,1782,-746
2016,9,6,13,1712,2776,1969,-807
2016,9,6,14,1625,3122,2116,-1006
2016,9,6,15,1796,3316,2192,-1124
2016,9,6,16,1824,3387,2180,-1207
2016,9,6,17,1909,3410,2215,-1195
2016,9,6,18,1994,3430,2159,-1271
2016,9,6,19,2061,3452,2187,-1265
2016,9,6,20,2221,3462,2272,-1190
2016,9,6,21,2363,3456,2295,-1161
2016,9,6,22,2354,3438,2255,-1183
2016,9,6,23,2332,3361,2117,-1244
2016,9,7,0,2320,3358,2051,-1307
2016,9,7,1,2339,3424,2170,-1254
2016,9,7,2,2335,3388,2221,-1167
2016,9,7,3,2322,3467,2422,-1045
2016,9,7,4,2311,3541,2519,-1022
2016,9,7,5,2072,3320,2374,-946
2016,9,7,6,2225,3130,2445,-685
2016,9,7,7,1985,2923,2320,-603
2016,9,7,8,1789,2729,2078,-651
2016,9,7,9,1656,2577,1934,-643
2016,9,7,10,1586,2457,1755,-702
2016,9,7,11,1544,2455,1791,-664
2016,9,7,12,1605,2534,1886,-648
2016,9,7,13,1815,2794,2085,-709
2016,9,7,14,1877,3130,2047,-1083
2016,9,7,15,1955,3349,2210,-1139
2016,9,7,16,1954,3379,2138,-1241
2016,9,7,17,1817,3284,1909,-1375
2016,9,7,18,1840,3346,1869,-1477
2016,9,7,19,1978,3456,2127,-1329
2016,9,7,20,2040,3431,2096,-1335
2016,9,7,21,2130,3437,2180,-1257
2016,9,7,22,2160,3410,2153,-1257
2016,9,7,23,2148,3381,2097,-1284
2016,9,8,0,2147,3365,2123,-1242
2016,9,8,1,2271,3388,2228,-1160
2016,9,8,2,2285,3402,2261,-1141
2016,9,8,3,2325,3500,2370,-1130
2016,9,8,4,2348,3552,2495,-1057
2016,9,8,5,2159,3316,2383,-933
2016,9,8,6,2210,3031,2299,-732
2016,9,8,7,1817,2744,1971,-773
2016,9,8,8,1433,2639,1732,-907
2016,9,8,9,1355,2564,1612,-952
2016,9,8,10,1348,2483,1505,-978
2016,9,8,11,1340,2477,1456,-1021
2016,9,8,12,1331,2585,1561,-1024
2016,9,8,13,1406,2825,1709,-1116
2016,9,8,14,1351,3130,1642,-1488
2016,9,8,15,1527,3295,1732,-1563
2016,9,8,16,1606,3311,1650,-1661
2016,9,8,17,1592,3299,1649,-1650
2016,9,8,18,1748,3337,1805,-1532
2016,9,8,19,1898,3332,1858,-1474
2016,9,8,20,1962,3340,1894,-1446
2016,9,8,21,1903,3349,1920,-1429
2016,9,8,22,1924,3354,1976,-1378
2016,9,8,23,1956,3334,1998,-1336
2016,9,9,0,1991,3367,2079,-1288
2016,9,9,1,2052,3428,2186,-1242
2016,9,9,2,2083,3418,2244,-1174
2016,9,9,3,2081,3468,2302,-1166
2016,9,9,4,2052,3533,2292,-1241
2016,9,9,5,2026,3329,2124,-1205
2016,9,9,6,1896,3103,2033,-1070
2016,9,9,7,1677,2891,2055,-836
2016,9,9,8,1594,2568,1638,-930
2016,9,9,9,1487,2540,1558,-982
2016,9,9,10,1445,2482,1484,-998
2016,9,9,11,1444,2484,1463,-1021
2016,9,9,12,1532,2575,1513,-1062
2016,9,9,13,1743,2820,1725,-1095
2016,9,9,14,1638,3181,1862,-1319
2016,9,9,15,1837,3361,1894,-1467
2016,9,9,16,1919,3379,1913,-1466
2016,9,9,17,1918,3372,1867,-1505
2016,9,9,18,1945,3341,1894,-1447
2016,9,9,19,1966,3371,1884,-1487
2016,9,9,20,2087,3451,1981,-1470
2016,9,9,21,2208,3478,2078,-1400
2016,9,9,22,2215,3473,2089,-1384
2016,9,9,23,2215,3494,2171,-1323
2016,9,10,0,2234,3475,2141,-1334
2016,9,10,1,2239,3501,2174,-1327
2016,9,10,2,2204,3451,2137,-1314
2016,9,10,3,2189,3431,2100,-1331
2016,9,10,4,2187,3471,2115,-1356
2016,9,10,5,2084,3317,2002,-1315
2016,9,10,6,2305,3117,2108,-1009
2016,9,10,7,2068,2897,1931,-966
2016,9,10,8,1607,2685,1805,-880
2016,9,10,9,1501,2515,1682,-833
2016,9,10,10,1443,2505,1690,-815
2016,9,10,11,1415,2484,1687,-797
2016,9,10,12,1435,2475,1619,-856
2016,9,10,13,1539,2532,1723,-809
2016,9,10,14,1508,2676,1729,-947
2016,9,10,15,1669,2887,1849,-1038
2016,9,10,16,1855,3072,1885,-1187
2016,9,10,17,1960,3230,2004,-1226
2016,9,10,18,1975,3291,2080,-1211
2016,9,10,19,1948,3323,2107,-1216
2016,9,10,20,1871,3316,2056,-1260
2016,9,10,21,1793,3271,1973,-1298
2016,9,10,22,1719,3250,1932,-1318
2016,9,10,23,1666,3253,1910,-1343
2016,9,11,0,1766,3281,1869,-1412
2016,9,11,1,1907,3306,1979,-1327
2016,9,11,2,1938,3282,2000,-1282
2016,9,11,3,1971,3312,2152,-1160
2016,9,11,4,1993,3294,2086,-1208
2016,9,11,5,1869,3168,1962,-1206
2016,9,11,6,1795,2974,1852,-1122
2016,9,11,7,1490,2803,1773,-1030
2016,9,11,8,1373,2594,1595,-999
2016,9,11,9,1369,2518,1625,-893
2016,9,11,10,1360,2468,1638,-830
2016,9,11,11,1348,2433,1701,-732
2016,9,11,12,1329,2424,1639,-785
2016,9,11,13,1301,2456,1601,-855
2016,9,11,14,1263,2552,1590,-962
2016,9,11,15,1283,2659,1575,-1084
2016,9,11,16,1437,2949,1779,-1170
2016,9,11,17,1617,3135,1809,-1326
2016,9,11,18,1727,3209,1926,-1283
2016,9,11,19,1785,3184,1870,-1314
2016,9,11,20,1812,3107,1653,-1454
2016,9,11,21,1818,3074,1588,-1486
2016,9,11,22,1821,3047,1505,-1542
2016,9,11,23,1842,3046,1524,-1522
2016,9,12,0,1893,3111,1568,-1543
2016,9,12,1,2054,3198,1836,-1362
2016,9,12,2,2065,3305,2067,-1238
2016,9,12,3,2135,3343,2194,-1149
2016,9,12,4,2190,3378,2238,-1140
2016,9,12,5,2094,3192,2238,-954
2016,9,12,6,1924,2895,2017,-878
2016,9,12,7,1720,2671,1831,-840
2016,9,12,8,1608,2542,1702,-840
2016,9,12,9,1413,2461,1585,-876
2016,9,12,10,1432,2431,1554,-877
2016,9,12,11,1437,2439,1582,-857
2016,9,12,12,1439,2546,1589,-957
2016,9,12,13,1575,2814,1719,-1095
2016,9,12,14,1630,3167,1802,-1365
2016,9,12,15,1789,3361,1877,-1484
2016,9,12,16,1837,3402,2032,-1370
2016,9,12,17,1809,3413,2053,-1360
2016,9,12,18,1823,3429,2057,-1372
2016,9,12,19,1826,3436,2129,-1307
2016,9,12,20,1916,3455,2183,-1272
2016,9,12,21,2009,3468,2178,-1290
2016,9,12,22,1992,3475,2174,-1301
2016,9,12,23,1981,3428,2047,-1381
2016,9,13,0,2040,3437,1960,-1477
2016,9,13,1,2113,3485,1965,-1520
2016,9,13,2,2149,3494,2030,-1464
2016,9,13,3,2171,3496,2046,-1450
2016,9,13,4,2184,3522,2082,-1440
2016,9,13,5,2125,3307,2071,-1236
2016,9,13,6,2118,3004,2053,-951
2016,9,13,7,1789,2730,1813,-917
2016,9,13,8,1572,2622,1614,-1008
2016,9,13,9,1480,2553,1540,-1013
2016,9,13,10,1416,2494,1499,-995
2016,9,13,11,1394,2500,1459,-1041
2016,9,13,12,1381,2631,1524,-1107
2016,9,13,13,1514,2916,1756,-1160
2016,9,13,14,1409,3215,1787,-1428
2016,9,13,15,1735,3403,1831,-1572
2016,9,13,16,1772,3404,1887,-1517
2016,9,13,17,1809,3391,1856,-1535
2016,9,13,18,1845,3410,1927,-1483
2016,9,13,19,1862,3427,1945,-1482
2016,9,13,20,1967,3467,2011,-1456
2016,9,13,21,2107,3525,2127,-1398
2016,9,13,22,2123,3522,2138,-1384
2016,9,13,23,2142,3531,2116,-1415
2016,9,14,0,2174,3569,2173,-1396
2016,9,14,1,2192,3601,2212,-1389
2016,9,14,2,2171,3581,2204,-1377
2016,9,14,3,2194,3564,2139,-1425
2016,9,14,4,2229,3585,2164,-1421
2016,9,14,5,2072,3345,2111,-1234
2016,9,14,6,2127,3056,2054,-1002
2016,9,14,7,1789,2730,1811,-919
2016,9,14,8,1693,2579,1751,-828
2016,9,14,9,1532,2505,1697,-808
2016,9,14,10,1489,2467,1707,-760
2016,9,14,11,1441,2502,1672,-830
2016,9,14,12,1568,2595,1731,-864
2016,9,14,13,1762,2844,1918,-926
2016,9,14,14,1561,3181,1921,-1260
2016,9,14,15,1764,3335,1887,-1448
2016,9,14,16,1809,3399,1947,-1452
2016,9,14,17,1845,3408,1997,-1411
2016,9,14,18,1891,3407,1916,-1491
2016,9,14,19,1928,3416,1934,-1482
2016,9,14,20,2050,3462,2039,-1423
2016,9,14,21,2233,3524,2181,-1343
2016,9,14,22,2231,3545,2203,-1342
2016,9,14,23,2239,3583,2246,-1337
2016,9,15,0,2253,3632,2288,-1344
2016,9,15,1,2263,3665,2323,-1342
2016,9,15,2,2222,3566,2307,-1259
2016,9,15,3,2223,3544,2308,-1236
2016,9,15,4,2254,3612,2361,-1251
2016,9,15,5,2087,3452,2341,-1111
2016,9,15,6,2206,3145,2314,-831
2016,9,15,7,1931,2828,2036,-792
2016,9,15,8,1698,2622,1834,-788
2016,9,15,9,1614,2511,1774,-737
2016,9,15,10,1572,2448,1727,-721
2016,9,15,11,1595,2492,1769,-723
2016,9,15,12,1629,2558,1724,-834
2016,9,15,13,1850,2827,1867,-960
2016,9,15,14,1652,3176,1910,-1266
2016,9,15,15,1813,3296,1781,-1515
2016,9,15,16,1858,3366,1836,-1530
2016,9,15,17,1867,3390,1830,-1560
2016,9,15,18,1908,3424,1885,-1539
2016,9,15,19,1924,3367,1894,-1473
2016,9,15,20,2025,3393,1993,-1400
2016,9,15,21,2135,3445,2114,-1331
2016,9,15,22,2138,3446,2123,-1323
2016,9,15,23,2208,3485,2136,-1349
2016,9,16,0,2246,3544,2168,-1376
2016,9,16,1,2304,3565,2174,-1391
2016,9,16,2,2303,3506,2124,-1382
2016,9,16,3,2365,3573,2215,-1358
2016,9,16,4,2338,3575,2235,-1340
2016,9,16,5,2113,3351,2142,-1209
2016,9,16,6,2151,2992,2106,-886
2016,9,16,7,1877,2694,2014,-680
2016,9,16,8,1585,2542,1886,-656
2016,9,16,9,1454,2529,1831,-698
2016,9,16,10,1482,2496,1803,-693
2016,9,16,11,1422,2541,1758,-783
2016,9,16,12,1693,2654,1782,-872
2016,9,16,13,1810,2856,1970,-886
2016,9,16,14,1647,3195,1973,-1222
2016,9,16,15,1896,3345,2005,-1340
2016,9,16,16,1960,3379,1977,-1402
2016,9,16,17,2011,3410,1996,-1414
2016,9,16,18,2107,3414,2057,-1357
2016,9,16,19,2044,3378,2024,-1354
2016,9,16,20,2183,3457,2156,-1301
2016,9,16,21,2278,3501,2246,-1255
2016,9,16,22,2275,3482,2235,-1247
2016,9,16,23,2277,3473,2219,-1254
2016,9,17,0,2290,3452,2185,-1267
2016,9,17,1,2291,3448,2156,-1292
2016,9,17,2,2265,3416,2182,-1234
2016,9,17,3,2232,3482,2201,-1281
2016,9,17,4,2237,3437,2212,-1225
2016,9,17,5,2096,3270,2059,-1211
2016,9,17,6,2278,3049,2225,-824
2016,9,17,7,2041,2812,1883,-929
2016,9,17,8,1341,2637,1454,-1183
2016,9,17,9,1334,2500,1375,-1125
2016,9,17,10,1250,2429,1346,-1083
2016,9,17,11,1226,2335,1302,-1033
2016,9,17,12,1151,2325,1268,-1057
2016,9,17,13,1321,2407,1288,-1119
2016,9,17,14,1339,2640,1323,-1317
2016,9,17,15,1466,2872,1453,-1419
2016,9,17,16,1209,3101,1512,-1589
2016,9,17,17,1336,3255,1435,-1820
2016,9,17,18,1388,3368,1501,-1867
2016,9,17,19,1388,3341,1469,-1872
2016,9,17,20,1351,3278,1364,-1914
2016,9,17,21,1303,3185,1406,-1779
2016,9,17,22,1275,3120,1382,-1738
2016,9,17,23,1264,3119,1418,-1701
2016,9,18,0,1283,3141,1448,-1693
2016,9,18,1,1434,3203,1567,-1636
2016,9,18,2,1449,3262,1643,-1619
2016,9,18,3,1524,3308,1644,-1664
2016,9,18,4,1535,3266,1621,-1645
2016,9,18,5,1320,3122,1556,-1566
2016,9,18,6,1560,2961,1596,-1365
2016,9,18,7,1379,2767,1561,-1206
2016,9,18,8,1333,2570,1439,-1131
2016,9,18,9,1269,2464,1419,-1045
2016,9,18,10,1276,2424,1447,-977
2016,9,18,11,1275,2395,1426,-969
2016,9,18,12,1268,2441,1482,-959
2016,9,18,13,1255,2512,1521,-991
2016,9,18,14,1286,2644,1542,-1102
2016,9,18,15,1497,2777,1487,-1290
2016,9,18,16,1356,3003,1498,-1505
2016,9,18,17,1528,3185,1582,-1603
2016,9,18,18,1544,3205,1477,-1728
2016,9,18,19,1486,3217,1565,-1652
2016,9,18,20,1499,3235,1701,-1534
2016,9,18,21,1668,3197,1723,-1474
2016,9,18,22,1733,3181,1754,-1427
2016,9,18,23,1715,3159,1777,-1382
2016,9,19,0,1720,3212,1881,-1331
2016,9,19,1,1788,3268,1930,-1338
2016,9,19,2,1832,3310,2010,-1300
2016,9,19,3,1867,3440,2025,-1415
2016,9,19,4,1920,3423,2022,-1401
2016,9,19,5,1775,3186,1829,-1357
2016,9,19,6,1838,2928,1783,-1145
2016,9,19,7,1622,2666,1651,-1015
2016,9,19,8,1460,2568,1731,-837
2016,9,19,9,1455,2482,1657,-825
2016,9,19,10,1446,2497,1756,-741
2016,9,19,11,1478,2528,1783,-745
2016,9,19,12,1599,2587,1752,-835
2016,9,19,13,1789,2853,1989,-864
2016,9,19,14,1878,3236,2097,-1139
2016,9,19,15,1991,3371,2066,-1305
2016,9,19,16,2141,3422,2112,-1310
2016,9,19,17,2091,3459,2157,-1302
2016,9,19,18,2076,3489,2100,-1389
2016,9,19,19,2046,3472,1990,-1482
2016,9,19,20,2014,3455,2030,-1425
2016,9,19,21,2019,3411,1986,-1425
2016,9,19,22,2010,3371,1921,-1450
2016,9,19,23,2016,3315,1921,-1394
2016,9,20,0,2081,3348,1959,-1389
2016,9,20,1,2177,3418,2090,-1328
2016,9,20,2,2263,3407,2051,-1356
2016,9,20,3,2376,3605,2285,-1320
2016,9,20,4,2365,3600,2315,-1285
2016,9,20,5,2112,3316,2089,-1227
2016,9,20,6,2231,3060,2149,-911
2016,9,20,7,1957,2816,2025,-791
2016,9,20,8,1536,2621,1827,-793
2016,9,20,9,1517,2526,1722,-804
2016,9,20,10,1511,2480,1650,-830
2016,9,20,11,1543,2464,1597,-867
2016,9,20,12,1565,2559,1655,-904
2016,9,20,13,1746,2848,1956,-892
2016,9,20,14,1659,3186,1970,-1216
2016,9,20,15,2086,3409,2110,-1299
2016,9,20,16,2113,3430,2137,-1293
2016,9,20,17,2102,3430,2135,-1295
2016,9,20,18,2117,3425,2169,-1256
2016,9,20,19,2085,3388,2120,-1268
2016,9,20,20,2185,3430,2194,-1236
2016,9,20,21,2275,3413,2280,-1133
2016,9,20,22,2267,3396,2270,-1126
2016,9,20,23,2242,3399,2332,-1067
2016,9,21,0,2273,3436,2457,-979
2016,9,21,1,2309,3473,2506,-967
2016,9,21,2,2322,3492,2531,-961
2016,9,21,3,2380,3581,2540,-1041
2016,9,21,4,2402,3581,2500,-1081
2016,9,21,5,2223,3372,2393,-979
2016,9,21,6,2250,3054,2290,-764
2016,9,21,7,1934,2750,1985,-765
2016,9,21,8,1707,2599,1711,-889
2016,9,21,9,1627,2508,1619,-889
2016,9,21,10,1632,2478,1601,-877
2016,9,21,11,1678,2516,1658,-858
2016,9,21,12,1768,2663,1761,-902
2016,9,21,13,1989,2975,1897,-1078
2016,9,21,14,2162,3361,2108,-1253
2016,9,21,15,2199,3486,2148,-1338
2016,9,21,16,2190,3497,2137,-1360
2016,9,21,17,2141,3453,2122,-1331
2016,9,21,18,2125,3412,2124,-1288
2016,9,21,19,2101,3343,2096,-1247
2016,9,21,20,2191,3372,2187,-1185
2016,9,21,21,2264,3414,2313,-1101
2016,9,21,22,2250,3379,2274,-1105
2016,9,21,23,2249,3356,2201,-1155
2016,9,22,0,2282,3354,2232,-1122
2016,9,22,1,2324,3436,2270,-1166
2016,9,22,2,2393,3444,2273,-1171
2016,9,22,3,2493,3566,2378,-1188
2016,9,22,4,2475,3551,2406,-1145
2016,9,22,5,2283,3351,2239,-1112
2016,9,22,6,2328,3071,2275,-796
2016,9,22,7,2089,2833,2042,-791
2016,9,22,8,1863,2653,1854,-799
2016,9,22,9,1672,2578,1680,-898
2016,9,22,10,1640,2564,1658,-906
2016,9,22,11,1647,2592,1699,-893
2016,9,22,12,1829,2693,1823,-870
2016,9,22,13,2048,2958,2014,-944
2016,9,22,14,1867,3302,1975,-1327
2016,9,22,15,1958,3434,1910,-1524
2016,9,22,16,1860,3417,1884,-1533
2016,9,22,17,1800,3366,1889,-1477
2016,9,22,18,1781,3314,1734,-1580
2016,9,22,19,1723,3290,1699,-1591
2016,9,22,20,1783,3286,1734,-1552
2016,9,22,21,1965,3281,1827,-1454
2016,9,22,22,1945,3242,1780,-1462
2016,9,22,23,1928,3210,1693,-1517
2016,9,23,0,1944,3274,1811,-1463
2016,9,23,1,1963,3352,1878,-1474
2016,9,23,2,1992,3382,1893,-1489
2016,9,23,3,2105,3577,2072,-1505
2016,9,23,4,2062,3574,2153,-1421
2016,9,23,5,1879,3368,2041,-1327
2016,9,23,6,2099,3104,2117,-987
2016,9,23,7,1828,2768,1888,-880
2016,9,23,8,1688,2600,1636,-964
2016,9,23,9,1448,2521,1435,-1086
2016,9,23,10,1212,2397,1312,-1085
2016,9,23,11,1173,2380,1319,-1061
2016,9,23,12,1214,2467,1395,-1072
2016,9,23,13,1653,2825,1596,-1229
2016,9,23,14,1463,3243,1738,-1505
2016,9,23,15,1628,3373,1658,-1715
2016,9,23,16,1539,3404,1624,-1780
2016,9,23,17,1529,3472,1782,-1690
2016,9,23,18,1523,3443,1685,-1758
2016,9,23,19,1498,3414,1609,-1805
2016,9,23,20,1593,3467,1672,-1795
2016,9,23,21,1702,3465,1688,-1777
2016,9,23,22,1684,3420,1651,-1769
2016,9,23,23,1682,3414,1599,-1815
2016,9,24,0,1704,3386,1679,-1707
2016,9,24,1,1737,3428,1762,-1666
2016,9,24,2,1726,3378,1782,-1596
2016,9,24,3,1724,3480,1883,-1597
2016,9,24,4,1692,3419,1840,-1579
2016,9,24,5,1528,3224,1699,-1525
2016,9,24,6,1858,3063,1890,-1173
2016,9,24,7,1549,2831,1750,-1081
2016,9,24,8,1467,2647,1578,-1069
2016,9,24,9,1381,2534,1530,-1004
2016,9,24,10,1350,2484,1497,-987
2016,9,24,11,1360,2485,1477,-1008
2016,9,24,12,1416,2500,1418,-1082
2016,9,24,13,1382,2623,1534,-1089
2016,9,24,14,1186,2723,1309,-1414
2016,9,24,15,1365,2906,1290,-1616
2016,9,24,16,1464,3107,1330,-1777
2016,9,24,17,1605,3234,1569,-1665
2016,9,24,18,1683,3231,1609,-1622
2016,9,24,19,1699,3165,1555,-1610
2016,9,24,20,1713,3152,1582,-1570
2016,9,24,21,1695,3115,1602,-1513
2016,9,24,22,1775,3102,1693,-1409
2016,9,24,23,1874,3093,1788,-1305
2016,9,25,0,1924,3157,1855,-1302
2016,9,25,1,2013,3196,1892,-1304
2016,9,25,2,2106,3239,1923,-1316
2016,9,25,3,2143,3337,2026,-1311
2016,9,25,4,2168,3301,1996,-1305
2016,9,25,5,1952,3158,1977,-1181
2016,9,25,6,2240,2987,2111,-876
2016,9,25,7,1965,2793,1963,-830
2016,9,25,8,1840,2651,1894,-757
2016,9,25,9,1585,2559,1777,-782
2016,9,25,10,1562,2455,1674,-781
2016,9,25,11,1575,2424,1622,-802
2016,9,25,12,1537,2423,1637,-786
2016,9,25,13,1566,2456,1775,-681
2016,9,25,14,1640,2570,1807,-763
2016,9,25,15,1627,2735,1873,-862
2016,9,25,16,1767,2999,2061,-938
2016,9,25,17,1875,3196,2238,-958
2016,9,25,18,1931,3223,2215,-1008
2016,9,25,19,1932,3173,2082,-1091
2016,9,25,20,1934,3206,2074,-1132
2016,9,25,21,1981,3250,2222,-1028
2016,9,25,22,2002,3236,2224,-1012
2016,9,25,23,2002,3271,2221,-1050
2016,9,26,0,2113,3297,2203,-1094
2016,9,26,1,2287,3401,2335,-1066
2016,9,26,2,2340,3426,2355,-1071
2016,9,26,3,2414,3561,2399,-1162
2016,9,26,4,2379,3476,2341,-1135
2016,9,26,5,2103,3241,2227,-1014
2016,9,26,6,1944,3016,2179,-837
2016,9,26,7,1822,2710,2006,-704
2016,9,26,8,1777,2562,1814,-748
2016,9,26,9,1667,2484,1714,-770
2016,9,26,10,1646,2445,1678,-767
2016,9,26,11,1669,2438,1686,-752
2016,9,26,12,1796,2506,1772,-734
2016,9,26,13,1983,2761,1946,-815
2016,9,26,14,1847,3117,2027,-1090
2016,9,26,15,1980,3293,2084,-1209
2016,9,26,16,2035,3339,2112,-1227
2016,9,26,17,2091,3379,2107,-1272
2016,9,26,18,2140,3466,2178,-1288
2016,9,26,19,2255,3495,2233,-1262
2016,9,26,20,2421,3515,2271,-1244
2016,9,26,21,2417,3543,2283,-1260
2016,9,26,22,2448,3566,2343,-1223
2016,9,26,23,2467,3576,2378,-1198
2016,9,27,0,2511,3609,2411,-1198
2016,9,27,1,2549,3689,2615,-1074
2016,9,27,2,2549,3655,2642,-1013
2016,9,27,3,2575,3702,2659,-1043
2016,9,27,4,2536,3579,2580,-999
2016,9,27,5,2277,3220,2355,-865
2016,9,27,6,2449,2933,2357,-576
2016,9,27,7,2189,2735,2231,-504
2016,9,27,8,1582,2635,1838,-797
2016,9,27,9,1364,2545,1758,-787
2016,9,27,10,1479,2486,1733,-753
2016,9,27,11,1507,2471,1734,-737
2016,9,27,12,1548,2522,1663,-859
2016,9,27,13,1640,2789,1819,-970
2016,9,27,14,1847,3154,1969,-1185
2016,9,27,15,1958,3333,1998,-1335
2016,9,27,16,1937,3365,1960,-1405
2016,9,27,17,1980,3343,1801,-1542
2016,9,27,18,2142,3392,1871,-1521
2016,9,27,19,2279,3384,1962,-1422
2016,9,27,20,2331,3440,2244,-1196
2016,9,27,21,2379,3454,2325,-1129
2016,9,27,22,2407,3464,2418,-1046
2016,9,27,23,2432,3458,2445,-1013
2016,9,28,0,2486,3492,2477,-1015
2016,9,28,1,2535,3506,2534,-972
2016,9,28,2,2588,3495,2540,-955
2016,9,28,3,2690,3631,2610,-1021
2016,9,28,4,2538,3494,2508,-986
2016,9,28,5,2399,3268,2378,-890
2016,9,28,6,2407,3038,2381,-657
2016,9,28,7,2167,2805,2173,-632
2016,9,28,8,1545,2572,1732,-840
2016,9,28,9,1602,2502,1708,-794
2016,9,28,10,1573,2431,1613,-818
2016,9,28,11,1585,2445,1609,-836
2016,9,28,12,1637,2579,1699,-880
2016,9,28,13,1770,2864,1831,-1033
2016,9,28,14,2043,3245,2019,-1226
2016,9,28,15,2095,3431,2089,-1342
2016,9,28,16,2067,3456,2088,-1368
2016,9,28,17,2054,3448,2060,-1388
2016,9,28,18,2164,3446,2125,-1321
2016,9,28,19,2147,3413,2123,-1290
2016,9,28,20,2186,3390,2138,-1252
2016,9,28,21,2287,3397,2227,-1170
2016,9,28,22,2281,3408,2193,-1215
2016,9,28,23,2271,3411,2224,-1187
2016,9,29,0,2304,3436,2266,-1170
2016,9,29,1,2348,3471,2304,-1167
2016,9,29,2,2359,3491,2344,-1147
2016,9,29,3,2441,3639,2453,-1186
2016,9,29,4,2435,3511,2300,-1211
2016,9,29,5,2205,3290,2127,-1163
2016,9,29,6,2274,3054,2209,-845
2016,9,29,7,1914,2748,1928,-820
2016,9,29,8,1561,2594,1686,-908
2016,9,29,9,1518,2575,1575,-1000
2016,9,29,10,1526,2529,1519,-1010
2016,9,29,11,1527,2542,1521,-1021
2016,9,29,12,1642,2680,1611,-1069
2016,9,29,13,1895,2964,1813,-1151
2016,9,29,14,1651,3319,1790,-1529
2016,9,29,15,1815,3547,1881,-1666
2016,9,29,16,1829,3392,1705,-1687
2016,9,29,17,1808,3437,1682,-1755
2016,9,29,18,1776,3399,1635,-1764
2016,9,29,19,1832,3404,1745,-1659
2016,9,29,20,1959,3424,1862,-1562
2016,9,29,21,1970,3430,1933,-1497
2016,9,29,22,1948,3407,1999,-1408
2016,9,29,23,1942,3366,1948,-1418
2016,9,30,0,1972,3371,1907,-1464
2016,9,30,1,2006,3425,1946,-1479
2016,9,30,2,2023,3479,1975,-1504
2016,9,30,3,2025,3627,2011,-1616
2016,9,30,4,1997,3576,2022,-1554
2016,9,30,5,1692,3374,1988,-1386
2016,9,30,6,1987,3130,2046,-1084
2016,9,30,7,1715,2911,2036,-875
2016,9,30,8,1668,2739,1797,-942
2016,9,30,9,1567,2616,1581,-1035
2016,9,30,10,1497,2652,1785,-867
2016,9,30,11,1490,2601,1630,-971
2016,9,30,12,1587,2741,1694,-1047
2016,9,30,13,1798,3068,1925,-1143
2016,9,30,14,1583,3369,1662,-1707
2016,9,30,15,1787,3631,1925,-1706
2016,9,30,16,1838,3645,1926,-1719
2016,9,30,17,1841,3602,1938,-1664
2016,9,30,18,1942,3555,1985,-1570
2016,9,30,19,1988,3498,1994,-1504
2016,9,30,20,1995,3450,1949,-1501
2016,9,30,21,1969,3405,1921,-1484
2016,9,30,22,1935,3357,1890,-1467
2016,9,30,23,1918,3333,1914,-1419
2016,10,1,0,1893,3342,1856,-1486
2016,10,1,1,1895,3375,1894,-1481
2016,10,1,2,1882,3378,1884,-1494
2016,10,1,3,1855,3483,1911,-1572
2016,10,1,4,1792,3413,1849,-1564
2016,10,1,5,1467,3267,1859,-1408
2016,10,1,6,1878,3103,1918,-1185
2016,10,1,7,1478,2789,1643,-1146
2016,10,1,8,1710,2675,1598,-1077
2016,10,1,9,1565,2559,1612,-947
2016,10,1,10,1521,2539,1696,-843
2016,10,1,11,1534,2489,1536,-953
2016,10,1,12,1550,2517,1500,-1017
2016,10,1,13,1553,2536,1435,-1101
2016,10,1,14,1367,2699,1470,-1229
2016,10,1,15,1615,2896,1544,-1352
2016,10,1,16,1632,3107,1603,-1504
2016,10,1,17,1764,3245,1658,-1587
2016,10,1,18,1819,3301,1688,-1613
2016,10,1,19,1837,3232,1670,-1562
2016,10,1,20,1830,3268,1825,-1443
2016,10,1,21,1796,3235,1834,-1401
2016,10,1,22,1767,3133,1703,-1430
2016,10,1,23,1765,3094,1623,-1471
2016,10,2,0,1739,3214,1911,-1303
2016,10,2,1,1760,3340,1941,-1399
2016,10,2,2,1764,3391,2000,-1391
2016,10,2,3,1900,3435,2016,-1419
2016,10,2,4,1861,3370,1902,-1468
2016,10,2,5,1734,3256,1791,-1465
2016,10,2,6,1838,3095,1763,-1332
2016,10,2,7,1811,2900,1753,-1147
2016,10,2,8,1468,2722,1570,-1152
2016,10,2,9,1376,2664,1551,-1113
2016,10,2,10,1315,2587,1482,-1105
2016,10,2,11,1306,2552,1479,-1073
2016,10,2,12,1314,2580,1503,-1077
2016,10,2,13,1354,2659,1522,-1137
2016,10,2,14,1334,2814,1542,-1272
2016,10,2,15,1535,3008,1627,-1381
2016,10,2,16,1762,3198,1757,-1441
2016,10,2,17,1883,3333,1909,-1424
2016,10,2,18,1919,3312,1932,-1380
2016,10,2,19,1907,3294,1806,-1488
2016,10,2,20,1897,3225,1783,-1442
2016,10,2,21,1876,3205,1786,-1419
2016,10,2,22,1816,3153,1780,-1373
2016,10,2,23,1769,3163,1802,-1361
2016,10,3,0,1768,3226,1836,-1390
2016,10,3,1,1818,3316,1792,-1524
2016,10,3,2,1902,3422,1919,-1503
2016,10,3,3,2003,3528,1938,-1590
2016,10,3,4,1865,3433,1848,-1585
2016,10,3,5,1644,3231,1810,-1421
2016,10,3,6,1530,2974,1759,-1215
2016,10,3,7,1276,2760,1604,-1156
2016,10,3,8,1366,2556,1306,-1250
2016,10,3,9,1308,2491,1283,-1208
2016,10,3,10,1270,2499,1366,-1133
2016,10,3,11,1232,2547,1457,-1090
2016,10,3,12,1333,2663,1467,-1196
2016,10,3,13,1393,2879,1381,-1498
2016,10,3,14,1691,3259,1535,-1724
2016,10,3,15,1678,3467,1633,-1834
2016,10,3,16,1698,3500,1593,-1907
2016,10,3,17,1648,3477,1511,-1966
2016,10,3,18,1613,3468,1716,-1752
2016,10,3,19,1601,3440,1787,-1653
2016,10,3,20,1539,3424,1724,-1700
2016,10,3,21,1541,3378,1671,-1707
2016,10,3,22,1548,3379,1715,-1664
2016,10,3,23,1576,3354,1619,-1735
2016,10,4,0,1673,3394,1660,-1734
2016,10,4,1,1817,3487,1656,-1831
2016,10,4,2,1987,3609,1871,-1738
2016,10,4,3,2129,3701,1940,-1761
2016,10,4,4,2093,3575,1803,-1772
2016,10,4,5,1903,3347,1758,-1589
2016,10,4,6,1869,3066,1702,-1364
2016,10,4,7,1646,2803,1517,-1286
2016,10,4,8,1542,2656,1444,-1212
2016,10,4,9,1447,2610,1525,-1085
2016,10,4,10,1486,2595,1589,-1006
2016,10,4,11,1475,2600,1620,-980
2016,10,4,12,1456,2729,1769,-960
2016,10,4,13,1656,2929,1758,-1171
2016,10,4,14,1560,3312,1734,-1578
2016,10,4,15,1735,3498,1672,-1826
2016,10,4,16,1745,3479,1680,-1799
2016,10,4,17,1668,3508,1838,-1670
2016,10,4,18,1618,3498,1839,-1659
2016,10,4,19,1556,3461,1813,-1648
2016,10,4,20,1553,3458,1761,-1697
2016,10,4,21,1554,3417,1654,-1763
2016,10,4,22,1559,3357,1747,-1610
2016,10,4,23,1583,3392,1693,-1699
2016,10,5,0,1641,3435,1811,-1624
2016,10,5,1,1736,3546,2014,-1532
2016,10,5,2,1869,3658,2036,-1622
2016,10,5,3,1979,3689,2053,-1636
2016,10,5,4,1869,3620,2076,-1544
2016,10,5,5,1631,3315,1889,-1426
2016,10,5,6,1770,3074,1863,-1211
2016,10,5,7,1515,2803,1722,-1081
2016,10,5,8,1550,2666,1574,-1092
2016,10,5,9,1478,2569,1371,-1198
2016,10,5,10,1467,2514,1282,-1232
2016,10,5,11,1519,2535,1324,-1211
2016,10,5,12,1672,2657,1451,-1206
2016,10,5,13,1860,2936,1570,-1366
2016,10,5,14,1707,3291,1652,-1639
2016,10,5,15,1951,3525,1857,-1668
2016,10,5,16,1984,3505,1762,-1743
2016,10,5,17,1953,3473,1748,-1725
2016,10,5,18,1931,3470,1729,-1741
2016,10,5,19,1913,3455,1808,-1647
2016,10,5,20,1898,3418,1709,-1709
2016,10,5,21,1874,3389,1684,-1705
2016,10,5,22,1858,3369,1629,-1740
2016,10,5,23,1852,3361,1721,-1640
2016,10,6,0,1886,3380,1806,-1574
2016,10,6,1,1959,3459,1875,-1584
2016,10,6,2,2069,3575,2008,-1567
2016,10,6,3,2167,3689,2030,-1659
2016,10,6,4,2075,3570,1940,-1630
2016,10,6,5,1872,3333,1755,-1578
2016,10,6,6,2137,3084,1897,-1187
2016,10,6,7,1882,2799,1652,-1147
2016,10,6,8,1360,2471,1183,-1288
2016,10,6,9,1269,2369,1164,-1205
2016,10,6,10,1272,2360,1137,-1223
2016,10,6,11,1277,2389,1200,-1189
2016,10,6,12,1333,2540,1246,-1294
2016,10,6,13,1555,2912,1593,-1319
2016,10,6,14,1472,3256,1535,-1721
2016,10,6,15,1691,3445,1639,-1806
2016,10,6,16,1709,3469,1597,-1872
2016,10,6,17,1663,3460,1556,-1904
2016,10,6,18,1628,3444,1499,-1945
2016,10,6,19,1594,3418,1493,-1925
2016,10,6,20,1574,3422,1536,-1886
2016,10,6,21,1535,3369,1491,-1878
2016,10,6,22,1508,3375,1496,-1879
2016,10,6,23,1584,3408,1631,-1777
2016,10,7,0,1593,3470,1679,-1791
2016,10,7,1,1686,3552,1789,-1763
2016,10,7,2,1681,3669,1871,-1798
2016,10,7,3,1581,3704,1838,-1866
2016,10,7,4,1715,3589,1872,-1717
2016,10,7,5,1646,3401,1788,-1613
2016,10,7,6,1786,3139,1811,-1328
2016,10,7,7,1529,2953,1552,-1401
2016,10,7,8,1318,2799,1534,-1265
2016,10,7,9,1216,2683,1458,-1225
2016,10,7,10,1166,2615,1357,-1258
2016,10,7,11,1154,2613,1287,-1326
2016,10,7,12,1217,2710,1412,-1298
2016,10,7,13,1412,3017,1639,-1378
2016,10,7,14,1222,3271,1341,-1930
2016,10,7,15,1415,3539,1341,-2198
2016,10,7,16,1377,3568,1358,-2210
2016,10,7,17,1304,3559,1370,-2189
2016,10,7,18,1242,3524,1332,-2192
2016,10,7,19,1178,3450,1323,-2127
2016,10,7,20,1154,3400,1354,-2046
2016,10,7,21,1130,3360,1321,-2039
2016,10,7,22,1092,3293,1280,-2013
2016,10,7,23,1080,3267,1346,-1921
2016,10,8,0,1095,3241,1327,-1914
2016,10,8,1,1168,3241,1164,-2077
2016,10,8,2,1276,3364,1210,-2154
2016,10,8,3,1354,3407,1373,-2034
2016,10,8,4,1302,3298,1423,-1875
2016,10,8,5,1194,3150,1401,-1749
2016,10,8,6,1521,2975,1531,-1444
2016,10,8,7,1351,2772,1531,-1241
2016,10,8,8,1606,2578,1344,-1234
2016,10,8,9,1512,2490,1362,-1128
2016,10,8,10,1414,2424,1306,-1118
2016,10,8,11,1179,2476,1383,-1093
2016,10,8,12,1180,2450,1238,-1212
2016,10,8,13,1273,2540,1262,-1278
2016,10,8,14,1002,2658,1147,-1511
2016,10,8,15,1116,2902,1228,-1674
2016,10,8,16,1320,3118,1407,-1711
2016,10,8,17,1454,3259,1544,-1715
2016,10,8,18,1490,3266,1499,-1767
2016,10,8,19,1475,3250,1444,-1806
2016,10,8,20,1426,3244,1450,-1794
2016,10,8,21,1375,3230,1387,-1843
2016,10,8,22,1322,3194,1363,-1831
2016,10,8,23,1306,3174,1291,-1883
2016,10,9,0,1342,3222,1386,-1836
2016,10,9,1,1401,3282,1552,-1730
2016,10,9,2,1470,3348,1487,-1861
2016,10,9,3,1492,3334,1458,-1876
2016,10,9,4,1380,3181,1198,-1983
2016,10,9,5,1219,3015,1129,-1886
2016,10,9,6,1489,2929,1551,-1378
2016,10,9,7,1264,2707,1483,-1224
2016,10,9,8,1500,2571,1489,-1082
2016,10,9,9,1375,2457,1460,-997
2016,10,9,10,1194,2355,1228,-1127
2016,10,9,11,1124,2327,1177,-1150
2016,10,9,12,1088,2342,1126,-1216
2016,10,9,13,1115,2391,1130,-1261
2016,10,9,14,898,2535,1166,-1369
2016,10,9,15,1083,2723,1233,-1490
2016,10,9,16,992,2919,1242,-1677
2016,10,9,17,1168,3068,1160,-1908
2016,10,9,18,1258,3195,1311,-1884
2016,10,9,19,1318,3193,1355,-1838
2016,10,9,20,1422,3219,1423,-1796
2016,10,9,21,1499,3216,1426,-1790
2016,10,9,22,1528,3164,1431,-1733
2016,10,9,23,1547,3145,1568,-1577
2016,10,10,0,1576,3256,1696,-1560
2016,10,10,1,1694,3437,1814,-1623
2016,10,10,2,1816,3478,1889,-1589
2016,10,10,3,1906,3511,1914,-1597
2016,10,10,4,1840,3430,1848,-1582
2016,10,10,5,1709,3214,1758,-1456
2016,10,10,6,1982,2993,1831,-1162
2016,10,10,7,1802,2761,1747,-1014
2016,10,10,8,1982,2584,1533,-1051
2016,10,10,9,1904,2470,1397,-1073
2016,10,10,10,1876,2438,1477,-961
2016,10,10,11,1860,2566,1662,-904
2016,10,10,12,1924,2734,1695,-1039
2016,10,10,13,2067,2967,1696,-1271
2016,10,10,14,1859,3338,1717,-1621
2016,10,10,15,1944,3581,1687,-1894
2016,10,10,16,1793,3592,1603,-1989
2016,10,10,17,1773,3577,1493,-2084
2016,10,10,18,1749,3461,1306,-2155
2016,10,10,19,1693,3385,1310,-2075
2016,10,10,20,1671,3318,1278,-2040
2016,10,10,21,1608,3287,1358,-1929
2016,10,10,22,1573,3321,1553,-1768
2016,10,10,23,1559,3324,1622,-1702
2016,10,11,0,1619,3351,1628,-1723
2016,10,11,1,1727,3411,1406,-2005
2016,10,11,2,1875,3585,1588,-1997
2016,10,11,3,1970,3707,1689,-2018
2016,10,11,4,1891,3619,1760,-1859
2016,10,11,5,1662,3400,1789,-1611
2016,10,11,6,2142,3172,1922,-1250
2016,10,11,7,1916,2930,1823,-1107
2016,10,11,8,1417,2814,1757,-1057
2016,10,11,9,1388,2725,1556,-1169
2016,10,11,10,1411,2731,1545,-1186
2016,10,11,11,1523,2836,1567,-1269
2016,10,11,12,1600,3066,1710,-1356
2016,10,11,13,1863,3401,1839,-1562
2016,10,11,14,1550,3796,1716,-2080
2016,10,11,15,1752,4056,1809,-2247
2016,10,11,16,1707,4000,1774,-2226
2016,10,11,17,1616,3847,1550,-2297
2016,10,11,18,1532,3690,1434,-2256
2016,10,11,19,1456,3580,1453,-2127
2016,10,11,20,1404,3491,1386,-2105
2016,10,11,21,1359,3409,1297,-2112
2016,10,11,22,1319,3387,1315,-2072
2016,10,11,23,1302,3389,1297,-2092
2016,10,12,0,1337,3388,1182,-2206
2016,10,12,1,1435,3570,1449,-2121
2016,10,12,2,1573,3755,1514,-2241
2016,10,12,3,1647,3874,1671,-2203
2016,10,12,4,1576,3808,1689,-2119
2016,10,12,5,1386,3620,1634,-1986
2016,10,12,6,1847,3345,1606,-1739
2016,10,12,7,1630,3115,1560,-1555
2016,10,12,8,1472,2970,1576,-1394
2016,10,12,9,1407,2922,1604,-1318
2016,10,12,10,1391,2910,1585,-1325
2016,10,12,11,1434,2958,1614,-1344
2016,10,12,12,1548,3126,1654,-1472
2016,10,12,13,1849,3466,1838,-1628
2016,10,12,14,1690,3867,1735,-2132
2016,10,12,15,1965,4117,1828,-2289
2016,10,12,16,1891,4067,1724,-2343
2016,10,12,17,1764,3923,1571,-2352
2016,10,12,18,1653,3819,1565,-2254
2016,10,12,19,1570,3688,1519,-2169
2016,10,12,20,1506,3585,1425,-2160
2016,10,12,21,1459,3555,1540,-2015
2016,10,12,22,1420,3528,1520,-2008
2016,10,12,23,1407,3535,1518,-2017
2016,10,13,0,1448,3569,1488,-2081
2016,10,13,1,1544,3663,1528,-2135
2016,10,13,2,1698,3848,1599,-2249
2016,10,13,3,1760,3881,1601,-2280
2016,10,13,4,1669,3779,1581,-2198
2016,10,13,5,1459,3537,1483,-2054
2016,10,13,6,1802,3270,1604,-1666
2016,10,13,7,1533,3000,1524,-1476
2016,10,13,8,1512,2853,1506,-1347
2016,10,13,9,1504,2734,1450,-1284
2016,10,13,10,1457,2683,1386,-1297
2016,10,13,11,1474,2723,1459,-1264
2016,10,13,12,1516,2833,1505,-1328
2016,10,13,13,1754,3098,1516,-1582
2016,10,13,14,1658,3402,1385,-2017
2016,10,13,15,1618,3676,1524,-2152
2016,10,13,16,1618,3677,1535,-2142
2016,10,13,17,1578,3666,1539,-2127
2016,10,13,18,1545,3704,1662,-2042
2016,10,13,19,1517,3682,1542,-2140
2016,10,13,20,1501,3695,1593,-2102
2016,10,13,21,1479,3675,1571,-2104
2016,10,13,22,1456,3689,1628,-2061
2016,10,13,23,1454,3704,1623,-2081
2016,10,14,0,1473,3768,1620,-2148
2016,10,14,1,1527,3917,1700,-2217
2016,10,14,2,1605,3972,1682,-2290
2016,10,14,3,1580,3932,1579,-2353
2016,10,14,4,1400,3798,1497,-2301
2016,10,14,5,1161,3598,1517,-2081
2016,10,14,6,1464,3294,1487,-1807
2016,10,14,7,1183,3027,1457,-1570
2016,10,14,8,1314,2851,1578,-1273
2016,10,14,9,1350,2770,1740,-1030
2016,10,14,10,1300,2719,1808,-911
2016,10,14,11,1297,2737,1802,-935
2016,10,14,12,1281,2821,1755,-1066
2016,10,14,13,1346,3054,1737,-1317
2016,10,14,14,1245,3391,1751,-1640
2016,10,14,15,1410,3646,1780,-1866
2016,10,14,16,1463,3662,1745,-1917
2016,10,14,17,1461,3696,1774,-1922
2016,10,14,18,1452,3721,1789,-1932
2016,10,14,19,1436,3734,1757,-1977
2016,10,14,20,1427,3642,1535,-2107
2016,10,14,21,1409,3567,1501,-2066
2016,10,14,22,1388,3488,1399,-2089
2016,10,14,23,1410,3499,1481,-2018
2016,10,15,0,1472,3563,1683,-1880
2016,10,15,1,1575,3661,1656,-2005
2016,10,15,2,1622,3744,1610,-2134
2016,10,15,3,1607,3730,1615,-2115
2016,10,15,4,1544,3605,1590,-2015
2016,10,15,5,1415,3424,1573,-1851
2016,10,15,6,1524,3249,1535,-1714
2016,10,15,7,1358,3037,1457,-1580
2016,10,15,8,1526,2858,1404,-1454
2016,10,15,9,1442,2776,1360,-1416
2016,10,15,10,1391,2701,1323,-1378
2016,10,15,11,1374,2714,1442,-1272
2016,10,15,12,1396,2727,1386,-1341
2016,10,15,13,1417,2837,1408,-1429
2016,10,15,14,1149,2979,1355,-1624
2016,10,15,15,1330,3194,1373,-1821
2016,10,15,16,1519,3413,1358,-2055
2016,10,15,17,1650,3600,1274,-2326
2016,10,15,18,1664,3670,1211,-2459
2016,10,15,19,1660,3717,1257,-2460
2016,10,15,20,1735,3739,1348,-2391
2016,10,15,21,1697,3699,1348,-2351
2016,10,15,22,1607,3609,1368,-2241
2016,10,15,23,1542,3491,1376,-2115
2016,10,16,0,1569,3452,1363,-2089
2016,10,16,1,1602,3551,1421,-2130
2016,10,16,2,1647,3639,1553,-2086
2016,10,16,3,1660,3552,1500,-2052
2016,10,16,4,1505,3408,1479,-1929
2016,10,16,5,1376,3209,1474,-1735
2016,10,16,6,1632,3119,1751,-1368
2016,10,16,7,1408,2912,1634,-1278
2016,10,16,8,1541,2802,1649,-1153
2016,10,16,9,1438,2731,1665,-1066
2016,10,16,10,1396,2686,1595,-1091
2016,10,16,11,1359,2688,1532,-1156
2016,10,16,12,1398,2711,1515,-1196
2016,10,16,13,1474,2800,1556,-1244
2016,10,16,14,1424,2917,1580,-1337
2016,10,16,15,1412,3068,1532,-1536
2016,10,16,16,1334,3271,1597,-1674
2016,10,16,17,1465,3445,1642,-1803
2016,10,16,18,1487,3490,1607,-1883
2016,10,16,19,1468,3503,1637,-1866
2016,10,16,20,1452,3437,1550,-1887
2016,10,16,21,1468,3346,1376,-1970
2016,10,16,22,1495,3285,1385,-1900
2016,10,16,23,1283,3269,1311,-1958
2016,10,17,0,1429,3358,1418,-1940
2016,10,17,1,1361,3557,1463,-2094
2016,10,17,2,1508,3671,1366,-2305
2016,10,17,3,1508,3662,1374,-2288
2016,10,17,4,1466,3545,1360,-2185
2016,10,17,5,1245,3282,1300,-1982
2016,10,17,6,1362,3054,1297,-1757
2016,10,17,7,1349,2874,1400,-1474
2016,10,17,8,1453,2813,1661,-1152
2016,10,17,9,1260,2716,1594,-1122
2016,10,17,10,1275,2710,1659,-1051
2016,10,17,11,1289,2747,1659,-1088
2016,10,17,12,1295,2865,1594,-1271
2016,10,17,13,1525,3142,1530,-1612
2016,10,17,14,1280,3472,1509,-1963
2016,10,17,15,1509,3743,1572,-2171
2016,10,17,16,1533,3743,1604,-2139
2016,10,17,17,1501,3729,1563,-2166
2016,10,17,18,1481,3699,1469,-2230
2016,10,17,19,1451,3691,1519,-2172
2016,10,17,20,1421,3646,1478,-2168
2016,10,17,21,1386,3594,1479,-2115
2016,10,17,22,1356,3482,1326,-2156
2016,10,17,23,1360,3443,1299,-2144
2016,10,18,0,1392,3469,1308,-2161
2016,10,18,1,1531,3653,1506,-2147
2016,10,18,2,1592,3868,1588,-2280
2016,10,18,3,1589,3867,1649,-2218
2016,10,18,4,1579,3732,1629,-2103
2016,10,18,5,1553,3563,1692,-1871
2016,10,18,6,1583,3277,1569,-1708
2016,10,18,7,1580,3032,1607,-1425
2016,10,18,8,1548,2864,1498,-1366
2016,10,18,9,1460,2820,1541,-1279
2016,10,18,10,1438,2776,1521,-1255
2016,10,18,11,1468,2815,1649,-1166
2016,10,18,12,1689,2932,1700,-1232
2016,10,18,13,1768,3221,1704,-1517
2016,10,18,14,1597,3526,1563,-1963
2016,10,18,15,1802,3773,1674,-2099
2016,10,18,16,1696,3750,1727,-2023
2016,10,18,17,1686,3706,1740,-1966
2016,10,18,18,1579,3642,1645,-1997
2016,10,18,19,1541,3572,1592,-1980
2016,10,18,20,1499,3512,1494,-2018
2016,10,18,21,1465,3467,1442,-2025
2016,10,18,22,1453,3457,1437,-2020
2016,10,18,23,1471,3423,1423,-2000
2016,10,19,0,1525,3480,1459,-2021
2016,10,19,1,1659,3630,1638,-1992
2016,10,19,2,1816,3850,1803,-2047
2016,10,19,3,1840,3870,1750,-2120
2016,10,19,4,1735,3752,1680,-2072
2016,10,19,5,1510,3536,1668,-1868
2016,10,19,6,1738,3262,1664,-1598
2016,10,19,7,1549,3016,1691,-1325
2016,10,19,8,1366,2881,1752,-1129
2016,10,19,9,1296,2850,1866,-984
2016,10,19,10,1304,2831,1868,-963
2016,10,19,11,1374,2855,1893,-962
2016,10,19,12,1682,2946,1824,-1122
2016,10,19,13,1949,3273,1896,-1377
2016,10,19,14,1877,3670,1900,-1770
2016,10,19,15,1929,3912,1925,-1987
2016,10,19,16,1949,3881,2036,-1845
2016,10,19,17,1861,3781,1915,-1866
2016,10,19,18,1829,3748,2052,-1696
2016,10,19,19,1775,3670,1975,-1695
2016,10,19,20,1723,3617,1705,-1912
2016,10,19,21,1721,3554,1577,-1977
2016,10,19,22,1669,3532,1546,-1986
2016,10,19,23,1667,3578,1635,-1943
2016,10,20,0,1703,3691,1758,-1933
2016,10,20,1,1831,3845,1765,-2080
2016,10,20,2,1995,3918,1802,-2116
2016,10,20,3,2028,3889,1808,-2081
2016,10,20,4,1949,3805,1832,-1973
2016,10,20,5,1727,3551,1635,-1916
2016,10,20,6,1996,3288,1683,-1605
2016,10,20,7,1747,3044,1667,-1377
2016,10,20,8,1615,2923,1675,-1248
2016,10,20,9,1523,2834,1640,-1194
2016,10,20,10,1479,2792,1613,-1179
2016,10,20,11,1483,2818,1614,-1204
2016,10,20,12,1576,2919,1627,-1292
2016,10,20,13,1812,3201,1695,-1506
2016,10,20,14,1667,3557,1669,-1888
2016,10,20,15,1842,3767,1719,-2048
2016,10,20,16,1827,3769,1688,-2081
2016,10,20,17,1748,3704,1581,-2123
2016,10,20,18,1683,3687,1495,-2192
2016,10,20,19,1662,3689,1575,-2114
2016,10,20,20,1600,3647,1645,-2002
2016,10,20,21,1583,3584,1698,-1886
2016,10,20,22,1535,3516,1675,-1841
2016,10,20,23,1605,3511,1757,-1754
2016,10,21,0,1706,3564,1872,-1692
2016,10,21,1,1839,3648,1916,-1732
2016,10,21,2,1991,3767,1817,-1950
2016,10,21,3,1994,3839,1962,-1877
2016,10,21,4,1879,3696,1715,-1981
2016,10,21,5,1691,3536,1743,-1793
2016,10,21,6,1882,3293,1834,-1459
2016,10,21,7,1674,3040,1750,-1290
2016,10,21,8,1427,2844,1561,-1283
2016,10,21,9,1467,2788,1645,-1143
2016,10,21,10,1413,2775,1655,-1120
2016,10,21,11,1543,2786,1633,-1153
2016,10,21,12,1511,2899,1564,-1335
2016,10,21,13,1725,3137,1469,-1668
2016,10,21,14,1522,3492,1409,-2083
2016,10,21,15,1801,3833,1804,-2029
2016,10,21,16,1809,3834,1749,-2085
2016,10,21,17,1791,3763,1732,-2031
2016,10,21,18,1762,3689,1585,-2104
2016,10,21,19,1717,3611,1564,-2047
2016,10,21,20,1646,3546,1486,-2060
2016,10,21,21,1602,3465,1453,-2012
2016,10,21,22,1557,3435,1444,-1991
2016,10,21,23,1551,3474,1504,-1970
2016,10,22,0,1585,3582,1624,-1958
2016,10,22,1,1692,3693,1591,-2102
2016,10,22,2,1779,3799,1722,-2077
2016,10,22,3,1762,3764,1749,-2015
2016,10,22,4,1660,3654,1704,-1950
2016,10,22,5,1477,3470,1585,-1885
2016,10,22,6,1815,3312,1742,-1570
2016,10,22,7,1545,3045,1651,-1394
2016,10,22,8,1370,2866,1427,-1439
2016,10,22,9,1199,2813,1535,-1278
2016,10,22,10,1207,2748,1462,-1286
2016,10,22,11,1210,2736,1473,-1263
2016,10,22,12,1201,2826,1529,-1297
2016,10,22,13,1281,2938,1566,-1372
2016,10,22,14,1157,3104,1551,-1553
2016,10,22,15,1297,3336,1443,-1893
2016,10,22,16,1441,3549,1484,-2065
2016,10,22,17,1616,3640,1691,-1949
2016,10,22,18,1616,3630,1703,-1927
2016,10,22,19,1605,3497,1547,-1950
2016,10,22,20,1549,3421,1552,-1869
2016,10,22,21,1532,3313,1391,-1922
2016,10,22,22,1405,3264,1334,-1930
2016,10,22,23,1360,3176,1133,-2043
2016,10,23,0,1376,3212,1147,-2065
2016,10,23,1,1432,3314,1201,-2113
2016,10,23,2,1544,3562,1439,-2123
2016,10,23,3,1533,3531,1497,-2034
2016,10,23,4,1451,3500,1688,-1812
2016,10,23,5,1342,3389,1746,-1643
2016,10,23,6,1724,3213,1743,-1470
2016,10,23,7,1585,3000,1744,-1256
2016,10,23,8,1648,2869,1767,-1102
2016,10,23,9,1539,2777,1732,-1045
2016,10,23,10,1402,2696,1604,-1092
2016,10,23,11,1397,2582,1348,-1234
2016,10,23,12,1430,2614,1333,-1281
2016,10,23,13,1507,2745,1454,-1291
2016,10,23,14,1189,2872,1378,-1494
2016,10,23,15,1362,3072,1340,-1732
2016,10,23,16,1558,3263,1316,-1947
2016,10,23,17,1669,3399,1455,-1944
2016,10,23,18,1691,3482,1542,-1940
2016,10,23,19,1669,3462,1569,-1893
2016,10,23,20,1623,3425,1569,-1856
2016,10,23,21,1592,3381,1547,-1834
2016,10,23,22,1552,3357,1575,-1782
2016,10,23,23,1546,3374,1593,-1781
2016,10,24,0,1604,3462,1735,-1727
2016,10,24,1,1745,3584,1724,-1860
2016,10,24,2,1905,3679,1661,-2018
2016,10,24,3,1910,3704,1847,-1857
2016,10,24,4,1789,3530,1702,-1828
2016,10,24,5,1591,3400,1676,-1724
2016,10,24,6,1840,3163,1674,-1489
2016,10,24,7,1621,2914,1661,-1253
2016,10,24,8,1280,2739,1577,-1162
2016,10,24,9,1207,2662,1579,-1083
2016,10,24,10,1187,2609,1520,-1089
2016,10,24,11,1196,2621,1556,-1065
2016,10,24,12,1304,2832,1828,-1004
2016,10,24,13,1578,3114,1718,-1396
2016,10,24,14,1362,3464,1589,-1875
2016,10,24,15,1515,3727,1571,-2156
2016,10,24,16,1537,3712,1567,-2145
2016,10,24,17,1484,3672,1613,-2059
2016,10,24,18,1452,3659,1568,-2091
2016,10,24,19,1400,3623,1563,-2060
2016,10,24,20,1366,3560,1244,-2316
2016,10,24,21,1334,3497,1148,-2349
2016,10,24,22,1304,3523,1268,-2255
2016,10,24,23,1330,3544,1317,-2227
2016,10,25,0,1382,3684,1455,-2229
2016,10,25,1,1533,3893,1647,-2246
2016,10,25,2,1710,3987,1627,-2360
2016,10,25,3,1687,3923,1587,-2336
2016,10,25,4,1550,3779,1536,-2243
2016,10,25,5,1291,3503,1355,-2148
2016,10,25,6,1530,3274,1547,-1727
2016,10,25,7,1289,3030,1504,-1526
2016,10,25,8,1449,2872,1501,-1371
2016,10,25,9,1384,2832,1613,-1219
2016,10,25,10,1355,2802,1709,-1093
2016,10,25,11,1373,2814,1717,-1097
2016,10,25,12,1482,2936,1753,-1183
2016,10,25,13,1747,3229,1843,-1386
2016,10,25,14,1554,3560,1715,-1845
2016,10,25,15,1823,3855,1890,-1965
2016,10,25,16,1810,3782,1775,-2007
2016,10,25,17,1770,3725,1738,-1987
2016,10,25,18,1740,3670,1786,-1884
2016,10,25,19,1685,3633,1784,-1849
2016,10,25,20,1658,3623,1768,-1855
2016,10,25,21,1628,3554,1688,-1866
2016,10,25,22,1601,3506,1614,-1892
2016,10,25,23,1595,3490,1597,-1893
2016,10,26,0,1640,3533,1624,-1909
2016,10,26,1,1779,3662,1630,-2032
2016,10,26,2,1850,3874,1694,-2180
2016,10,26,3,1843,3869,1717,-2152
2016,10,26,4,1724,3708,1584,-2124
2016,10,26,5,1609,3543,1612,-1931
2016,10,26,6,1779,3287,1769,-1518
2016,10,26,7,1518,3037,1668,-1369
2016,10,26,8,1518,2899,1707,-1192
2016,10,26,9,1435,2819,1689,-1130
2016,10,26,10,1395,2776,1656,-1120
2016,10,26,11,1416,2768,1592,-1176
2016,10,26,12,1515,2915,1682,-1233
2016,10,26,13,1733,3199,1747,-1452
2016,10,26,14,1462,3487,1504,-1983
2016,10,26,15,1687,3804,1673,-2131
2016,10,26,16,1662,3820,1621,-2199
2016,10,26,17,1625,3821,1639,-2182
2016,10,26,18,1605,3835,1668,-2167
2016,10,26,19,1597,3823,1677,-2146
2016,10,26,20,1571,3785,1651,-2134
2016,10,26,21,1546,3781,1718,-2063
2016,10,26,22,1541,3743,1709,-2034
2016,10,26,23,1539,3747,1761,-1986
2016,10,27,0,1587,3815,1778,-2037
2016,10,27,1,1676,3946,1777,-2169
2016,10,27,2,1843,4009,1740,-2269
2016,10,27,3,1817,3956,1749,-2207
2016,10,27,4,1697,3833,1752,-2081
2016,10,27,5,1485,3580,1651,-1929
2016,10,27,6,1885,3334,1792,-1542
2016,10,27,7,1635,3079,1749,-1330
2016,10,27,8,1498,2919,1731,-1188
2016,10,27,9,1499,2833,1724,-1109
2016,10,27,10,1452,2786,1701,-1085
2016,10,27,11,1454,2811,1723,-1088
2016,10,27,12,1454,2890,1673,-1217
2016,10,27,13,1704,3136,1636,-1500
2016,10,27,14,1335,3526,1651,-1875
2016,10,27,15,1502,3744,1595,-2149
2016,10,27,16,1488,3726,1539,-2187
2016,10,27,17,1472,3724,1628,-2096
2016,10,27,18,1457,3704,1635,-2069
2016,10,27,19,1436,3602,1567,-2035
2016,10,27,20,1409,3519,1581,-1938
2016,10,27,21,1372,3463,1500,-1963
2016,10,27,22,1350,3405,1446,-1959
2016,10,27,23,1342,3409,1488,-1921
2016,10,28,0,1381,3432,1456,-1976
2016,10,28,1,1476,3536,1473,-2063
2016,10,28,2,1633,3674,1407,-2267
2016,10,28,3,1618,3674,1490,-2184
2016,10,28,4,1512,3568,1460,-2108
2016,10,28,5,1328,3365,1435,-1930
2016,10,28,6,1658,3065,1450,-1615
2016,10,28,7,1621,2800,1434,-1366
2016,10,28,8,1262,2628,1330,-1298
2016,10,28,9,1178,2533,1324,-1209
2016,10,28,10,1154,2559,1443,-1116
2016,10,28,11,1175,2569,1453,-1116
2016,10,28,12,1285,2664,1405,-1259
2016,10,28,13,1546,2920,1404,-1516
2016,10,28,14,1398,3312,1519,-1793
2016,10,28,15,1676,3545,1548,-1997
2016,10,28,16,1707,3521,1561,-1960
2016,10,28,17,1679,3465,1516,-1949
2016,10,28,18,1644,3404,1497,-1907
2016,10,28,19,1588,3349,1436,-1913
2016,10,28,20,1538,3291,1487,-1804
2016,10,28,21,1488,3238,1459,-1779
2016,10,28,22,1445,3165,1360,-1805
2016,10,28,23,1438,3129,1353,-1776
2016,10,29,0,1479,3198,1420,-1778
2016,10,29,1,1572,3298,1478,-1820
2016,10,29,2,1664,3428,1488,-1940
2016,10,29,3,1587,3408,1578,-1830
2016,10,29,4,1512,3327,1594,-1733
2016,10,29,5,1374,3175,1597,-1578
2016,10,29,6,1624,3006,1587,-1419
2016,10,29,7,1424,2791,1463,-1328
2016,10,29,8,1332,2630,1422,-1208
2016,10,29,9,1242,2524,1377,-1147
2016,10,29,10,1197,2465,1369,-1096
2016,10,29,11,1192,2452,1368,-1084
2016,10,29,12,1236,2497,1418,-1079
2016,10,29,13,1320,2577,1445,-1132
2016,10,29,14,1115,2727,1387,-1340
2016,10,29,15,1300,2971,1405,-1566
2016,10,29,16,1262,3176,1355,-1821
2016,10,29,17,1370,3344,1487,-1857
2016,10,29,18,1395,3439,1523,-1916
2016,10,29,19,1375,3454,1465,-1989
2016,10,29,20,1338,3393,1434,-1959
2016,10,29,21,1288,3260,1375,-1885
2016,10,29,22,1224,3178,1345,-1833
2016,10,29,23,1192,3097,1251,-1846
2016,10,30,0,1229,3166,1373,-1793
2016,10,30,1,1321,3247,1378,-1869
2016,10,30,2,1460,3406,1478,-1928
2016,10,30,3,1407,3383,1507,-1876
2016,10,30,4,1335,3283,1413,-1870
2016,10,30,5,1221,3155,1388,-1767
2016,10,30,6,1527,3027,1521,-1506
2016,10,30,7,1371,2858,1497,-1361
2016,10,30,8,1532,2715,1549,-1166
2016,10,30,9,1442,2634,1562,-1072
2016,10,30,10,1405,2590,1541,-1049
2016,10,30,11,1388,2596,1554,-1042
2016,10,30,12,1406,2639,1573,-1066
2016,10,30,13,1498,2740,1589,-1151
2016,10,30,14,1183,2908,1543,-1365
2016,10,30,15,1367,3138,1569,-1569
2016,10,30,16,1559,3330,1522,-1808
2016,10,30,17,1577,3459,1562,-1897
2016,10,30,18,1662,3451,1597,-1854
2016,10,30,19,1672,3437,1605,-1832
2016,10,30,20,1630,3400,1573,-1827
2016,10,30,21,1572,3398,1612,-1786
2016,10,30,22,1508,3371,1599,-1772
2016,10,30,23,1470,3384,1577,-1807
2016,10,31,0,1563,3473,1550,-1923
2016,10,31,1,1676,3626,1661,-1965
2016,10,31,2,1771,3695,1577,-2118
2016,10,31,3,1768,3667,1688,-1979
2016,10,31,4,1637,3523,1567,-1956
2016,10,31,5,1377,3287,1316,-1971
2016,10,31,6,1555,3001,1319,-1682
2016,10,31,7,1274,2673,1242,-1431
2016,10,31,8,1078,2555,1399,-1156
2016,10,31,9,1085,2435,1277,-1158
2016,10,31,10,1090,2404,1255,-1149
2016,10,31,11,1096,2407,1238,-1169
2016,10,31,12,1192,2663,1444,-1219
2016,10,31,13,1275,2980,1524,-1456
2016,10,31,14,1363,3341,1562,-1779
2016,10,31,15,1636,3589,1587,-2002
2016,10,31,16,1651,3634,1602,-2032
2016,10,31,17,1624,3615,1616,-1999
2016,10,31,18,1609,3623,1502,-2121
2016,10,31,19,1585,3578,1553,-2025
2016,10,31,20,1524,3535,1536,-1999
2016,10,31,21,1485,3431,1436,-1995
2016,10,31,22,1432,3388,1510,-1878
2016,10,31,23,1474,3377,1516,-1861
2016,11,1,0,1630,3496,1616,-1880
2016,11,1,1,1761,3637,1716,-1921
2016,11,1,2,2051,3665,1683,-1982
2016,11,1,3,2109,3576,1602,-1974
2016,11,1,4,1930,3528,1682,-1846
2016,11,1,5,1809,3373,1642,-1731
2016,11,1,6,1892,3122,1622,-1500
2016,11,1,7,1707,2885,1661,-1224
2016,11,1,8,1624,2735,1664,-1071
2016,11,1,9,1538,2636,1585,-1051
2016,11,1,10,1531,2589,1594,-995
2016,11,1,11,1542,2646,1665,-981
2016,11,1,12,1645,2778,1725,-1053
2016,11,1,13,1786,3068,1843,-1225
2016,11,1,14,1675,3486,1840,-1646
2016,11,1,15,1872,3712,2072,-1640
2016,11,1,16,1839,3747,2106,-1641
2016,11,1,17,1872,3720,1985,-1735
2016,11,1,18,1827,3742,1949,-1793
2016,11,1,19,1764,3673,1824,-1849
2016,11,1,20,1723,3667,2010,-1657
2016,11,1,21,1679,3622,1962,-1660
2016,11,1,22,1677,3616,2045,-1571
2016,11,1,23,1752,3661,1989,-1672
2016,11,2,0,1758,3812,2056,-1756
2016,11,2,1,1943,3999,2285,-1714
2016,11,2,2,2196,4095,2319,-1776
2016,11,2,3,2222,4003,2257,-1746
2016,11,2,4,2150,3903,2185,-1718
2016,11,2,5,1974,3656,2032,-1624
2016,11,2,6,1999,3367,2017,-1350
2016,11,2,7,1857,3052,1827,-1225
2016,11,2,8,1830,2924,1732,-1192
2016,11,2,9,1744,2849,1700,-1149
2016,11,2,10,1694,2805,1713,-1092
2016,11,2,11,1716,2847,1757,-1090
2016,11,2,12,1817,2963,1825,-1138
2016,11,2,13,1854,3243,1816,-1427
2016,11,2,14,1629,3572,1719,-1853
2016,11,2,15,1971,3838,1913,-1925
2016,11,2,16,1976,3828,1819,-2009
2016,11,2,17,1939,3794,1748,-2046
2016,11,2,18,1915,3802,1700,-2102
2016,11,2,19,1876,3771,1684,-2087
2016,11,2,20,1833,3791,1750,-2041
2016,11,2,21,1801,3757,1774,-1983
2016,11,2,22,1782,3714,1746,-1968
2016,11,2,23,1818,3710,1775,-1935
2016,11,3,0,1913,3784,1832,-1952
2016,11,3,1,2007,3989,1975,-2014
2016,11,3,2,2087,4057,1906,-2151
2016,11,3,3,2031,3994,1856,-2138
2016,11,3,4,1928,3828,1749,-2079
2016,11,3,5,1731,3570,1625,-1945
2016,11,3,6,1929,3391,1820,-1571
2016,11,3,7,1740,3090,1757,-1333
2016,11,3,8,1530,2843,1503,-1340
2016,11,3,9,1437,2724,1469,-1255
2016,11,3,10,1437,2718,1521,-1197
2016,11,3,11,1442,2730,1601,-1129
2016,11,3,12,1526,2908,1747,-1161
2016,11,3,13,1617,3228,1837,-1391
2016,11,3,14,1571,3639,1813,-1826
2016,11,3,15,1897,3895,1817,-2078
2016,11,3,16,1898,3872,1805,-2067
2016,11,3,17,1860,3801,1762,-2039
2016,11,3,18,1830,3726,1751,-1975
2016,11,3,19,1784,3663,1740,-1923
2016,11,3,20,1760,3606,1757,-1849
2016,11,3,21,1724,3574,1796,-1778
2016,11,3,22,1701,3527,1798,-1729
2016,11,3,23,1737,3514,1774,-1740
2016,11,4,0,1820,3565,1804,-1761
2016,11,4,1,1910,3703,1832,-1871
2016,11,4,2,2051,3907,1911,-1996
2016,11,4,3,2018,3893,1880,-2013
2016,11,4,4,1940,3806,1856,-1950
2016,11,4,5,1801,3612,1784,-1828
2016,11,4,6,1858,3371,1849,-1522
2016,11,4,7,1612,3126,1787,-1339
2016,11,4,8,1561,2996,1736,-1260
2016,11,4,9,1468,2900,1698,-1202
2016,11,4,10,1438,2881,1689,-1192
2016,11,4,11,1460,2926,1702,-1224
2016,11,4,12,1590,3078,1778,-1300
2016,11,4,13,1686,3358,1810,-1548
2016,11,4,14,1650,3752,1865,-1887
2016,11,4,15,1997,4025,2028,-1997
2016,11,4,16,1976,4005,1892,-2113
2016,11,4,17,1889,3954,1970,-1984
2016,11,4,18,1841,3892,1944,-1948
2016,11,4,19,1755,3792,1756,-2036
2016,11,4,20,1682,3719,1727,-1992
2016,11,4,21,1650,3662,1733,-1929
2016,11,4,22,1622,3620,1756,-1864
2016,11,4,23,1663,3601,1747,-1854
2016,11,5,0,1726,3661,1781,-1880
2016,11,5,1,1802,3791,1854,-1937
2016,11,5,2,1913,3829,1822,-2007
2016,11,5,3,1840,3770,1827,-1943
2016,11,5,4,1748,3651,1819,-1832
2016,11,5,5,1599,3504,1761,-1743
2016,11,5,6,1763,3307,1858,-1449
2016,11,5,7,1537,3029,1597,-1432
2016,11,5,8,1598,2878,1547,-1331
2016,11,5,9,1476,2807,1527,-1280
2016,11,5,10,1408,2747,1501,-1246
2016,11,5,11,1377,2722,1502,-1220
2016,11,5,12,1377,2749,1515,-1234
2016,11,5,13,1462,2873,1584,-1289
2016,11,5,14,1184,3001,1496,-1505
2016,11,5,15,1277,3226,1569,-1657
2016,11,5,16,1494,3449,1567,-1882
2016,11,5,17,1616,3539,1559,-1980
2016,11,5,18,1670,3632,1632,-2000
2016,11,5,19,1685,3650,1691,-1959
2016,11,5,20,1640,3644,1739,-1905
2016,11,5,21,1590,3603,1704,-1899
2016,11,5,22,1552,3565,1743,-1822
2016,11,5,23,1539,3599,1811,-1788
2016,11,6,0,1585,3661,1822,-1839
2016,11,6,1,1651,3769,1901,-1868
2016,11,6,2,1782,3791,1855,-1936
2016,11,6,3,1721,3691,1753,-1938
2016,11,6,4,1601,3568,1551,-2017
2016,11,6,5,1495,3456,1536,-1920
2016,11,6,6,1666,3272,1548,-1724
2016,11,6,7,1427,2795,1281,-1514
2016,11,6,8,1375,3124,1619,-1505
2016,11,6,9,1380,2835,1697,-1138
2016,11,6,10,1437,2726,1735,-991
2016,11,6,11,1389,2662,1575,-1087
2016,11,6,12,1245,2556,1512,-1044
2016,11,6,13,1260,2557,1404,-1153
2016,11,6,14,1273,2741,1501,-1240
2016,11,6,15,1201,2964,1531,-1433
2016,11,6,16,1344,3300,1583,-1717
2016,11,6,17,1468,3501,1646,-1855
2016,11,6,18,1518,3606,1651,-1955
2016,11,6,19,1418,3583,1594,-1989
2016,11,6,20,1433,3538,1585,-1953
2016,11,6,21,1469,3503,1583,-1920
2016,11,6,22,1509,3438,1644,-1794
2016,11,6,23,1574,3428,1668,-1760
2016,11,7,0,1676,3487,1739,-1748
2016,11,7,1,1575,3721,1794,-1927
2016,11,7,2,1728,3928,1814,-2114
2016,11,7,3,1721,3868,1724,-2144
2016,11,7,4,1644,3799,1755,-2044
2016,11,7,5,1492,3638,1691,-1947
2016,11,7,6,1701,3421,1683,-1738
2016,11,7,7,1679,3170,1688,-1482
2016,11,7,8,1623,2941,1652,-1289
2016,11,7,9,1486,2834,1505,-1329
2016,11,7,10,1412,2777,1510,-1267
2016,11,7,11,1378,2767,1518,-1249
2016,11,7,12,1420,2811,1553,-1258
2016,11,7,13,1496,2962,1575,-1387
2016,11,7,14,1783,3273,1634,-1639
2016,11,7,15,1314,3628,1633,-1995
2016,11,7,16,1590,3819,1596,-2223
2016,11,7,17,1566,3769,1504,-2265
2016,11,7,18,1508,3761,1602,-2159
2016,11,7,19,1470,3759,1649,-2110
2016,11,7,20,1434,3722,1661,-2061
2016,11,7,21,1417,3689,1664,-2025
2016,11,7,22,1402,3639,1628,-2011
2016,11,7,23,1390,3608,1627,-1981
2016,11,8,0,1430,3594,1559,-2035
2016,11,8,1,1595,3795,1646,-2149
2016,11,8,2,1815,4012,1678,-2334
2016,11,8,3,1801,3904,1550,-2354
2016,11,8,4,1715,3840,1604,-2236
2016,11,8,5,1582,3688,1485,-2203
2016,11,8,6,1355,3452,1310,-2142
2016,11,8,7,1662,3235,1429,-1806
2016,11,8,8,1579,3026,1498,-1528
2016,11,8,9,1445,2868,1491,-1377
2016,11,8,10,1346,2774,1492,-1282
2016,11,8,11,1302,2771,1485,-1286
2016,11,8,12,1319,2809,1487,-1322
2016,11,8,13,1455,2942,1505,-1437
2016,11,8,14,1521,3234,1491,-1743
2016,11,8,15,1322,3654,1582,-2072
2016,11,8,16,1607,3782,1512,-2270
2016,11,8,17,1592,3707,1464,-2243
2016,11,8,18,1555,3679,1570,-2109
2016,11,8,19,1523,3622,1500,-2122
2016,11,8,20,1476,3631,1611,-2020
2016,11,8,21,1471,3613,1612,-2001
2016,11,8,22,1460,3575,1560,-2015
2016,11,8,23,1478,3545,1565,-1980
2016,11,9,0,1491,3577,1596,-1981
2016,11,9,1,1495,3612,1432,-2180
2016,11,9,2,1695,3890,1540,-2350
2016,11,9,3,1679,3881,1549,-2332
2016,11,9,4,1592,3777,1561,-2216
2016,11,9,5,1468,3637,1525,-2112
2016,11,9,6,1402,3448,1543,-1905
2016,11,9,7,1596,3200,1494,-1706
2016,11,9,8,1355,3006,1468,-1538
2016,11,9,9,1482,2857,1463,-1394
2016,11,9,10,1387,2779,1476,-1303
2016,11,9,11,1345,2633,1234,-1399
2016,11,9,12,1357,2628,1209,-1419
2016,11,9,13,1428,2833,1430,-1403
2016,11,9,14,1570,3143,1638,-1505
2016,11,9,15,1422,3479,1642,-1837
2016,11,9,16,1638,3679,1666,-2013
2016,11,9,17,1634,3628,1568,-2060
2016,11,9,18,1588,3673,1720,-1953
2016,11,9,19,1566,3528,1725,-1803
2016,11,9,20,1531,3505,1725,-1780
2016,11,9,21,1517,3473,1696,-1777
2016,11,9,22,1520,3349,1462,-1887
2016,11,9,23,1521,3380,1591,-1789
2016,11,10,0,1582,3417,1706,-1711
2016,11,10,1,1752,3551,1703,-1848
2016,11,10,2,1968,3795,1797,-1998
2016,11,10,3,1955,3772,1747,-2025
2016,11,10,4,1881,3690,1715,-1975
2016,11,10,5,1755,3583,1519,-2064
2016,11,10,6,1560,3334,1371,-1963
2016,11,10,7,1677,3103,1431,-1672
2016,11,10,8,1477,2879,1383,-1496
2016,11,10,9,1422,2756,1443,-1313
2016,11,10,10,1318,2674,1362,-1312
2016,11,10,11,1191,2648,1364,-1284
2016,11,10,12,1131,2676,1425,-1251
2016,11,10,13,1288,2829,1608,-1221
2016,11,10,14,1577,3138,1730,-1408
2016,11,10,15,1499,3485,1644,-1841
2016,11,10,16,1711,3683,1666,-2017
2016,11,10,17,1698,3668,1655,-2013
2016,11,10,18,1706,3578,1691,-1887
2016,11,10,19,1734,3469,1678,-1791
2016,11,10,20,1618,3448,1665,-1783
2016,11,10,21,1657,3455,1700,-1755
2016,11,10,22,1636,3396,1694,-1702
2016,11,10,23,1622,3387,1774,-1613
2016,11,11,0,1660,3431,1800,-1631
2016,11,11,1,1765,3585,1858,-1727
2016,11,11,2,1946,3770,1900,-1870
2016,11,11,3,1924,3740,1850,-1890
2016,11,11,4,1857,3672,1808,-1864
2016,11,11,5,1798,3566,1786,-1780
2016,11,11,6,1743,3363,1506,-1857
2016,11,11,7,1906,3136,1471,-1665
2016,11,11,8,1714,2905,1456,-1449
2016,11,11,9,1539,2774,1533,-1241
2016,11,11,10,1448,2692,1476,-1216
2016,11,11,11,1391,2641,1423,-1218
2016,11,11,12,1393,2668,1447,-1221
2016,11,11,13,1490,2760,1456,-1304
2016,11,11,14,1692,2975,1537,-1438
2016,11,11,15,1210,3196,1435,-1761
2016,11,11,16,1536,3417,1492,-1925
2016,11,11,17,1616,3538,1487,-2051
2016,11,11,18,1637,3593,1479,-2114
2016,11,11,19,1611,3580,1535,-2045
2016,11,11,20,1538,3543,1581,-1962
2016,11,11,21,1486,3500,1592,-1908
2016,11,11,22,1452,3450,1564,-1886
2016,11,11,23,1452,3397,1550,-1847
2016,11,12,0,1476,3442,1601,-1841
2016,11,12,1,1627,3595,1603,-1992
2016,11,12,2,1829,3727,1658,-2069
2016,11,12,3,1782,3645,1627,-2018
2016,11,12,4,1650,3539,1643,-1896
2016,11,12,5,1537,3435,1659,-1776
2016,11,12,6,1360,3282,1645,-1637
2016,11,12,7,1813,3069,1605,-1464
2016,11,12,8,1608,2922,1675,-1247
2016,11,12,9,1924,2791,1723,-1068
2016,11,12,10,1793,2713,1754,-959
2016,11,12,11,1718,2657,1719,-938
2016,11,12,12,1726,2687,1773,-914
2016,11,12,13,1702,2743,1834,-909
2016,11,12,14,1801,2839,1872,-967
2016,11,12,15,1671,2967,1851,-1116
2016,11,12,16,1900,3180,1939,-1241
2016,11,12,17,1975,3411,2100,-1311
2016,11,12,18,1833,3528,2058,-1470
2016,11,12,19,1835,3582,1952,-1630
2016,11,12,20,1801,3567,1900,-1667
2016,11,12,21,1739,3479,1744,-1735
2016,11,12,22,1692,3346,1650,-1696
2016,11,12,23,1687,3325,1572,-1753
2016,11,13,0,1721,3413,1627,-1786
2016,11,13,1,1714,3536,1604,-1932
2016,11,13,2,1891,3763,1767,-1996
2016,11,13,3,1876,3723,1796,-1927
2016,11,13,4,1801,3619,1749,-1870
2016,11,13,5,1692,3538,1729,-1809
2016,11,13,6,1597,3393,1718,-1675
2016,11,13,7,1549,3263,1805,-1458
2016,11,13,8,1400,3056,1796,-1260
2016,11,13,9,1448,2970,1778,-1192
2016,11,13,10,1417,2834,1658,-1176
2016,11,13,11,1417,2834,1671,-1163
2016,11,13,12,1475,2823,1624,-1199
2016,11,13,13,1548,2884,1611,-1273
2016,11,13,14,1693,2975,1581,-1394
2016,11,13,15,1393,3071,1416,-1655
2016,11,13,16,1488,3305,1559,-1746
2016,11,13,17,1676,3517,1692,-1825
2016,11,13,18,1780,3697,1825,-1872
2016,11,13,19,1783,3750,1810,-1940
2016,11,13,20,1757,3761,1791,-1970
2016,11,13,21,1718,3754,1687,-2067
2016,11,13,22,1664,3766,1739,-2027
2016,11,13,23,1615,3738,1718,-2020
2016,11,14,0,1659,3797,1770,-2027
2016,11,14,1,1835,3942,1854,-2088
2016,11,14,2,2082,4067,1835,-2232
2016,11,14,3,2071,3957,1843,-2114
2016,11,14,4,1999,3814,1854,-1960
2016,11,14,5,1851,3601,1792,-1809
2016,11,14,6,1655,3439,1782,-1657
2016,11,14,7,1876,3162,1742,-1420
2016,11,14,8,1657,2886,1656,-1230
2016,11,14,9,1589,2788,1667,-1121
2016,11,14,10,1497,2678,1578,-1100
2016,11,14,11,1461,2685,1594,-1091
2016,11,14,12,1475,2709,1572,-1137
2016,11,14,13,1579,2951,1672,-1279
2016,11,14,14,1825,3258,1784,-1474
2016,11,14,15,1658,3602,1738,-1864
2016,11,14,16,1713,3848,1751,-2097
2016,11,14,17,1632,3796,1626,-2170
2016,11,14,18,1530,3769,1674,-2095
2016,11,14,19,1471,3617,1464,-2153
2016,11,14,20,1459,3610,1668,-1942
2016,11,14,21,1435,3589,1717,-1872
2016,11,14,22,1462,3577,1702,-1875
2016,11,14,23,1521,3577,1624,-1953
2016,11,15,0,1651,3673,1630,-2043
2016,11,15,1,1919,3895,1792,-2103
2016,11,15,2,2245,4138,1937,-2201
2016,11,15,3,2302,4124,1955,-2169
2016,11,15,4,2247,3966,1880,-2086
2016,11,15,5,2115,3763,1703,-2060
2016,11,15,6,1900,3533,1679,-1854
2016,11,15,7,1994,3283,1689,-1594
2016,11,15,8,1738,3021,1660,-1361
2016,11,15,9,1545,2848,1624,-1224
2016,11,15,10,1536,2800,1611,-1189
2016,11,15,11,1535,2793,1645,-1148
2016,11,15,12,1559,2809,1597,-1212
2016,11,15,13,1753,3030,1685,-1345
2016,11,15,14,1588,3385,1748,-1637
2016,11,15,15,1707,3717,1738,-1979
2016,11,15,16,1813,3908,1792,-2116
2016,11,15,17,1770,3819,1800,-2019
2016,11,15,18,1697,3838,1911,-1927
2016,11,15,19,1651,3777,1845,-1932
2016,11,15,20,1622,3747,1845,-1902
2016,11,15,21,1602,3726,1793,-1933
2016,11,15,22,1578,3689,1738,-1951
2016,11,15,23,1573,3727,1876,-1851
2016,11,16,0,1624,3829,1921,-1908
2016,11,16,1,1825,4052,1950,-2102
2016,11,16,2,2079,4254,1952,-2302
2016,11,16,3,2080,4250,1918,-2332
2016,11,16,4,1990,4082,1838,-2244
2016,11,16,5,1853,3914,1691,-2223
2016,11,16,6,1643,3667,1688,-1979
2016,11,16,7,1684,3417,1867,-1550
2016,11,16,8,1441,3147,1665,-1482
2016,11,16,9,1394,2961,1571,-1390
2016,11,16,10,1284,2900,1595,-1305
2016,11,16,11,1282,2884,1615,-1269
2016,11,16,12,1302,2941,1609,-1332
2016,11,16,13,1574,3207,1750,-1457
2016,11,16,14,1736,3530,1750,-1780
2016,11,16,15,1606,3920,1739,-2181
2016,11,16,16,1680,4121,1732,-2389
2016,11,16,17,1655,4076,1696,-2380
2016,11,16,18,1589,3992,1673,-2319
2016,11,16,19,1541,3951,1658,-2293
2016,11,16,20,1503,3902,1600,-2302
2016,11,16,21,1510,3853,1583,-2270
2016,11,16,22,1519,3801,1584,-2217
2016,11,16,23,1540,3794,1609,-2185
2016,11,17,0,1629,3863,1708,-2155
2016,11,17,1,1805,4131,1930,-2201
2016,11,17,2,2149,4329,1938,-2391
2016,11,17,3,2184,4335,1996,-2339
2016,11,17,4,2109,4160,1931,-2229
2016,11,17,5,1980,4002,1875,-2127
2016,11,17,6,1771,3737,1727,-2010
2016,11,17,7,1892,3446,1704,-1742
2016,11,17,8,1649,3177,1614,-1563
2016,11,17,9,1497,3014,1463,-1551
2016,11,17,10,1433,2941,1479,-1462
2016,11,17,11,1414,2936,1532,-1404
2016,11,17,12,1457,2997,1625,-1372
2016,11,17,13,1621,3242,1747,-1495
2016,11,17,14,1936,3615,1814,-1801
2016,11,17,15,1768,3991,1769,-2222
2016,11,17,16,1860,4175,1768,-2407
2016,11,17,17,1837,4142,1807,-2335
2016,11,17,18,1766,4056,1827,-2229
2016,11,17,19,1706,3986,1823,-2163
2016,11,17,20,1632,3881,1739,-2142
2016,11,17,21,1621,3801,1687,-2114
2016,11,17,22,1593,3772,1688,-2084
2016,11,17,23,1551,3772,1739,-2033
2016,11,18,0,1636,3829,1772,-2057
2016,11,18,1,1872,4076,1832,-2244
2016,11,18,2,2106,4350,1864,-2486
2016,11,18,3,2119,4361,1906,-2455
2016,11,18,4,2034,4323,1881,-2442
2016,11,18,5,1900,4210,1798,-2412
2016,11,18,6,1675,3993,1758,-2235
2016,11,18,7,1908,3714,1775,-1939
2016,11,18,8,1668,3413,1640,-1773
2016,11,18,9,1780,3303,1698,-1605
2016,11,18,10,1699,3236,1692,-1544
2016,11,18,11,1668,3237,1731,-1506
2016,11,18,12,1707,3300,1793,-1507
2016,11,18,13,1696,3474,1830,-1644
2016,11,18,14,1987,3798,1895,-1903
2016,11,18,15,1939,4208,1937,-2271
2016,11,18,16,2017,4371,1848,-2523
2016,11,18,17,1970,4343,1826,-2517
2016,11,18,18,1874,4279,1860,-2419
2016,11,18,19,1785,4218,1934,-2284
2016,11,18,20,1688,4144,1931,-2213
2016,11,18,21,1609,4097,1915,-2182
2016,11,18,22,1541,4068,1879,-2189
2016,11,18,23,1534,4033,1883,-2150
2016,11,19,0,1580,4078,1970,-2108
2016,11,19,1,1777,4248,2023,-2225
2016,11,19,2,1988,4360,1980,-2380
2016,11,19,3,1949,4271,1955,-2316
2016,11,19,4,1841,4148,1942,-2206
2016,11,19,5,1710,4013,1865,-2148
2016,11,19,6,1553,3793,1679,-2114
2016,11,19,7,1710,3572,1614,-1958
2016,11,19,8,1516,3331,1543,-1788
2016,11,19,9,1514,3154,1522,-1632
2016,11,19,10,1390,3062,1593,-1469
2016,11,19,11,1300,3009,1534,-1475
2016,11,19,12,1283,3004,1499,-1505
2016,11,19,13,1342,3061,1495,-1566
2016,11,19,14,1485,3194,1491,-1703
2016,11,19,15,1158,3274,1232,-2042
2016,11,19,16,1472,3609,1533,-2076
2016,11,19,17,1420,3790,1537,-2253
2016,11,19,18,1518,3858,1491,-2367
2016,11,19,19,1506,3851,1482,-2369
2016,11,19,20,1463,3803,1440,-2363
2016,11,19,21,1383,3751,1446,-2305
2016,11,19,22,1301,3657,1416,-2241
2016,11,19,23,1223,3633,1494,-2139
2016,11,20,0,1288,3638,1495,-2143
2016,11,20,1,1474,3858,1629,-2229
2016,11,20,2,1630,3975,1618,-2357
2016,11,20,3,1659,3964,1685,-2279
2016,11,20,4,1560,3868,1598,-2270
2016,11,20,5,1422,3746,1449,-2297
2016,11,20,6,1283,3575,1379,-2196
2016,11,20,7,1529,3419,1467,-1952
2016,11,20,8,1338,3205,1460,-1745
2016,11,20,9,1607,3067,1523,-1544
2016,11,20,10,1487,2959,1490,-1469
2016,11,20,11,1441,2883,1457,-1426
2016,11,20,12,1413,2874,1463,-1411
2016,11,20,13,1443,2916,1518,-1398
2016,11,20,14,1626,3019,1591,-1428
2016,11,20,15,1394,3104,1371,-1733
2016,11,20,16,1635,3371,1567,-1804
2016,11,20,17,1628,3555,1546,-2009
2016,11,20,18,1665,3696,1646,-2050
2016,11,20,19,1678,3738,1632,-2106
2016,11,20,20,1642,3716,1576,-2140
2016,11,20,21,1598,3738,1682,-2056
2016,11,20,22,1558,3705,1592,-2113
2016,11,20,23,1515,3663,1549,-2114
2016,11,21,0,1610,3722,1600,-2122
2016,11,21,1,1824,3893,1661,-2232
2016,11,21,2,2104,4097,1772,-2325
2016,11,21,3,2064,4089,1820,-2269
2016,11,21,4,1968,4001,1787,-2214
2016,11,21,5,1793,3870,1611,-2259
2016,11,21,6,1582,3618,1479,-2139
2016,11,21,7,1674,3408,1556,-1852
2016,11,21,8,1428,3153,1523,-1630
2016,11,21,9,1247,2992,1473,-1519
2016,11,21,10,1202,2899,1419,-1480
2016,11,21,11,1199,2904,1415,-1489
2016,11,21,12,1216,2935,1412,-1523
2016,11,21,13,1386,3063,1444,-1619
2016,11,21,14,1710,3413,1728,-1685
2016,11,21,15,1633,3784,1742,-2042
2016,11,21,16,1719,4012,1767,-2245
2016,11,21,17,1691,3961,1675,-2286
2016,11,21,18,1616,3894,1589,-2305
2016,11,21,19,1550,3847,1565,-2282
2016,11,21,20,1499,3770,1453,-2317
2016,11,21,21,1484,3751,1460,-2291
2016,11,21,22,1481,3713,1447,-2266
2016,11,21,23,1497,4222,2086,-2136
2016,11,22,0,1598,4308,2179,-2129
2016,11,22,1,1842,4560,2386,-2174
2016,11,22,2,2089,4791,2457,-2334
2016,11,22,3,2062,4771,2457,-2314
2016,11,22,4,1943,4179,1781,-2398
2016,11,22,5,1775,4098,1665,-2433
2016,11,22,6,1543,3858,1498,-2360
2016,11,22,7,1638,3584,1550,-2034
2016,11,22,8,1372,3315,1484,-1831
2016,11,22,9,1307,3158,1455,-1703
2016,11,22,10,1276,3247,1610,-1637
2016,11,22,11,1454,3064,1488,-1576
2016,11,22,12,1583,3154,1642,-1512
2016,11,22,13,1639,3393,1755,-1638
2016,11,22,14,1937,3646,1742,-1904
2016,11,22,15,1730,4034,1661,-2373
2016,11,22,16,1836,4234,1727,-2507
2016,11,22,17,1814,4201,1681,-2520
2016,11,22,18,1750,4145,1726,-2419
2016,11,22,19,1709,4094,1727,-2367
2016,11,22,20,1664,4127,1692,-2435
2016,11,22,21,1607,4005,1644,-2361
2016,11,22,22,1575,3989,1620,-2369
2016,11,22,23,1523,3992,1678,-2314
2016,11,23,0,1588,4086,1836,-2250
2016,11,23,1,1778,4286,1856,-2430
2016,11,23,2,1868,4390,1813,-2577
2016,11,23,3,1871,4361,1847,-2514
2016,11,23,4,1753,4269,1886,-2383
2016,11,23,5,1777,4152,1838,-2314
2016,11,23,6,1528,3927,1683,-2244
2016,11,23,7,1732,3628,1564,-2064
2016,11,23,8,1476,3363,1439,-1924
2016,11,23,9,1254,3194,1419,-1775
2016,11,23,10,1204,3105,1429,-1676
2016,11,23,11,1107,3073,1448,-1625
2016,11,23,12,1128,3091,1499,-1592
2016,11,23,13,1164,3206,1523,-1683
2016,11,23,14,1643,3536,1632,-1904
2016,11,23,15,1646,3843,1416,-2427
2016,11,23,16,1652,4138,1535,-2603
2016,11,23,17,1662,4181,1611,-2570
2016,11,23,18,1664,4134,1576,-2558
2016,11,23,19,1660,4093,1609,-2484
2016,11,23,20,1634,4008,1426,-2582
2016,11,23,21,1605,4027,1414,-2613
2016,11,23,22,1585,3991,1258,-2733
2016,11,23,23,1589,3966,1324,-2642
2016,11,24,0,1628,4071,1529,-2542
2016,11,24,1,1615,4333,1744,-2589
2016,11,24,2,1713,4422,1694,-2728
2016,11,24,3,1693,4348,1703,-2645
2016,11,24,4,1671,4252,1676,-2576
2016,11,24,5,1588,4098,1645,-2453
2016,11,24,6,1585,3918,1698,-2220
2016,11,24,7,1594,3671,1750,-1921
2016,11,24,8,1259,3424,1649,-1775
2016,11,24,9,1657,3237,1605,-1632
2016,11,24,10,1587,3107,1647,-1460
2016,11,24,11,1540,3071,1673,-1398
2016,11,24,12,1531,3045,1622,-1423
2016,11,24,13,1571,3114,1641,-1473
2016,11,24,14,1675,3250,1683,-1567
2016,11,24,15,1472,3389,1587,-1802
2016,11,24,16,1454,3591,1594,-1997
2016,11,24,17,1664,3866,1635,-2231
2016,11,24,18,1853,4100,1693,-2407
2016,11,24,19,1934,4254,1660,-2594
2016,11,24,20,1933,4340,1726,-2614
2016,11,24,21,1839,4290,1702,-2588
2016,11,24,22,1691,4122,1518,-2604
2016,11,24,23,1546,4012,1506,-2506
2016,11,25,0,1473,3881,1447,-2434
2016,11,25,1,1447,3897,1452,-2445
2016,11,25,2,1403,3834,1457,-2377
2016,11,25,3,1284,3684,1316,-2368
2016,11,25,4,1217,3636,1342,-2294
2016,11,25,5,1237,3591,1363,-2228
2016,11,25,6,1245,3497,1356,-2141
2016,11,25,7,1302,3338,1375,-1963
2016,11,25,8,1304,3004,1183,-1821
2016,11,25,9,1079,2827,1152,-1675
2016,11,25,10,824,2541,1034,-1507
2016,11,25,11,827,2485,921,-1564
2016,11,25,12,822,2587,1057,-1530
2016,11,25,13,958,2841,1186,-1655
2016,11,25,14,1278,3256,1536,-1720
2016,11,25,15,1162,3463,1463,-2000
2016,11,25,16,1133,3649,1482,-2167
2016,11,25,17,1282,3803,1461,-2342
2016,11,25,18,1421,3897,1485,-2412
2016,11,25,19,1499,3877,1424,-2453
2016,11,25,20,1487,3763,1294,-2469
2016,11,25,21,1430,3705,1366,-2339
2016,11,25,22,1381,3670,1436,-2234
2016,11,25,23,1402,3672,1477,-2195
2016,11,26,0,1487,3749,1589,-2160
2016,11,26,1,1709,3962,1741,-2221
2016,11,26,2,1860,4068,1709,-2359
2016,11,26,3,1803,4004,1699,-2305
2016,11,26,4,1743,3924,1736,-2188
2016,11,26,5,1631,3829,1721,-2108
2016,11,26,6,1455,3680,1716,-1964
2016,11,26,7,1684,3511,1693,-1818
2016,11,26,8,1452,3280,1484,-1796
2016,11,26,9,1447,3130,1459,-1671
2016,11,26,10,1438,3034,1470,-1564
2016,11,26,11,1411,2984,1480,-1504
2016,11,26,12,1376,2975,1484,-1491
2016,11,26,13,1434,3023,1508,-1515
2016,11,26,14,1544,3141,1551,-1590
2016,11,26,15,1128,3302,1536,-1766
2016,11,26,16,1298,3508,1538,-1970
2016,11,26,17,1501,3668,1465,-2203
2016,11,26,18,1587,3842,1535,-2307
2016,11,26,19,1588,3922,1535,-2387
2016,11,26,20,1544,3896,1495,-2401
2016,11,26,21,1471,3827,1430,-2397
2016,11,26,22,1400,3795,1451,-2344
2016,11,26,23,1374,3786,1581,-2205
2016,11,27,0,1424,3824,1558,-2266
2016,11,27,1,1601,3994,1586,-2408
2016,11,27,2,1777,4102,1677,-2425
2016,11,27,3,1733,4065,1684,-2381
2016,11,27,4,1679,4016,1704,-2312
2016,11,27,5,1592,3912,1613,-2299
2016,11,27,6,1474,3770,1601,-2169
2016,11,27,7,1929,3577,1610,-1967
2016,11,27,8,1697,3372,1580,-1792
2016,11,27,9,1837,3212,1578,-1634
2016,11,27,10,1679,3099,1591,-1508
2016,11,27,11,1565,3042,1642,-1400
2016,11,27,12,1492,2969,1492,-1477
2016,11,27,13,1453,3059,1655,-1404
2016,11,27,14,1519,3186,1743,-1443
2016,11,27,15,1376,3335,1719,-1616
2016,11,27,16,1365,3500,1642,-1858
2016,11,27,17,1564,3716,1711,-2005
2016,11,27,18,1664,3900,1822,-2078
2016,11,27,19,1669,3976,1788,-2188
2016,11,27,20,1633,4045,1779,-2266
2016,11,27,21,1585,4098,1784,-2314
2016,11,27,22,1547,4123,1816,-2307
2016,11,27,23,1492,4123,1719,-2404
2016,11,28,0,1554,4135,1659,-2476
2016,11,28,1,1721,4346,1705,-2641
2016,11,28,2,1966,4425,1618,-2807
2016,11,28,3,1943,4369,1637,-2732
2016,11,28,4,1875,4290,1704,-2586
2016,11,28,5,1781,4128,1809,-2319
2016,11,28,6,1591,3917,1809,-2108
2016,11,28,7,1576,3614,1719,-1895
2016,11,28,8,1347,3357,1638,-1719
2016,11,28,9,1321,3212,1661,-1551
2016,11,28,10,1295,3107,1596,-1511
2016,11,28,11,1297,3114,1639,-1475
2016,11,28,12,1298,3188,1644,-1544
2016,11,28,13,1440,3397,1713,-1684
2016,11,28,14,1890,3611,1453,-2158
2016,11,28,15,1664,4152,1806,-2346
2016,11,28,16,1777,4369,1772,-2597
2016,11,28,17,1765,4355,1738,-2617
2016,11,28,18,1715,4275,1742,-2533
2016,11,28,19,1659,4178,1658,-2520
2016,11,28,20,1622,4109,1658,-2451
2016,11,28,21,1600,4057,1659,-2398
2016,11,28,22,1603,4004,1668,-2336
2016,11,28,23,1620,3960,1611,-2349
2016,11,29,0,1554,4008,1683,-2325
2016,11,29,1,1790,4297,1836,-2461
2016,11,29,2,2018,4538,1891,-2647
2016,11,29,3,2011,4498,1886,-2612
2016,11,29,4,1927,4419,1825,-2594
2016,11,29,5,1790,4285,1691,-2594
2016,11,29,6,1551,4013,1598,-2415
2016,11,29,7,1800,3713,1686,-2027
2016,11,29,8,1537,3462,1709,-1753
2016,11,29,9,1402,3285,1739,-1546
2016,11,29,10,1318,3144,1641,-1503
2016,11,29,11,1297,3119,1642,-1477
2016,11,29,12,1332,3207,1644,-1563
2016,11,29,13,1475,3383,1626,-1757
2016,11,29,14,1716,3689,1637,-2052
2016,11,29,15,1663,4078,1590,-2488
2016,11,29,16,1835,4287,1580,-2707
2016,11,29,17,1816,4243,1646,-2597
2016,11,29,18,1750,4172,1678,-2494
2016,11,29,19,1689,4146,1669,-2477
2016,11,29,20,1644,4080,1677,-2403
2016,11,29,21,1620,4170,1699,-2471
2016,11,29,22,1580,3995,1609,-2386
2016,11,29,23,1563,3930,1576,-2354
2016,11,30,0,1666,3985,1694,-2291
2016,11,30,1,1883,4285,1847,-2438
2016,11,30,2,2123,4518,1998,-2520
2016,11,30,3,2121,4517,2131,-2386
2016,11,30,4,2049,4442,2138,-2304
2016,11,30,5,1911,4289,2017,-2272
2016,11,30,6,1685,4010,1793,-2217
2016,11,30,7,1814,3727,1871,-1856
2016,11,30,8,1542,3428,1635,-1793
2016,11,30,9,1661,3312,1660,-1652
2016,11,30,10,1588,3217,1543,-1674
2016,11,30,11,1576,3186,1521,-1665
2016,11,30,12,1585,3224,1547,-1677
2016,11,30,13,1701,3377,1548,-1829
2016,11,30,14,1744,3687,1639,-2048
2016,11,30,15,1649,4057,1657,-2400
2016,11,30,16,1881,4311,1780,-2531
2016,11,30,17,1790,4286,1881,-2405
2016,11,30,18,1673,4260,1894,-2366
2016,11,30,19,1568,4162,1695,-2467
2016,11,30,20,1520,4100,1665,-2435
2016,11,30,21,1531,4003,1645,-2358
2016,11,30,22,1542,3891,1615,-2276
2016,11,30,23,1554,3791,1587,-2204
2016,12,1,0,1568,3796,1569,-2227
2016,12,1,1,1585,4103,1749,-2354
2016,12,1,2,1801,4355,1890,-2465
2016,12,1,3,1771,4305,1882,-2423
2016,12,1,4,1704,4228,1869,-2359
2016,12,1,5,1672,4131,1800,-2331
2016,12,1,6,1674,3901,1778,-2123
2016,12,1,7,1662,3568,1631,-1937
2016,12,1,8,1603,3284,1446,-1838
2016,12,1,9,1291,3173,1508,-1665
2016,12,1,10,1245,3083,1500,-1583
2016,12,1,11,1110,2983,1431,-1552
2016,12,1,12,1197,3083,1511,-1572
2016,12,1,13,1250,3235,1492,-1743
2016,12,1,14,1453,3557,1505,-2052
2016,12,1,15,1115,3962,1452,-2510
2016,12,1,16,1439,4274,1585,-2689
2016,12,1,17,1348,4213,1483,-2730
2016,12,1,18,1270,4142,1459,-2683
2016,12,1,19,1214,4088,1480,-2608
2016,12,1,20,1388,4029,1439,-2590
2016,12,1,21,1365,4072,1558,-2514
2016,12,1,22,1361,4046,1548,-2498
2016,12,1,23,1397,4056,1583,-2473
2016,12,2,0,1527,4093,1558,-2535
2016,12,2,1,1765,4228,1664,-2564
2016,12,2,2,1993,4342,1853,-2489
2016,12,2,3,1989,4307,1861,-2446
2016,12,2,4,1914,4219,1778,-2441
2016,12,2,5,1820,4076,1622,-2454
2016,12,2,6,1612,3844,1451,-2393
2016,12,2,7,1875,3502,1526,-1976
2016,12,2,8,1642,3171,1579,-1592
2016,12,2,9,1587,2956,1338,-1618
2016,12,2,10,1507,2883,1348,-1535
2016,12,2,11,1476,2869,1367,-1502
2016,12,2,12,1606,2950,1434,-1516
2016,12,2,13,1741,3135,1559,-1576
2016,12,2,14,2000,3444,1627,-1817
2016,12,2,15,1547,3845,1593,-2252
2016,12,2,16,1866,4091,1684,-2407
2016,12,2,17,1830,4072,1519,-2553
2016,12,2,18,1773,4058,1412,-2646
2016,12,2,19,1701,4056,1456,-2600
2016,12,2,20,1610,4060,1549,-2511
2016,12,2,21,1520,4050,1563,-2487
2016,12,2,22,1445,4030,1557,-2473
2016,12,2,23,1408,4051,1636,-2415
2016,12,3,0,1445,4114,1807,-2307
2016,12,3,1,1667,4351,1818,-2533
2016,12,3,2,1805,4487,1829,-2658
2016,12,3,3,1724,4339,1733,-2606
2016,12,3,4,1569,4236,1791,-2445
2016,12,3,5,1402,4135,1875,-2260
2016,12,3,6,1244,3972,1896,-2076
2016,12,3,7,1892,3765,1993,-1772
2016,12,3,8,1629,3500,1839,-1661
2016,12,3,9,1579,3310,1700,-1610
2016,12,3,10,1613,3203,1599,-1604
2016,12,3,11,1552,3122,1602,-1520
2016,12,3,12,1544,3125,1675,-1450
2016,12,3,13,1558,3208,1749,-1459
2016,12,3,14,1681,3352,1824,-1528
2016,12,3,15,1351,3561,1769,-1792
2016,12,3,16,1456,3793,1750,-2043
2016,12,3,17,1609,3954,1724,-2230
2016,12,3,18,1737,4061,1730,-2331
2016,12,3,19,1770,4015,1623,-2392
2016,12,3,20,1732,3983,1586,-2397
2016,12,3,21,1672,3947,1570,-2377
2016,12,3,22,1630,3916,1573,-2343
2016,12,3,23,1600,3922,1603,-2319
2016,12,4,0,1667,3982,1590,-2392
2016,12,4,1,1874,4231,1704,-2527
2016,12,4,2,2007,4294,1701,-2593
2016,12,4,3,1960,4230,1676,-2554
2016,12,4,4,1869,4152,1679,-2473
2016,12,4,5,1780,4061,1661,-2400
2016,12,4,6,1629,3899,1650,-2249
2016,12,4,7,1878,3684,1676,-2008
2016,12,4,8,1629,3474,1699,-1775
2016,12,4,9,1625,3295,1635,-1660
2016,12,4,10,1530,3188,1627,-1561
2016,12,4,11,1464,3167,1656,-1511
2016,12,4,12,1468,3151,1625,-1526
2016,12,4,13,1520,3162,1584,-1578
2016,12,4,14,1636,3321,1657,-1664
2016,12,4,15,1317,3524,1610,-1914
2016,12,4,16,1538,3765,1598,-2167
2016,12,4,17,1430,3928,1433,-2495
2016,12,4,18,1539,4083,1516,-2567
2016,12,4,19,1564,4115,1543,-2572
2016,12,4,20,1554,4072,1546,-2526
2016,12,4,21,1554,4021,1537,-2484
2016,12,4,22,1525,3956,1500,-2456
2016,12,4,23,1520,3927,1473,-2454
2016,12,5,0,1587,4034,1576,-2458
2016,12,5,1,1823,4442,1867,-2575
2016,12,5,2,2046,4677,1882,-2795
2016,12,5,3,2060,4634,1876,-2758
2016,12,5,4,2016,4593,1937,-2656
2016,12,5,5,1947,4455,1831,-2624
2016,12,5,6,1773,4255,1811,-2444
2016,12,5,7,2118,3941,1895,-2046
2016,12,5,8,1850,3675,1922,-1753
2016,12,5,9,1528,3505,1864,-1641
2016,12,5,10,1590,3464,1933,-1531
2016,12,5,11,1565,3407,1875,-1532
2016,12,5,12,1568,3540,2050,-1490
2016,12,5,13,1785,3718,2019,-1699
2016,12,5,14,2046,4080,2064,-2016
2016,12,5,15,1698,4492,1945,-2547
2016,12,5,16,2109,4763,2031,-2732
2016,12,5,17,2114,4766,1917,-2849
2016,12,5,18,2056,4716,1881,-2835
2016,12,5,19,2014,4687,1945,-2742
2016,12,5,20,1948,4638,1951,-2687
2016,12,5,21,1918,4606,1979,-2627
2016,12,5,22,1885,4557,1960,-2597
2016,12,5,23,1895,4526,1998,-2528
2016,12,6,0,1973,4571,2129,-2442
2016,12,6,1,2251,4860,2345,-2515
2016,12,6,2,2496,5052,2570,-2482
2016,12,6,3,2504,5015,2563,-2452
2016,12,6,4,2425,4921,2558,-2363
2016,12,6,5,2307,4778,2487,-2291
2016,12,6,6,2066,4516,2226,-2290
2016,12,6,7,2570,4169,2282,-1887
2016,12,6,8,2269,3867,2164,-1703
2016,12,6,9,2268,3691,2202,-1489
2016,12,6,10,2190,3615,2191,-1424
2016,12,6,11,2179,3617,2232,-1385
2016,12,6,12,2237,3667,2416,-1251
2016,12,6,13,2411,3858,2460,-1398
2016,12,6,14,2766,4238,2637,-1601
2016,12,6,15,2254,4677,2594,-2083
2016,12,6,16,2578,4924,2738,-2186
2016,12,6,17,2502,4847,2639,-2208
2016,12,6,18,2374,4720,2517,-2203
2016,12,6,19,2272,4595,2368,-2227
2016,12,6,20,2162,4477,2281,-2196
2016,12,6,21,2101,4406,2093,-2313
2016,12,6,22,2059,4353,1994,-2359
2016,12,6,23,2071,4387,2247,-2140
2016,12,7,0,2155,4502,2330,-2172
2016,12,7,1,2454,4862,2545,-2317
2016,12,7,2,2708,5132,2654,-2478
2016,12,7,3,2720,5148,2601,-2547
2016,12,7,4,2636,5083,2614,-2469
2016,12,7,5,2506,4962,2547,-2415
2016,12,7,6,2263,4680,2347,-2333
2016,12,7,7,2803,4361,2576,-1785
2016,12,7,8,2509,4064,2366,-1698
2016,12,7,9,2128,3899,2302,-1597
2016,12,7,10,2072,3827,2250,-1577
2016,12,7,11,2329,3821,2243,-1578
2016,12,7,12,2136,3841,2205,-1636
2016,12,7,13,2359,3990,2147,-1843
2016,12,7,14,2697,4377,2281,-2096
2016,12,7,15,2286,4818,2469,-2349
2016,12,7,16,2576,5090,2532,-2558
2016,12,7,17,2495,5035,2416,-2619
2016,12,7,18,2355,4892,2385,-2507
2016,12,7,19,2216,4723,2291,-2432
2016,12,7,20,2101,4603,2240,-2363
2016,12,7,21,2022,4487,2207,-2280
2016,12,7,22,2023,4407,2144,-2263
2016,12,7,23,2026,4362,2021,-2341
2016,12,8,0,2031,4499,2243,-2256
2016,12,8,1,2299,4982,2448,-2534
2016,12,8,2,2535,5125,2467,-2658
2016,12,8,3,2530,5151,2556,-2595
2016,12,8,4,2450,5096,2584,-2512
2016,12,8,5,2324,4976,2577,-2399
2016,12,8,6,2082,4733,2533,-2200
2016,12,8,7,2568,4387,2564,-1823
2016,12,8,8,2271,4103,2541,-1562
2016,12,8,9,2209,3935,2520,-1415
2016,12,8,10,2149,3882,2594,-1288
2016,12,8,11,2150,3881,2511,-1370
2016,12,8,12,2209,3953,2584,-1369
2016,12,8,13,2396,4136,2592,-1544
2016,12,8,14,2749,4468,2614,-1854
2016,12,8,15,2349,4907,2696,-2211
2016,12,8,16,2689,5127,2707,-2420
2016,12,8,17,2611,5052,2610,-2442
2016,12,8,18,2468,4969,2690,-2279
2016,12,8,19,2340,4831,2549,-2282
2016,12,8,20,2221,4776,2618,-2158
2016,12,8,21,2139,4710,2582,-2128
2016,12,8,22,2076,4636,2577,-2059
2016,12,8,23,2060,4665,2588,-2077
2016,12,9,0,2168,4773,2625,-2148
2016,12,9,1,2460,5052,2619,-2433
2016,12,9,2,2688,5246,2753,-2493
2016,12,9,3,2688,5192,2726,-2466
2016,12,9,4,2627,5086,2786,-2300
2016,12,9,5,2510,4932,2727,-2205
2016,12,9,6,2261,4642,2560,-2082
2016,12,9,7,2691,4305,2582,-1723
2016,12,9,8,2383,3980,2169,-1811
2016,12,9,9,1868,3820,2007,-1813
2016,12,9,10,1776,3728,1816,-1912
2016,12,9,11,1624,3701,1776,-1925
2016,12,9,12,1692,3755,1777,-1978
2016,12,9,13,2069,3913,1914,-1999
2016,12,9,14,2513,4218,2155,-2063
2016,12,9,15,2276,4544,2085,-2459
2016,12,9,16,2601,4810,2257,-2553
2016,12,9,17,2594,4903,2178,-2725
2016,12,9,18,2509,4911,2236,-2675
2016,12,9,19,2427,4876,2175,-2701
2016,12,9,20,2344,4827,2074,-2753
2016,12,9,21,2271,4791,2052,-2739
2016,12,9,22,2219,4729,2059,-2670
2016,12,9,23,2209,4709,2069,-2640
2016,12,10,0,2276,4727,2113,-2614
2016,12,10,1,2529,4940,2392,-2548
2016,12,10,2,2707,5021,2406,-2615
2016,12,10,3,2648,4881,2345,-2536
2016,12,10,4,2535,4754,2325,-2429
2016,12,10,5,2397,4610,2254,-2356
2016,12,10,6,2202,4300,1993,-2307
2016,12,10,7,2345,3923,1885,-2038
2016,12,10,8,1811,3633,1643,-1990
2016,12,10,9,1521,3440,1615,-1825
2016,12,10,10,1389,3319,1499,-1820
2016,12,10,11,1323,3266,1501,-1765
2016,12,10,12,1365,3346,1623,-1723
2016,12,10,13,1402,3449,1688,-1761
2016,12,10,14,1535,3596,1765,-1831
2016,12,10,15,1150,3801,1790,-2011
2016,12,10,16,1272,4048,1763,-2285
2016,12,10,17,1507,4270,1756,-2514
2016,12,10,18,1639,4347,1815,-2532
2016,12,10,19,1649,4370,1778,-2592
2016,12,10,20,1590,4354,1759,-2595
2016,12,10,21,1516,4336,1732,-2604
2016,12,10,22,1426,4281,1690,-2591
2016,12,10,23,1407,4249,1652,-2597
2016,12,11,0,1470,4281,1654,-2627
2016,12,11,1,1723,4493,1778,-2715
2016,12,11,2,1838,4558,1787,-2771
2016,12,11,3,1728,4476,1722,-2754
2016,12,11,4,1553,4366,1715,-2651
2016,12,11,5,1309,4277,1777,-2500
2016,12,11,6,1064,4115,1752,-2363
2016,12,11,7,1502,3852,1665,-2187
2016,12,11,8,1216,3617,1459,-2158
2016,12,11,9,1391,3416,1573,-1843
2016,12,11,10,1263,3272,1517,-1755
2016,12,11,11,1192,3217,1421,-1796
2016,12,11,12,1180,3222,1447,-1775
2016,12,11,13,1218,3277,1422,-1855
2016,12,11,14,1327,3374,1357,-2017
2016,12,11,15,1105,3543,1307,-2236
2016,12,11,16,1088,3732,1215,-2517
2016,12,11,17,1177,3988,1402,-2586
2016,12,11,18,1312,4116,1392,-2724
2016,12,11,19,1335,4170,1501,-2669
2016,12,11,20,1307,4196,1632,-2564
2016,12,11,21,1268,4200,1616,-2584
2016,12,11,22,1221,4149,1587,-2562
2016,12,11,23,1166,4140,1737,-2403
2016,12,12,0,1229,4200,1681,-2519
2016,12,12,1,1460,4454,1684,-2770
2016,12,12,2,1770,4650,1915,-2735
2016,12,12,3,1762,4615,1985,-2630
2016,12,12,4,1682,4484,1808,-2676
2016,12,12,5,1568,4411,1907,-2504
2016,12,12,6,1374,4164,1891,-2273
2016,12,12,7,1613,3805,1780,-2025
2016,12,12,8,1506,3524,1644,-1880
2016,12,12,9,1473,3290,1637,-1653
2016,12,12,10,1445,3199,1605,-1594
2016,12,12,11,1502,3205,1645,-1560
2016,12,12,12,1646,3321,1783,-1538
2016,12,12,13,1731,3546,1845,-1701
2016,12,12,14,2080,3907,1881,-2026
2016,12,12,15,1631,4309,1916,-2393
2016,12,12,16,1979,4648,2021,-2627
2016,12,12,17,1946,4498,1772,-2726
2016,12,12,18,1856,4461,1793,-2668
2016,12,12,19,1791,4407,1816,-2591
2016,12,12,20,1720,4314,1716,-2598
2016,12,12,21,1698,4329,1741,-2588
2016,12,12,22,1678,4305,1778,-2527
2016,12,12,23,1690,4294,1822,-2472
2016,12,13,0,1775,4376,1963,-2413
2016,12,13,1,2064,4653,2097,-2556
2016,12,13,2,2324,4828,2334,-2494
2016,12,13,3,2340,4784,2260,-2524
2016,12,13,4,2268,4709,2222,-2487
2016,12,13,5,2142,4558,2132,-2426
2016,12,13,6,1900,4291,2029,-2262
2016,12,13,7,2360,3930,2028,-1902
2016,12,13,8,1887,3611,1904,-1707
2016,12,13,9,1557,3308,1553,-1755
2016,12,13,10,1477,3200,1473,-1727
2016,12,13,11,1461,3166,1448,-1718
2016,12,13,12,1518,3243,1468,-1775
2016,12,13,13,1679,3597,1721,-1876
2016,12,13,14,1943,3896,1735,-2161
2016,12,13,15,1611,4258,1580,-2678
2016,12,13,16,1956,4574,1731,-2843
2016,12,13,17,1922,4520,1680,-2840
2016,12,13,18,1817,4440,1675,-2765
2016,12,13,19,1744,4396,1684,-2712
2016,12,13,20,1670,4296,1527,-2769
2016,12,13,21,1628,4249,1488,-2761
2016,12,13,22,1591,4252,1536,-2716
2016,12,13,23,1592,4274,1598,-2676
2016,12,14,0,1670,4376,1683,-2693
2016,12,14,1,1922,4700,1867,-2833
2016,12,14,2,2168,4936,1919,-3017
2016,12,14,3,2190,4934,1910,-3024
2016,12,14,4,2115,4868,1843,-3025
2016,12,14,5,1990,4758,1864,-2894
2016,12,14,6,1750,4477,1696,-2781
2016,12,14,7,2102,4155,1694,-2461
2016,12,14,8,1792,3872,1721,-2151
2016,12,14,9,1498,3688,1639,-2049
2016,12,14,10,1379,3649,1608,-2041
2016,12,14,11,1375,3657,1597,-2060
2016,12,14,12,1433,3737,1669,-2068
2016,12,14,13,1644,3923,1729,-2194
2016,12,14,14,1869,4313,1857,-2456
2016,12,14,15,1635,4726,1876,-2850
2016,12,14,16,1997,4993,2009,-2984
2016,12,14,17,2009,4917,1820,-3097
2016,12,14,18,1879,4804,1726,-3078
2016,12,14,19,1834,4748,1722,-3026
2016,12,14,20,1762,4605,1646,-2959
2016,12,14,21,1711,4546,1684,-2862
2016,12,14,22,1688,4514,1716,-2798
2016,12,14,23,1673,4499,1774,-2725
2016,12,15,0,1789,4653,1933,-2720
2016,12,15,1,2069,4968,2050,-2918
2016,12,15,2,2294,5132,2226,-2906
2016,12,15,3,2311,5075,2271,-2804
2016,12,15,4,2244,5004,2152,-2852
2016,12,15,5,2094,4870,2054,-2816
2016,12,15,6,1816,4538,1787,-2751
2016,12,15,7,1981,4215,1859,-2356
2016,12,15,8,1598,3885,1704,-2181
2016,12,15,9,1575,3671,1684,-1987
2016,12,15,10,1506,3594,1642,-1952
2016,12,15,11,1458,3600,1647,-1953
2016,12,15,12,1420,3646,1705,-1941
2016,12,15,13,1578,3800,1684,-2116
2016,12,15,14,1956,4147,1759,-2388
2016,12,15,15,1808,4495,1589,-2906
2016,12,15,16,2213,4824,1945,-2879
2016,12,15,17,2197,4779,1932,-2847
2016,12,15,18,2116,4715,1929,-2786
2016,12,15,19,2035,4638,2027,-2611
2016,12,15,20,1943,4532,1992,-2540
2016,12,15,21,1882,4438,2006,-2432
2016,12,15,22,1827,4385,2025,-2360
2016,12,15,23,1832,4345,2020,-2325
2016,12,16,0,1926,4458,2046,-2412
2016,12,16,1,2207,4781,2201,-2580
2016,12,16,2,2457,4984,2231,-2753
2016,12,16,3,2458,4928,2223,-2705
2016,12,16,4,2381,4831,2026,-2805
2016,12,16,5,2258,4742,2071,-2671
2016,12,16,6,2011,4531,1998,-2533
2016,12,16,7,2241,4235,2037,-2198
2016,12,16,8,1930,3954,1993,-1961
2016,12,16,9,1862,3782,1976,-1806
2016,12,16,10,1782,3722,2011,-1711
2016,12,16,11,1768,3724,2064,-1660
2016,12,16,12,1812,3818,2137,-1681
2016,12,16,13,1974,4020,2088,-1932
2016,12,16,14,2310,4379,2104,-2275
2016,12,16,15,2217,4774,2096,-2678
2016,12,16,16,2579,5085,2257,-2828
2016,12,16,17,2567,5104,2247,-2857
2016,12,16,18,2485,5010,2210,-2800
2016,12,16,19,2390,4886,2121,-2765
2016,12,16,20,2327,4749,2109,-2640
2016,12,16,21,2282,4594,1904,-2690
2016,12,16,22,2243,4525,1902,-2623
2016,12,16,23,2249,4519,1949,-2570
2016,12,17,0,2332,4630,2169,-2461
2016,12,17,1,2606,4962,2291,-2671
2016,12,17,2,2837,5182,2326,-2856
2016,12,17,3,2783,5144,2316,-2828
2016,12,17,4,2676,5105,2364,-2741
2016,12,17,5,2528,5008,2369,-2639
2016,12,17,6,2333,4839,2221,-2618
2016,12,17,7,2529,4596,2214,-2382
2016,12,17,8,2233,4344,2118,-2226
2016,12,17,9,1968,4179,2232,-1947
2016,12,17,10,1896,4100,2070,-2030
2016,12,17,11,1851,4066,2007,-2059
2016,12,17,12,1872,4116,2030,-2086
2016,12,17,13,1938,4211,2119,-2092
2016,12,17,14,2093,4364,2176,-2188
2016,12,17,15,1749,4568,2169,-2399
2016,12,17,16,2116,4809,2324,-2485
2016,12,17,17,2339,4990,2238,-2752
2016,12,17,18,2442,5077,2220,-2857
2016,12,17,19,2399,5037,2248,-2789
2016,12,17,20,2316,4933,2200,-2733
2016,12,17,21,2206,4809,2094,-2715
2016,12,17,22,2128,4746,2022,-2724
2016,12,17,23,2079,4688,1922,-2766
2016,12,18,0,2161,4650,1957,-2693
2016,12,18,1,2430,4903,2227,-2676
2016,12,18,2,2584,5023,2298,-2725
2016,12,18,3,2524,4954,2300,-2654
2016,12,18,4,2453,4877,2315,-2562
2016,12,18,5,2350,4791,2382,-2409
2016,12,18,6,2189,4598,2335,-2263
2016,12,18,7,2433,4393,2400,-1993
2016,12,18,8,2188,4168,2336,-1832
2016,12,18,9,2140,3951,2223,-1728
2016,12,18,10,2072,3881,2204,-1677
2016,12,18,11,2031,3882,2174,-1708
2016,12,18,12,2072,3905,2163,-1742
2016,12,18,13,2186,4063,2232,-1831
2016,12,18,14,2282,4195,2217,-1978
2016,12,18,15,1618,4304,1978,-2326
2016,12,18,16,1839,4540,1994,-2546
2016,12,18,17,2047,4825,2186,-2639
2016,12,18,18,2193,4902,2077,-2825
2016,12,18,19,2193,4820,2080,-2740
2016,12,18,20,2114,4765,2090,-2675
2016,12,18,21,2041,4727,2060,-2667
2016,12,18,22,1959,4689,1933,-2756
2016,12,18,23,1709,4642,1905,-2737
2016,12,19,0,1764,4664,1969,-2695
2016,12,19,1,2034,4919,2217,-2702
2016,12,19,2,2257,5063,2269,-2794
2016,12,19,3,2237,5019,2222,-2797
2016,12,19,4,2170,4948,2185,-2763
2016,12,19,5,2033,4850,2288,-2562
2016,12,19,6,1805,4615,2197,-2418
2016,12,19,7,2297,4297,2220,-2077
2016,12,19,8,2032,4010,1992,-2018
2016,12,19,9,1649,3756,1813,-1943
2016,12,19,10,1629,3651,1791,-1860
2016,12,19,11,1600,3634,1806,-1828
2016,12,19,12,1655,3712,1795,-1917
2016,12,19,13,1725,3964,1804,-2160
2016,12,19,14,1997,4275,1910,-2365
2016,12,19,15,1620,4587,1932,-2655
2016,12,19,16,1869,4747,1890,-2857
2016,12,19,17,1881,4787,1968,-2819
2016,12,19,18,1825,4836,1944,-2892
2016,12,19,19,1757,4786,2015,-2771
2016,12,19,20,1685,4732,1900,-2832
2016,12,19,21,1634,4690,1911,-2779
2016,12,19,22,1587,4614,1872,-2742
2016,12,19,23,1542,4548,1851,-2697
2016,12,20,0,1619,4562,1873,-2689
2016,12,20,1,1869,4771,2006,-2765
2016,12,20,2,2052,4912,1924,-2988
2016,12,20,3,2052,4890,1876,-3014
2016,12,20,4,1983,4784,1861,-2923
2016,12,20,5,1900,4644,1811,-2833
2016,12,20,6,1753,4405,1770,-2635
2016,12,20,7,2047,4091,1853,-2238
2016,12,20,8,1764,3806,1713,-2093
2016,12,20,9,1528,3608,1602,-2006
2016,12,20,10,1326,3483,1454,-2029
2016,12,20,11,1200,3417,1452,-1965
2016,12,20,12,1158,3430,1495,-1935
2016,12,20,13,1258,3532,1463,-2069
2016,12,20,14,1520,3826,1545,-2281
2016,12,20,15,1182,4124,1490,-2634
2016,12,20,16,1531,4419,1643,-2776
2016,12,20,17,1670,4407,1567,-2840
2016,12,20,18,1584,4414,1537,-2877
2016,12,20,19,1665,4410,1716,-2694
2016,12,20,20,1607,4317,1745,-2572
2016,12,20,21,1555,4269,1670,-2599
2016,12,20,22,1523,4243,1721,-2522
2016,12,20,23,1505,4166,1715,-2451
2016,12,21,0,1599,4278,1776,-2502
2016,12,21,1,1846,4523,1773,-2750
2016,12,21,2,2046,4756,1874,-2882
2016,12,21,3,2021,4746,1985,-2761
2016,12,21,4,1900,4586,1880,-2706
2016,12,21,5,1776,4482,1776,-2706
2016,12,21,6,1592,4267,1670,-2597
2016,12,21,7,1874,4016,1687,-2329
2016,12,21,8,1587,3740,1511,-2229
2016,12,21,9,1181,3552,1355,-2197
2016,12,21,10,1127,3448,1334,-2114
2016,12,21,11,1145,3408,1333,-2075
2016,12,21,12,1240,3592,1659,-1933
2016,12,21,13,1528,3798,1742,-2056
2016,12,21,14,1652,4093,1738,-2355
2016,12,21,15,1578,4393,1613,-2780
2016,12,21,16,1753,4684,1725,-2959
2016,12,21,17,1874,4761,1818,-2943
2016,12,21,18,1897,4747,1844,-2903
2016,12,21,19,1877,4625,1866,-2759
2016,12,21,20,1818,4482,1787,-2695
2016,12,21,21,1770,4416,1816,-2600
2016,12,21,22,1725,4341,1842,-2499
2016,12,21,23,1702,4280,1750,-2530
2016,12,22,0,1816,4367,1832,-2535
2016,12,22,1,2063,4638,2046,-2592
2016,12,22,2,2266,4885,2100,-2785
2016,12,22,3,2227,4907,2144,-2763
2016,12,22,4,2132,4859,2084,-2775
2016,12,22,5,2012,4764,2077,-2687
2016,12,22,6,1835,4559,1958,-2601
2016,12,22,7,2007,4286,1979,-2307
2016,12,22,8,1723,3987,1710,-2277
2016,12,22,9,1537,3798,1662,-2136
2016,12,22,10,1492,3708,1710,-1998
2016,12,22,11,1401,3684,1664,-2020
2016,12,22,12,1453,3725,1678,-2047
2016,12,22,13,1602,3845,1737,-2108
2016,12,22,14,1904,4135,1766,-2369
2016,12,22,15,1749,4459,1793,-2666
2016,12,22,16,2035,4666,1960,-2706
2016,12,22,17,2083,4770,2067,-2703
2016,12,22,18,2042,4790,2048,-2742
2016,12,22,19,1987,4775,1981,-2794
2016,12,22,20,1902,4737,1971,-2766
2016,12,22,21,1829,4649,1978,-2671
2016,12,22,22,1781,4547,1868,-2679
2016,12,22,23,1746,4524,1811,-2713
2016,12,23,0,1845,4551,1869,-2682
2016,12,23,1,2070,4748,2006,-2742
2016,12,23,2,2231,4890,2087,-2803
2016,12,23,3,2172,4808,2052,-2756
2016,12,23,4,2070,4732,2038,-2694
2016,12,23,5,1960,4603,1978,-2625
2016,12,23,6,1789,4377,1834,-2543
2016,12,23,7,1969,4092,1708,-2384
2016,12,23,8,1692,3707,1509,-2198
2016,12,23,9,1526,3394,1374,-2020
2016,12,23,10,1409,3277,1339,-1938
2016,12,23,11,1361,3247,1333,-1914
2016,12,23,12,1407,3326,1412,-1914
2016,12,23,13,1550,3457,1460,-1997
2016,12,23,14,1828,3686,1479,-2207
2016,12,23,15,1642,3929,1376,-2553
2016,12,23,16,2004,4161,1403,-2758
2016,12,23,17,2109,4347,1473,-2874
2016,12,23,18,2133,4447,1601,-2846
2016,12,23,19,2109,4496,1688,-2808
2016,12,23,20,2052,4482,1588,-2894
2016,12,23,21,2004,4482,1636,-2846
2016,12,23,22,1961,4452,1662,-2790
2016,12,23,23,1920,4428,1634,-2794
2016,12,24,0,1969,4478,1717,-2761
2016,12,24,1,2175,4657,1857,-2800
2016,12,24,2,2251,4768,1990,-2778
2016,12,24,3,2224,4666,1879,-2787
2016,12,24,4,2098,4524,1875,-2649
2016,12,24,5,1985,4435,1710,-2725
2016,12,24,6,1842,4247,1761,-2486
2016,12,24,7,2054,4028,1764,-2264
2016,12,24,8,1792,3776,1759,-2017
2016,12,24,9,1445,3570,1578,-1992
2016,12,24,10,1300,3449,1538,-1911
2016,12,24,11,1245,3360,1460,-1900
2016,12,24,12,1268,3383,1552,-1831
2016,12,24,13,1338,3411,1439,-1972
2016,12,24,14,1491,3600,1563,-2037
2016,12,24,15,1379,3769,1378,-2391
2016,12,24,16,1680,3992,1315,-2677
2016,12,24,17,1778,4225,1361,-2864
2016,12,24,18,1855,4416,1488,-2928
2016,12,24,19,1859,4418,1374,-3044
2016,12,24,20,1821,4332,1280,-3052
2016,12,24,21,1766,4246,1273,-2973
2016,12,24,22,1715,4186,1281,-2905
2016,12,24,23,1685,4090,1154,-2936
2016,12,25,0,1715,4126,1248,-2878
2016,12,25,1,1666,4303,1300,-3003
2016,12,25,2,1892,4426,1309,-3117
2016,12,25,3,1847,4326,1302,-3024
2016,12,25,4,1721,4274,1344,-2930
2016,12,25,5,1637,4230,1355,-2875
2016,12,25,6,1539,4144,1358,-2786
2016,12,25,7,1783,3973,1384,-2589
2016,12,25,8,1572,3741,1267,-2474
2016,12,25,9,1359,3597,1353,-2244
2016,12,25,10,1274,3510,1348,-2162
2016,12,25,11,1253,3490,1402,-2088
2016,12,25,12,1269,3521,1447,-2074
2016,12,25,13,1412,3615,1491,-2124
2016,12,25,14,1557,3822,1556,-2266
2016,12,25,15,1401,4026,1549,-2477
2016,12,25,16,1614,4302,1585,-2717
2016,12,25,17,1822,4525,1590,-2935
2016,12,25,18,1967,4580,1575,-3005
2016,12,25,19,1979,4512,1590,-2922
2016,12,25,20,1948,4382,1491,-2891
2016,12,25,21,1893,4271,1407,-2864
2016,12,25,22,1830,4199,1459,-2740
2016,12,25,23,1774,4199,1587,-2612
2016,12,26,0,1805,4234,1637,-2597
2016,12,26,1,1963,4419,1642,-2777
2016,12,26,2,2121,4539,1673,-2866
2016,12,26,3,2128,4515,1684,-2831
2016,12,26,4,2083,4470,1650,-2820
2016,12,26,5,2031,4468,1724,-2744
2016,12,26,6,1914,4358,1655,-2703
2016,12,26,7,2110,4174,1663,-2511
2016,12,26,8,1868,3967,1619,-2348
2016,12,26,9,1730,3813,1604,-2209
2016,12,26,10,1630,3731,1600,-2131
2016,12,26,11,1579,3698,1601,-2097
2016,12,26,12,1584,3743,1634,-2109
2016,12,26,13,1653,3841,1606,-2235
2016,12,26,14,1805,4017,1598,-2419
2016,12,26,15,1617,4191,1570,-2621
2016,12,26,16,1862,4348,1574,-2774
2016,12,26,17,2006,4494,1607,-2887
2016,12,26,18,2138,4515,1561,-2954
2016,12,26,19,2190,4534,1496,-3038
2016,12,26,20,2169,4526,1453,-3073
2016,12,26,21,2118,4532,1479,-3053
2016,12,26,22,2065,4513,1471,-3042
2016,12,26,23,2022,4549,1513,-3036
2016,12,27,0,2035,4654,1611,-3043
2016,12,27,1,2161,4846,1613,-3233
2016,12,27,2,2331,4897,1682,-3215
2016,12,27,3,2381,4887,1753,-3134
2016,12,27,4,2312,4755,1739,-3016
2016,12,27,5,2199,4612,1735,-2877
2016,12,27,6,2054,4402,1680,-2722
2016,12,27,7,2090,4109,1646,-2463
2016,12,27,8,1798,3815,1504,-2311
2016,12,27,9,1419,3594,1441,-2153
2016,12,27,10,1445,3497,1417,-2080
2016,12,27,11,1464,3452,1451,-2001
2016,12,27,12,1485,3432,1350,-2082
2016,12,27,13,1586,3653,1478,-2175
2016,12,27,14,1597,3909,1490,-2419
2016,12,27,15,1592,4195,1529,-2666
2016,12,27,16,1594,4433,1634,-2799
2016,12,27,17,1583,4521,1631,-2890
2016,12,27,18,1587,4593,1705,-2888
2016,12,27,19,1591,4559,1683,-2876
2016,12,27,20,1596,4506,1653,-2853
2016,12,27,21,1526,4464,1678,-2786
2016,12,27,22,1529,4496,1723,-2773
2016,12,27,23,1484,4464,1709,-2755
2016,12,28,0,1516,4519,1657,-2862
2016,12,28,1,1736,4712,1629,-3083
2016,12,28,2,1954,4897,1623,-3274
2016,12,28,3,1962,4844,1664,-3180
2016,12,28,4,1883,4731,1685,-3046
2016,12,28,5,1739,4615,1715,-2900
2016,12,28,6,1539,4370,1600,-2770
2016,12,28,7,1575,4093,1623,-2470
2016,12,28,8,1291,3832,1641,-2191
2016,12,28,9,1562,3668,1655,-2013
2016,12,28,10,1526,3574,1645,-1929
2016,12,28,11,1185,3544,1641,-1903
2016,12,28,12,1373,3595,1648,-1947
2016,12,28,13,1549,3746,1640,-2106
2016,12,28,14,1364,4019,1657,-2362
2016,12,28,15,1160,4292,1580,-2712
2016,12,28,16,1235,4469,1466,-3003
2016,12,28,17,1363,4586,1582,-3004
2016,12,28,18,1435,4614,1548,-3066
2016,12,28,19,1443,4574,1567,-3007
2016,12,28,20,1401,4440,1514,-2926
2016,12,28,21,1375,4349,1484,-2865
2016,12,28,22,1386,4233,1423,-2810
2016,12,28,23,1417,4228,1452,-2776
2016,12,29,0,1585,4309,1434,-2875
2016,12,29,1,1489,4566,1443,-3123
2016,12,29,2,1742,4799,1542,-3257
2016,12,29,3,1788,4746,1552,-3194
2016,12,29,4,1716,4580,1422,-3158
2016,12,29,5,1593,4457,1395,-3062
2016,12,29,6,1403,4226,1262,-2964
2016,12,29,7,1750,3971,1271,-2700
2016,12,29,8,1555,3704,1249,-2455
2016,12,29,9,1193,3443,1155,-2288
2016,12,29,10,1171,3388,1190,-2198
2016,12,29,11,1128,3351,1173,-2178
2016,12,29,12,1150,3394,1205,-2189
2016,12,29,13,1349,3641,1376,-2265
2016,12,29,14,1587,3899,1370,-2529
2016,12,29,15,1040,4137,1252,-2885
2016,12,29,16,1188,4392,1342,-3050
2016,12,29,17,1307,4452,1258,-3194
2016,12,29,18,1368,4457,1130,-3327
2016,12,29,19,1372,4520,1253,-3267
2016,12,29,20,1514,4531,1352,-3179
2016,12,29,21,1443,4508,1415,-3093
2016,12,29,22,1370,4471,1452,-3019
2016,12,29,23,1307,4470,1463,-3007
2016,12,30,0,1369,4500,1495,-3005
2016,12,30,1,1519,4663,1539,-3124
2016,12,30,2,1652,4776,1578,-3198
2016,12,30,3,1601,4659,1518,-3141
2016,12,30,4,1423,4477,1455,-3022
2016,12,30,5,1267,4357,1495,-2862
2016,12,30,6,1209,4161,1522,-2639
2016,12,30,7,1416,3906,1580,-2326
2016,12,30,8,1369,3647,1564,-2083
2016,12,30,9,1449,3477,1590,-1887
2016,12,30,10,1336,3399,1606,-1793
2016,12,30,11,1313,3368,1624,-1744
2016,12,30,12,1371,3416,1635,-1781
2016,12,30,13,1259,3540,1522,-2018
2016,12,30,14,1542,3756,1386,-2370
2016,12,30,15,1092,4018,1232,-2786
2016,12,30,16,1073,4274,1235,-3039
2016,12,30,17,1256,4410,1291,-3119
2016,12,30,18,1373,4477,1411,-3066
2016,12,30,19,1422,4454,1413,-3041
2016,12,30,20,1419,4360,1391,-2969
2016,12,30,21,1389,4256,1343,-2913
2016,12,30,22,1351,4229,1386,-2843
2016,12,30,23,1336,4170,1376,-2794
2016,12,31,0,1365,4204,1410,-2794
2016,12,31,1,1471,4396,1301,-3095
2016,12,31,2,1767,4697,1515,-3182
2016,12,31,3,1644,4663,1560,-3103
2016,12,31,4,1543,4602,1526,-3076
2016,12,31,5,1413,4537,1518,-3019
2016,12,31,6,1363,4398,1502,-2896
2016,12,31,7,1830,4180,1529,-2651
2016,12,31,8,1618,3947,1592,-2355
2016,12,31,9,1551,3800,1634,-2166
2016,12,31,10,1444,3687,1511,-2176
2016,12,31,11,1438,3685,1594,-2091
2016,12,31,12,1453,3695,1605,-2090
2016,12,31,13,1470,3766,1619,-2147
2016,12,31,14,1611,3918,1627,-2291
2016,12,31,15,1424,4074,1637,-2437
2016,12,31,16,1368,4274,1674,-2600
2016,12,31,17,1534,4482,1691,-2791
2016,12,31,18,1645,4631,1688,-2943
2016,12,31,19,1624,4713,1644,-3069
2016,12,31,20,1530,4717,1696,-3021
2016,12,31,21,1387,4664,1656,-3008
2016,12,31,22,1240,4583,1607,-2976
2016,12,31,23,1315,4533,1630,-2903
2017,1,1,0,1285,4599,1690,-2909
2017,1,1,1,1192,4776,1639,-3137
2017,1,1,2,1308,4857,1656,-3201
2017,1,1,3,1299,4744,1401,-3343
2017,1,1,4,1237,4613,1375,-3238
2017,1,1,5,1168,4448,1385,-3063
2017,1,1,6,1145,4271,1428,-2843
2017,1,1,7,1527,4090,1438,-2652
2017,1,1,8,1386,3911,1513,-2398
2017,1,1,9,1568,3797,1586,-2211
2017,1,1,10,1547,3685,1566,-2119
2017,1,1,11,1518,3622,1516,-2106
2017,1,1,12,1484,3607,1447,-2160
2017,1,1,13,1463,3650,1390,-2260
2017,1,1,14,1459,3770,1393,-2377
2017,1,1,15,1388,3926,1401,-2525
2017,1,1,16,1501,4095,1427,-2668
2017,1,1,17,1536,4221,1374,-2847
2017,1,1,18,1565,4395,1507,-2888
2017,1,1,19,1586,4467,1550,-2917
2017,1,1,20,1527,4477,1584,-2893
2017,1,1,21,1582,4448,1620,-2828
2017,1,1,22,1657,4453,1706,-2747
2017,1,1,23,1489,4392,1745,-2647
2017,1,2,0,1516,4449,1796,-2653
2017,1,2,1,1575,4638,1851,-2787
2017,1,2,2,1771,4880,1933,-2947
2017,1,2,3,1744,4822,1903,-2919
2017,1,2,4,1604,4757,1902,-2855
2017,1,2,5,1501,4649,1927,-2722
2017,1,2,6,1502,4446,1862,-2584
2017,1,2,7,1831,4212,1972,-2240
2017,1,2,8,1634,3957,1934,-2023
2017,1,2,9,1974,3877,2141,-1736
2017,1,2,10,1991,3750,2042,-1708
2017,1,2,11,2012,3784,2149,-1635
2017,1,2,12,2092,3827,2149,-1678
2017,1,2,13,2103,3958,2181,-1777
2017,1,2,14,2394,4103,2096,-2007
2017,1,2,15,2586,4333,2163,-2170
2017,1,2,16,2964,4601,2314,-2287
2017,1,2,17,2821,4803,2398,-2405
2017,1,2,18,2752,4926,2450,-2476
2017,1,2,19,2682,4957,2452,-2505
2017,1,2,20,2598,4889,2406,-2483
2017,1,2,21,2573,4815,2353,-2462
2017,1,2,22,2521,4748,2367,-2381
2017,1,2,23,2490,4698,2391,-2307
2017,1,3,0,2536,4757,2457,-2300
2017,1,3,1,2673,5036,2587,-2449
2017,1,3,2,2923,5315,2699,-2616
2017,1,3,3,2918,5311,2526,-2785
2017,1,3,4,2833,5248,2597,-2651
2017,1,3,5,2688,5116,2478,-2638
2017,1,3,6,2410,4853,2318,-2535
2017,1,3,7,2418,4532,2314,-2218
2017,1,3,8,2130,4271,2345,-1926
2017,1,3,9,2371,4138,2382,-1756
2017,1,3,10,2319,4106,2385,-1721
2017,1,3,11,2328,4114,2372,-1742
2017,1,3,12,2409,4055,2290,-1765
2017,1,3,13,2447,4258,2260,-1998
2017,1,3,14,2466,4624,2222,-2402
2017,1,3,15,2426,5050,2210,-2840
2017,1,3,16,2440,5305,2242,-3063
2017,1,3,17,2433,5270,2235,-3035
2017,1,3,18,2425,5141,2152,-2989
2017,1,3,19,2418,5009,2169,-2840
2017,1,3,20,2411,4893,2198,-2695
2017,1,3,21,2364,4798,2228,-2570
2017,1,3,22,2272,4701,2225,-2476
2017,1,3,23,2255,4671,2193,-2478
2017,1,4,0,2337,4730,2166,-2564
2017,1,4,1,2421,5037,2260,-2777
2017,1,4,2,2433,5344,2291,-3053
2017,1,4,3,2445,5346,2247,-3099
2017,1,4,4,2455,5319,2356,-2963
2017,1,4,5,2436,5179,2485,-2694
2017,1,4,6,2422,4911,2303,-2608
2017,1,4,7,2449,4609,2332,-2277
2017,1,4,8,2398,4325,2343,-1982
2017,1,4,9,2138,4162,2233,-1929
2017,1,4,10,2111,4121,2209,-1912
2017,1,4,11,2003,4137,2208,-1929
2017,1,4,12,2046,4215,2206,-2009
2017,1,4,13,2134,4407,2221,-2186
2017,1,4,14,2328,4726,2260,-2466
2017,1,4,15,2164,5117,2362,-2755
2017,1,4,16,2503,5364,2450,-2914
2017,1,4,17,2464,5283,2347,-2936
2017,1,4,18,2299,5140,2219,-2921
2017,1,4,19,2164,4996,2303,-2693
2017,1,4,20,2042,4849,2218,-2631
2017,1,4,21,1967,4737,2276,-2461
2017,1,4,22,1916,4645,2284,-2361
2017,1,4,23,1912,4610,2242,-2368
2017,1,5,0,2008,4648,2233,-2415
2017,1,5,1,2252,4937,2419,-2518
2017,1,5,2,2585,5257,2483,-2774
2017,1,5,3,2633,5296,2433,-2863
2017,1,5,4,2561,5249,2440,-2809
2017,1,5,5,2427,5122,2367,-2755
2017,1,5,6,2148,4859,2328,-2531
2017,1,5,7,2352,4523,2235,-2288
2017,1,5,8,2061,4244,2075,-2169
2017,1,5,9,2159,4098,2040,-2058
2017,1,5,10,2132,4109,2062,-2047
2017,1,5,11,1978,4128,2037,-2091
2017,1,5,12,2031,4233,2046,-2187
2017,1,5,13,2236,4437,2078,-2359
2017,1,5,14,2623,4801,2133,-2668
2017,1,5,15,2380,5245,2241,-3004
2017,1,5,16,2739,5504,2540,-2964
2017,1,5,17,2684,5467,2504,-2963
2017,1,5,18,2531,5315,2320,-2995
2017,1,5,19,2493,5094,2218,-2876
2017,1,5,20,2366,4924,2113,-2811
2017,1,5,21,2272,4763,1969,-2794
2017,1,5,22,2189,4650,1923,-2727
2017,1,5,23,2119,4612,1993,-2619
2017,1,6,0,2221,4668,2016,-2652
2017,1,6,1,2445,4915,2211,-2704
2017,1,6,2,2668,5256,2440,-2816
2017,1,6,3,2698,5293,2520,-2773
2017,1,6,4,2608,5267,2548,-2719
2017,1,6,5,2457,5157,2420,-2737
2017,1,6,6,2205,4889,2194,-2695
2017,1,6,7,2510,4573,2198,-2375
2017,1,6,8,2206,4288,2157,-2131
2017,1,6,9,2101,4161,2150,-2011
2017,1,6,10,2016,4091,2155,-1936
2017,1,6,11,2008,4111,2135,-1976
2017,1,6,12,2072,4200,2272,-1928
2017,1,6,13,2251,4391,2287,-2104
2017,1,6,14,2597,4738,2451,-2287
2017,1,6,15,2520,5146,2421,-2725
2017,1,6,16,2855,5395,2669,-2726
2017,1,6,17,2848,5350,2580,-2770
2017,1,6,18,2776,5223,2453,-2770
2017,1,6,19,2536,5045,2361,-2684
2017,1,6,20,2418,4863,2202,-2661
2017,1,6,21,2359,4741,2161,-2580
2017,1,6,22,2261,4633,2069,-2564
2017,1,6,23,2217,4578,2135,-2443
2017,1,7,0,2277,4585,2265,-2320
2017,1,7,1,2469,4815,2324,-2491
2017,1,7,2,2744,5074,2495,-2579
2017,1,7,3,2734,5081,2550,-2531
2017,1,7,4,2633,5005,2510,-2495
2017,1,7,5,2507,4915,2562,-2353
2017,1,7,6,2309,4769,2522,-2247
2017,1,7,7,2245,4550,2322,-2228
2017,1,7,8,2204,4319,2337,-1982
2017,1,7,9,2205,4184,2237,-1947
2017,1,7,10,2120,4160,2137,-2023
2017,1,7,11,2094,4154,2165,-1989
2017,1,7,12,2100,4191,2140,-2051
2017,1,7,13,2172,4288,2169,-2119
2017,1,7,14,2308,4452,2215,-2237
2017,1,7,15,1867,4630,2256,-2374
2017,1,7,16,2243,4882,2268,-2614
2017,1,7,17,2355,5054,2323,-2731
2017,1,7,18,2462,5141,2404,-2737
2017,1,7,19,2416,5137,2451,-2686
2017,1,7,20,2298,5069,2314,-2755
2017,1,7,21,2143,4999,2289,-2710
2017,1,7,22,2048,4920,2263,-2657
2017,1,7,23,1973,4845,2303,-2542
2017,1,8,0,2016,4847,2337,-2510
2017,1,8,1,2209,4985,2305,-2680
2017,1,8,2,2434,5054,2377,-2677
2017,1,8,3,2390,4964,2306,-2658
2017,1,8,4,2282,4825,2233,-2592
2017,1,8,5,2151,4753,2210,-2543
2017,1,8,6,1987,4560,2059,-2501
2017,1,8,7,2296,4252,1916,-2336
2017,1,8,8,2045,3910,1787,-2123
2017,1,8,9,1835,3753,1797,-1956
2017,1,8,10,1746,3651,1679,-1972
2017,1,8,11,1814,3611,1784,-1827
2017,1,8,12,1657,3604,1658,-1946
2017,1,8,13,1754,3660,1676,-1984
2017,1,8,14,1851,3773,1773,-2000
2017,1,8,15,1545,3942,1922,-2020
2017,1,8,16,1772,4160,1954,-2206
2017,1,8,17,1792,4359,1881,-2478
2017,1,8,18,1944,4499,1925,-2574
2017,1,8,19,1956,4587,1943,-2644
2017,1,8,20,1903,4614,2018,-2596
2017,1,8,21,1838,4619,2098,-2521
2017,1,8,22,1784,4629,2179,-2450
2017,1,8,23,1727,4590,2143,-2447
2017,1,9,0,1745,4593,2082,-2511
2017,1,9,1,1930,4748,2039,-2709
2017,1,9,2,2168,4856,2097,-2759
2017,1,9,3,2145,4804,2046,-2758
2017,1,9,4,2054,4687,1980,-2707
2017,1,9,5,1901,4496,1614,-2882
2017,1,9,6,1665,4248,1554,-2694
2017,1,9,7,1813,3927,1633,-2294
2017,1,9,8,1551,3584,1519,-2065
2017,1,9,9,1527,3433,1463,-1970
2017,1,9,10,1530,3380,1482,-1898
2017,1,9,11,1567,3435,1590,-1845
2017,1,9,12,1567,3495,1570,-1925
2017,1,9,13,1613,3653,1509,-2144
2017,1,9,14,1749,4000,1610,-2390
2017,1,9,15,1253,4420,1452,-2968
2017,1,9,16,1536,4691,1485,-3206
2017,1,9,17,1456,4706,1461,-3245
2017,1,9,18,1324,4605,1312,-3293
2017,1,9,19,1216,4603,1355,-3248
2017,1,9,20,1119,4557,1378,-3179
2017,1,9,21,1123,4507,1363,-3144
2017,1,9,22,1123,4473,1404,-3069
2017,1,9,23,1120,4419,1427,-2992
2017,1,10,0,1111,4482,1538,-2944
2017,1,10,1,1262,4684,1628,-3056
2017,1,10,2,1532,4896,1714,-3182
2017,1,10,3,1597,4878,1700,-3178
2017,1,10,4,1551,4808,1629,-3179
2017,1,10,5,1494,4668,1535,-3133
2017,1,10,6,1295,4393,1432,-2961
2017,1,10,7,1725,4069,1412,-2657
2017,1,10,8,1700,3800,1535,-2265
2017,1,10,9,1416,3631,1474,-2157
2017,1,10,10,1459,3572,1463,-2109
2017,1,10,11,1430,3550,1463,-2087
2017,1,10,12,1551,3613,1503,-2110
2017,1,10,13,1694,3779,1522,-2257
2017,1,10,14,1712,4111,1654,-2457
2017,1,10,15,1722,4484,1732,-2752
2017,1,10,16,1854,4718,1797,-2921
2017,1,10,17,1819,4742,1773,-2969
2017,1,10,18,1876,4699,1728,-2971
2017,1,10,19,1785,4616,1694,-2922
2017,1,10,20,1713,4516,1664,-2852
2017,1,10,21,1660,4456,1718,-2738
2017,1,10,22,1611,4406,1731,-2675
2017,1,10,23,1579,4398,1799,-2599
2017,1,11,0,1634,4517,1990,-2527
2017,1,11,1,1707,4746,2016,-2730
2017,1,11,2,2008,5068,2122,-2946
2017,1,11,3,2056,5030,2051,-2979
2017,1,11,4,1963,4997,2173,-2824
2017,1,11,5,1818,4858,2038,-2820
2017,1,11,6,1694,4596,1984,-2612
2017,1,11,7,1693,4284,2055,-2229
2017,1,11,8,1577,4002,1953,-2049
2017,1,11,9,1893,3870,1975,-1895
2017,1,11,10,1892,3784,1926,-1858
2017,1,11,11,1911,3775,1902,-1873
2017,1,11,12,2021,3851,2089,-1762
2017,1,11,13,2219,4071,2312,-1759
2017,1,11,14,2282,4425,2290,-2135
2017,1,11,15,2316,4841,2322,-2519
2017,1,11,16,2503,5072,2417,-2655
2017,1,11,17,2460,5039,2144,-2895
2017,1,11,18,2249,4939,2078,-2861
2017,1,11,19,2131,4869,2057,-2812
2017,1,11,20,2092,4778,2021,-2757
2017,1,11,21,2003,4742,2031,-2711
2017,1,11,22,1986,4654,1993,-2661
2017,1,11,23,2022,4625,2013,-2612
2017,1,12,0,2134,4671,2032,-2639
2017,1,12,1,2376,4875,2148,-2727
2017,1,12,2,2613,5164,2336,-2828
2017,1,12,3,2678,5201,2420,-2781
2017,1,12,4,2624,5124,2449,-2675
2017,1,12,5,2520,5020,2352,-2668
2017,1,12,6,2375,4755,2140,-2615
2017,1,12,7,2285,4422,2123,-2299
2017,1,12,8,1993,4142,1989,-2153
2017,1,12,9,2157,4024,2026,-1998
2017,1,12,10,2133,3967,2013,-1954
2017,1,12,11,2164,4002,2026,-1976
2017,1,12,12,2332,4165,2098,-2067
2017,1,12,13,2519,4331,2179,-2152
2017,1,12,14,2462,4666,2295,-2371
2017,1,12,15,2593,5083,2399,-2684
2017,1,12,16,2722,5378,2551,-2827
2017,1,12,17,2629,5343,2691,-2652
2017,1,12,18,2564,5171,2587,-2584
2017,1,12,19,2501,4970,2411,-2559
2017,1,12,20,2459,4802,2288,-2514
2017,1,12,21,2361,4661,2146,-2515
2017,1,12,22,2256,4579,2035,-2544
2017,1,12,23,2231,4555,2030,-2525
2017,1,13,0,2293,4611,2104,-2507
2017,1,13,1,2514,4917,2286,-2631
2017,1,13,2,2841,5259,2468,-2791
2017,1,13,3,2878,5331,2462,-2869
2017,1,13,4,2819,5306,2495,-2811
2017,1,13,5,2680,5227,2538,-2689
2017,1,13,6,2447,4973,2364,-2609
2017,1,13,7,2382,4631,2279,-2352
2017,1,13,8,2095,4320,2088,-2232
2017,1,13,9,2188,4202,2168,-2034
2017,1,13,10,2146,4173,2179,-1994
2017,1,13,11,2199,4200,2197,-2003
2017,1,13,12,2305,4283,2184,-2099
2017,1,13,13,2489,4475,2188,-2287
2017,1,13,14,2571,4823,2216,-2607
2017,1,13,15,2550,5238,2402,-2836
2017,1,13,16,2789,5492,2620,-2872
2017,1,13,17,2686,5419,2609,-2810
2017,1,13,18,2642,5328,2504,-2824
2017,1,13,19,2581,5156,2406,-2750
2017,1,13,20,2441,4981,2304,-2677
2017,1,13,21,2352,4868,2177,-2691
2017,1,13,22,2254,4779,2100,-2679
2017,1,13,23,2191,4774,2046,-2728
2017,1,14,0,2212,4829,2168,-2661
2017,1,14,1,2397,4999,2257,-2742
2017,1,14,2,2663,5183,2409,-2774
2017,1,14,3,2664,5143,2382,-2761
2017,1,14,4,2551,5030,2318,-2712
2017,1,14,5,2438,4901,2248,-2653
2017,1,14,6,2248,4701,2139,-2562
2017,1,14,7,2283,4442,2102,-2340
2017,1,14,8,2031,4199,1901,-2298
2017,1,14,9,1949,3979,1867,-2112
2017,1,14,10,1895,3906,1935,-1971
2017,1,14,11,1858,3910,1977,-1933
2017,1,14,12,1914,3968,2010,-1958
2017,1,14,13,2016,4151,2090,-2061
2017,1,14,14,2022,4285,2045,-2240
2017,1,14,15,1849,4392,1853,-2539
2017,1,14,16,1982,4703,1937,-2766
2017,1,14,17,2150,4898,2056,-2842
2017,1,14,18,2223,5011,2014,-2997
2017,1,14,19,1976,4977,2038,-2939
2017,1,14,20,1877,4778,1851,-2927
2017,1,14,21,1971,4660,1870,-2790
2017,1,14,22,1866,4495,1853,-2642
2017,1,14,23,1808,4352,1830,-2522
2017,1,15,0,1837,4370,1868,-2502
2017,1,15,1,2006,4538,1968,-2570
2017,1,15,2,2265,4869,2117,-2752
2017,1,15,3,2228,4895,2133,-2762
2017,1,15,4,2138,4837,2121,-2716
2017,1,15,5,2051,4744,2029,-2715
2017,1,15,6,1901,4582,1929,-2653
2017,1,15,7,1866,4349,1866,-2483
2017,1,15,8,1635,4112,1659,-2453
2017,1,15,9,1702,4010,1718,-2292
2017,1,15,10,1710,3936,1702,-2234
2017,1,15,11,1699,3919,1734,-2185
2017,1,15,12,1754,3930,1760,-2170
2017,1,15,13,1728,4027,1789,-2238
2017,1,15,14,1721,4185,1779,-2406
2017,1,15,15,1591,4408,1710,-2698
2017,1,15,16,1819,4668,1825,-2843
2017,1,15,17,1842,4874,1799,-3075
2017,1,15,18,1900,4938,1785,-3153
2017,1,15,19,1864,4864,1755,-3109
2017,1,15,20,1808,4720,1673,-3047
2017,1,15,21,1726,4576,1643,-2933
2017,1,15,22,1643,4442,1636,-2806
2017,1,15,23,1580,4360,1670,-2690
2017,1,16,0,1577,4346,1661,-2685
2017,1,16,1,1749,4546,1743,-2803
2017,1,16,2,1887,4904,1814,-3090
2017,1,16,3,1895,4940,1793,-3147
2017,1,16,4,1840,4891,1837,-3054
2017,1,16,5,1879,4772,1875,-2897
2017,1,16,6,1648,4578,1777,-2801
2017,1,16,7,1739,4276,1721,-2555
2017,1,16,8,1457,4021,1716,-2305
2017,1,16,9,1652,3862,1691,-2171
2017,1,16,10,1654,3762,1638,-2124
2017,1,16,11,1650,3654,1543,-2111
2017,1,16,12,1723,3741,1534,-2207
2017,1,16,13,1702,3921,1541,-2380
2017,1,16,14,1655,4242,1594,-2648
2017,1,16,15,1585,4555,1622,-2933
2017,1,16,16,1792,4831,1865,-2966
2017,1,16,17,1888,4939,1910,-3029
2017,1,16,18,1895,4965,1876,-3089
2017,1,16,19,1810,4913,1768,-3145
2017,1,16,20,1641,4829,1666,-3163
2017,1,16,21,1518,4655,1542,-3113
2017,1,16,22,1406,4553,1541,-3012
2017,1,16,23,1364,4530,1562,-2968
2017,1,17,0,1364,4538,1606,-2932
2017,1,17,1,1487,4706,1732,-2974
2017,1,17,2,1832,4926,1917,-3009
2017,1,17,3,1903,4887,1928,-2959
2017,1,17,4,1818,4766,1870,-2896
2017,1,17,5,1678,4596,1781,-2815
2017,1,17,6,1639,4311,1703,-2608
2017,1,17,7,1913,3955,1659,-2296
2017,1,17,8,1615,3608,1635,-1973
2017,1,17,9,1536,3457,1505,-1952
2017,1,17,10,1454,3379,1458,-1921
2017,1,17,11,1448,3357,1433,-1924
2017,1,17,12,1519,3464,1452,-2012
2017,1,17,13,1585,3662,1518,-2144
2017,1,17,14,1564,4001,1545,-2456
2017,1,17,15,1531,4404,1582,-2822
2017,1,17,16,1564,4637,1695,-2942
2017,1,17,17,1535,4584,1605,-2979
2017,1,17,18,1444,4471,1739,-2732
2017,1,17,19,1714,4378,1741,-2637
2017,1,17,20,1652,4345,1570,-2775
2017,1,17,21,1606,4373,1540,-2833
2017,1,17,22,1559,4385,1581,-2804
2017,1,17,23,1539,4437,1552,-2885
2017,1,18,0,1576,4505,1666,-2839
2017,1,18,1,1734,4650,1752,-2898
2017,1,18,2,2010,4790,1779,-3011
2017,1,18,3,2026,4742,1768,-2974
2017,1,18,4,1904,4610,1734,-2876
2017,1,18,5,1741,4443,1656,-2787
2017,1,18,6,1470,4202,1566,-2636
2017,1,18,7,1774,3884,1562,-2322
2017,1,18,8,1477,3614,1569,-2045
2017,1,18,9,1555,3430,1614,-1816
2017,1,18,10,1505,3332,1567,-1765
2017,1,18,11,1445,3292,1580,-1712
2017,1,18,12,1469,3261,1531,-1730
2017,1,18,13,1650,3472,1642,-1830
2017,1,18,14,1654,3784,1663,-2121
2017,1,18,15,1551,4141,1643,-2498
2017,1,18,16,1631,4382,1685,-2697
2017,1,18,17,1576,4353,1562,-2791
2017,1,18,18,1515,4293,1589,-2704
2017,1,18,19,1476,4264,1627,-2637
2017,1,18,20,1436,4162,1535,-2627
2017,1,18,21,1397,4120,1619,-2501
2017,1,18,22,1395,4105,1599,-2506
2017,1,18,23,1392,4106,1566,-2540
2017,1,19,0,1441,4148,1579,-2569
2017,1,19,1,1610,4318,1607,-2711
2017,1,19,2,1955,4537,1686,-2851
2017,1,19,3,1968,4516,1598,-2918
2017,1,19,4,1870,4433,1562,-2871
2017,1,19,5,1687,4297,1531,-2766
2017,1,19,6,1435,4064,1475,-2589
2017,1,19,7,1790,3779,1519,-2260
2017,1,19,8,1535,3483,1444,-2039
2017,1,19,9,1531,3336,1581,-1755
2017,1,19,10,1569,3271,1667,-1604
2017,1,19,11,1572,3152,1581,-1571
2017,1,19,12,1653,3220,1622,-1598
2017,1,19,13,1768,3407,1670,-1737
2017,1,19,14,1925,3614,1644,-1970
2017,1,19,15,1420,4014,1597,-2417
2017,1,19,16,1744,4268,1728,-2540
2017,1,19,17,1729,4208,1698,-2510
2017,1,19,18,1679,4155,1645,-2510
2017,1,19,19,1650,4103,1717,-2386
2017,1,19,20,1615,4054,1690,-2364
2017,1,19,21,1612,4055,1655,-2400
2017,1,19,22,1603,4040,1577,-2463
2017,1,19,23,1600,4039,1587,-2452
2017,1,20,0,1666,4084,1616,-2468
2017,1,20,1,1826,4198,1544,-2654
2017,1,20,2,1995,4452,1722,-2730
2017,1,20,3,1991,4437,1709,-2728
2017,1,20,4,1902,4351,1765,-2586
2017,1,20,5,1773,4211,1773,-2438
2017,1,20,6,1650,3998,1642,-2356
2017,1,20,7,1976,3700,1524,-2176
2017,1,20,8,1714,3460,1491,-1969
2017,1,20,9,1267,2835,1198,-1637
2017,1,20,10,1324,2772,1381,-1391
2017,1,20,11,1398,2804,1319,-1485
2017,1,20,12,1268,2960,1212,-1748
2017,1,20,13,1361,3169,1268,-1901
2017,1,20,14,1150,3483,1325,-2158
2017,1,20,15,1296,3903,1381,-2522
2017,1,20,16,1942,4180,1642,-2538
2017,1,20,17,1728,4108,1681,-2427
2017,1,20,18,1726,4011,1603,-2408
2017,1,20,19,1659,3948,1621,-2327
2017,1,20,20,1583,4017,1691,-2326
2017,1,20,21,1545,3952,1568,-2384
2017,1,20,22,1484,3902,1560,-2342
2017,1,20,23,1436,3854,1589,-2265
2017,1,21,0,1460,3872,1595,-2277
2017,1,21,1,1587,4040,1688,-2352
2017,1,21,2,1836,4210,1788,-2422
2017,1,21,3,1824,4169,1826,-2343
2017,1,21,4,1704,4030,1678,-2352
2017,1,21,5,1596,3906,1664,-2242
2017,1,21,6,1442,3873,1572,-2301
2017,1,21,7,1729,3667,1609,-2058
2017,1,21,8,1512,3424,1490,-1934
2017,1,21,9,1594,3278,1554,-1724
2017,1,21,10,1492,3166,1439,-1727
2017,1,21,11,1442,3149,1480,-1669
2017,1,21,12,1458,3134,1520,-1614
2017,1,21,13,1519,3201,1512,-1689
2017,1,21,14,1405,3348,1499,-1849
2017,1,21,15,980,3550,1444,-2106
2017,1,21,16,1316,3794,1393,-2401
2017,1,21,17,1364,3895,1195,-2700
2017,1,21,18,1512,4000,1245,-2755
2017,1,21,19,1542,4045,1494,-2551
2017,1,21,20,1481,3924,1450,-2474
2017,1,21,21,1375,3776,1363,-2413
2017,1,21,22,1285,3571,1318,-2253
2017,1,21,23,1227,3507,1205,-2302
2017,1,22,0,1229,3565,1177,-2388
2017,1,22,1,1349,3853,1360,-2493
2017,1,22,2,1544,4098,1510,-2588
2017,1,22,3,1517,4080,1402,-2678
2017,1,22,4,1421,3989,1330,-2659
2017,1,22,5,1305,3886,1307,-2579
2017,1,22,6,1166,3715,1225,-2490
2017,1,22,7,1519,3588,1360,-2228
2017,1,22,8,1419,3375,1350,-2025
2017,1,22,9,1388,3216,1304,-1912
2017,1,22,10,1405,3164,1320,-1844
2017,1,22,11,1258,3125,1265,-1860
2017,1,22,12,1215,3097,1204,-1893
2017,1,22,13,1313,3204,1310,-1894
2017,1,22,14,1382,3371,1422,-1949
2017,1,22,15,1355,3418,1207,-2211
2017,1,22,16,1507,3740,1568,-2172
2017,1,22,17,1731,3933,1682,-2251
2017,1,22,18,1721,4220,1747,-2473
2017,1,22,19,1537,4288,1652,-2636
2017,1,22,20,1655,4327,1643,-2684
2017,1,22,21,1692,4329,1604,-2725
2017,1,22,22,1678,4281,1591,-2690
2017,1,22,23,1634,4214,1565,-2649
2017,1,23,0,1699,4181,1577,-2604
2017,1,23,1,1661,4271,1606,-2665
2017,1,23,2,1714,4532,1590,-2942
2017,1,23,3,1476,4582,1642,-2940
2017,1,23,4,1722,4531,1796,-2735
2017,1,23,5,1668,4398,1789,-2609
2017,1,23,6,1511,4174,1709,-2465
2017,1,23,7,1614,3894,1684,-2210
2017,1,23,8,1775,3646,1631,-2015
2017,1,23,9,1550,3527,1666,-1861
2017,1,23,10,1504,3451,1568,-1883
2017,1,23,11,1604,3436,1629,-1807
2017,1,23,12,1643,3484,1661,-1823
2017,1,23,13,1720,3695,1749,-1946
2017,1,23,14,1884,4051,1804,-2247
2017,1,23,15,1804,4464,1759,-2705
2017,1,23,16,2136,4768,1922,-2846
2017,1,23,17,2097,4733,1796,-2937
2017,1,23,18,1979,4658,1745,-2913
2017,1,23,19,1997,4520,1678,-2842
2017,1,23,20,1893,4357,1602,-2755
2017,1,23,21,1816,4241,1675,-2566
2017,1,23,22,1741,4133,1636,-2497
2017,1,23,23,1670,4053,1574,-2479
2017,1,24,0,1672,4098,1632,-2466
2017,1,24,1,1784,4272,1684,-2588
2017,1,24,2,2028,4651,1851,-2800
2017,1,24,3,2076,4770,1914,-2856
2017,1,24,4,2015,4697,1718,-2979
2017,1,24,5,1886,4629,1854,-2775
2017,1,24,6,1639,4351,1689,-2662
2017,1,24,7,1882,4059,1739,-2320
2017,1,24,8,1612,3811,1700,-2111
2017,1,24,9,1529,3683,1709,-1974
2017,1,24,10,1635,3663,1736,-1927
2017,1,24,11,1659,3668,1736,-1932
2017,1,24,12,1690,3733,1722,-2011
2017,1,24,13,1811,3922,1718,-2204
2017,1,24,14,1816,4274,1813,-2461
2017,1,24,15,1800,4683,1875,-2808
2017,1,24,16,2105,4924,2031,-2893
2017,1,24,17,2022,4881,1960,-2921
2017,1,24,18,1855,4715,1743,-2972
2017,1,24,19,1729,4647,1611,-3036
2017,1,24,20,1612,4515,1505,-3010
2017,1,24,21,1526,4434,1479,-2955
2017,1,24,22,1457,4376,1474,-2902
2017,1,24,23,1417,4335,1584,-2751
2017,1,25,0,1415,4308,1459,-2849
2017,1,25,1,1593,4513,1655,-2858
2017,1,25,2,1897,4859,1975,-2884
2017,1,25,3,1946,4882,1977,-2905
2017,1,25,4,1905,4806,1991,-2815
2017,1,25,5,1788,4674,1999,-2675
2017,1,25,6,1559,4368,1808,-2560
2017,1,25,7,2000,4071,1796,-2275
2017,1,25,8,1722,3799,1718,-2081
2017,1,25,9,1760,3650,1676,-1974
2017,1,25,10,1747,3581,1648,-1933
2017,1,25,11,1818,3565,1643,-1922
2017,1,25,12,1823,3616,1655,-1961
2017,1,25,13,1891,3794,1670,-2124
2017,1,25,14,2072,4128,1924,-2204
2017,1,25,15,1967,4523,2024,-2499
2017,1,25,16,2296,4774,2153,-2621
2017,1,25,17,2285,4684,2073,-2611
2017,1,25,18,2162,4600,2029,-2571
2017,1,25,19,2157,4530,1942,-2588
2017,1,25,20,2021,4439,1844,-2595
2017,1,25,21,1946,4370,1770,-2600
2017,1,25,22,1884,4303,1770,-2533
2017,1,25,23,1832,4237,1652,-2585
2017,1,26,0,1870,4298,1738,-2560
2017,1,26,1,1926,4487,1957,-2530
2017,1,26,2,2219,4764,2203,-2561
2017,1,26,3,2259,4756,2224,-2532
2017,1,26,4,2178,4650,2157,-2493
2017,1,26,5,2061,4508,2107,-2401
2017,1,26,6,1978,4193,1896,-2297
2017,1,26,7,2119,3911,2026,-1885
2017,1,26,8,1855,3592,1904,-1688
2017,1,26,9,2011,3443,2010,-1433
2017,1,26,10,1883,3350,1965,-1385
2017,1,26,11,1905,3237,1729,-1508
2017,1,26,12,1942,3311,1828,-1483
2017,1,26,13,2167,3608,2103,-1505
2017,1,26,14,2348,3954,2226,-1728
2017,1,26,15,2121,4348,2165,-2183
2017,1,26,16,2462,4598,2348,-2250
2017,1,26,17,2505,4530,2230,-2300
2017,1,26,18,2332,4412,2040,-2372
2017,1,26,19,2396,4307,2000,-2307
2017,1,26,20,2302,4229,1955,-2274
2017,1,26,21,2236,4193,1950,-2243
2017,1,26,22,2178,4063,1862,-2201
2017,1,26,23,2151,4076,1963,-2113
2017,1,27,0,2166,4122,1944,-2178
2017,1,27,1,2174,4259,2110,-2149
2017,1,27,2,2456,4574,2302,-2272
2017,1,27,3,2496,4604,2383,-2221
2017,1,27,4,2426,4550,2276,-2274
2017,1,27,5,2313,4442,2275,-2167
2017,1,27,6,2100,4202,2192,-2010
2017,1,27,7,2352,3889,2068,-1821
2017,1,27,8,2093,3570,1841,-1729
2017,1,27,9,1682,3362,1806,-1556
2017,1,27,10,1874,3351,1910,-1441
2017,1,27,11,1888,3353,1929,-1424
2017,1,27,12,1916,3376,1859,-1517
2017,1,27,13,2174,3664,2067,-1597
2017,1,27,14,2189,3954,1998,-1956
2017,1,27,15,2015,4380,2104,-2276
2017,1,27,16,2346,4651,2209,-2442
2017,1,27,17,2317,4664,2125,-2539
2017,1,27,18,2231,4559,2031,-2528
2017,1,27,19,2191,4438,1980,-2458
2017,1,27,20,2084,4248,1892,-2356
2017,1,27,21,1996,4092,1827,-2265
2017,1,27,22,1906,3977,1822,-2155
2017,1,27,23,1841,3893,1751,-2142
2017,1,28,0,1834,3935,1792,-2143
2017,1,28,1,1972,4153,2087,-2066
2017,1,28,2,2181,4408,2193,-2215
2017,1,28,3,2199,4397,2248,-2149
2017,1,28,4,2098,4302,2194,-2108
2017,1,28,5,2009,4187,2180,-2007
2017,1,28,6,1847,3983,1992,-1991
2017,1,28,7,2124,3840,2181,-1659
2017,1,28,8,1901,3631,1964,-1667
2017,1,28,9,1806,3480,1870,-1610
2017,1,28,10,1724,3415,1833,-1582
2017,1,28,11,1742,3316,1692,-1624
2017,1,28,12,1740,3348,1739,-1609
2017,1,28,13,1891,3408,1770,-1638
2017,1,28,14,1887,3560,1789,-1771
2017,1,28,15,1492,3722,1565,-2157
2017,1,28,16,1700,4049,1777,-2272
2017,1,28,17,1855,4231,1602,-2629
2017,1,28,18,1924,4326,1618,-2708
2017,1,28,19,1942,4298,1574,-2724
2017,1,28,20,1835,4217,1546,-2671
2017,1,28,21,1731,4107,1528,-2579
2017,1,28,22,1629,4003,1570,-2433
2017,1,28,23,1537,3830,1359,-2471
2017,1,29,0,1555,3834,1425,-2409
2017,1,29,1,1656,4042,1665,-2377
2017,1,29,2,1863,4307,1751,-2556
2017,1,29,3,1893,4345,1744,-2601
2017,1,29,4,1811,4269,1713,-2556
2017,1,29,5,1714,4155,1751,-2404
2017,1,29,6,1595,3883,1667,-2216
2017,1,29,7,2076,3700,1627,-2073
2017,1,29,8,1867,3495,1648,-1847
2017,1,29,9,1461,3340,1619,-1721
2017,1,29,10,1403,3268,1613,-1655
2017,1,29,11,1386,3231,1602,-1629
2017,1,29,12,1411,3214,1549,-1665
2017,1,29,13,1463,3294,1579,-1715
2017,1,29,14,1417,3437,1617,-1820
2017,1,29,15,1289,3638,1594,-2044
2017,1,29,16,1494,3865,1567,-2298
2017,1,29,17,1624,4034,1459,-2575
2017,1,29,18,1735,4118,1510,-2608
2017,1,29,19,1742,4125,1556,-2569
2017,1,29,20,1705,4103,1550,-2553
2017,1,29,21,1699,4095,1595,-2500
2017,1,29,22,1613,4075,1579,-2496
2017,1,29,23,1567,4034,1628,-2406
2017,1,30,0,1588,4016,1630,-2386
2017,1,30,1,1731,4133,1697,-2436
2017,1,30,2,1963,4337,1855,-2482
2017,1,30,3,1982,4335,1798,-2537
2017,1,30,4,1890,4220,1806,-2414
2017,1,30,5,1723,4079,1813,-2266
2017,1,30,6,1495,3827,1777,-2050
2017,1,30,7,1679,3517,1727,-1790
2017,1,30,8,1411,3291,1732,-1559
2017,1,30,9,1609,3134,1691,-1443
2017,1,30,10,1535,3076,1668,-1408
2017,1,30,11,1510,3045,1571,-1474
2017,1,30,12,1530,3056,1466,-1590
2017,1,30,13,1615,3234,1452,-1782
2017,1,30,14,1610,3592,1542,-2050
2017,1,30,15,1409,3963,1484,-2479
2017,1,30,16,1756,4275,1653,-2622
2017,1,30,17,1778,4212,1530,-2682
2017,1,30,18,1732,4174,1447,-2727
2017,1,30,19,1686,4183,1548,-2635
2017,1,30,20,1621,4194,1641,-2553
2017,1,30,21,1583,4157,1626,-2531
2017,1,30,22,1534,4130,1612,-2518
2017,1,30,23,1509,4119,1656,-2463
2017,1,31,0,1538,4167,1720,-2447
2017,1,31,1,1672,4326,1845,-2481
2017,1,31,2,1695,4570,1897,-2673
2017,1,31,3,1756,4588,1961,-2627
2017,1,31,4,1688,4487,1950,-2537
2017,1,31,5,1803,4340,1923,-2417
2017,1,31,6,1547,4028,1713,-2315
2017,1,31,7,1859,3732,1806,-1926
2017,1,31,8,1432,3445,1693,-1752
2017,1,31,9,1599,3344,1716,-1628
2017,1,31,10,1574,3292,1744,-1548
2017,1,31,11,1545,3309,1797,-1512
2017,1,31,12,1631,3396,1865,-1531
2017,1,31,13,1639,3601,1857,-1744
2017,1,31,14,1706,3969,1993,-1976
2017,1,31,15,1681,4359,1945,-2414
2017,1,31,16,1988,4616,1957,-2659
2017,1,31,17,1984,4574,1823,-2751
2017,1,31,18,1915,4487,1738,-2749
2017,1,31,19,1957,4463,1949,-2514
2017,1,31,20,1886,4342,1983,-2359
2017,1,31,21,1848,4190,1928,-2262
2017,1,31,22,1789,4094,1765,-2329
2017,1,31,23,1779,3992,1612,-2380
2017,2,1,0,1813,4071,1758,-2313
2017,2,1,1,1942,4351,2002,-2349
2017,2,1,2,2023,4730,2125,-2605
2017,2,1,3,2104,4830,2212,-2618
2017,2,1,4,2066,4804,2266,-2538
2017,2,1,5,1936,4718,2237,-2481
2017,2,1,6,1820,4463,2098,-2365
2017,2,1,7,1906,4156,2089,-2067
2017,2,1,8,1742,3884,2029,-1855
2017,2,1,9,1872,3747,1990,-1757
2017,2,1,10,1891,3713,1962,-1751
2017,2,1,11,1907,3737,1935,-1802
2017,2,1,12,1979,3812,1946,-1866
2017,2,1,13,2162,4065,2149,-1916
2017,2,1,14,2379,4456,2247,-2209
2017,2,1,15,2000,4855,2246,-2609
2017,2,1,16,2320,5141,2296,-2845
2017,2,1,17,2227,5042,2192,-2850
2017,2,1,18,2067,4903,2148,-2755
2017,2,1,19,2036,4735,2249,-2486
2017,2,1,20,1910,4583,2288,-2295
2017,2,1,21,1825,4468,2323,-2145
2017,2,1,22,1745,4355,2258,-2097
2017,2,1,23,1702,4310,2067,-2243
2017,2,2,0,1725,4397,2164,-2233
2017,2,2,1,1879,4583,2214,-2369
2017,2,2,2,2154,4953,2263,-2690
2017,2,2,3,2248,5052,2293,-2759
2017,2,2,4,2190,5006,2299,-2707
2017,2,2,5,2073,4886,2279,-2607
2017,2,2,6,1845,4625,2222,-2403
2017,2,2,7,2174,4300,2173,-2127
2017,2,2,8,1903,4012,2108,-1904
2017,2,2,9,2045,3889,2170,-1719
2017,2,2,10,2068,3846,2159,-1687
2017,2,2,11,2106,3836,2144,-1692
2017,2,2,12,2240,3917,2172,-1745
2017,2,2,13,2479,4101,2370,-1731
2017,2,2,14,2242,4517,2532,-1985
2017,2,2,15,2433,4963,2665,-2298
2017,2,2,16,2751,5202,2733,-2469
2017,2,2,17,2660,5099,2600,-2499
2017,2,2,18,2506,4921,2505,-2416
2017,2,2,19,2593,4771,2502,-2269
2017,2,2,20,2483,4611,2345,-2266
2017,2,2,21,2399,4470,2146,-2324
2017,2,2,22,2322,4413,2279,-2134
2017,2,2,23,2281,4349,2278,-2071
2017,2,3,0,2312,4392,2309,-2083
2017,2,3,1,2459,4573,2359,-2214
2017,2,3,2,2573,4917,2490,-2427
2017,2,3,3,2667,4987,2591,-2396
2017,2,3,4,2605,4956,2501,-2455
2017,2,3,5,2475,4782,2443,-2339
2017,2,3,6,2247,4504,2245,-2259
2017,2,3,7,2099,4178,2097,-2081
2017,2,3,8,1954,3855,2002,-1853
2017,2,3,9,2123,3719,2192,-1527
2017,2,3,10,2176,3614,2090,-1524
2017,2,3,11,2124,3584,2022,-1562
2017,2,3,12,2271,3658,2116,-1542
2017,2,3,13,2447,3902,2273,-1629
2017,2,3,14,2425,4237,2308,-1929
2017,2,3,15,2294,4653,2365,-2288
2017,2,3,16,2632,4926,2410,-2516
2017,2,3,17,2591,4890,2331,-2559
2017,2,3,18,2500,4839,2260,-2579
2017,2,3,19,2471,4783,2267,-2516
2017,2,3,20,2396,4706,2207,-2499
2017,2,3,21,2332,4688,2192,-2496
2017,2,3,22,2270,4675,2197,-2478
2017,2,3,23,2241,4669,2138,-2531
2017,2,4,0,2270,4715,2124,-2591
2017,2,4,1,2367,4790,2163,-2627
2017,2,4,2,2503,4917,2341,-2576
2017,2,4,3,2500,4867,2353,-2514
2017,2,4,4,2362,4720,2195,-2525
2017,2,4,5,2249,4579,2043,-2536
2017,2,4,6,2062,4355,1933,-2422
2017,2,4,7,2336,4098,2011,-2087
2017,2,4,8,2296,3843,2042,-1801
2017,2,4,9,1709,3654,1688,-1966
2017,2,4,10,1689,3550,1693,-1857
2017,2,4,11,1617,3497,1645,-1852
2017,2,4,12,1615,3488,1655,-1833
2017,2,4,13,1647,3520,1650,-1870
2017,2,4,14,1438,3643,1646,-1997
2017,2,4,15,1610,3776,1535,-2241
2017,2,4,16,1695,3964,1465,-2499
2017,2,4,17,1717,4168,1457,-2711
2017,2,4,18,1660,4274,1452,-2822
2017,2,4,19,1642,4375,1694,-2681
2017,2,4,20,1580,4290,1559,-2731
2017,2,4,21,1478,4246,1600,-2646
2017,2,4,22,1407,4218,1650,-2568
2017,2,4,23,1389,4206,1651,-2555
2017,2,5,0,1420,4237,1734,-2503
2017,2,5,1,1519,4332,1743,-2589
2017,2,5,2,1659,4458,1810,-2648
2017,2,5,3,1616,4453,1810,-2643
2017,2,5,4,1477,4332,1685,-2647
2017,2,5,5,1419,4252,1712,-2540
2017,2,5,6,1363,3915,1502,-2413
2017,2,5,7,1614,3684,1498,-2186
2017,2,5,8,1398,3481,1558,-1923
2017,2,5,9,1527,3334,1592,-1742
2017,2,5,10,1516,3313,1528,-1785
2017,2,5,11,1481,3319,1565,-1754
2017,2,5,12,1500,3373,1671,-1702
2017,2,5,13,1578,3447,1663,-1784
2017,2,5,14,1447,3545,1633,-1912
2017,2,5,15,878,3348,1177,-2171
2017,2,5,16,1287,3801,1354,-2447
2017,2,5,17,1395,4123,1561,-2562
2017,2,5,18,1621,4452,1788,-2664
2017,2,5,19,1766,4561,1831,-2730
2017,2,5,20,1875,4625,1924,-2701
2017,2,5,21,1951,4652,1929,-2723
2017,2,5,22,1947,4643,1983,-2660
2017,2,5,23,1941,4610,2087,-2523
2017,2,6,0,1898,4578,2088,-2490
2017,2,6,1,1939,4537,2039,-2498
2017,2,6,2,2113,4685,2103,-2582
2017,2,6,3,2109,4697,2124,-2573
2017,2,6,4,2027,4660,2134,-2526
2017,2,6,5,1923,4623,2000,-2623
2017,2,6,6,1692,4414,2033,-2381
2017,2,6,7,2326,4145,2087,-2058
2017,2,6,8,2032,3885,1998,-1887
2017,2,6,9,1798,3733,1774,-1959
2017,2,6,10,1674,3606,1690,-1916
2017,2,6,11,1760,3625,1760,-1865
2017,2,6,12,1841,3640,1731,-1909
2017,2,6,13,1857,3824,1823,-2001
2017,2,6,14,1772,4035,1804,-2231
2017,2,6,15,1833,4262,1707,-2555
2017,2,6,16,2007,4490,1795,-2695
2017,2,6,17,1961,4535,1858,-2677
2017,2,6,18,1857,4594,1888,-2706
2017,2,6,19,1858,4558,1883,-2675
2017,2,6,20,1757,4600,1908,-2692
2017,2,6,21,1691,4629,1953,-2676
2017,2,6,22,1702,4568,1898,-2670
2017,2,6,23,1714,4540,1992,-2548
2017,2,7,0,1725,4494,2007,-2487
2017,2,7,1,1716,4514,1987,-2527
2017,2,7,2,1886,4831,2177,-2654
2017,2,7,3,1988,4915,2209,-2706
2017,2,7,4,1911,4779,2176,-2603
2017,2,7,5,1773,4591,2110,-2481
2017,2,7,6,1656,4311,2057,-2254
2017,2,7,7,2191,4073,2142,-1931
2017,2,7,8,1949,3677,1871,-1806
2017,2,7,9,1631,3535,1772,-1763
2017,2,7,10,1839,3512,1756,-1756
2017,2,7,11,1753,3534,1764,-1770
2017,2,7,12,2012,3792,2041,-1751
2017,2,7,13,2051,3962,1988,-1974
2017,2,7,14,2077,4279,2105,-2174
2017,2,7,15,2129,4609,2226,-2383
2017,2,7,16,2294,4850,2253,-2597
2017,2,7,17,2224,4929,2351,-2578
2017,2,7,18,2295,4889,2315,-2574
2017,2,7,19,2292,4778,2205,-2573
2017,2,7,20,2167,4673,2124,-2549
2017,2,7,21,2145,4605,2210,-2395
2017,2,7,22,2074,4516,2154,-2362
2017,2,7,23,2038,4472,2087,-2385
2017,2,8,0,2031,4487,2086,-2401
2017,2,8,1,2084,4598,2164,-2434
2017,2,8,2,2071,4851,2199,-2652
2017,2,8,3,2197,4968,2327,-2641
2017,2,8,4,2129,4865,2345,-2520
2017,2,8,5,2219,4695,2259,-2436
2017,2,8,6,1990,4411,2124,-2287
2017,2,8,7,1996,4091,2130,-1961
2017,2,8,8,1854,3749,1981,-1768
2017,2,8,9,1955,3625,2071,-1554
2017,2,8,10,1889,3562,2036,-1526
2017,2,8,11,1889,3563,2020,-1543
2017,2,8,12,1949,3622,2058,-1564
2017,2,8,13,2036,3885,2087,-1798
2017,2,8,14,2082,4279,2267,-2012
2017,2,8,15,2166,4664,2395,-2269
2017,2,8,16,2265,4893,2449,-2444
2017,2,8,17,2302,4894,2453,-2441
2017,2,8,18,2269,4877,2420,-2457
2017,2,8,19,2141,4827,2461,-2366
2017,2,8,20,2025,4772,2224,-2548
2017,2,8,21,1964,4761,2210,-2551
2017,2,8,22,1919,4745,2120,-2625
2017,2,8,23,1894,4767,2204,-2563
2017,2,9,0,1937,4779,2193,-2586
2017,2,9,1,2050,4874,2308,-2566
2017,2,9,2,2318,5074,2389,-2685
2017,2,9,3,2417,5085,2387,-2698
2017,2,9,4,2331,4975,2285,-2690
2017,2,9,5,2190,4797,2156,-2641
2017,2,9,6,2034,4530,2094,-2436
2017,2,9,7,1898,4170,2135,-2035
2017,2,9,8,1786,3893,2035,-1858
2017,2,9,9,1958,3717,1932,-1785
2017,2,9,10,1856,3631,1853,-1778
2017,2,9,11,1663,3594,1742,-1852
2017,2,9,12,1767,3624,1729,-1895
2017,2,9,13,1815,3742,1752,-1990
2017,2,9,14,2005,4018,1991,-2027
2017,2,9,15,2244,4382,2201,-2181
2017,2,9,16,2423,4546,2215,-2331
2017,2,9,17,2359,4504,2051,-2453
2017,2,9,18,2259,4435,2032,-2403
2017,2,9,19,2266,4326,1828,-2498
2017,2,9,20,2050,4220,1847,-2373
2017,2,9,21,1869,4166,1838,-2328
2017,2,9,22,1760,4058,1899,-2159
2017,2,9,23,1706,4001,1917,-2084
2017,2,10,0,1727,4021,1875,-2146
2017,2,10,1,1876,4138,1959,-2179
2017,2,10,2,1977,4347,1885,-2462
2017,2,10,3,2094,4428,1965,-2463
2017,2,10,4,2003,4366,1972,-2394
2017,2,10,5,1892,4262,1837,-2425
2017,2,10,6,1676,4047,1782,-2265
2017,2,10,7,1705,3763,1768,-1995
2017,2,10,8,1468,3486,1710,-1776
2017,2,10,9,1910,3360,1748,-1612
2017,2,10,10,1734,3268,1728,-1540
2017,2,10,11,1820,3216,1716,-1500
2017,2,10,12,1891,3290,1841,-1449
2017,2,10,13,1882,3487,1874,-1613
2017,2,10,14,1970,3811,1811,-2000
2017,2,10,15,1736,4202,1794,-2408
2017,2,10,16,1968,4443,1859,-2584
2017,2,10,17,1927,4394,1832,-2562
2017,2,10,18,1853,4322,1847,-2475
2017,2,10,19,1834,4297,1873,-2424
2017,2,10,20,1824,4295,1776,-2519
2017,2,10,21,1789,4261,1699,-2562
2017,2,10,22,1778,4235,1777,-2458
2017,2,10,23,1761,4253,1879,-2374
2017,2,11,0,1782,4314,2010,-2304
2017,2,11,1,1879,4353,1977,-2376
2017,2,11,2,2055,4570,1969,-2601
2017,2,11,3,2086,4644,1951,-2693
2017,2,11,4,1941,4561,1928,-2633
2017,2,11,5,1791,4444,1886,-2558
2017,2,11,6,1618,4260,1769,-2491
2017,2,11,7,2122,4031,1818,-2213
2017,2,11,8,1887,3784,1736,-2048
2017,2,11,9,1803,3638,1862,-1776
2017,2,11,10,1825,3540,1860,-1680
2017,2,11,11,1809,3504,1883,-1621
2017,2,11,12,1805,3456,1715,-1741
2017,2,11,13,1890,3569,1786,-1783
2017,2,11,14,1881,3753,1868,-1885
2017,2,11,15,1573,3940,1772,-2168
2017,2,11,16,1595,4146,1703,-2443
2017,2,11,17,1750,4369,1831,-2538
2017,2,11,18,1844,4417,1928,-2489
2017,2,11,19,1816,4357,1867,-2490
2017,2,11,20,1749,4251,1938,-2313
2017,2,11,21,1681,3986,1734,-2252
2017,2,11,22,1650,3867,1640,-2227
2017,2,11,23,1663,3836,1700,-2136
2017,2,12,0,1713,3970,1813,-2157
2017,2,12,1,1843,4070,1893,-2177
2017,2,12,2,1963,4305,1976,-2329
2017,2,12,3,2078,4400,2003,-2397
2017,2,12,4,2045,4336,2083,-2253
2017,2,12,5,1962,4264,2124,-2140
2017,2,12,6,1830,4133,2004,-2129
2017,2,12,7,2371,3959,2068,-1891
2017,2,12,8,2170,3768,2022,-1746
2017,2,12,9,1795,3634,1818,-1816
2017,2,12,10,1742,3567,1792,-1775
2017,2,12,11,1767,3551,1810,-1741
2017,2,12,12,1717,3571,1746,-1825
2017,2,12,13,1932,3650,1794,-1856
2017,2,12,14,1906,3784,1858,-1926
2017,2,12,15,1715,3958,1788,-2170
2017,2,12,16,1910,4235,1861,-2374
2017,2,12,17,2062,4416,1779,-2637
2017,2,12,18,2097,4511,1799,-2712
2017,2,12,19,2072,4467,1779,-2688
2017,2,12,20,1997,4272,1648,-2624
2017,2,12,21,1930,4099,1592,-2507
2017,2,12,22,1847,3935,1495,-2440
2017,2,12,23,1772,3725,1381,-2344
2017,2,13,0,1714,3633,1351,-2282
2017,2,13,1,1769,3821,1738,-2083
2017,2,13,2,1995,4275,2099,-2176
2017,2,13,3,2107,4512,2249,-2263
2017,2,13,4,2112,4516,2262,-2254
2017,2,13,5,2066,4466,2121,-2345
2017,2,13,6,1889,4234,1996,-2238
2017,2,13,7,2246,3999,2073,-1926
2017,2,13,8,2006,3768,2028,-1740
2017,2,13,9,1911,3645,1912,-1733
2017,2,13,10,1891,3589,1872,-1717
2017,2,13,11,1945,3605,1863,-1742
2017,2,13,12,1904,3695,1861,-1834
2017,2,13,13,2196,3889,1847,-2042
2017,2,13,14,2439,4283,2054,-2229
2017,2,13,15,2228,4757,2266,-2491
2017,2,13,16,2493,4983,2333,-2650
2017,2,13,17,2370,4878,2188,-2690
2017,2,13,18,2188,4669,2043,-2626
2017,2,13,19,2244,4485,2124,-2361
2017,2,13,20,2107,4306,1905,-2401
2017,2,13,21,2013,4144,1711,-2433
2017,2,13,22,1915,3843,1498,-2345
2017,2,13,23,1831,3702,1360,-2342
2017,2,14,0,1827,3683,1388,-2295
2017,2,14,1,1921,3847,1661,-2186
2017,2,14,2,2037,4268,1843,-2425
2017,2,14,3,2208,4512,1934,-2578
2017,2,14,4,2155,4483,1843,-2640
2017,2,14,5,2022,4434,1824,-2610
2017,2,14,6,1801,4172,1700,-2472
2017,2,14,7,2024,3919,1790,-2129
2017,2,14,8,1962,3690,1780,-1910
2017,2,14,9,1718,3515,1731,-1784
2017,2,14,10,1555,3345,1558,-1787
2017,2,14,11,1741,3341,1591,-1750
2017,2,14,12,1747,3410,1615,-1795
2017,2,14,13,1850,3614,1728,-1886
2017,2,14,14,1867,3985,1876,-2109
2017,2,14,15,1955,4415,1938,-2477
2017,2,14,16,2216,4607,1928,-2679
2017,2,14,17,2093,4481,1909,-2572
2017,2,14,18,1940,4298,1770,-2528
2017,2,14,19,2005,4153,1696,-2457
2017,2,14,20,1888,3914,1495,-2419
2017,2,14,21,1802,3859,1662,-2197
2017,2,14,22,1712,3785,1687,-2098
2017,2,14,23,1654,3606,1542,-2064
2017,2,15,0,1646,3629,1564,-2065
2017,2,15,1,1771,3877,1726,-2151
2017,2,15,2,1833,4105,1828,-2277
2017,2,15,3,1994,4210,1808,-2402
2017,2,15,4,1938,4144,1790,-2354
2017,2,15,5,1812,4011,1727,-2284
2017,2,15,6,1563,3791,1497,-2294
2017,2,15,7,1686,3534,1533,-2001
2017,2,15,8,1603,3263,1518,-1745
2017,2,15,9,1257,3117,1443,-1674
2017,2,15,10,1222,3034,1427,-1607
2017,2,15,11,1236,2999,1416,-1583
2017,2,15,12,1221,3029,1407,-1622
2017,2,15,13,1435,3171,1408,-1763
2017,2,15,14,1521,3471,1522,-1949
2017,2,15,15,1339,3846,1539,-2307
2017,2,15,16,1604,4045,1565,-2480
2017,2,15,17,1550,3991,1422,-2569
2017,2,15,18,1327,3919,1311,-2608
2017,2,15,19,1431,3847,1350,-2497
2017,2,15,20,1395,3818,1341,-2477
2017,2,15,21,1354,3849,1295,-2554
2017,2,15,22,1327,3864,1384,-2480
2017,2,15,23,1315,3843,1345,-2498
2017,2,16,0,1307,3913,1462,-2451
2017,2,16,1,1368,4031,1527,-2504
2017,2,16,2,1610,4204,1602,-2602
2017,2,16,3,1715,4195,1568,-2627
2017,2,16,4,1601,4094,1579,-2515
2017,2,16,5,1456,3957,1565,-2392
2017,2,16,6,1232,3696,1416,-2280
2017,2,16,7,1430,3401,1484,-1917
2017,2,16,8,1314,2939,1244,-1695
2017,2,16,9,1439,2955,1389,-1566
2017,2,16,10,1451,2889,1435,-1454
2017,2,16,11,1401,2831,1419,-1412
2017,2,16,12,1346,2847,1396,-1451
2017,2,16,13,1486,3004,1441,-1563
2017,2,16,14,1525,3343,1661,-1682
2017,2,16,15,1446,3719,1729,-1990
2017,2,16,16,1761,3907,1681,-2226
2017,2,16,17,1569,3831,1409,-2422
2017,2,16,18,1518,3778,1406,-2372
2017,2,16,19,1534,3796,1544,-2252
2017,2,16,20,1478,3748,1572,-2176
2017,2,16,21,1427,3712,1626,-2086
2017,2,16,22,1342,3659,1596,-2063
2017,2,16,23,1262,3595,1552,-2043
2017,2,17,0,1217,3564,1423,-2141
2017,2,17,1,1200,3697,1510,-2187
2017,2,17,2,1408,3957,1727,-2230
2017,2,17,3,1519,4119,1952,-2167
2017,2,17,4,1447,4084,1791,-2293
2017,2,17,5,1318,4003,1823,-2180
2017,2,17,6,1275,3679,1597,-2082
2017,2,17,7,1276,3390,1582,-1808
2017,2,17,8,1271,3065,1557,-1508
2017,2,17,9,1416,2887,1524,-1363
2017,2,17,10,1386,2752,1450,-1302
2017,2,17,11,1370,2746,1461,-1285
2017,2,17,12,1391,2855,1533,-1322
2017,2,17,13,1611,3241,1661,-1580
2017,2,17,14,1566,3665,1732,-1933
2017,2,17,15,1470,4060,1595,-2465
2017,2,17,16,1836,4270,1555,-2715
2017,2,17,17,1852,4263,1611,-2652
2017,2,17,18,1810,4137,1579,-2558
2017,2,17,19,1792,4049,1617,-2432
2017,2,17,20,1697,3895,1481,-2414
2017,2,17,21,1612,3788,1475,-2313
2017,2,17,22,1538,3640,1437,-2203
2017,2,17,23,1470,3560,1434,-2126
2017,2,18,0,1457,3557,1458,-2099
2017,2,18,1,1453,3643,1485,-2158
2017,2,18,2,1677,3995,1672,-2323
2017,2,18,3,1802,4179,1703,-2476
2017,2,18,4,1774,4135,1743,-2392
2017,2,18,5,1686,4046,1684,-2362
2017,2,18,6,1560,3870,1594,-2276
2017,2,18,7,1776,3689,1664,-2025
2017,2,18,8,1760,3484,1645,-1839
2017,2,18,9,1675,3322,1658,-1664
2017,2,18,10,1627,3241,1734,-1507
2017,2,18,11,1633,3203,1709,-1494
2017,2,18,12,1579,3215,1680,-1535
2017,2,18,13,1681,3272,1699,-1573
2017,2,18,14,1686,3406,1734,-1672
2017,2,18,15,1288,3586,1766,-1820
2017,2,18,16,1552,3820,1791,-2029
2017,2,18,17,1736,4017,1743,-2274
2017,2,18,18,1814,4130,1807,-2323
2017,2,18,19,1803,4152,1755,-2397
2017,2,18,20,1767,4122,1754,-2368
2017,2,18,21,1694,4061,1711,-2350
2017,2,18,22,1620,4019,1692,-2327
2017,2,18,23,1566,3979,1624,-2355
2017,2,19,0,1531,3946,1558,-2388
2017,2,19,1,1557,4044,1720,-2324
2017,2,19,2,1724,4192,1789,-2403
2017,2,19,3,1829,4207,1850,-2357
2017,2,19,4,1796,4134,1803,-2331
2017,2,19,5,1698,4010,1772,-2238
2017,2,19,6,1570,3870,1769,-2101
2017,2,19,7,1867,3680,1751,-1929
2017,2,19,8,1818,3441,1673,-1768
2017,2,19,9,1700,3311,1655,-1656
2017,2,19,10,1639,3246,1674,-1572
2017,2,19,11,1613,3200,1642,-1558
2017,2,19,12,1618,3211,1666,-1545
2017,2,19,13,1633,3263,1655,-1608
2017,2,19,14,1578,3378,1617,-1761
2017,2,19,15,1230,3575,1638,-1937
2017,2,19,16,1518,3772,1603,-2169
2017,2,19,17,1599,3922,1506,-2416
2017,2,19,18,1708,3954,1416,-2538
2017,2,19,19,1699,3978,1471,-2507
2017,2,19,20,1596,3948,1427,-2521
2017,2,19,21,1634,3903,1394,-2509
2017,2,19,22,1550,3779,1411,-2368
2017,2,19,23,1485,3677,1328,-2349
2017,2,20,0,1498,3724,1384,-2340
2017,2,20,1,1568,4001,1677,-2324
2017,2,20,2,1766,4238,1821,-2417
2017,2,20,3,1899,4316,1858,-2458
2017,2,20,4,1775,4239,1862,-2377
2017,2,20,5,1825,4154,1900,-2254
2017,2,20,6,1641,3953,1803,-2150
2017,2,20,7,1868,3703,1764,-1939
2017,2,20,8,1762,3444,1547,-1897
2017,2,20,9,1623,3359,1669,-1690
2017,2,20,10,1656,3292,1641,-1651
2017,2,20,11,1662,3281,1655,-1626
2017,2,20,12,1631,3334,1676,-1658
2017,2,20,13,1640,3463,1669,-1794
2017,2,20,14,1768,3681,1635,-2046
2017,2,20,15,1461,3942,1651,-2291
2017,2,20,16,1765,4127,1707,-2420
2017,2,20,17,1895,4240,1872,-2368
2017,2,20,18,1950,4333,1916,-2417
2017,2,20,19,2076,4353,1941,-2412
2017,2,20,20,1928,4323,1840,-2483
2017,2,20,21,1766,4306,1775,-2531
2017,2,20,22,1617,4220,1557,-2663
2017,2,20,23,1500,4165,1527,-2638
2017,2,21,0,1443,4091,1580,-2511
2017,2,21,1,1478,4207,1798,-2409
2017,2,21,2,1497,4443,1893,-2550
2017,2,21,3,1721,4520,1863,-2657
2017,2,21,4,1703,4408,1757,-2651
2017,2,21,5,1665,4270,1719,-2551
2017,2,21,6,1563,4022,1636,-2386
2017,2,21,7,1909,3757,1766,-1991
2017,2,21,8,1740,3477,1624,-1853
2017,2,21,9,1734,3396,1752,-1644
2017,2,21,10,1707,3315,1752,-1563
2017,2,21,11,1685,3271,1738,-1533
2017,2,21,12,1816,3326,1776,-1550
2017,2,21,13,1910,3495,1857,-1638
2017,2,21,14,1959,3806,1907,-1899
2017,2,21,15,1789,4162,1865,-2297
2017,2,21,16,2090,4366,1999,-2367
2017,2,21,17,2069,4360,1919,-2441
2017,2,21,18,1986,4348,1886,-2462
2017,2,21,19,2103,4328,1932,-2396
2017,2,21,20,1972,4311,1865,-2446
2017,2,21,21,1842,4229,1834,-2395
2017,2,21,22,1699,4146,1802,-2344
2017,2,21,23,1578,4043,1789,-2254
2017,2,22,0,1520,3988,1705,-2283
2017,2,22,1,1546,4116,1821,-2295
2017,2,22,2,1637,4378,1862,-2516
2017,2,22,3,1850,4559,1838,-2721
2017,2,22,4,1809,4509,1730,-2779
2017,2,22,5,1674,4377,1820,-2557
2017,2,22,6,1504,4150,1850,-2300
2017,2,22,7,1664,3855,1806,-2049
2017,2,22,8,1415,3414,1489,-1925
2017,2,22,9,1516,3265,1463,-1802
2017,2,22,10,1502,3239,1555,-1684
2017,2,22,11,1522,3280,1659,-1621
2017,2,22,12,1589,3413,1653,-1760
2017,2,22,13,1671,3667,1790,-1877
2017,2,22,14,1676,4016,1796,-2220
2017,2,22,15,1619,4435,1771,-2664
2017,2,22,16,1734,4606,1701,-2905
2017,2,22,17,1870,4562,1615,-2947
2017,2,22,18,1773,4408,1474,-2934
2017,2,22,19,1693,4268,1357,-2911
2017,2,22,20,1627,4224,1383,-2841
2017,2,22,21,1593,4137,1392,-2745
2017,2,22,22,1577,4039,1425,-2614
2017,2,22,23,1576,3975,1456,-2519
2017,2,23,0,1613,4002,1505,-2497
2017,2,23,1,1729,4114,1595,-2519
2017,2,23,2,1651,4377,1666,-2711
2017,2,23,3,1858,4631,1808,-2823
2017,2,23,4,1834,4628,1793,-2835
2017,2,23,5,1709,4533,1728,-2805
2017,2,23,6,1490,4325,1674,-2651
2017,2,23,7,1949,4041,1674,-2367
2017,2,23,8,1581,3776,1583,-2193
2017,2,23,9,1502,3658,1586,-2072
2017,2,23,10,1530,3596,1592,-2004
2017,2,23,11,1630,3539,1545,-1994
2017,2,23,12,1765,3609,1606,-2003
2017,2,23,13,1617,3817,1777,-2040
2017,2,23,14,1909,4157,1887,-2270
2017,2,23,15,1810,4531,1865,-2666
2017,2,23,16,2061,4706,1843,-2863
2017,2,23,17,1960,4693,1842,-2851
2017,2,23,18,1810,4456,1623,-2833
2017,2,23,19,1704,4340,1500,-2840
2017,2,23,20,1641,4226,1473,-2753
2017,2,23,21,1508,4069,1412,-2657
2017,2,23,22,1446,3986,1387,-2599
2017,2,23,23,1444,3941,1429,-2512
2017,2,24,0,1436,3964,1456,-2508
2017,2,24,1,1515,4188,1555,-2633
2017,2,24,2,1742,4462,1759,-2703
2017,2,24,3,1949,4722,1902,-2820
2017,2,24,4,1938,4704,1960,-2744
2017,2,24,5,1850,4628,1872,-2756
2017,2,24,6,1627,4381,1773,-2608
2017,2,24,7,2026,4089,1916,-2173
2017,2,24,8,1778,3823,1847,-1976
2017,2,24,9,1648,3608,1742,-1866
2017,2,24,10,1515,3460,1622,-1838
2017,2,24,11,1434,3472,1619,-1853
2017,2,24,12,1489,3545,1611,-1934
2017,2,24,13,1578,3863,1734,-2129
2017,2,24,14,1811,4193,1775,-2418
2017,2,24,15,1701,4569,1690,-2879
2017,2,24,16,1812,4775,1743,-3032
2017,2,24,17,1946,4711,1608,-3103
2017,2,24,18,1820,4657,1741,-2916
2017,2,24,19,1698,4539,1663,-2876
2017,2,24,20,1579,4413,1675,-2738
2017,2,24,21,1505,4290,1580,-2710
2017,2,24,22,1438,4035,1459,-2576
2017,2,24,23,1379,3943,1406,-2537
2017,2,25,0,1389,3916,1404,-2512
2017,2,25,1,1447,3986,1476,-2510
2017,2,25,2,1672,4261,1691,-2570
2017,2,25,3,1855,4485,1738,-2747
2017,2,25,4,1818,4500,1785,-2715
2017,2,25,5,1722,4421,1735,-2686
2017,2,25,6,1562,4256,1722,-2534
2017,2,25,7,1726,4033,1759,-2274
2017,2,25,8,1511,3721,1614,-2107
2017,2,25,9,1410,3568,1577,-1991
2017,2,25,10,1421,3500,1589,-1911
2017,2,25,11,1501,3506,1600,-1906
2017,2,25,12,1541,3546,1595,-1951
2017,2,25,13,1559,3653,1611,-2042
2017,2,25,14,1734,3861,1723,-2138
2017,2,25,15,1543,4084,1647,-2437
2017,2,25,16,1666,4313,1643,-2670
2017,2,25,17,1808,4489,1726,-2763
2017,2,25,18,1810,4502,1725,-2777
2017,2,25,19,1674,4362,1583,-2779
2017,2,25,20,1542,4249,1600,-2649
2017,2,25,21,1310,4003,1370,-2633
2017,2,25,22,1259,3744,1090,-2654
2017,2,25,23,1250,3592,1010,-2582
2017,2,26,0,1243,3659,1201,-2458
2017,2,26,1,1232,3834,1399,-2435
2017,2,26,2,1351,4165,1661,-2504
2017,2,26,3,1530,4385,1809,-2576
2017,2,26,4,1464,4220,1692,-2528
2017,2,26,5,1344,4132,1655,-2477
2017,2,26,6,1326,3962,1619,-2343
2017,2,26,7,1499,3760,1565,-2195
2017,2,26,8,1299,3548,1366,-2182
2017,2,26,9,1215,3414,1329,-2085
2017,2,26,10,1172,3291,1245,-2046
2017,2,26,11,1172,3266,1243,-2023
2017,2,26,12,1256,3345,1282,-2063
2017,2,26,13,1400,3554,1458,-2096
2017,2,26,14,1421,3687,1467,-2220
2017,2,26,15,1090,3870,1411,-2459
2017,2,26,16,1318,4098,1468,-2630
2017,2,26,17,1546,4293,1412,-2881
2017,2,26,18,1688,4363,1347,-3016
2017,2,26,19,1706,4405,1399,-3006
2017,2,26,20,1684,4416,1424,-2992
2017,2,26,21,1662,4334,1372,-2962
2017,2,26,22,1633,4286,1439,-2847
2017,2,26,23,1594,4229,1467,-2762
2017,2,27,0,1566,4224,1504,-2720
2017,2,27,1,1600,4290,1532,-2758
2017,2,27,2,1768,4466,1687,-2779
2017,2,27,3,1943,4624,1850,-2774
2017,2,27,4,1920,4578,1840,-2738
2017,2,27,5,1848,4468,1784,-2684
2017,2,27,6,1658,4258,1774,-2484
2017,2,27,7,2160,3959,1835,-2124
2017,2,27,8,1951,3703,1744,-1959
2017,2,27,9,1590,3573,1685,-1888
2017,2,27,10,1550,3526,1641,-1885
2017,2,27,11,1542,3531,1638,-1893
2017,2,27,12,1673,3609,1674,-1935
2017,2,27,13,1828,3805,1802,-2003
2017,2,27,14,2237,4157,1882,-2275
2017,2,27,15,1843,4600,1954,-2646
2017,2,27,16,2082,4794,2123,-2671
2017,2,27,17,1958,4806,2014,-2792
2017,2,27,18,1790,4759,2001,-2758
2017,2,27,19,1741,4720,1947,-2773
2017,2,27,20,1618,4659,1722,-2937
2017,2,27,21,1552,4634,1694,-2940
2017,2,27,22,1519,4548,1663,-2885
2017,2,27,23,1518,4510,1637,-2873
2017,2,28,0,1584,4561,1704,-2857
2017,2,28,1,1689,4676,1747,-2929
2017,2,28,2,1830,4837,1869,-2968
2017,2,28,3,2046,4943,1811,-3132
2017,2,28,4,1961,4875,1742,-3133
2017,2,28,5,1754,4763,1817,-2946
2017,2,28,6,1493,4486,1747,-2739
2017,2,28,7,1680,4165,1840,-2325
2017,2,28,8,1394,3892,1767,-2125
2017,2,28,9,1706,3729,1823,-1906
2017,2,28,10,1786,3673,1854,-1819
2017,2,28,11,1826,3666,1824,-1842
2017,2,28,12,1778,3732,1758,-1974
2017,2,28,13,1857,3921,1824,-2097
2017,2,28,14,2132,4277,1934,-2343
2017,2,28,15,1941,4680,2009,-2671
2017,2,28,16,1993,4869,2290,-2579
2017,2,28,17,1953,4857,2302,-2555
2017,2,28,18,1943,4688,1827,-2861
2017,2,28,19,2067,4529,1621,-2908
2017,2,28,20,1955,4344,1531,-2813
2017,2,28,21,1887,4137,1457,-2680
2017,2,28,22,1834,4034,1449,-2585
2017,2,28,23,1813,4004,1625,-2379
2017,3,1,0,1850,3979,1533,-2446
2017,3,1,1,1929,4272,1805,-2467
2017,3,1,2,2055,4544,2089,-2455
2017,3,1,3,2265,4686,2120,-2566
2017,3,1,4,2166,4667,2041,-2626
2017,3,1,5,1975,4546,1932,-2614
2017,3,1,6,1665,4279,1787,-2492
2017,3,1,7,1972,3975,1775,-2200
2017,3,1,8,1780,3683,1658,-2025
2017,3,1,9,1591,3489,1554,-1935
2017,3,1,10,1488,3303,1386,-1917
2017,3,1,11,1472,3342,1536,-1806
2017,3,1,12,1469,3405,1577,-1828
2017,3,1,13,1716,3671,1825,-1846
2017,3,1,14,1814,4006,1895,-2111
2017,3,1,15,1699,4337,1811,-2526
2017,3,1,16,1819,4555,1723,-2832
2017,3,1,17,1763,4503,1608,-2895
2017,3,1,18,1573,4317,1486,-2831
2017,3,1,19,1664,4199,1407,-2792
2017,3,1,20,1581,4039,1316,-2723
2017,3,1,21,1574,3822,1271,-2551
2017,3,1,22,1575,3752,1192,-2560
2017,3,1,23,1573,3720,1224,-2496
2017,3,2,0,1571,3696,1246,-2450
2017,3,2,1,1601,3842,1312,-2530
2017,3,2,2,1819,4345,1728,-2617
2017,3,2,3,2020,4539,1791,-2748
2017,3,2,4,1984,4495,1723,-2772
2017,3,2,5,1883,4369,1675,-2694
2017,3,2,6,1715,4067,1649,-2418
2017,3,2,7,1932,3868,1781,-2087
2017,3,2,8,1904,3510,1628,-1882
2017,3,2,9,1486,3289,1440,-1849
2017,3,2,10,1453,3239,1367,-1872
2017,3,2,11,1409,3282,1424,-1858
2017,3,2,12,1403,3385,1480,-1905
2017,3,2,13,1487,3548,1503,-2045
2017,3,2,14,1533,3894,1614,-2280
2017,3,2,15,1679,4292,1587,-2705
2017,3,2,16,1737,4469,1554,-2915
2017,3,2,17,1592,4405,1419,-2986
2017,3,2,18,1601,4266,1283,-2983
2017,3,2,19,1619,4161,1250,-2911
2017,3,2,20,1607,3867,1082,-2785
2017,3,2,21,1578,3812,1083,-2729
2017,3,2,22,1522,3778,1043,-2735
2017,3,2,23,1480,3783,1044,-2739
2017,3,3,0,1471,3850,1108,-2742
2017,3,3,1,1529,4101,1292,-2809
2017,3,3,2,1536,4488,1558,-2930
2017,3,3,3,1662,4594,1537,-3057
2017,3,3,4,1551,4560,1556,-3004
2017,3,3,5,1448,4430,1528,-2902
2017,3,3,6,1315,4164,1406,-2758
2017,3,3,7,1536,3836,1379,-2457
2017,3,3,8,1503,3523,1390,-2133
2017,3,3,9,1278,3352,1408,-1944
2017,3,3,10,1283,3287,1509,-1778
2017,3,3,11,1385,3239,1524,-1715
2017,3,3,12,1386,3272,1556,-1716
2017,3,3,13,1557,3415,1556,-1859
2017,3,3,14,1688,3696,1591,-2105
2017,3,3,15,1397,4069,1547,-2522
2017,3,3,16,1521,4246,1532,-2714
2017,3,3,17,1539,4154,1354,-2800
2017,3,3,18,1619,4146,1575,-2571
2017,3,3,19,1681,4112,1624,-2488
2017,3,3,20,1591,4071,1577,-2494
2017,3,3,21,1547,4025,1569,-2456
2017,3,3,22,1530,3990,1576,-2414
2017,3,3,23,1504,3954,1547,-2407
2017,3,4,0,1529,3965,1546,-2419
2017,3,4,1,1596,4173,1696,-2477
2017,3,4,2,1559,4285,1775,-2510
2017,3,4,3,1819,4345,1797,-2548
2017,3,4,4,1696,4266,1749,-2517
2017,3,4,5,1556,4163,1742,-2421
2017,3,4,6,1447,3728,1433,-2295
2017,3,4,7,1798,3607,1608,-1999
2017,3,4,8,1639,3407,1638,-1769
2017,3,4,9,1353,3261,1562,-1699
2017,3,4,10,1356,3205,1531,-1674
2017,3,4,11,1314,3195,1511,-1684
2017,3,4,12,1223,3221,1446,-1775
2017,3,4,13,1382,3445,1580,-1865
2017,3,4,14,1461,3560,1383,-2177
2017,3,4,15,1362,3781,1261,-2520
2017,3,4,16,1414,4013,1180,-2833
2017,3,4,17,1596,4260,1560,-2700
2017,3,4,18,1467,4215,1304,-2911
2017,3,4,19,1448,4069,1181,-2888
2017,3,4,20,1421,3923,1200,-2723
2017,3,4,21,1525,3767,1076,-2691
2017,3,4,22,1443,3701,1105,-2596
2017,3,4,23,1392,3680,1114,-2566
2017,3,5,0,1405,3783,1230,-2553
2017,3,5,1,1480,4042,1413,-2629
2017,3,5,2,1547,4198,1460,-2738
2017,3,5,3,1703,4333,1458,-2875
2017,3,5,4,1642,4296,1474,-2822
2017,3,5,5,1516,4212,1516,-2696
2017,3,5,6,1409,4058,1522,-2536
2017,3,5,7,1858,3844,1540,-2304
2017,3,5,8,1980,3641,1526,-2115
2017,3,5,9,1409,3491,1519,-1972
2017,3,5,10,1397,3404,1501,-1903
2017,3,5,11,1281,3399,1483,-1916
2017,3,5,12,1184,3426,1435,-1991
2017,3,5,13,1379,3453,1359,-2094
2017,3,5,14,1388,3561,1303,-2258
2017,3,5,15,1580,3482,1087,-2395
2017,3,5,16,1566,3865,1315,-2550
2017,3,5,17,1474,4153,1457,-2696
2017,3,5,18,1393,4180,1457,-2723
2017,3,5,19,1406,4167,1432,-2735
2017,3,5,20,1408,4179,1399,-2780
2017,3,5,21,1427,4107,1239,-2868
2017,3,5,22,1413,4056,1305,-2751
2017,3,5,23,1394,4007,1382,-2625
2017,3,6,0,1444,4102,1535,-2567
2017,3,6,1,1606,4252,1648,-2604
2017,3,6,2,1800,4427,1714,-2713
2017,3,6,3,1978,4591,1800,-2791
2017,3,6,4,1948,4546,1806,-2740
2017,3,6,5,1816,4432,1826,-2606
2017,3,6,6,1554,4163,1613,-2550
2017,3,6,7,1556,3950,1674,-2276
2017,3,6,8,1402,3699,1625,-2074
2017,3,6,9,1464,3559,1601,-1958
2017,3,6,10,1312,3334,1373,-1961
2017,3,6,11,1316,3362,1441,-1921
2017,3,6,12,1365,3470,1488,-1982
2017,3,6,13,1467,3729,1562,-2167
2017,3,6,14,1613,4165,1634,-2531
2017,3,6,15,1544,4602,1612,-2990
2017,3,6,16,1638,4809,1653,-3156
2017,3,6,17,1576,4767,1527,-3240
2017,3,6,18,1565,4637,1519,-3118
2017,3,6,19,1564,4572,1551,-3021
2017,3,6,20,1520,4469,1453,-3016
2017,3,6,21,1462,4372,1397,-2975
2017,3,6,22,1398,4244,1451,-2793
2017,3,6,23,1348,4096,1382,-2714
2017,3,7,0,1358,4162,1430,-2732
2017,3,7,1,1457,4301,1378,-2923
2017,3,7,2,1587,4574,1520,-3054
2017,3,7,3,1780,4785,1620,-3165
2017,3,7,4,1765,4856,1816,-3040
2017,3,7,5,1613,4684,1823,-2861
2017,3,7,6,1404,4433,1757,-2676
2017,3,7,7,1523,4098,1720,-2378
2017,3,7,8,1455,3815,1684,-2131
2017,3,7,9,1348,3538,1503,-2035
2017,3,7,10,1331,3464,1414,-2050
2017,3,7,11,1297,3506,1377,-2129
2017,3,7,12,1462,3582,1456,-2126
2017,3,7,13,1446,3825,1515,-2310
2017,3,7,14,1443,4162,1513,-2649
2017,3,7,15,1453,4521,1312,-3209
2017,3,7,16,1275,4782,1359,-3423
2017,3,7,17,1281,4745,1387,-3358
2017,3,7,18,1152,4560,1262,-3298
2017,3,7,19,1514,4640,1387,-3253
2017,3,7,20,1391,4586,1408,-3178
2017,3,7,21,1301,4553,1372,-3181
2017,3,7,22,1244,4511,1367,-3144
2017,3,7,23,1215,4486,1363,-3123
2017,3,8,0,1225,4520,1380,-3140
2017,3,8,1,1308,4581,1418,-3163
2017,3,8,2,1293,4687,1461,-3226
2017,3,8,3,1401,4806,1463,-3343
2017,3,8,4,1285,4772,1507,-3265
2017,3,8,5,1225,4595,1456,-3139
2017,3,8,6,989,4154,1386,-2768
2017,3,8,7,1305,3765,1314,-2451
2017,3,8,8,1353,3481,1375,-2106
2017,3,8,9,1342,3304,1416,-1888
2017,3,8,10,1086,3099,1281,-1818
2017,3,8,11,1174,3112,1309,-1803
2017,3,8,12,1207,3357,1523,-1834
2017,3,8,13,1361,3743,1702,-2041
2017,3,8,14,1700,4088,1721,-2367
2017,3,8,15,1508,4479,1705,-2774
2017,3,8,16,1566,4671,1673,-2998
2017,3,8,17,1514,4612,1668,-2944
2017,3,8,18,1389,4383,1526,-2857
2017,3,8,19,1370,4311,1525,-2786
2017,3,8,20,1300,4255,1541,-2714
2017,3,8,21,1273,4199,1499,-2700
2017,3,8,22,1273,4218,1580,-2638
2017,3,8,23,1337,4249,1632,-2617
2017,3,9,0,1446,4297,1599,-2698
2017,3,9,1,1636,4472,1643,-2829
2017,3,9,2,1524,4634,1596,-3038
2017,3,9,3,1735,4783,1626,-3157
2017,3,9,4,1754,4276,1226,-3050
2017,3,9,5,1794,4109,1534,-2575
2017,3,9,6,1798,3761,1278,-2483
2017,3,9,7,1726,3463,1243,-2220
2017,3,9,8,1832,3190,1201,-1989
2017,3,9,9,1162,3003,1010,-1993
2017,3,9,10,1181,2904,987,-1917
2017,3,9,11,1191,2881,996,-1885
2017,3,9,12,1252,2939,1138,-1801
2017,3,9,13,1359,3109,1210,-1899
2017,3,9,14,1510,3442,1289,-2153
2017,3,9,15,1221,3741,1236,-2505
2017,3,9,16,1261,3914,1189,-2725
2017,3,9,17,1191,3892,1090,-2802
2017,3,9,18,1238,3841,1049,-2792
2017,3,9,19,1413,3800,1138,-2662
2017,3,9,20,1307,3742,1036,-2706
2017,3,9,21,1243,3698,1073,-2625
2017,3,9,22,1230,3692,1077,-2615
2017,3,9,23,1212,3682,1097,-2585
2017,3,10,0,1218,3721,1116,-2605
2017,3,10,1,1236,3789,1257,-2532
2017,3,10,2,1258,3908,1356,-2552
2017,3,10,3,1301,4221,1508,-2713
2017,3,10,4,1271,4169,1461,-2708
2017,3,10,5,1283,4007,1450,-2557
2017,3,10,6,1129,3773,1226,-2547
2017,3,10,7,1646,3470,1216,-2254
2017,3,10,8,1371,3164,1222,-1942
2017,3,10,9,1074,2956,1149,-1807
2017,3,10,10,847,2815,1107,-1708
2017,3,10,11,760,2700,1048,-1652
2017,3,10,12,772,2741,1081,-1660
2017,3,10,13,951,2937,1144,-1793
2017,3,10,14,1293,3325,1290,-2035
2017,3,10,15,1036,3699,1352,-2347
2017,3,10,16,951,3855,1295,-2560
2017,3,10,17,961,3854,1320,-2534
2017,3,10,18,969,3671,1181,-2490
2017,3,10,19,970,3620,1197,-2423
2017,3,10,20,1022,3558,1213,-2345
2017,3,10,21,1024,3455,1123,-2332
2017,3,10,22,1107,3359,1089,-2270
2017,3,10,23,859,3295,1032,-2263
2017,3,11,0,1269,3283,1017,-2266
2017,3,11,1,1046,3315,985,-2330
2017,3,11,2,1275,3508,1167,-2341
2017,3,11,3,1280,3808,1338,-2470
2017,3,11,4,1288,3767,1265,-2502
2017,3,11,5,1276,3698,1240,-2458
2017,3,11,6,1234,3470,1167,-2303
2017,3,11,7,1258,3477,1381,-2096
2017,3,11,8,1202,3257,1386,-1871
2017,3,11,9,1206,3124,1379,-1745
2017,3,11,10,1254,3069,1301,-1768
2017,3,11,11,1133,3025,1223,-1802
2017,3,11,12,1158,3037,1205,-1832
2017,3,11,13,1180,3095,1201,-1894
2017,3,11,14,1258,3226,1145,-2081
2017,3,11,15,1035,3426,1077,-2349
2017,3,11,16,1272,3690,1160,-2530
2017,3,11,17,1420,3909,1179,-2730
2017,3,11,18,1471,4018,1133,-2885
2017,3,11,19,1459,4042,1146,-2896
2017,3,11,20,1390,4017,1136,-2881
2017,3,11,21,1282,3899,1048,-2851
2017,3,11,22,1154,3709,990,-2719
2017,3,11,23,1014,3629,1096,-2533
2017,3,12,0,892,3500,1096,-2404
2017,3,12,1,896,3433,926,-2507
2017,3,12,2,970,3722,1228,-2494
2017,3,12,3,1059,3934,1462,-2472
2017,3,12,4,1012,3934,1551,-2383
2017,3,12,5,983,3757,1346,-2411
2017,3,12,6,1013,3420,1298,-2122
2017,3,12,7,1189,3214,1303,-1911
2017,3,12,8,1076,2991,1201,-1790
2017,3,12,9,1165,2843,1207,-1636
2017,3,12,10,1049,2724,1087,-1637
2017,3,12,11,1049,2660,1072,-1588
2017,3,12,12,1051,2688,1186,-1502
2017,3,12,13,742,2756,1109,-1647
2017,3,12,14,902,2892,1067,-1825
2017,3,12,15,1145,3094,1110,-1984
2017,3,12,16,1171,3236,1053,-2183
2017,3,12,17,1235,3298,950,-2348
2017,3,12,18,1262,3373,1012,-2361
2017,3,12,19,1292,3482,1162,-2320
2017,3,12,20,1299,3548,1032,-2516
2017,3,12,21,1278,3480,980,-2500
2017,3,12,22,1281,3463,1100,-2363
2017,3,12,23,1324,3429,1074,-2355
2017,3,13,0,1376,3458,1058,-2400
2017,3,13,1,1476,3709,1281,-2428
2017,3,13,2,1628,3965,1519,-2446
2017,3,13,3,1695,4115,1547,-2568
2017,3,13,4,1516,4091,1532,-2559
2017,3,13,5,1609,3922,1550,-2372
2017,3,13,6,1324,3645,1510,-2135
2017,3,13,7,1100,3357,1443,-1914
2017,3,13,8,1087,3034,1311,-1723
2017,3,13,9,1121,2787,1161,-1626
2017,3,13,10,1151,2750,1158,-1592
2017,3,13,11,1138,2788,1170,-1618
2017,3,13,12,1258,3044,1285,-1759
2017,3,13,13,1199,3445,1384,-2061
2017,3,13,14,1074,3800,1234,-2566
2017,3,13,15,1347,4096,1374,-2722
2017,3,13,16,1411,4082,1280,-2802
2017,3,13,17,1330,3998,1125,-2873
2017,3,13,18,1281,4058,1327,-2731
2017,3,13,19,1223,4044,1385,-2659
2017,3,13,20,1204,4026,1421,-2605
2017,3,13,21,1202,3993,1398,-2595
2017,3,13,22,1199,3959,1366,-2593
2017,3,13,23,1194,3974,1412,-2562
2017,3,14,0,1189,3981,1407,-2574
2017,3,14,1,1185,4054,1419,-2635
2017,3,14,2,1182,4034,1369,-2665
2017,3,14,3,1311,4083,1398,-2685
2017,3,14,4,1295,4014,1342,-2672
2017,3,14,5,1180,3912,1474,-2438
2017,3,14,6,1575,3638,1481,-2157
2017,3,14,7,1296,3372,1463,-1909
2017,3,14,8,1339,3171,1437,-1734
2017,3,14,9,1296,2935,1347,-1588
2017,3,14,10,1272,2875,1312,-1563
2017,3,14,11,1290,2975,1352,-1623
2017,3,14,12,1158,3102,1260,-1842
2017,3,14,13,1072,3361,1181,-2180
2017,3,14,14,1313,3774,1322,-2452
2017,3,14,15,1326,4007,1379,-2628
2017,3,14,16,1483,3965,1378,-2587
2017,3,14,17,1392,3894,1333,-2561
2017,3,14,18,1375,3819,1332,-2487
2017,3,14,19,1329,3725,1231,-2494
2017,3,14,20,1300,3548,1145,-2403
2017,3,14,21,1285,3512,1240,-2272
2017,3,14,22,1241,3516,1291,-2225
2017,3,14,23,1224,3414,1221,-2193
2017,3,15,0,1260,3613,1411,-2202
2017,3,15,1,1303,3527,1209,-2318
2017,3,15,2,1386,3783,1349,-2434
2017,3,15,3,1513,4069,1573,-2496
2017,3,15,4,1500,4027,1579,-2448
2017,3,15,5,1347,3788,1401,-2387
2017,3,15,6,1596,3499,1367,-2132
2017,3,15,7,1431,3227,1332,-1895
2017,3,15,8,1014,2821,1150,-1671
2017,3,15,9,1020,2592,1093,-1499
2017,3,15,10,1010,2552,1116,-1436
2017,3,15,11,1001,2569,1086,-1483
2017,3,15,12,1074,2722,1145,-1577
2017,3,15,13,1495,3373,1484,-1889
2017,3,15,14,1329,3783,1521,-2262
2017,3,15,15,1450,4059,1523,-2536
2017,3,15,16,1424,4029,1438,-2591
2017,3,15,17,1347,3976,1304,-2672
2017,3,15,18,1428,3980,1363,-2617
2017,3,15,19,1373,3919,1428,-2491
2017,3,15,20,1323,3852,1453,-2399
2017,3,15,21,1267,3795,1463,-2332
2017,3,15,22,1225,3658,1477,-2181
2017,3,15,23,1194,3636,1479,-2157
2017,3,16,0,1187,3728,1525,-2203
2017,3,16,1,1224,3849,1574,-2275
2017,3,16,2,1259,3962,1633,-2329
2017,3,16,3,1361,4157,1691,-2466
2017,3,16,4,1319,4137,1616,-2521
2017,3,16,5,1283,3823,1591,-2232
2017,3,16,6,1321,3569,1669,-1900
2017,3,16,7,1303,3074,1348,-1726
2017,3,16,8,1208,2839,1250,-1589
2017,3,16,9,1125,2718,1095,-1623
2017,3,16,10,1095,2705,1100,-1605
2017,3,16,11,1158,2776,1123,-1653
2017,3,16,12,1190,3003,1143,-1860
2017,3,16,13,1316,3432,1384,-2048
2017,3,16,14,1256,3910,1463,-2447
2017,3,16,15,1533,4464,1761,-2703
2017,3,16,16,1512,4387,1601,-2786
2017,3,16,17,1408,4209,1540,-2669
2017,3,16,18,1320,3961,1406,-2555
2017,3,16,19,1240,3852,1405,-2447
2017,3,16,20,1206,3626,1262,-2364
2017,3,16,21,1180,3533,1231,-2302
2017,3,16,22,1170,3480,1212,-2268
2017,3,16,23,1182,3449,1165,-2284
2017,3,17,0,1274,3611,1266,-2345
2017,3,17,1,1207,3843,1454,-2389
2017,3,17,2,1354,3928,1461,-2467
2017,3,17,3,1546,4120,1480,-2640
2017,3,17,4,1615,4216,1498,-2718
2017,3,17,5,1455,4073,1475,-2598
2017,3,17,6,1637,3808,1490,-2318
2017,3,17,7,1450,3543,1486,-2057
2017,3,17,8,1256,3235,1303,-1932
2017,3,17,9,1223,3181,1301,-1880
2017,3,17,10,1218,3170,1300,-1870
2017,3,17,11,1248,3219,1290,-1929
2017,3,17,12,1207,3444,1359,-2085
2017,3,17,13,1351,3847,1488,-2359
2017,3,17,14,1305,4299,1524,-2775
2017,3,17,15,1627,4543,1532,-3011
2017,3,17,16,1658,4521,1654,-2867
2017,3,17,17,1662,4426,1691,-2735
2017,3,17,18,1558,4356,1557,-2799
2017,3,17,19,1458,4320,1487,-2833
2017,3,17,20,1418,4285,1500,-2785
2017,3,17,21,1367,4235,1401,-2834
2017,3,17,22,1325,4190,1401,-2789
2017,3,17,23,1325,4194,1411,-2783
2017,3,18,0,1308,4282,1519,-2763
2017,3,18,1,1349,4323,1530,-2793
2017,3,18,2,1340,4322,1533,-2789
2017,3,18,3,1415,4333,1540,-2793
2017,3,18,4,1410,4231,1462,-2769
2017,3,18,5,1217,3987,1381,-2606
2017,3,18,6,1645,3718,1498,-2220
2017,3,18,7,1536,3456,1468,-1988
2017,3,18,8,1080,2968,1198,-1770
2017,3,18,9,1078,2808,1168,-1640
2017,3,18,10,1023,2738,1116,-1622
2017,3,18,11,995,2690,1146,-1544
2017,3,18,12,975,2669,1051,-1618
2017,3,18,13,1057,2756,988,-1768
2017,3,18,14,965,2939,1033,-1906
2017,3,18,15,1123,3167,1092,-2075
2017,3,18,16,1218,3402,1246,-2156
2017,3,18,17,1398,3614,1400,-2214
2017,3,18,18,1282,3725,1374,-2351
2017,3,18,19,1349,3729,1270,-2459
2017,3,18,20,1281,3621,1215,-2406
2017,3,18,21,1018,3552,1361,-2191
2017,3,18,22,1052,3457,1187,-2270
2017,3,18,23,1055,3356,1263,-2093
2017,3,19,0,1062,3319,1055,-2264
2017,3,19,1,1061,3432,1186,-2246
2017,3,19,2,1072,3481,1216,-2265
2017,3,19,3,1086,3633,1240,-2393
2017,3,19,4,1117,3653,1286,-2367
2017,3,19,5,1099,3578,1419,-2159
2017,3,19,6,1261,3422,1429,-1993
2017,3,19,7,1102,3232,1426,-1806
2017,3,19,8,1303,3081,1319,-1762
2017,3,19,9,1146,3012,1288,-1724
2017,3,19,10,1221,2995,1354,-1641
2017,3,19,11,1232,3017,1384,-1633
2017,3,19,12,1268,3125,1289,-1836
2017,3,19,13,1255,3277,1230,-2047
2017,3,19,14,1275,3513,1212,-2301
2017,3,19,15,1486,3959,1382,-2577
2017,3,19,16,1662,4307,1532,-2775
2017,3,19,17,1718,4302,1512,-2790
2017,3,19,18,1684,4165,1486,-2679
2017,3,19,19,1621,3927,1365,-2562
2017,3,19,20,1550,3669,1249,-2420
2017,3,19,21,1440,3469,1190,-2279
2017,3,19,22,1368,3278,1115,-2163
2017,3,19,23,1368,3181,1089,-2092
2017,3,20,0,1362,3277,1160,-2117
2017,3,20,1,1412,3479,1211,-2268
2017,3,20,2,1510,3679,1330,-2349
2017,3,20,3,1665,3978,1376,-2602
2017,3,20,4,1715,4065,1405,-2660
2017,3,20,5,1557,3955,1425,-2530
2017,3,20,6,1821,3714,1467,-2247
2017,3,20,7,1573,3321,1268,-2053
2017,3,20,8,1278,3183,1304,-1879
2017,3,20,9,1171,2971,1215,-1756
2017,3,20,10,1277,2962,1310,-1652
2017,3,20,11,1454,3070,1465,-1605
2017,3,20,12,1598,3411,1579,-1832
2017,3,20,13,1735,3747,1648,-2099
2017,3,20,14,1529,4178,1697,-2481
2017,3,20,15,1814,4416,1809,-2607
2017,3,20,16,1786,4380,1706,-2674
2017,3,20,17,1665,4227,1660,-2567
2017,3,20,18,1655,4081,1659,-2422
2017,3,20,19,1541,3821,1500,-2321
2017,3,20,20,1470,3626,1370,-2256
2017,3,20,21,1371,3485,1292,-2193
2017,3,20,22,1261,3455,1297,-2158
2017,3,20,23,1235,3472,1311,-2161
2017,3,21,0,1247,3638,1455,-2183
2017,3,21,1,1305,3771,1471,-2300
2017,3,21,2,1306,3834,1433,-2401
2017,3,21,3,1429,4048,1550,-2498
2017,3,21,4,1453,4023,1402,-2621
2017,3,21,5,1350,3707,1347,-2360
2017,3,21,6,1708,3492,1457,-2035
2017,3,21,7,1514,3075,1273,-1802
2017,3,21,8,1215,2882,1279,-1603
2017,3,21,9,1219,2727,1157,-1570
2017,3,21,10,1143,2699,1162,-1537
2017,3,21,11,1174,2735,1177,-1558
2017,3,21,12,1484,3081,1393,-1688
2017,3,21,13,1523,3418,1428,-1990
2017,3,21,14,1441,3824,1446,-2378
2017,3,21,15,1704,4054,1447,-2607
2017,3,21,16,1682,4003,1476,-2527
2017,3,21,17,1587,3937,1491,-2446
2017,3,21,18,1512,3838,1420,-2418
2017,3,21,19,1455,3800,1444,-2356
2017,3,21,20,1399,3755,1364,-2391
2017,3,21,21,1331,3621,1252,-2369
2017,3,21,22,1260,3588,1207,-2381
2017,3,21,23,1191,3550,1230,-2320
2017,3,22,0,1198,3538,1177,-2361
2017,3,22,1,1264,3522,1149,-2373
2017,3,22,2,1346,3554,1238,-2316
2017,3,22,3,1472,3683,1318,-2365
2017,3,22,4,1540,3720,1355,-2365
2017,3,22,5,1367,3530,1264,-2266
2017,3,22,6,1549,3247,1364,-1883
2017,3,22,7,1466,2982,1351,-1631
2017,3,22,8,1049,2609,1079,-1530
2017,3,22,9,1003,2526,1047,-1479
2017,3,22,10,958,2472,999,-1473
2017,3,22,11,1060,2520,993,-1527
2017,3,22,12,1181,2742,1135,-1607
2017,3,22,13,1356,3115,1249,-1866
2017,3,22,14,1420,3571,1402,-2169
2017,3,22,15,1639,3777,1460,-2317
2017,3,22,16,1798,3729,1440,-2289
2017,3,22,17,1722,3639,1410,-2229
2017,3,22,18,1687,3566,1465,-2101
2017,3,22,19,1590,3528,1406,-2122
2017,3,22,20,1491,3529,1334,-2195
2017,3,22,21,1417,3409,1303,-2106
2017,3,22,22,1368,3315,1248,-2067
2017,3,22,23,1377,3296,1267,-2029
2017,3,23,0,1415,3385,1231,-2154
2017,3,23,1,1471,3549,1267,-2282
2017,3,23,2,1540,3596,1424,-2172
2017,3,23,3,1603,3728,1537,-2191
2017,3,23,4,1603,3605,1453,-2152
2017,3,23,5,1398,3408,1353,-2055
2017,3,23,6,1316,3129,1208,-1921
2017,3,23,7,1312,2863,1061,-1802
2017,3,23,8,1176,2716,1145,-1571
2017,3,23,9,1165,2644,1115,-1529
2017,3,23,10,1156,2636,1108,-1528
2017,3,23,11,1553,2876,1362,-1514
2017,3,23,12,1468,3046,1502,-1544
2017,3,23,13,1489,3360,1588,-1772
2017,3,23,14,1294,3805,1572,-2233
2017,3,23,15,1560,4037,1589,-2448
2017,3,23,16,1531,3964,1393,-2571
2017,3,23,17,1301,3792,1229,-2563
2017,3,23,18,1406,3696,1217,-2479
2017,3,23,19,1449,3593,1171,-2422
2017,3,23,20,1411,3453,1081,-2372
2017,3,23,21,1363,3350,1069,-2281
2017,3,23,22,1318,3270,1080,-2190
2017,3,23,23,1292,3210,1050,-2160
2017,3,24,0,1327,3236,1047,-2189
2017,3,24,1,1184,3371,1107,-2264
2017,3,24,2,1135,3550,1273,-2277
2017,3,24,3,1222,3682,1411,-2271
2017,3,24,4,1295,3674,1375,-2299
2017,3,24,5,1164,3414,1226,-2188
2017,3,24,6,1560,3215,1313,-1902
2017,3,24,7,1297,2901,1157,-1744
2017,3,24,8,1082,2736,1090,-1646
2017,3,24,9,1145,2610,1052,-1558
2017,3,24,10,1140,2541,1047,-1494
2017,3,24,11,1158,2575,1083,-1492
2017,3,24,12,1326,2795,1235,-1560
2017,3,24,13,1474,3190,1426,-1764
2017,3,24,14,1562,3597,1503,-2094
2017,3,24,15,1859,3856,1608,-2248
2017,3,24,16,1946,3902,1598,-2304
2017,3,24,17,1892,3884,1561,-2323
2017,3,24,18,1773,3853,1621,-2232
2017,3,24,19,1704,3762,1534,-2228
2017,3,24,20,1611,3671,1463,-2208
2017,3,24,21,1574,3610,1378,-2232
2017,3,24,22,1495,3529,1305,-2224
2017,3,24,23,1445,3370,1163,-2207
2017,3,25,0,1385,3422,1160,-2262
2017,3,25,1,1385,3600,1232,-2368
2017,3,25,2,1441,3750,1307,-2443
2017,3,25,3,1444,3600,1193,-2407
2017,3,25,4,1446,3558,1256,-2302
2017,3,25,5,1478,3419,1287,-2132
2017,3,25,6,1676,3427,1485,-1942
2017,3,25,7,1629,3194,1424,-1770
2017,3,25,8,1220,2825,1216,-1609
2017,3,25,9,1239,2742,1205,-1537
2017,3,25,10,1212,2688,1197,-1491
2017,3,25,11,1250,2688,1207,-1481
2017,3,25,12,1267,2754,1211,-1543
2017,3,25,13,1224,2872,1203,-1669
2017,3,25,14,1213,3071,1210,-1861
2017,3,25,15,1222,3296,1211,-2085
2017,3,25,16,1299,3655,1349,-2306
2017,3,25,17,1325,3738,1478,-2260
2017,3,25,18,1335,3671,1370,-2301
2017,3,25,19,1286,3455,1255,-2200
2017,3,25,20,1234,3365,1215,-2150
2017,3,25,21,1161,3244,1187,-2057
2017,3,25,22,1156,3155,1106,-2049
2017,3,25,23,1153,3105,1063,-2042
2017,3,26,0,1149,3124,1051,-2073
2017,3,26,1,1141,3182,1080,-2102
2017,3,26,2,1216,3262,1151,-2111
2017,3,26,3,1318,3468,1283,-2185
2017,3,26,4,1407,3678,1500,-2178
2017,3,26,5,1338,3578,1491,-2087
2017,3,26,6,1905,3402,1459,-1943
2017,3,26,7,1723,3184,1423,-1761
2017,3,26,8,1187,2794,1129,-1665
2017,3,26,9,1140,2693,1125,-1568
2017,3,26,10,1128,2652,1125,-1527
2017,3,26,11,1138,2656,1129,-1527
2017,3,26,12,1190,2705,1134,-1571
2017,3,26,13,1149,2818,1144,-1674
2017,3,26,14,1118,3010,1135,-1875
2017,3,26,15,1132,3216,1128,-2088
2017,3,26,16,1264,3444,1133,-2311
2017,3,26,17,1263,3660,1202,-2458
2017,3,26,18,1271,3768,1241,-2527
2017,3,26,19,1264,3776,1272,-2504
2017,3,26,20,1184,3694,1233,-2461
2017,3,26,21,1175,3538,1133,-2405
2017,3,26,22,1176,3498,1122,-2376
2017,3,26,23,1177,3468,1125,-2343
2017,3,27,0,1178,3519,1127,-2392
2017,3,27,1,1178,3703,1267,-2436
2017,3,27,2,1178,3874,1436,-2438
2017,3,27,3,1271,4063,1508,-2555
2017,3,27,4,1309,4050,1549,-2501
2017,3,27,5,1198,3864,1544,-2320
2017,3,27,6,1601,3523,1498,-2025
2017,3,27,7,1292,2923,1163,-1760
2017,3,27,8,1219,2747,1230,-1517
2017,3,27,9,1311,2677,1289,-1388
2017,3,27,10,1296,2648,1135,-1513
2017,3,27,11,1215,2696,1111,-1585
2017,3,27,12,1203,2872,1169,-1703
2017,3,27,13,1112,3226,1216,-2010
2017,3,27,14,1356,3958,1519,-2439
2017,3,27,15,1532,4189,1518,-2671
2017,3,27,16,1547,4154,1518,-2636
2017,3,27,17,1477,4057,1482,-2575
2017,3,27,18,1356,3694,1136,-2558
2017,3,27,19,1171,3573,1094,-2479
2017,3,27,20,1095,3501,1094,-2407
2017,3,27,21,1084,3420,1080,-2340
2017,3,27,22,1084,3381,1076,-2305
2017,3,27,23,1084,3392,1115,-2277
2017,3,28,0,1259,3428,1079,-2349
2017,3,28,1,1273,3549,1123,-2426
2017,3,28,2,1283,3626,1140,-2486
2017,3,28,3,1294,3891,1318,-2573
2017,3,28,4,1324,3904,1357,-2547
2017,3,28,5,1291,3519,1222,-2297
2017,3,28,6,1288,3205,1393,-1812
2017,3,28,7,1237,2916,1319,-1597
2017,3,28,8,1363,2784,1288,-1496
2017,3,28,9,1332,2708,1224,-1484
2017,3,28,10,1420,2684,1237,-1447
2017,3,28,11,1347,2638,1214,-1424
2017,3,28,12,1384,2734,1205,-1529
2017,3,28,13,1613,3004,1405,-1599
2017,3,28,14,1582,3362,1352,-2010
2017,3,28,15,1811,3587,1318,-2269
2017,3,28,16,1826,3582,1480,-2102
2017,3,28,17,1730,3531,1322,-2209
2017,3,28,18,1420,3519,1124,-2395
2017,3,28,19,1418,3489,1130,-2359
2017,3,28,20,1323,3610,1316,-2294
2017,3,28,21,1324,3574,1313,-2261
2017,3,28,22,1325,3520,1261,-2259
2017,3,28,23,1326,3486,1295,-2191
2017,3,29,0,1485,3417,1234,-2183
2017,3,29,1,1370,3551,1338,-2213
2017,3,29,2,1486,3606,1365,-2241
2017,3,29,3,1622,3725,1476,-2249
2017,3,29,4,1706,3853,1682,-2171
2017,3,29,5,1607,3624,1662,-1962
2017,3,29,6,1956,3320,1703,-1617
2017,3,29,7,1777,3046,1566,-1480
2017,3,29,8,1320,2706,1307,-1399
2017,3,29,9,1309,2584,1317,-1267
2017,3,29,10,1283,2550,1229,-1321
2017,3,29,11,1309,2584,1176,-1408
2017,3,29,12,1606,2945,1451,-1494
2017,3,29,13,1602,3296,1468,-1828
2017,3,29,14,1583,3698,1526,-2172
2017,3,29,15,1625,3906,1622,-2284
2017,3,29,16,1590,3893,1546,-2347
2017,3,29,17,1492,3846,1557,-2289
2017,3,29,18,1568,3781,1644,-2137
2017,3,29,19,1692,3705,1724,-1981
2017,3,29,20,1640,3653,1422,-2231
2017,3,29,21,1572,3498,1188,-2310
2017,3,29,22,1474,3296,1027,-2269
2017,3,29,23,1348,3263,1048,-2215
2017,3,30,0,1283,3261,994,-2267
2017,3,30,1,1293,3294,1046,-2248
2017,3,30,2,1293,3335,1135,-2200
2017,3,30,3,1339,3474,1232,-2242
2017,3,30,4,1444,3634,1356,-2278
2017,3,30,5,1284,3415,1281,-2134
2017,3,30,6,1400,3095,1261,-1834
2017,3,30,7,1208,2838,1249,-1589
2017,3,30,8,1308,2741,1231,-1510
2017,3,30,9,1327,2668,1150,-1518
2017,3,30,10,1127,2641,1141,-1500
2017,3,30,11,1145,2679,1195,-1484
2017,3,30,12,1127,2811,1292,-1519
2017,3,30,13,1198,3156,1345,-1811
2017,3,30,14,1219,3698,1452,-2246
2017,3,30,15,1526,3923,1455,-2468
2017,3,30,16,1308,3829,1430,-2399
2017,3,30,17,1325,3768,1425,-2343
2017,3,30,18,1330,3684,1465,-2219
2017,3,30,19,1318,3540,1474,-2066
2017,3,30,20,1309,3442,1273,-2169
2017,3,30,21,1301,3351,1166,-2185
2017,3,30,22,1292,3286,1144,-2142
2017,3,30,23,1285,3244,1143,-2101
2017,3,31,0,1279,3241,1158,-2083
2017,3,31,1,1425,3298,1249,-2049
2017,3,31,2,1414,3363,1348,-2015
2017,3,31,3,1520,3720,1562,-2158
2017,3,31,4,1616,3879,1583,-2296
2017,3,31,5,1485,3688,1524,-2164
2017,3,31,6,1549,3338,1420,-1918
2017,3,31,7,1518,3137,1437,-1700
2017,3,31,8,1255,2828,1262,-1566
2017,3,31,9,1154,2722,1201,-1521
2017,3,31,10,1208,2717,1203,-1514
2017,3,31,11,1221,2743,1108,-1635
2017,3,31,12,1223,2924,1101,-1823
2017,3,31,13,1572,3583,1427,-2156
2017,3,31,14,1513,4010,1466,-2544
2017,3,31,15,1801,4244,1555,-2689
2017,3,31,16,1815,4195,1512,-2683
2017,3,31,17,1687,4073,1443,-2630
2017,3,31,18,1590,3949,1429,-2520
2017,3,31,19,1508,3723,1328,-2395
2017,3,31,20,1452,3495,1217,-2278
2017,3,31,21,1445,3316,1158,-2158
2017,3,31,22,1449,3184,1105,-2079
2017,3,31,23,1455,3130,1101,-2029
2017,4,1,0,1436,3131,1141,-1990
2017,4,1,1,1419,3171,1121,-2050
2017,4,1,2,1450,3303,1302,-2001
2017,4,1,3,1498,3436,1396,-2040
2017,4,1,4,1579,3572,1522,-2050
2017,4,1,5,1474,3354,1407,-1947
2017,4,1,6,1633,3194,1542,-1652
2017,4,1,7,1667,3012,1546,-1466
2017,4,1,8,1428,2704,1502,-1202
2017,4,1,9,1416,2562,1457,-1105
2017,4,1,10,1428,2549,1472,-1077
2017,4,1,11,1366,2511,1398,-1113
2017,4,1,12,1536,2591,1447,-1144
2017,4,1,13,1754,2846,1638,-1208
2017,4,1,14,1792,3165,1726,-1439
2017,4,1,15,1689,3423,1719,-1704
2017,4,1,16,1811,3651,1764,-1887
2017,4,1,17,1773,3801,1805,-1996
2017,4,1,18,1689,3720,1758,-1962
2017,4,1,19,1604,3680,1675,-2005
2017,4,1,20,1508,3498,1579,-1919
2017,4,1,21,1493,3272,1440,-1832
2017,4,1,22,1495,3163,1437,-1726
2017,4,1,23,1496,3111,1432,-1679
2017,4,2,0,1496,3097,1330,-1767
2017,4,2,1,1494,3119,1355,-1764
2017,4,2,2,1399,3140,1423,-1717
2017,4,2,3,1464,3213,1493,-1720
2017,4,2,4,1539,3291,1549,-1742
2017,4,2,5,1456,3209,1546,-1663
2017,4,2,6,1515,3035,1571,-1464
2017,4,2,7,1342,2816,1370,-1446
2017,4,2,8,1444,2665,1349,-1316
2017,4,2,9,1282,2562,1191,-1371
2017,4,2,10,1459,2514,1191,-1323
2017,4,2,11,1324,2531,1146,-1385
2017,4,2,12,1349,2602,1175,-1427
2017,4,2,13,1622,2718,1340,-1378
2017,4,2,14,1493,2929,1345,-1584
2017,4,2,15,1431,3142,1344,-1798
2017,4,2,16,1615,3302,1294,-2008
2017,4,2,17,1678,3364,1361,-2003
2017,4,2,18,1656,3342,1390,-1952
2017,4,2,19,1628,3289,1539,-1750
2017,4,2,20,1581,3210,1466,-1744
2017,4,2,21,1540,3134,1384,-1750
2017,4,2,22,1489,3058,1345,-1713
2017,4,2,23,1501,3048,1350,-1698
2017,4,3,0,1544,3103,1406,-1697
2017,4,3,1,1664,3203,1465,-1738
2017,4,3,2,1677,3298,1563,-1735
2017,4,3,3,1750,3405,1528,-1877
2017,4,3,4,1876,3667,1556,-2111
2017,4,3,5,1765,3611,1598,-2013
2017,4,3,6,1777,3132,1346,-1786
2017,4,3,7,1601,2874,1322,-1552
2017,4,3,8,1328,2732,1406,-1326
2017,4,3,9,1308,2674,1376,-1298
2017,4,3,10,1277,2679,1340,-1339
2017,4,3,11,1153,2765,1259,-1506
2017,4,3,12,1601,3248,1501,-1747
2017,4,3,13,1800,3616,1621,-1995
2017,4,3,14,1549,4017,1601,-2416
2017,4,3,15,1734,4223,1661,-2562
2017,4,3,16,1742,4216,1557,-2659
2017,4,3,17,1670,4091,1533,-2558
2017,4,3,18,1513,3967,1451,-2516
2017,4,3,19,1495,3851,1424,-2427
2017,4,3,20,1490,3628,1293,-2335
2017,4,3,21,1435,3470,1260,-2210
2017,4,3,22,1386,3338,1246,-2092
2017,4,3,23,1352,3263,1228,-2035
2017,4,4,0,1352,3247,1204,-2043
2017,4,4,1,1452,3400,1319,-2081
2017,4,4,2,1475,3586,1469,-2117
2017,4,4,3,1562,3741,1527,-2214
2017,4,4,4,1612,3892,1568,-2324
2017,4,4,5,1561,3750,1511,-2239
2017,4,4,6,1680,3480,1531,-1949
2017,4,4,7,1520,3224,1508,-1716
2017,4,4,8,1202,2775,1285,-1490
2017,4,4,9,1213,2672,1239,-1433
2017,4,4,10,1169,2661,1231,-1430
2017,4,4,11,1231,2701,1265,-1436
2017,4,4,12,1375,3042,1368,-1674
2017,4,4,13,1706,3488,1622,-1866
2017,4,4,14,1746,3875,1585,-2290
2017,4,4,15,1963,4096,1735,-2361
2017,4,4,16,1937,4103,1671,-2432
2017,4,4,17,1819,4054,1696,-2358
2017,4,4,18,1669,3929,1698,-2231
2017,4,4,19,1565,3802,1622,-2180
2017,4,4,20,1462,3608,1537,-2071
2017,4,4,21,1400,3412,1389,-2023
2017,4,4,22,1388,3304,1312,-1992
2017,4,4,23,1393,3346,1327,-2019
2017,4,5,0,1391,3437,1346,-2091
2017,4,5,1,1500,3616,1450,-2166
2017,4,5,2,1563,3748,1508,-2240
2017,4,5,3,1642,3832,1557,-2275
2017,4,5,4,1722,3860,1539,-2321
2017,4,5,5,1554,3682,1511,-2171
2017,4,5,6,1504,3314,1446,-1868
2017,4,5,7,1334,2949,1296,-1653
2017,4,5,8,1357,2727,1269,-1458
2017,4,5,9,1304,2647,1256,-1391
2017,4,5,10,1322,2612,1295,-1317
2017,4,5,11,1318,2634,1328,-1306
2017,4,5,12,1498,2804,1400,-1404
2017,4,5,13,1599,3196,1541,-1655
2017,4,5,14,1637,3636,1643,-1993
2017,4,5,15,1765,3853,1624,-2229
2017,4,5,16,1753,3843,1570,-2273
2017,4,5,17,1697,3819,1560,-2259
2017,4,5,18,1640,3868,1606,-2262
2017,4,5,19,1612,3858,1595,-2263
2017,4,5,20,1559,3832,1606,-2226
2017,4,5,21,1526,3814,1599,-2215
2017,4,5,22,1487,3754,1590,-2164
2017,4,5,23,1443,3752,1630,-2122
2017,4,6,0,1466,3758,1656,-2102
2017,4,6,1,1532,3833,1722,-2111
2017,4,6,2,1600,3858,1816,-2042
2017,4,6,3,1659,3893,1712,-2181
2017,4,6,4,1740,3917,1694,-2223
2017,4,6,5,1581,3735,1607,-2128
2017,4,6,6,1875,3434,1623,-1811
2017,4,6,7,1600,3184,1619,-1565
2017,4,6,8,1425,2898,1471,-1427
2017,4,6,9,1488,2826,1410,-1416
2017,4,6,10,1314,2646,1209,-1437
2017,4,6,11,1324,2639,1173,-1466
2017,4,6,12,1456,2887,1321,-1566
2017,4,6,13,1659,3395,1611,-1784
2017,4,6,14,1637,3751,1674,-2077
2017,4,6,15,1700,3955,1700,-2255
2017,4,6,16,1695,3984,1704,-2280
2017,4,6,17,1619,3971,1583,-2388
2017,4,6,18,1626,3893,1512,-2381
2017,4,6,19,1580,3765,1510,-2255
2017,4,6,20,1457,3698,1533,-2165
2017,4,6,21,1405,3549,1516,-2033
2017,4,6,22,1358,3484,1629,-1855
2017,4,6,23,1357,3431,1539,-1892
2017,4,7,0,1373,3372,1433,-1939
2017,4,7,1,1477,3434,1448,-1986
2017,4,7,2,1484,3436,1444,-1992
2017,4,7,3,1537,3512,1456,-2056
2017,4,7,4,1599,3626,1450,-2176
2017,4,7,5,1475,3497,1503,-1994
2017,4,7,6,1786,3268,1592,-1676
2017,4,7,7,1532,2948,1544,-1404
2017,4,7,8,1404,2589,1354,-1235
2017,4,7,9,1363,2507,1285,-1222
2017,4,7,10,1307,2467,1184,-1283
2017,4,7,11,1358,2568,1267,-1301
2017,4,7,12,1503,2855,1364,-1491
2017,4,7,13,1488,3139,1401,-1738
2017,4,7,14,1496,3446,1402,-2044
2017,4,7,15,1506,3531,1414,-2117
2017,4,7,16,1588,3589,1496,-2093
2017,4,7,17,1563,3647,1583,-2064
2017,4,7,18,1500,3509,1561,-1948
2017,4,7,19,1392,3457,1527,-1930
2017,4,7,20,1400,3301,1393,-1908
2017,4,7,21,1397,3249,1318,-1931
2017,4,7,22,1395,3130,1273,-1857
2017,4,7,23,1398,3161,1391,-1770
2017,4,8,0,1399,3244,1456,-1788
2017,4,8,1,1407,3279,1400,-1879
2017,4,8,2,1512,3369,1488,-1881
2017,4,8,3,1584,3425,1549,-1876
2017,4,8,4,1765,3567,1715,-1852
2017,4,8,5,1667,3441,1699,-1742
2017,4,8,6,1847,3210,1717,-1493
2017,4,8,7,1669,2997,1596,-1401
2017,4,8,8,1261,2690,1367,-1323
2017,4,8,9,1221,2494,1230,-1264
2017,4,8,10,1258,2466,1158,-1308
2017,4,8,11,1208,2544,1274,-1270
2017,4,8,12,1239,2607,1328,-1279
2017,4,8,13,1276,2796,1374,-1422
2017,4,8,14,1272,3123,1456,-1667
2017,4,8,15,1303,3283,1480,-1803
2017,4,8,16,1445,3516,1560,-1956
2017,4,8,17,1473,3577,1572,-2005
2017,4,8,18,1457,3572,1554,-2018
2017,4,8,19,1405,3498,1472,-2026
2017,4,8,20,1338,3248,1315,-1933
2017,4,8,21,1330,3103,1261,-1842
2017,4,8,22,1337,3049,1265,-1784
2017,4,8,23,1348,2961,1231,-1730
2017,4,9,0,1356,3003,1314,-1689
2017,4,9,1,1361,3018,1274,-1744
2017,4,9,2,1363,3143,1394,-1749
2017,4,9,3,1365,3191,1396,-1795
2017,4,9,4,1456,3403,1522,-1881
2017,4,9,5,1366,3311,1461,-1850
2017,4,9,6,1642,3189,1541,-1648
2017,4,9,7,1438,2924,1455,-1469
2017,4,9,8,1509,2791,1472,-1319
2017,4,9,9,1466,2677,1423,-1254
2017,4,9,10,1481,2621,1400,-1221
2017,4,9,11,1496,2642,1409,-1233
2017,4,9,12,1547,2775,1490,-1285
2017,4,9,13,1626,2996,1570,-1426
2017,4,9,14,1540,3194,1548,-1646
2017,4,9,15,1396,3377,1501,-1876
2017,4,9,16,1575,3512,1488,-2024
2017,4,9,17,1503,3489,1331,-2158
2017,4,9,18,1497,3472,1379,-2093
2017,4,9,19,1457,3380,1307,-2073
2017,4,9,20,1432,3299,1264,-2035
2017,4,9,21,1416,3201,1263,-1938
2017,4,9,22,1351,3083,1221,-1862
2017,4,9,23,1334,3050,1214,-1836
2017,4,10,0,1364,3069,1248,-1821
2017,4,10,1,1596,3221,1328,-1893
2017,4,10,2,1678,3307,1456,-1851
2017,4,10,3,1776,3417,1535,-1882
2017,4,10,4,1909,3510,1656,-1854
2017,4,10,5,1773,3365,1619,-1746
2017,4,10,6,1794,3101,1558,-1543
2017,4,10,7,1641,2804,1386,-1418
2017,4,10,8,1368,2581,1310,-1271
2017,4,10,9,1350,2403,1226,-1177
2017,4,10,10,1340,2429,1260,-1169
2017,4,10,11,1267,2493,1232,-1261
2017,4,10,12,1367,2721,1282,-1439
2017,4,10,13,1610,3179,1511,-1668
2017,4,10,14,1558,3556,1539,-2017
2017,4,10,15,1568,3752,1601,-2151
2017,4,10,16,1529,3720,1603,-2117
2017,4,10,17,1587,3661,1637,-2024
2017,4,10,18,1562,3602,1599,-2003
2017,4,10,19,1534,3485,1407,-2078
2017,4,10,20,1525,3379,1312,-2067
2017,4,10,21,1521,3331,1301,-2030
2017,4,10,22,1545,3271,1278,-1993
2017,4,10,23,1573,3253,1356,-1897
2017,4,11,0,1629,3438,1586,-1852
2017,4,11,1,1726,3337,1507,-1830
2017,4,11,2,1818,3565,1563,-2002
2017,4,11,3,1887,3637,1691,-1946
2017,4,11,4,2008,3735,1877,-1858
2017,4,11,5,1900,3575,1883,-1692
2017,4,11,6,2112,3303,1952,-1351
2017,4,11,7,1835,3043,1788,-1255
2017,4,11,8,1542,2822,1558,-1264
2017,4,11,9,1689,2833,1573,-1260
2017,4,11,10,1726,2832,1547,-1285
2017,4,11,11,1657,2899,1586,-1313
2017,4,11,12,1744,3079,1744,-1335
2017,4,11,13,2111,3442,1859,-1583
2017,4,11,14,1976,3828,1802,-2026
2017,4,11,15,2151,4002,1908,-2094
2017,4,11,16,2073,3900,1908,-1992
2017,4,11,17,1881,3747,1829,-1918
2017,4,11,18,1715,3599,1672,-1927
2017,4,11,19,1566,3471,1539,-1932
2017,4,11,20,1515,3391,1512,-1879
2017,4,11,21,1527,3194,1434,-1760
2017,4,11,22,1543,3075,1400,-1675
2017,4,11,23,1424,2996,1352,-1644
2017,4,12,0,1429,3019,1336,-1683
2017,4,12,1,1533,3347,1663,-1684
2017,4,12,2,1615,3417,1707,-1710
2017,4,12,3,1696,3481,1797,-1684
2017,4,12,4,1831,3549,1815,-1734
2017,4,12,5,1688,3385,1761,-1624
2017,4,12,6,1998,3122,1796,-1326
2017,4,12,7,1724,2866,1708,-1158
2017,4,12,8,1481,2573,1619,-954
2017,4,12,9,1602,2393,1456,-937
2017,4,12,10,1589,2319,1377,-942
2017,4,12,11,1478,2383,1436,-947
2017,4,12,12,1463,2520,1404,-1116
2017,4,12,13,1963,3050,1738,-1312
2017,4,12,14,1801,3415,1715,-1700
2017,4,12,15,2065,3603,1784,-1819
2017,4,12,16,2048,3628,1666,-1962
2017,4,12,17,1825,3594,1656,-1938
2017,4,12,18,1753,3531,1618,-1913
2017,4,12,19,1700,3455,1587,-1868
2017,4,12,20,1679,3410,1543,-1867
2017,4,12,21,1679,3320,1541,-1779
2017,4,12,22,1668,3275,1570,-1705
2017,4,12,23,1665,3240,1549,-1691
2017,4,13,0,1699,3237,1540,-1697
2017,4,13,1,1757,3328,1569,-1759
2017,4,13,2,1793,3383,1631,-1752
2017,4,13,3,1815,3461,1790,-1671
2017,4,13,4,1914,3494,1734,-1760
2017,4,13,5,1809,3365,1718,-1647
2017,4,13,6,1933,3108,1774,-1334
2017,4,13,7,1672,2851,1550,-1301
2017,4,13,8,1372,2681,1362,-1319
2017,4,13,9,1314,2493,1238,-1255
2017,4,13,10,1203,2387,1185,-1202
2017,4,13,11,1186,2389,1204,-1185
2017,4,13,12,1192,2532,1208,-1324
2017,4,13,13,1705,3031,1523,-1508
2017,4,13,14,1562,3485,1666,-1819
2017,4,13,15,1794,3674,1749,-1925
2017,4,13,16,1792,3670,1777,-1893
2017,4,13,17,1638,3580,1694,-1886
2017,4,13,18,1598,3528,1580,-1948
2017,4,13,19,1592,3458,1484,-1974
2017,4,13,20,1594,3415,1434,-1981
2017,4,13,21,1630,3369,1422,-1947
2017,4,13,22,1647,3289,1432,-1857
2017,4,13,23,1714,3296,1488,-1808
2017,4,14,0,1760,3347,1539,-1808
2017,4,14,1,1840,3427,1598,-1829
2017,4,14,2,1901,3499,1636,-1863
2017,4,14,3,1946,3512,1604,-1908
2017,4,14,4,2043,3622,1678,-1944
2017,4,14,5,1872,3501,1564,-1937
2017,4,14,6,1822,3248,1617,-1631
2017,4,14,7,1468,2942,1467,-1475
2017,4,14,8,1439,2737,1403,-1334
2017,4,14,9,1407,2598,1380,-1218
2017,4,14,10,1210,2482,1303,-1179
2017,4,14,11,1283,2537,1330,-1207
2017,4,14,12,1436,2778,1436,-1342
2017,4,14,13,1711,3141,1533,-1608
2017,4,14,14,1587,3576,1660,-1916
2017,4,14,15,1551,3770,1619,-2151
2017,4,14,16,1527,3777,1608,-2169
2017,4,14,17,1520,3721,1604,-2117
2017,4,14,18,1474,3634,1548,-2086
2017,4,14,19,1397,3505,1527,-1978
2017,4,14,20,1357,3195,1301,-1894
2017,4,14,21,1353,3136,1241,-1895
2017,4,14,22,1356,3090,1290,-1800
2017,4,14,23,1366,3071,1330,-1741
2017,4,15,0,1371,3093,1337,-1756
2017,4,15,1,1374,3134,1345,-1789
2017,4,15,2,1376,3138,1359,-1779
2017,4,15,3,1378,3322,1503,-1819
2017,4,15,4,1425,3549,1602,-1947
2017,4,15,5,1376,3467,1618,-1849
2017,4,15,6,1705,3181,1592,-1589
2017,4,15,7,1489,2973,1609,-1364
2017,4,15,8,1312,2694,1457,-1237
2017,4,15,9,1301,2537,1364,-1173
2017,4,15,10,1242,2516,1361,-1155
2017,4,15,11,1304,2522,1358,-1164
2017,4,15,12,1321,2583,1367,-1216
2017,4,15,13,1262,2717,1347,-1370
2017,4,15,14,1212,2956,1357,-1599
2017,4,15,15,1312,3310,1434,-1876
2017,4,15,16,1497,3501,1471,-2030
2017,4,15,17,1539,3498,1403,-2095
2017,4,15,18,1408,3236,1129,-2107
2017,4,15,19,1333,3248,1192,-2056
2017,4,15,20,1246,3130,1116,-2014
2017,4,15,21,1191,2940,1045,-1895
2017,4,15,22,1167,2837,1026,-1811
2017,4,15,23,1164,2822,1071,-1751
2017,4,16,0,1201,2985,1228,-1757
2017,4,16,1,1287,3041,1260,-1781
2017,4,16,2,1249,3056,1249,-1807
2017,4,16,3,1198,3125,1277,-1848
2017,4,16,4,1319,3279,1325,-1954
2017,4,16,5,1268,3189,1276,-1913
2017,4,16,6,1539,3104,1316,-1788
2017,4,16,7,1494,2926,1291,-1635
2017,4,16,8,1235,2727,1223,-1504
2017,4,16,9,1076,2485,1068,-1417
2017,4,16,10,1116,2465,1094,-1371
2017,4,16,11,1133,2478,1103,-1375
2017,4,16,12,1087,2516,1100,-1416
2017,4,16,13,1307,2769,1221,-1548
2017,4,16,14,1190,3026,1322,-1704
2017,4,16,15,1241,3334,1433,-1901
2017,4,16,16,1380,3476,1457,-2019
2017,4,16,17,1350,3480,1478,-2002
2017,4,16,18,1320,3310,1448,-1862
2017,4,16,19,1336,3064,1332,-1732
2017,4,16,20,1287,2910,1305,-1605
2017,4,16,21,1289,2806,1292,-1514
2017,4,16,22,875,2710,1225,-1485
2017,4,16,23,872,2661,1235,-1426
2017,4,17,0,867,2676,1238,-1438
2017,4,17,1,1317,2723,1165,-1558
2017,4,17,2,1299,2769,1158,-1611
2017,4,17,3,1293,2989,1335,-1654
2017,4,17,4,1284,3244,1409,-1835
2017,4,17,5,1272,3140,1324,-1816
2017,4,17,6,1423,2837,1199,-1638
2017,4,17,7,1236,2501,1084,-1417
2017,4,17,8,1044,2264,993,-1271
2017,4,17,9,999,2188,984,-1204
2017,4,17,10,1062,2172,1009,-1163
2017,4,17,11,1019,2207,1029,-1178
2017,4,17,12,1139,2317,933,-1384
2017,4,17,13,1237,2697,1141,-1556
2017,4,17,14,1102,3056,1218,-1838
2017,4,17,15,1084,3255,1241,-2014
2017,4,17,16,1080,3207,1231,-1976
2017,4,17,17,1015,3178,1299,-1879
2017,4,17,18,986,3107,1249,-1858
2017,4,17,19,949,3141,1204,-1937
2017,4,17,20,937,3059,1089,-1970
2017,4,17,21,930,3156,1175,-1981
2017,4,17,22,964,3130,1149,-1981
2017,4,17,23,1010,3160,1231,-1929
2017,4,18,0,1097,3247,1329,-1918
2017,4,18,1,1249,3408,1442,-1966
2017,4,18,2,1331,3446,1370,-2076
2017,4,18,3,1387,3471,1384,-2087
2017,4,18,4,1542,3535,1414,-2121
2017,4,18,5,1416,3354,1370,-1984
2017,4,18,6,1535,3072,1366,-1706
2017,4,18,7,1252,2808,1401,-1407
2017,4,18,8,1333,2642,1340,-1302
2017,4,18,9,1260,2511,1294,-1217
2017,4,18,10,1391,2527,1335,-1192
2017,4,18,11,1312,2480,1205,-1275
2017,4,18,12,1239,2603,1249,-1354
2017,4,18,13,1370,2935,1260,-1675
2017,4,18,14,1316,3285,1311,-1974
2017,4,18,15,1343,3554,1426,-2128
2017,4,18,16,1326,3575,1428,-2147
2017,4,18,17,1334,3504,1412,-2092
2017,4,18,18,1242,3426,1335,-2091
2017,4,18,19,1348,3371,1402,-1969
2017,4,18,20,1271,3181,1262,-1919
2017,4,18,21,1210,3040,1157,-1883
2017,4,18,22,1170,2977,1138,-1839
2017,4,18,23,1185,2927,1167,-1760
2017,4,19,0,1190,2946,1204,-1742
2017,4,19,1,1249,3058,1240,-1818
2017,4,19,2,1302,3077,1244,-1833
2017,4,19,3,1333,3288,1371,-1917
2017,4,19,4,1469,3386,1326,-2060
2017,4,19,5,1365,3157,1242,-1915
2017,4,19,6,1576,3046,1471,-1575
2017,4,19,7,1473,2801,1438,-1363
2017,4,19,8,1168,2439,1125,-1314
2017,4,19,9,1064,2359,1065,-1294
2017,4,19,10,1120,2396,1107,-1289
2017,4,19,11,1239,2580,1222,-1358
2017,4,19,12,1390,2778,1316,-1462
2017,4,19,13,1531,3088,1415,-1673
2017,4,19,14,1458,3454,1407,-2047
2017,4,19,15,1488,3656,1333,-2323
2017,4,19,16,1447,3665,1299,-2366
2017,4,19,17,1435,3603,1284,-2319
2017,4,19,18,1371,3596,1356,-2240
2017,4,19,19,1316,3562,1294,-2268
2017,4,19,20,1308,3532,1306,-2226
2017,4,19,21,1284,3459,1316,-2143
2017,4,19,22,1245,3399,1303,-2096
2017,4,19,23,1194,3369,1296,-2073
2017,4,20,0,1223,3398,1279,-2119
2017,4,20,1,1337,3437,1371,-2066
2017,4,20,2,1365,3457,1338,-2119
2017,4,20,3,1352,3515,1370,-2145
2017,4,20,4,1475,3582,1365,-2217
2017,4,20,5,1343,3423,1300,-2123
2017,4,20,6,1713,3150,1370,-1780
2017,4,20,7,1431,2895,1303,-1592
2017,4,20,8,1242,2732,1254,-1478
2017,4,20,9,1150,2501,1129,-1372
2017,4,20,10,1105,2352,1067,-1285
2017,4,20,11,1098,2387,1166,-1221
2017,4,20,12,1251,2535,1267,-1268
2017,4,20,13,1248,2928,1381,-1547
2017,4,20,14,1312,3453,1529,-1924
2017,4,20,15,1540,3657,1619,-2038
2017,4,20,16,1523,3611,1646,-1965
2017,4,20,17,1455,3502,1522,-1980
2017,4,20,18,1400,3354,1469,-1885
2017,4,20,19,1345,3239,1394,-1845
2017,4,20,20,1300,3113,1351,-1762
2017,4,20,21,1255,3019,1302,-1717
2017,4,20,22,1222,2971,1294,-1677
2017,4,20,23,1209,2941,1307,-1634
2017,4,21,0,1228,3014,1358,-1656
2017,4,21,1,1277,3029,1300,-1729
2017,4,21,2,1335,3148,1432,-1716
2017,4,21,3,1375,3245,1483,-1762
2017,4,21,4,1501,3419,1548,-1871
2017,4,21,5,1393,3194,1364,-1830
2017,4,21,6,1511,2938,1370,-1568
2017,4,21,7,1231,2611,1294,-1317
2017,4,21,8,1274,2462,1312,-1150
2017,4,21,9,1207,2386,1275,-1111
2017,4,21,10,1237,2369,1247,-1122
2017,4,21,11,1219,2406,1147,-1259
2017,4,21,12,1317,2649,1218,-1431
2017,4,21,13,1475,3122,1438,-1684
2017,4,21,14,1311,3508,1420,-2088
2017,4,21,15,1228,3676,1392,-2284
2017,4,21,16,1228,3620,1320,-2300
2017,4,21,17,1244,3502,1311,-2191
2017,4,21,18,1253,3392,1290,-2102
2017,4,21,19,1278,3298,1271,-2027
2017,4,21,20,1288,3208,1292,-1916
2017,4,21,21,1300,3115,1236,-1879
2017,4,21,22,1255,3037,1233,-1804
2017,4,21,23,1238,2951,1163,-1788
2017,4,22,0,1241,3042,1209,-1833
2017,4,22,1,1274,3139,1255,-1884
2017,4,22,2,1292,2927,1112,-1815
2017,4,22,3,1294,2930,1080,-1850
2017,4,22,4,1298,3071,1215,-1856
2017,4,22,5,1305,2974,1194,-1780
2017,4,22,6,1585,3063,1512,-1551
2017,4,22,7,1571,2782,1504,-1278
2017,4,22,8,1283,2567,1324,-1243
2017,4,22,9,1095,2430,1252,-1178
2017,4,22,10,1056,2293,1176,-1117
2017,4,22,11,1140,2290,1191,-1099
2017,4,22,12,1176,2362,1236,-1126
2017,4,22,13,1307,2498,1280,-1218
2017,4,22,14,1240,2492,1106,-1386
2017,4,22,15,1240,2758,1187,-1571
2017,4,22,16,1338,3130,1413,-1717
2017,4,22,17,1411,3246,1460,-1786
2017,4,22,18,1397,3260,1408,-1852
2017,4,22,19,1379,3205,1263,-1942
2017,4,22,20,1281,3228,1209,-2019
2017,4,22,21,1270,3135,1170,-1965
2017,4,22,22,1212,2998,1156,-1842
2017,4,22,23,1187,2895,1146,-1749
2017,4,23,0,1205,2985,1214,-1771
2017,4,23,1,1226,2931,1135,-1796
2017,4,23,2,1244,2948,1123,-1825
2017,4,23,3,1257,3102,1293,-1809
2017,4,23,4,1264,3291,1413,-1878
2017,4,23,5,1268,3222,1428,-1794
2017,4,23,6,1552,3063,1475,-1588
2017,4,23,7,1490,2740,1434,-1306
2017,4,23,8,1407,2711,1437,-1274
2017,4,23,9,1127,2479,1294,-1185
2017,4,23,10,1223,2475,1336,-1139
2017,4,23,11,1162,2369,1214,-1155
2017,4,23,12,1181,2425,1260,-1165
2017,4,23,13,1290,2516,1309,-1207
2017,4,23,14,1177,2698,1285,-1413
2017,4,23,15,1179,2795,1220,-1575
2017,4,23,16,1329,3036,1256,-1780
2017,4,23,17,1323,3221,1272,-1949
2017,4,23,18,1322,3278,1283,-1995
2017,4,23,19,1322,3253,1274,-1979
2017,4,23,20,1325,3268,1239,-2029
2017,4,23,21,1332,3184,1164,-2020
2017,4,23,22,1339,3212,1202,-2010
2017,4,23,23,1347,3226,1203,-2023
2017,4,24,0,1357,3386,1295,-2091
2017,4,24,1,1406,3461,1316,-2145
2017,4,24,2,1439,3507,1356,-2151
2017,4,24,3,1444,3543,1398,-2145
2017,4,24,4,1527,3633,1499,-2134
2017,4,24,5,1388,3470,1526,-1944
2017,4,24,6,1617,3198,1563,-1635
2017,4,24,7,1320,2853,1497,-1356
2017,4,24,8,1152,2635,1386,-1249
2017,4,24,9,1142,2460,1262,-1198
2017,4,24,10,1111,2423,1135,-1288
2017,4,24,11,1145,2495,1242,-1253
2017,4,24,12,1448,2843,1462,-1381
2017,4,24,13,1720,3230,1618,-1612
2017,4,24,14,1579,3609,1683,-1926
2017,4,24,15,1860,3810,1781,-2029
2017,4,24,16,1875,3782,1700,-2082
2017,4,24,17,1850,3696,1633,-2063
2017,4,24,18,1719,3661,1572,-2089
2017,4,24,19,1677,3598,1579,-2019
2017,4,24,20,1627,3565,1522,-2043
2017,4,24,21,1563,3523,1520,-2003
2017,4,24,22,1495,3481,1477,-2004
2017,4,24,23,1448,3459,1477,-1982
2017,4,25,0,1430,3471,1490,-1981
2017,4,25,1,1471,3474,1390,-2084
2017,4,25,2,1506,3516,1479,-2037
2017,4,25,3,1518,3530,1499,-2031
2017,4,25,4,1612,3606,1381,-2225
2017,4,25,5,1438,3446,1401,-2045
2017,4,25,6,1625,3162,1405,-1757
2017,4,25,7,1300,2875,1263,-1612
2017,4,25,8,1165,2600,1165,-1435
2017,4,25,9,1081,2452,1062,-1390
2017,4,25,10,1164,2424,1095,-1329
2017,4,25,11,1083,2410,1076,-1334
2017,4,25,12,1178,2547,1091,-1456
2017,4,25,13,1524,3108,1506,-1602
2017,4,25,14,1439,3372,1357,-2015
2017,4,25,15,1429,3641,1494,-2147
2017,4,25,16,1421,3526,1364,-2162
2017,4,25,17,1357,3439,1366,-2073
2017,4,25,18,1288,3406,1443,-1963
2017,4,25,19,1282,3296,1272,-2024
2017,4,25,20,1276,3292,1271,-2021
2017,4,25,21,1272,3232,1269,-1963
2017,4,25,22,1274,3196,1299,-1897
2017,4,25,23,1280,3183,1285,-1898
2017,4,26,0,1289,3217,1324,-1893
2017,4,26,1,1374,3477,1539,-1938
2017,4,26,2,1472,3547,1701,-1846
2017,4,26,3,1571,3588,1794,-1794
2017,4,26,4,1695,3655,1823,-1832
2017,4,26,5,1575,3513,1759,-1754
2017,4,26,6,1789,3236,1775,-1461
2017,4,26,7,1510,2893,1556,-1337
2017,4,26,8,1372,2596,1417,-1179
2017,4,26,9,1287,2414,1276,-1138
2017,4,26,10,1399,2398,1328,-1070
2017,4,26,11,1289,2388,1376,-1012
2017,4,26,12,1316,2494,1306,-1188
2017,4,26,13,1628,2931,1574,-1357
2017,4,26,14,1599,3299,1645,-1654
2017,4,26,15,1826,3692,1877,-1815
2017,4,26,16,1834,3702,1816,-1886
2017,4,26,17,1774,3577,1747,-1830
2017,4,26,18,1633,3483,1570,-1913
2017,4,26,19,1575,3423,1574,-1849
2017,4,26,20,1572,3365,1549,-1816
2017,4,26,21,1487,3324,1546,-1778
2017,4,26,22,1481,3206,1489,-1717
2017,4,26,23,1478,3171,1433,-1738
2017,4,27,0,1477,3214,1457,-1757
2017,4,27,1,1558,3278,1449,-1829
2017,4,27,2,1558,3296,1404,-1892
2017,4,27,3,1560,3363,1471,-1892
2017,4,27,4,1656,3472,1470,-2002
2017,4,27,5,1561,3327,1375,-1952
2017,4,27,6,1559,2967,1252,-1715
2017,4,27,7,1392,2816,1322,-1494
2017,4,27,8,1171,2559,1241,-1318
2017,4,27,9,1187,2477,1274,-1203
2017,4,27,10,1223,2457,1272,-1185
2017,4,27,11,1155,2506,1282,-1224
2017,4,27,12,1141,2654,1254,-1400
2017,4,27,13,1326,3124,1413,-1711
2017,4,27,14,1249,3598,1547,-2051
2017,4,27,15,1557,3844,1609,-2235
2017,4,27,16,1558,3771,1576,-2195
2017,4,27,17,1559,3594,1480,-2114
2017,4,27,18,1559,3328,1338,-1990
2017,4,27,19,1481,3221,1267,-1954
2017,4,27,20,1423,3173,1254,-1919
2017,4,27,21,1331,3074,1234,-1840
2017,4,27,22,1327,3049,1243,-1806
2017,4,27,23,1327,3027,1235,-1792
2017,4,28,0,1325,3089,1281,-1808
2017,4,28,1,1422,3218,1381,-1837
2017,4,28,2,1475,3346,1468,-1878
2017,4,28,3,1550,3217,1290,-1927
2017,4,28,4,1543,3501,1521,-1980
2017,4,28,5,1567,3426,1503,-1923
2017,4,28,6,1726,2954,1283,-1671
2017,4,28,7,1507,2693,1231,-1462
2017,4,28,8,1162,2544,1166,-1378
2017,4,28,9,1091,2466,1118,-1348
2017,4,28,10,1086,2446,1117,-1329
2017,4,28,11,1066,2480,1097,-1383
2017,4,28,12,1099,2622,1117,-1505
2017,4,28,13,1144,3017,1228,-1789
2017,4,28,14,1176,3528,1324,-2204
2017,4,28,15,1445,3800,1393,-2407
2017,4,28,16,1445,3775,1368,-2407
2017,4,28,17,1426,3648,1323,-2325
2017,4,28,18,1384,3527,1302,-2225
2017,4,28,19,1416,3462,1250,-2212
2017,4,28,20,1418,3389,1266,-2123
2017,4,28,21,1346,3289,1239,-2050
2017,4,28,22,1364,3164,1241,-1923
2017,4,28,23,1321,3075,1231,-1844
2017,4,29,0,1341,3030,1199,-1831
2017,4,29,1,1357,3037,1202,-1835
2017,4,29,2,1369,3028,1278,-1750
2017,4,29,3,1429,3046,1332,-1714
2017,4,29,4,1443,3217,1417,-1800
2017,4,29,5,1468,3235,1469,-1766
2017,4,29,6,1720,3095,1478,-1617
2017,4,29,7,1749,2821,1422,-1399
2017,4,29,8,1214,2541,1272,-1269
2017,4,29,9,1294,2451,1272,-1179
2017,4,29,10,1213,2432,1243,-1189
2017,4,29,11,1277,2449,1232,-1217
2017,4,29,12,1245,2535,1148,-1387
2017,4,29,13,1304,2720,1125,-1595
2017,4,29,14,1282,3014,1197,-1817
2017,4,29,15,1473,3314,1272,-2042
2017,4,29,16,1651,3464,1270,-2194
2017,4,29,17,1637,3495,1233,-2262
2017,4,29,18,1606,3510,1272,-2238
2017,4,29,19,1561,3427,1275,-2152
2017,4,29,20,1460,3228,1150,-2078
2017,4,29,21,1380,3085,1053,-2032
2017,4,29,22,1327,2981,1012,-1969
2017,4,29,23,1341,3009,1036,-1973
2017,4,30,0,1342,3032,1060,-1972
2017,4,30,1,1352,3156,1141,-2015
2017,4,30,2,1366,3312,1252,-2060
2017,4,30,3,1384,3310,1244,-2066
2017,4,30,4,1412,3321,1237,-2084
2017,4,30,5,1437,3324,1417,-1907
2017,4,30,6,1746,3141,1450,-1691
2017,4,30,7,1544,2678,1158,-1520
2017,4,30,8,1379,2513,1162,-1351
2017,4,30,9,1313,2420,1244,-1176
2017,4,30,10,1298,2342,1183,-1159
2017,4,30,11,1314,2368,1208,-1160
2017,4,30,12,1293,2367,1182,-1185
2017,4,30,13,1298,2465,1201,-1264
2017,4,30,14,1304,2606,1229,-1377
2017,4,30,15,1313,2806,1284,-1522
2017,4,30,16,1519,3027,1343,-1684
2017,4,30,17,1576,3166,1384,-1782
2017,4,30,18,1568,3179,1382,-1797
2017,4,30,19,1568,3160,1385,-1775
2017,4,30,20,1577,3093,1410,-1683
2017,4,30,21,1524,2947,1320,-1627
2017,4,30,22,1523,2941,1352,-1589
2017,4,30,23,1523,2960,1353,-1607
2017,5,1,0,1525,3035,1379,-1656
2017,5,1,1,1582,3110,1389,-1721
2017,5,1,2,1673,3222,1476,-1746
2017,5,1,3,1718,3213,1420,-1793
2017,5,1,4,1825,3281,1425,-1856
2017,5,1,5,1738,3186,1398,-1788
2017,5,1,6,1772,2888,1318,-1570
2017,5,1,7,1585,2650,1335,-1315
2017,5,1,8,1374,2472,1330,-1142
2017,5,1,9,1245,2383,1278,-1105
2017,5,1,10,1287,2363,1250,-1113
2017,5,1,11,1204,2423,1243,-1180
2017,5,1,12,1228,2627,1260,-1367
2017,5,1,13,1504,3213,1471,-1742
2017,5,1,14,1491,3586,1431,-2155
2017,5,1,15,1556,3809,1462,-2347
2017,5,1,16,1611,3804,1356,-2448
2017,5,1,17,1606,3785,1347,-2438
2017,5,1,18,1553,3765,1360,-2405
2017,5,1,19,1536,3726,1314,-2412
2017,5,1,20,1496,3672,1352,-2320
2017,5,1,21,1457,3617,1313,-2304
2017,5,1,22,1409,3597,1365,-2232
2017,5,1,23,1400,3536,1318,-2218
2017,5,2,0,1401,3649,1373,-2276
2017,5,2,1,1468,3719,1388,-2331
2017,5,2,2,1495,3748,1400,-2348
2017,5,2,3,1583,3731,1456,-2275
2017,5,2,4,1614,3760,1526,-2234
2017,5,2,5,1576,3605,1545,-2060
2017,5,2,6,1566,3241,1361,-1880
2017,5,2,7,1572,2900,1530,-1370
2017,5,2,8,1412,2821,1363,-1458
2017,5,2,9,1370,2608,1232,-1376
2017,5,2,10,1386,2544,1201,-1343
2017,5,2,11,1370,2508,1125,-1383
2017,5,2,12,1532,2836,1287,-1549
2017,5,2,13,1757,3296,1510,-1786
2017,5,2,14,1505,3642,1572,-2070
2017,5,2,15,1650,3802,1564,-2238
2017,5,2,16,1655,3750,1550,-2200
2017,5,2,17,1604,3635,1524,-2111
2017,5,2,18,1547,3528,1499,-2029
2017,5,2,19,1487,3365,1419,-1946
2017,5,2,20,1436,3283,1334,-1949
2017,5,2,21,1395,3246,1336,-1910
2017,5,2,22,1363,3137,1259,-1878
2017,5,2,23,1355,3154,1275,-1879
2017,5,3,0,1381,3203,1331,-1872
2017,5,3,1,1511,3390,1455,-1935
2017,5,3,2,1527,3444,1535,-1909
2017,5,3,3,1528,3466,1547,-1919
2017,5,3,4,1587,3531,1577,-1954
2017,5,3,5,1521,3405,1551,-1854
2017,5,3,6,1843,3128,1511,-1617
2017,5,3,7,1572,2874,1521,-1353
2017,5,3,8,1493,2616,1372,-1244
2017,5,3,9,1514,2420,1275,-1145
2017,5,3,10,1493,2381,1280,-1101
2017,5,3,11,1488,2403,1285,-1118
2017,5,3,12,1365,2501,1246,-1255
2017,5,3,13,1649,2910,1426,-1484
2017,5,3,14,1650,3249,1478,-1771
2017,5,3,15,1601,3459,1471,-1988
2017,5,3,16,1646,3473,1452,-2021
2017,5,3,17,1650,3379,1375,-2004
2017,5,3,18,1672,3366,1366,-2000
2017,5,3,19,1694,3419,1497,-1922
2017,5,3,20,1752,3330,1429,-1901
2017,5,3,21,1772,3308,1500,-1808
2017,5,3,22,1798,3352,1691,-1661
2017,5,3,23,1824,3291,1514,-1777
2017,5,4,0,1891,3391,1644,-1747
2017,5,4,1,1925,3416,1654,-1762
2017,5,4,2,1895,3400,1689,-1711
2017,5,4,3,1846,3384,1676,-1708
2017,5,4,4,1819,3435,1678,-1757
2017,5,4,5,1724,3385,1670,-1715
2017,5,4,6,1959,3104,1682,-1422
2017,5,4,7,1685,2746,1437,-1309
2017,5,4,8,1333,2435,1282,-1153
2017,5,4,9,1249,2271,1219,-1052
2017,5,4,10,1239,2212,1211,-1001
2017,5,4,11,1253,2226,1199,-1027
2017,5,4,12,1331,2334,1239,-1095
2017,5,4,13,1458,2667,1375,-1292
2017,5,4,14,1342,2840,1260,-1580
2017,5,4,15,1349,3179,1406,-1773
2017,5,4,16,1411,3178,1395,-1783
2017,5,4,17,1419,3221,1452,-1769
2017,5,4,18,1332,3106,1325,-1781
2017,5,4,19,1357,3173,1406,-1767
2017,5,4,20,1379,3217,1427,-1790
2017,5,4,21,1403,3252,1424,-1828
2017,5,4,22,1401,3289,1437,-1852
2017,5,4,23,1451,3284,1416,-1868
2017,5,5,0,1402,3268,1444,-1824
2017,5,5,1,1422,3282,1450,-1832
2017,5,5,2,1444,3255,1444,-1811
2017,5,5,3,1389,3164,1337,-1827
2017,5,5,4,1392,3202,1374,-1828
2017,5,5,5,1340,2952,1329,-1623
2017,5,5,6,1417,2737,1324,-1413
2017,5,5,7,1402,2513,1339,-1174
2017,5,5,8,1199,2347,1185,-1162
2017,5,5,9,1047,2133,1032,-1101
2017,5,5,10,1071,2077,1090,-987
2017,5,5,11,998,2065,1062,-1003
2017,5,5,12,1013,2132,1045,-1087
2017,5,5,13,1199,2394,984,-1410
2017,5,5,14,1212,2734,1132,-1602
2017,5,5,15,1315,2971,1223,-1748
2017,5,5,16,1347,2974,1256,-1718
2017,5,5,17,1364,3027,1344,-1683
2017,5,5,18,1359,3057,1248,-1809
2017,5,5,19,1398,3061,1268,-1793
2017,5,5,20,1406,3074,1221,-1853
2017,5,5,21,1407,3056,1184,-1872
2017,5,5,22,1407,2967,1225,-1742
2017,5,5,23,1408,3005,1335,-1670
2017,5,6,0,1407,3020,1349,-1671
2017,5,6,1,1407,3030,1395,-1635
2017,5,6,2,1408,3012,1362,-1650
2017,5,6,3,1409,2950,1303,-1647
2017,5,6,4,1409,3013,1293,-1720
2017,5,6,5,1408,3004,1276,-1728
2017,5,6,6,1383,2852,1268,-1584
2017,5,6,7,1344,2633,1290,-1343
2017,5,6,8,1105,2417,1176,-1241
2017,5,6,9,1069,2332,1130,-1202
2017,5,6,10,1190,2324,1188,-1136
2017,5,6,11,1228,2347,1172,-1175
2017,5,6,12,1199,2394,1116,-1278
2017,5,6,13,1265,2516,1107,-1409
2017,5,6,14,1137,2629,937,-1692
2017,5,6,15,1185,2866,1093,-1773
2017,5,6,16,1478,3183,1189,-1994
2017,5,6,17,1533,3066,1012,-2054
2017,5,6,18,1512,3154,1142,-2012
2017,5,6,19,1441,2969,1052,-1917
2017,5,6,20,1359,2917,1088,-1829
2017,5,6,21,1271,2875,1087,-1788
2017,5,6,22,1215,2813,1071,-1742
2017,5,6,23,1234,2728,1069,-1659
2017,5,7,0,1257,2738,1108,-1630
2017,5,7,1,1279,2761,1067,-1694
2017,5,7,2,1300,2797,1135,-1662
2017,5,7,3,1315,2882,1210,-1672
2017,5,7,4,1374,2916,1229,-1687
2017,5,7,5,1384,3001,1305,-1696
2017,5,7,6,1692,2950,1339,-1611
2017,5,7,7,1576,2755,1297,-1458
2017,5,7,8,1181,2530,1208,-1322
2017,5,7,9,1205,2476,1214,-1262
2017,5,7,10,1144,2383,1052,-1331
2017,5,7,11,1019,2408,1096,-1312
2017,5,7,12,1083,2487,1151,-1336
2017,5,7,13,1198,2535,1076,-1459
2017,5,7,14,984,2633,994,-1639
2017,5,7,15,1111,2811,958,-1853
2017,5,7,16,1299,3077,1017,-2060
2017,5,7,17,1406,3189,1056,-2133
2017,5,7,18,1423,3193,1102,-2091
2017,5,7,19,1385,3136,1092,-2044
2017,5,7,20,1336,2992,1006,-1986
2017,5,7,21,1290,2883,980,-1903
2017,5,7,22,1259,2808,976,-1832
2017,5,7,23,1256,2818,1008,-1810
2017,5,8,0,1283,2873,1065,-1808
2017,5,8,1,1238,3035,1166,-1869
2017,5,8,2,1283,3114,1217,-1897
2017,5,8,3,1246,3216,1291,-1925
2017,5,8,4,1251,3300,1380,-1920
2017,5,8,5,1255,3291,1384,-1907
2017,5,8,6,1260,3061,1386,-1675
2017,5,8,7,1273,2665,1219,-1446
2017,5,8,8,1224,2491,1204,-1287
2017,5,8,9,1050,2318,1133,-1185
2017,5,8,10,993,2301,1032,-1269
2017,5,8,11,1062,2350,1039,-1311
2017,5,8,12,1321,2659,1282,-1377
2017,5,8,13,1609,3004,1439,-1565
2017,5,8,14,1566,3349,1530,-1819
2017,5,8,15,1693,3517,1491,-2026
2017,5,8,16,1706,3506,1419,-2087
2017,5,8,17,1654,3455,1356,-2099
2017,5,8,18,1613,3424,1404,-2020
2017,5,8,19,1568,3371,1355,-2016
2017,5,8,20,1538,3310,1456,-1854
2017,5,8,21,1563,3296,1523,-1773
2017,5,8,22,1578,3226,1501,-1725
2017,5,8,23,1559,3198,1471,-1727
2017,5,9,0,1569,3212,1483,-1729
2017,5,9,1,1557,3257,1503,-1754
2017,5,9,2,1572,3270,1545,-1725
2017,5,9,3,1558,3264,1648,-1616
2017,5,9,4,1598,3316,1620,-1696
2017,5,9,5,1528,3279,1520,-1759
2017,5,9,6,1696,3019,1530,-1489
2017,5,9,7,1439,2673,1409,-1264
2017,5,9,8,1294,2454,1422,-1032
2017,5,9,9,1246,2301,1305,-996
2017,5,9,10,1265,2271,1237,-1034
2017,5,9,11,1249,2328,1213,-1115
2017,5,9,12,1364,2618,1374,-1244
2017,5,9,13,1538,2953,1451,-1502
2017,5,9,14,1464,3288,1340,-1948
2017,5,9,15,1474,3452,1408,-2044
2017,5,9,16,1660,3410,1382,-2028
2017,5,9,17,1611,3328,1366,-1962
2017,5,9,18,1626,3293,1366,-1927
2017,5,9,19,1593,3246,1314,-1932
2017,5,9,20,1547,3228,1360,-1868
2017,5,9,21,1527,3207,1396,-1811
2017,5,9,22,1525,3192,1359,-1833
2017,5,9,23,1523,3249,1384,-1865
2017,5,10,0,1543,3266,1376,-1890
2017,5,10,1,1640,3305,1428,-1877
2017,5,10,2,1632,3308,1433,-1875
2017,5,10,3,1604,3304,1406,-1898
2017,5,10,4,1656,3347,1413,-1934
2017,5,10,5,1603,3308,1432,-1876
2017,5,10,6,1775,3044,1464,-1580
2017,5,10,7,1364,2779,1341,-1438
2017,5,10,8,1063,2343,1114,-1229
2017,5,10,9,1014,2248,980,-1268
2017,5,10,10,1018,2204,978,-1226
2017,5,10,11,1039,2223,989,-1234
2017,5,10,12,1126,2407,1078,-1329
2017,5,10,13,1286,2778,1220,-1558
2017,5,10,14,1267,3073,1193,-1880
2017,5,10,15,1223,3323,1231,-2092
2017,5,10,16,1262,3318,1200,-2118
2017,5,10,17,1240,3294,1196,-2098
2017,5,10,18,1223,3295,1222,-2073
2017,5,10,19,1223,3273,1183,-2090
2017,5,10,20,1223,3276,1195,-2081
2017,5,10,21,1223,3267,1186,-2081
2017,5,10,22,1224,3211,1140,-2071
2017,5,10,23,1226,3223,1154,-2069
2017,5,11,0,1307,3295,1202,-2093
2017,5,11,1,1328,3320,1202,-2118
2017,5,11,2,1290,3282,1203,-2079
2017,5,11,3,1258,3284,1210,-2074
2017,5,11,4,1275,3326,1251,-2075
2017,5,11,5,1226,3259,1248,-2011
2017,5,11,6,1383,2752,1043,-1709
2017,5,11,7,1312,2465,933,-1532
2017,5,11,8,1025,2309,944,-1365
2017,5,11,9,1018,2205,951,-1254
2017,5,11,10,950,2128,960,-1168
2017,5,11,11,973,2124,1016,-1108
2017,5,11,12,1057,2214,1078,-1136
2017,5,11,13,1148,2530,1100,-1430
2017,5,11,14,1145,2768,986,-1782
2017,5,11,15,1305,3134,1126,-2008
2017,5,11,16,1361,3282,1227,-2055
2017,5,11,17,1397,3263,1177,-2086
2017,5,11,18,1351,3298,1178,-2120
2017,5,11,19,1365,3379,1276,-2103
2017,5,11,20,1343,3348,1362,-1986
2017,5,11,21,1325,3323,1277,-2046
2017,5,11,22,1278,3361,1274,-2087
2017,5,11,23,1309,3322,1275,-2047
2017,5,12,0,1336,3289,1357,-1932
2017,5,12,1,1349,3344,1433,-1911
2017,5,12,2,1253,3351,1409,-1942
2017,5,12,3,1247,3306,1247,-2059
2017,5,12,4,1242,3313,1177,-2136
2017,5,12,5,1232,3258,1231,-2027
2017,5,12,6,1425,2902,1113,-1789
2017,5,12,7,1328,2629,1075,-1554
2017,5,12,8,1061,2465,1015,-1450
2017,5,12,9,1096,2414,1065,-1349
2017,5,12,10,1065,2366,1011,-1355
2017,5,12,11,1053,2391,1039,-1352
2017,5,12,12,1025,2513,1071,-1442
2017,5,12,13,1055,2805,1112,-1693
2017,5,12,14,1057,3312,1271,-2041
2017,5,12,15,1314,3599,1427,-2172
2017,5,12,16,1314,3569,1380,-2189
2017,5,12,17,1318,3519,1360,-2159
2017,5,12,18,1284,3475,1362,-2113
2017,5,12,19,1281,3431,1319,-2112
2017,5,12,20,1181,3394,1405,-1989
2017,5,12,21,1384,3231,1409,-1822
2017,5,12,22,1389,3098,1312,-1786
2017,5,12,23,1111,3080,1359,-1721
2017,5,13,0,1310,3046,1323,-1723
2017,5,13,1,1309,3096,1245,-1851
2017,5,13,2,1308,3280,1282,-1998
2017,5,13,3,1304,3307,1222,-2085
2017,5,13,4,1303,3307,1223,-2084
2017,5,13,5,1385,3332,1261,-2071
2017,5,13,6,1679,3158,1282,-1876
2017,5,13,7,1449,2915,1273,-1642
2017,5,13,8,1226,2707,1259,-1448
2017,5,13,9,1044,2462,1097,-1365
2017,5,13,10,1165,2479,1119,-1360
2017,5,13,11,1125,2459,1044,-1415
2017,5,13,12,1158,2542,1124,-1418
2017,5,13,13,1086,2687,1191,-1496
2017,5,13,14,1085,2800,1140,-1660
2017,5,13,15,1104,3075,1200,-1875
2017,5,13,16,1201,3300,1164,-2136
2017,5,13,17,1256,3362,1090,-2272
2017,5,13,18,1257,3200,962,-2238
2017,5,13,19,1260,3149,1074,-2075
2017,5,13,20,1217,3050,1019,-2031
2017,5,13,21,1179,2933,942,-1991
2017,5,13,22,1195,2835,930,-1905
2017,5,13,23,1212,2777,982,-1795
2017,5,14,0,1228,2784,1144,-1640
2017,5,14,1,1243,2906,1171,-1735
2017,5,14,2,1253,2928,1177,-1751
2017,5,14,3,1285,2941,1071,-1870
2017,5,14,4,1291,3005,1233,-1772
2017,5,14,5,1297,3027,1291,-1736
2017,5,14,6,1449,3084,1415,-1669
2017,5,14,7,1256,2757,1273,-1484
2017,5,14,8,1146,2486,1140,-1346
2017,5,14,9,1024,2345,1071,-1274
2017,5,14,10,1056,2302,1093,-1209
2017,5,14,11,991,2286,1072,-1214
2017,5,14,12,1069,2338,1096,-1242
2017,5,14,13,1032,2433,1154,-1279
2017,5,14,14,1005,2566,1143,-1423
2017,5,14,15,1081,2776,1103,-1673
2017,5,14,16,1268,2969,1010,-1959
2017,5,14,17,1256,3058,891,-2167
2017,5,14,18,1293,3089,975,-2114
2017,5,14,19,1310,3019,925,-2094
2017,5,14,20,1312,2954,917,-2037
2017,5,14,21,1259,2853,916,-1937
2017,5,14,22,1263,2791,908,-1883
2017,5,14,23,1270,2773,993,-1780
2017,5,15,0,1275,2822,1039,-1783
2017,5,15,1,1282,2871,1027,-1844
2017,5,15,2,1334,2949,1144,-1805
2017,5,15,3,1393,3023,1237,-1786
2017,5,15,4,1474,3290,1431,-1859
2017,5,15,5,1466,3308,1468,-1840
2017,5,15,6,1572,3085,1475,-1610
2017,5,15,7,1396,2697,1229,-1468
2017,5,15,8,1032,2411,1037,-1374
2017,5,15,9,1035,2351,1015,-1336
2017,5,15,10,1004,2314,965,-1349
2017,5,15,11,1002,2341,951,-1390
2017,5,15,12,1039,2533,1063,-1470
2017,5,15,13,1268,3031,1357,-1674
2017,5,15,14,1273,3355,1278,-2077
2017,5,15,15,1273,3552,1296,-2256
2017,5,15,16,1284,3546,1244,-2302
2017,5,15,17,1270,3540,1314,-2226
2017,5,15,18,1254,3543,1337,-2206
2017,5,15,19,1427,3513,1319,-2194
2017,5,15,20,1393,3510,1299,-2211
2017,5,15,21,1366,3492,1292,-2200
2017,5,15,22,1314,3488,1301,-2187
2017,5,15,23,1301,3495,1302,-2193
2017,5,16,0,1327,3562,1346,-2216
2017,5,16,1,1378,3661,1373,-2288
2017,5,16,2,1384,3693,1367,-2326
2017,5,16,3,1402,3686,1376,-2310
2017,5,16,4,1462,3677,1405,-2272
2017,5,16,5,1422,3544,1380,-2164
2017,5,16,6,1542,3255,1403,-1852
2017,5,16,7,1521,2997,1306,-1691
2017,5,16,8,1187,2775,1221,-1554
2017,5,16,9,1162,2581,1150,-1431
2017,5,16,10,1078,2520,1177,-1343
2017,5,16,11,1106,2548,1221,-1327
2017,5,16,12,1168,2717,1281,-1436
2017,5,16,13,1151,3008,1351,-1657
2017,5,16,14,1119,3364,1259,-2105
2017,5,16,15,1261,3598,1204,-2394
2017,5,16,16,1283,3603,1218,-2385
2017,5,16,17,1237,3569,1149,-2420
2017,5,16,18,1200,3516,1264,-2252
2017,5,16,19,1222,3433,1376,-2057
2017,5,16,20,1240,3291,1357,-1934
2017,5,16,21,1246,3227,1344,-1883
2017,5,16,22,1250,3154,1326,-1828
2017,5,16,23,1256,3017,1171,-1846
2017,5,17,0,1270,3061,1170,-1891
2017,5,17,1,1269,3146,1171,-1975
2017,5,17,2,1260,3280,1291,-1989
2017,5,17,3,1246,3355,1337,-2018
2017,5,17,4,1231,3415,1305,-2110
2017,5,17,5,1217,3366,1189,-2177
2017,5,17,6,1213,3068,1141,-1927
2017,5,17,7,1163,2722,1097,-1625
2017,5,17,8,1022,2545,1110,-1435
2017,5,17,9,1054,2439,1022,-1417
2017,5,17,10,982,2411,981,-1430
2017,5,17,11,976,2439,1005,-1434
2017,5,17,12,1128,2681,1193,-1488
2017,5,17,13,1325,2998,1241,-1757
2017,5,17,14,1351,3376,1257,-2119
2017,5,17,15,1324,3513,1290,-2223
2017,5,17,16,1328,3581,1291,-2290
2017,5,17,17,1320,3514,1298,-2216
2017,5,17,18,1313,3468,1314,-2154
2017,5,17,19,1307,3235,1137,-2098
2017,5,17,20,1301,3155,1198,-1957
2017,5,17,21,1299,3098,1148,-1950
2017,5,17,22,1301,3062,1120,-1942
2017,5,17,23,1306,3069,1149,-1920
2017,5,18,0,1311,3099,1184,-1915
2017,5,18,1,1312,3141,1194,-1947
2017,5,18,2,1307,3130,1205,-1925
2017,5,18,3,1298,3305,1357,-1948
2017,5,18,4,1288,3359,1328,-2031
2017,5,18,5,1277,3328,1353,-1975
2017,5,18,6,1331,3107,1375,-1732
2017,5,18,7,1324,2849,1298,-1551
2017,5,18,8,966,2493,1064,-1429
2017,5,18,9,915,2369,964,-1405
2017,5,18,10,871,2342,954,-1388
2017,5,18,11,884,2368,940,-1428
2017,5,18,12,901,2510,968,-1542
2017,5,18,13,1230,2918,1129,-1789
2017,5,18,14,1197,3262,1127,-2135
2017,5,18,15,1197,3527,1194,-2333
2017,5,18,16,1206,3506,1193,-2313
2017,5,18,17,1237,3410,1170,-2240
2017,5,18,18,1350,3360,1172,-2188
2017,5,18,19,1310,3335,1195,-2140
2017,5,18,20,1287,3314,1199,-2115
2017,5,18,21,1265,3276,1180,-2096
2017,5,18,22,1237,3246,1205,-2041
2017,5,18,23,1240,3186,1177,-2009
2017,5,19,0,1260,3215,1193,-2022
2017,5,19,1,1288,3265,1201,-2064
2017,5,19,2,1283,3211,1162,-2049
2017,5,19,3,1260,3208,1168,-2040
2017,5,19,4,1267,3251,1168,-2083
2017,5,19,5,1245,3166,1089,-2077
2017,5,19,6,1377,2970,1187,-1783
2017,5,19,7,1103,2620,1052,-1568
2017,5,19,8,1124,2537,1125,-1412
2017,5,19,9,1048,2402,1070,-1332
2017,5,19,10,1004,2305,1010,-1295
2017,5,19,11,1033,2348,1031,-1317
2017,5,19,12,1157,2513,1093,-1420
2017,5,19,13,1284,2770,1153,-1617
2017,5,19,14,1238,3087,1147,-1940
2017,5,19,15,1307,3345,1204,-2141
2017,5,19,16,1344,3359,1208,-2151
2017,5,19,17,1333,3351,1239,-2112
2017,5,19,18,1328,3347,1304,-2043
2017,5,19,19,1313,3330,1264,-2066
2017,5,19,20,1297,3317,1293,-2024
2017,5,19,21,1290,3307,1255,-2052
2017,5,19,22,1277,3282,1250,-2032
2017,5,19,23,1263,3276,1262,-2014
2017,5,20,0,1260,3285,1266,-2019
2017,5,20,1,1281,3278,1256,-2022
2017,5,20,2,1226,3218,1250,-1968
2017,5,20,3,1199,3119,1214,-1905
2017,5,20,4,1207,3136,1234,-1902
2017,5,20,5,1217,3102,1255,-1847
2017,5,20,6,1366,2968,1342,-1626
2017,5,20,7,1230,2481,1085,-1396
2017,5,20,8,1027,2302,1051,-1251
2017,5,20,9,1003,2181,1005,-1176
2017,5,20,10,972,2128,1049,-1079
2017,5,20,11,997,2110,1044,-1066
2017,5,20,12,999,2131,980,-1151
2017,5,20,13,990,2190,979,-1211
2017,5,20,14,989,2306,960,-1346
2017,5,20,15,964,2483,924,-1559
2017,5,20,16,1012,2680,965,-1715
2017,5,20,17,1158,2912,1169,-1743
2017,5,20,18,1245,2822,1005,-1817
2017,5,20,19,1273,2813,959,-1854
2017,5,20,20,1271,2870,1062,-1808
2017,5,20,21,1243,2900,1119,-1781
2017,5,20,22,1227,2836,1088,-1748
2017,5,20,23,1225,2836,1098,-1738
2017,5,21,0,1237,2901,1072,-1829
2017,5,21,1,1259,2931,1088,-1843
2017,5,21,2,1239,2991,1140,-1851
2017,5,21,3,1214,3074,1226,-1848
2017,5,21,4,1217,3044,1201,-1843
2017,5,21,5,1197,3101,1233,-1868
2017,5,21,6,1417,2911,1211,-1700
2017,5,21,7,1298,2647,1150,-1497
2017,5,21,8,995,2344,1026,-1318
2017,5,21,9,939,2186,984,-1202
2017,5,21,10,923,2127,971,-1156
2017,5,21,11,932,2096,951,-1145
2017,5,21,12,910,2114,944,-1170
2017,5,21,13,929,2127,942,-1185
2017,5,21,14,909,2214,913,-1301
2017,5,21,15,917,2382,903,-1479
2017,5,21,16,961,2597,948,-1649
2017,5,21,17,966,2796,1031,-1765
2017,5,21,18,1033,2857,1033,-1824
2017,5,21,19,1197,3117,1266,-1851
2017,5,21,20,1197,3134,1293,-1841
2017,5,21,21,1181,3119,1287,-1832
2017,5,21,22,1163,3120,1291,-1829
2017,5,21,23,1189,3154,1295,-1859
2017,5,22,0,1237,3220,1286,-1934
2017,5,22,1,1217,3285,1277,-2008
2017,5,22,2,1228,3307,1279,-2028
2017,5,22,3,1334,3291,1315,-1976
2017,5,22,4,1348,3296,1317,-1979
2017,5,22,5,1319,3303,1336,-1967
2017,5,22,6,1474,3046,1305,-1741
2017,5,22,7,1235,2747,1269,-1478
2017,5,22,8,1117,2343,1055,-1288
2017,5,22,9,979,2159,993,-1166
2017,5,22,10,971,2108,996,-1112
2017,5,22,11,1025,2135,1023,-1112
2017,5,22,12,1118,2205,1027,-1178
2017,5,22,13,1122,2406,1165,-1241
2017,5,22,14,1129,2673,1173,-1500
2017,5,22,15,1317,2929,1325,-1604
2017,5,22,16,1415,3052,1347,-1705
2017,5,22,17,1473,3189,1464,-1725
2017,5,22,18,1526,3262,1489,-1773
2017,5,22,19,1563,3336,1509,-1827
2017,5,22,20,1623,3384,1661,-1723
2017,5,22,21,1656,3426,1705,-1721
2017,5,22,22,1677,3531,1773,-1758
2017,5,22,23,1705,3573,1751,-1822
2017,5,23,0,1834,3623,1775,-1848
2017,5,23,1,1723,3655,1784,-1871
2017,5,23,2,1839,3641,1829,-1812
2017,5,23,3,1799,3595,1805,-1790
2017,5,23,4,1747,3544,1787,-1757
2017,5,23,5,1688,3490,1662,-1828
2017,5,23,6,1628,3205,1575,-1630
2017,5,23,7,1332,2892,1378,-1514
2017,5,23,8,1299,2682,1381,-1301
2017,5,23,9,1251,2563,1364,-1199
2017,5,23,10,1273,2501,1368,-1133
2017,5,23,11,1187,2430,1313,-1117
2017,5,23,12,1255,2511,1328,-1183
2017,5,23,13,1286,2690,1305,-1385
2017,5,23,14,1282,2956,1323,-1633
2017,5,23,15,1423,3193,1362,-1831
2017,5,23,16,1471,3302,1362,-1940
2017,5,23,17,1496,3306,1309,-1997
2017,5,23,18,1537,3422,1352,-2070
2017,5,23,19,1555,3469,1383,-2086
2017,5,23,20,1561,3515,1397,-2118
2017,5,23,21,1564,3539,1480,-2059
2017,5,23,22,1547,3545,1503,-2042
2017,5,23,23,1539,3559,1481,-2078
2017,5,24,0,1601,3585,1542,-2043
2017,5,24,1,1598,3531,1576,-1955
2017,5,24,2,1572,3428,1454,-1974
2017,5,24,3,1469,3275,1289,-1986
2017,5,24,4,1428,3180,1229,-1951
2017,5,24,5,1261,3104,1140,-1964
2017,5,24,6,1259,2831,1219,-1612
2017,5,24,7,1129,2488,1184,-1304
2017,5,24,8,1054,2291,1203,-1088
2017,5,24,9,1110,2185,1210,-975
2017,5,24,10,1154,2142,1183,-959
2017,5,24,11,1162,2140,1179,-961
2017,5,24,12,1189,2231,1200,-1031
2017,5,24,13,1241,2416,1187,-1229
2017,5,24,14,1145,2730,1183,-1547
2017,5,24,15,1434,3072,1425,-1647
2017,5,24,16,1480,3084,1370,-1714
2017,5,24,17,1465,3080,1381,-1699
2017,5,24,18,1443,3079,1407,-1672
2017,5,24,19,1445,3097,1436,-1661
2017,5,24,20,1447,3114,1466,-1648
2017,5,24,21,1448,3066,1425,-1641
2017,5,24,22,1448,3053,1453,-1600
2017,5,24,23,1444,3031,1440,-1591
2017,5,25,0,1434,3030,1425,-1605
2017,5,25,1,1437,3069,1447,-1622
2017,5,25,2,1476,3101,1492,-1609
2017,5,25,3,1499,3166,1546,-1620
2017,5,25,4,1512,3223,1494,-1729
2017,5,25,5,1514,3283,1557,-1726
2017,5,25,6,1429,3078,1523,-1555
2017,5,25,7,1408,2799,1529,-1270
2017,5,25,8,1062,2415,1145,-1270
2017,5,25,9,980,2278,1040,-1238
2017,5,25,10,1111,2347,1141,-1206
2017,5,25,11,1015,2253,995,-1258
2017,5,25,12,943,2343,961,-1382
2017,5,25,13,1064,2595,1068,-1527
2017,5,25,14,1161,2974,1112,-1862
2017,5,25,15,1203,3178,1113,-2065
2017,5,25,16,1309,3174,1091,-2083
2017,5,25,17,1304,3129,1034,-2095
2017,5,25,18,1310,3117,1059,-2058
2017,5,25,19,1304,3109,1122,-1987
2017,5,25,20,1303,3047,1014,-2033
2017,5,25,21,1303,3053,1018,-2035
2017,5,25,22,1299,3015,1059,-1956
2017,5,25,23,1310,2976,1027,-1949
2017,5,26,0,1318,3005,1041,-1964
2017,5,26,1,1344,3159,1168,-1991
2017,5,26,2,1332,3220,1249,-1971
2017,5,26,3,1319,3293,1346,-1947
2017,5,26,4,1318,3293,1350,-1943
2017,5,26,5,1295,3307,1343,-1964
2017,5,26,6,1537,3089,1347,-1742
2017,5,26,7,1340,2729,1210,-1519
2017,5,26,8,1100,2394,1127,-1267
2017,5,26,9,1040,2223,1064,-1159
2017,5,26,10,977,2182,1063,-1119
2017,5,26,11,996,2190,1066,-1124
2017,5,26,12,1001,2262,979,-1283
2017,5,26,13,1100,2534,1075,-1459
2017,5,26,14,1090,2740,988,-1752
2017,5,26,15,1250,3036,1121,-1915
2017,5,26,16,1250,3183,1195,-1988
2017,5,26,17,1250,3179,1211,-1968
2017,5,26,18,1311,3271,1285,-1986
2017,5,26,19,1285,3271,1253,-2018
2017,5,26,20,1294,3315,1296,-2019
2017,5,26,21,1304,3334,1307,-2027
2017,5,26,22,1307,3336,1296,-2040
2017,5,26,23,1310,3370,1268,-2102
2017,5,27,0,1335,3413,1261,-2152
2017,5,27,1,1351,3459,1293,-2166
2017,5,27,2,1288,3419,1344,-2075
2017,5,27,3,1261,3294,1291,-2003
2017,5,27,4,1261,3216,1279,-1937
2017,5,27,5,1261,3184,1252,-1932
2017,5,27,6,1477,2979,1247,-1732
2017,5,27,7,1388,2792,1309,-1483
2017,5,27,8,1124,2456,1179,-1277
2017,5,27,9,1037,2265,1152,-1113
2017,5,27,10,1027,2152,1133,-1019
2017,5,27,11,1024,2121,1114,-1007
2017,5,27,12,1003,2124,1098,-1026
2017,5,27,13,995,2143,1087,-1056
2017,5,27,14,1028,2215,1010,-1205
2017,5,27,15,1025,2402,968,-1434
2017,5,27,16,1164,2606,938,-1668
2017,5,27,17,1255,2762,958,-1804
2017,5,27,18,1163,2840,1030,-1810
2017,5,27,19,1172,2878,1046,-1832
2017,5,27,20,1186,2889,1054,-1835
2017,5,27,21,1178,2897,1034,-1863
2017,5,27,22,1167,2935,1055,-1880
2017,5,27,23,1216,2986,1066,-1920
2017,5,28,0,1267,3116,1142,-1974
2017,5,28,1,1267,3260,1254,-2006
2017,5,28,2,1272,3348,1357,-1991
2017,5,28,3,1271,3325,1355,-1970
2017,5,28,4,1271,3261,1357,-1904
2017,5,28,5,1265,3254,1357,-1897
2017,5,28,6,1578,3093,1345,-1748
2017,5,28,7,1374,2706,1184,-1522
2017,5,28,8,1005,2384,1066,-1318
2017,5,28,9,1020,2249,1071,-1178
2017,5,28,10,986,2160,1046,-1114
2017,5,28,11,941,2124,1046,-1078
2017,5,28,12,975,2119,1051,-1068
2017,5,28,13,975,2094,1027,-1067
2017,5,28,14,975,2161,952,-1209
2017,5,28,15,974,2339,952,-1387
2017,5,28,16,974,2552,922,-1630
2017,5,28,17,1127,2721,952,-1769
2017,5,28,18,1177,2824,1056,-1768
2017,5,28,19,1257,2875,1069,-1806
2017,5,28,20,1257,2914,1074,-1840
2017,5,28,21,1258,2938,1070,-1868
2017,5,28,22,1258,2982,1079,-1903
2017,5,28,23,1257,3246,1284,-1962
2017,5,29,0,1258,3386,1364,-2022
2017,5,29,1,1286,3433,1360,-2073
2017,5,29,2,1273,3424,1356,-2068
2017,5,29,3,1257,3370,1351,-2019
2017,5,29,4,1257,3275,1304,-1971
2017,5,29,5,1257,3237,1247,-1990
2017,5,29,6,1502,3007,1246,-1761
2017,5,29,7,1385,2784,1279,-1505
2017,5,29,8,1258,2569,1279,-1290
2017,5,29,9,1210,2362,1215,-1147
2017,5,29,10,1081,2236,1108,-1128
2017,5,29,11,1080,2171,1083,-1088
2017,5,29,12,1086,2196,1121,-1075
2017,5,29,13,1229,2225,1139,-1086
2017,5,29,14,1218,2252,1125,-1127
2017,5,29,15,1251,2410,1143,-1267
2017,5,29,16,1415,2564,1201,-1363
2017,5,29,17,1540,2744,1261,-1483
2017,5,29,18,1491,2846,1227,-1619
2017,5,29,19,1561,2883,1220,-1663
2017,5,29,20,1489,2934,1266,-1668
2017,5,29,21,1489,2901,1267,-1634
2017,5,29,22,1489,2911,1220,-1691
2017,5,29,23,1488,3007,1276,-1731
2017,5,30,0,1491,3219,1434,-1785
2017,5,30,1,1535,3328,1519,-1809
2017,5,30,2,1529,3395,1567,-1828
2017,5,30,3,1494,3382,1588,-1794
2017,5,30,4,1544,3354,1534,-1820
2017,5,30,5,1612,3321,1546,-1775
2017,5,30,6,1701,3077,1571,-1506
2017,5,30,7,1452,2717,1274,-1443
2017,5,30,8,1203,2717,1274,-9999
2017,5,30,9,1119,2362,1215,-9999
2017,5,30,10,1071,2236,1108,-9999
2017,5,30,11,1083,2171,1083,-9999
2017,5,30,12,1091,2196,1121,-9999
2017,5,30,13,1175,2225,1139,-9999
2017,5,30,14,1225,2252,1125,-9999
2017,5,30,15,1314,2410,1143,-9999
2017,5,30,16,1401,2564,1201,-9999
2017,5,30,17,1415,2744,1261,-9999
2017,5,30,18,1271,2846,1227,-9999
2017,5,30,19,1263,2883,1220,-9999
2017,5,30,20,1260,2934,1266,-9999
2017,5,30,21,1243,2901,1267,-9999
2017,5,30,22,1218,2911,1220,-9999
2017,5,30,23,1266,3007,1276,-9999
2017,5,31,0,1192,3219,1434,-9999
2017,5,31,1,1235,3328,1519,-9999
2017,5,31,2,1269,3395,1567,-9999
2017,5,31,3,1316,3382,1588,-9999
2017,5,31,4,1334,3354,1534,-9999
2017,5,31,5,1275,3321,1546,-9999
2017,5,31,6,1337,3077,1571,-9999
2017,5,31,7,1292,2717,1274,-9999
2017,5,31,8,1088,2375,1174,-1201
2017,5,31,9,1095,2265,1157,-1108
2017,5,31,10,971,2227,1118,-1109
2017,5,31,11,1133,2306,1185,-1121
2017,5,31,12,1109,2382,1114,-1268
2017,5,31,13,1475,2621,1109,-1512
2017,5,31,14,1019,2782,1077,-1705
2017,5,31,15,1234,3179,1278,-1901
2017,5,31,16,1282,3308,1348,-1960
2017,5,31,17,1275,3306,1349,-1957
2017,5,31,18,1275,3308,1337,-1971
2017,5,31,19,1279,3318,1345,-1973
2017,5,31,20,1284,3326,1340,-1986
2017,5,31,21,1294,3341,1358,-1983
2017,5,31,22,1307,3339,1346,-1993
2017,5,31,23,1318,3357,1427,-1930
2017,6,1,0,1335,3367,1436,-1931
2017,6,1,1,1355,3393,1397,-1996
2017,6,1,2,1363,3375,1398,-1977
2017,6,1,3,1370,3367,1487,-1880
2017,6,1,4,1377,3371,1628,-1743
2017,6,1,5,1384,3297,1651,-1646
2017,6,1,6,1691,3064,1654,-1410
2017,6,1,7,1438,2649,1421,-1228
2017,6,1,8,1152,2347,1236,-1111
2017,6,1,9,1109,2232,1202,-1030
2017,6,1,10,1257,2258,1255,-1003
2017,6,1,11,1154,2180,1110,-1070
2017,6,1,12,1005,2238,1076,-1162
2017,6,1,13,1035,2412,1164,-1248
2017,6,1,14,1037,2699,1180,-1519
2017,6,1,15,1093,2986,1144,-1842
2017,6,1,16,1058,3069,1041,-2028
2017,6,1,17,1137,3138,1115,-2023
2017,6,1,18,1203,3204,1223,-1981
2017,6,1,19,1230,3290,1291,-1999
2017,6,1,20,1083,3120,1117,-2003
2017,6,1,21,1044,3087,1084,-2003
2017,6,1,22,1025,3056,1073,-1983
2017,6,1,23,1163,3158,1196,-1962
2017,6,2,0,1213,3143,1159,-1984
2017,6,2,1,1367,3286,1284,-2002
2017,6,2,2,1293,3195,1335,-1860
2017,6,2,3,1171,3163,1371,-1792
2017,6,2,4,1131,3030,1275,-1755
2017,6,2,5,1183,2964,1333,-1631
2017,6,2,6,1275,2756,1353,-1403
2017,6,2,7,1273,2499,1321,-1178
2017,6,2,8,1094,2333,1315,-1018
2017,6,2,9,948,2240,1228,-1012
2017,6,2,10,1002,2193,1252,-941
2017,6,2,11,1005,2190,1267,-923
2017,6,2,12,1023,2267,1208,-1059
2017,6,2,13,974,2438,1171,-1267
2017,6,2,14,954,2709,1137,-1572
2017,6,2,15,933,2941,1146,-1795
2017,6,2,16,1049,3095,1252,-1843
2017,6,2,17,1143,3276,1369,-1907
2017,6,2,18,1224,3301,1386,-1915
2017,6,2,19,1274,3313,1398,-1915
2017,6,2,20,1164,3311,1416,-1895
2017,6,2,21,1204,3308,1405,-1903
2017,6,2,22,1220,3297,1372,-1925
2017,6,2,23,1243,3306,1343,-1963
2017,6,3,0,1376,3332,1317,-2015
2017,6,3,1,1216,3332,1325,-2007
2017,6,3,2,1163,3285,1328,-1957
2017,6,3,3,1127,3216,1326,-1890
2017,6,3,4,1196,3187,1327,-1860
2017,6,3,5,1167,3195,1340,-1855
2017,6,3,6,1392,2941,1209,-1732
2017,6,3,7,1213,2642,1134,-1508
2017,6,3,8,1144,2351,1109,-1242
2017,6,3,9,1067,2171,1032,-1139
2017,6,3,10,965,2098,976,-1122
2017,6,3,11,993,2075,980,-1095
2017,6,3,12,1025,2083,981,-1102
2017,6,3,13,1032,2128,990,-1138
2017,6,3,14,965,2202,980,-1222
2017,6,3,15,965,2410,987,-1423
2017,6,3,16,1016,2624,993,-1631
2017,6,3,17,1099,2775,1045,-1730
2017,6,3,18,1131,2847,1072,-1775
2017,6,3,19,1136,2843,1064,-1779
2017,6,3,20,1116,2891,1121,-1770
2017,6,3,21,1123,2857,1121,-1736
2017,6,3,22,1132,2872,1178,-1694
2017,6,3,23,1145,2762,1118,-1644
2017,6,4,0,1156,2868,1140,-1728
2017,6,4,1,1165,2873,1108,-1765
2017,6,4,2,1171,2833,1086,-1747
2017,6,4,3,1174,2804,1092,-1712
2017,6,4,4,1178,2671,1011,-1660
2017,6,4,5,1182,2785,1150,-1635
2017,6,4,6,1184,2611,1156,-1455
2017,6,4,7,1103,2406,1132,-1274
2017,6,4,8,990,2228,1110,-1118
2017,6,4,9,972,2132,1152,-980
2017,6,4,10,954,2064,1068,-996
2017,6,4,11,962,2038,949,-1089
2017,6,4,12,1076,2071,1048,-1023
2017,6,4,13,1058,2082,1121,-961
2017,6,4,14,1017,2154,991,-1163
2017,6,4,15,1036,2331,982,-1349
2017,6,4,16,1142,2552,1099,-1453
2017,6,4,17,1213,2689,1100,-1589
2017,6,4,18,1286,2741,1153,-1588
2017,6,4,19,1286,2770,1189,-1581
2017,6,4,20,1291,2745,1213,-1532
2017,6,4,21,1305,2717,1225,-1492
2017,6,4,22,1325,2762,1312,-1450
2017,6,4,23,1270,2707,1298,-1409
2017,6,5,0,1298,2785,1381,-1404
2017,6,5,1,1347,2891,1426,-1465
2017,6,5,2,1361,2947,1438,-1509
2017,6,5,3,1310,2878,1368,-1510
2017,6,5,4,1265,2891,1366,-1525
2017,6,5,5,1261,2904,1344,-1560
2017,6,5,6,1263,2714,1300,-1414
2017,6,5,7,1241,2459,1180,-1279
2017,6,5,8,1186,2285,1119,-1166
2017,6,5,9,963,2198,1108,-1090
2017,6,5,10,975,2174,1085,-1089
2017,6,5,11,997,2194,1066,-1128
2017,6,5,12,1030,2309,1084,-1225
2017,6,5,13,1072,2504,990,-1514
2017,6,5,14,1052,2816,955,-1861
2017,6,5,15,1178,3156,1114,-2042
2017,6,5,16,1314,3253,1237,-2016
2017,6,5,17,1314,3231,1219,-2012
2017,6,5,18,1338,3235,1220,-2015
2017,6,5,19,1338,3269,1248,-2021
2017,6,5,20,1339,3287,1288,-1999
2017,6,5,21,1340,3273,1309,-1964
2017,6,5,22,1350,3278,1346,-1932
2017,6,5,23,1361,3302,1368,-1934
2017,6,6,0,1372,3336,1357,-1979
2017,6,6,1,1402,3366,1388,-1978
2017,6,6,2,1406,3363,1389,-1974
2017,6,6,3,1405,3325,1372,-1953
2017,6,6,4,1404,3344,1372,-1972
2017,6,6,5,1403,3328,1372,-1956
2017,6,6,6,1500,3097,1408,-1689
2017,6,6,7,1384,2722,1232,-1490
2017,6,6,8,1046,2368,1110,-1258
2017,6,6,9,923,2249,1094,-1155
2017,6,6,10,993,2200,1134,-1066
2017,6,6,11,1009,2196,1149,-1047
2017,6,6,12,1191,2276,1253,-1023
2017,6,6,13,1321,2566,1435,-1131
2017,6,6,14,1473,2863,1441,-1422
2017,6,6,15,1477,3199,1560,-1639
2017,6,6,16,1548,3141,1441,-1700
2017,6,6,17,1612,3317,1555,-1762
2017,6,6,18,1619,3385,1562,-1823
2017,6,6,19,1719,3405,1633,-1772
2017,6,6,20,1628,3449,1696,-1753
2017,6,6,21,1648,3494,1735,-1759
2017,6,6,22,1673,3524,1741,-1783
2017,6,6,23,1799,3570,1758,-1812
2017,6,7,0,1872,3618,1745,-1873
2017,6,7,1,1868,3670,1749,-1921
2017,6,7,2,1870,3655,1754,-1901
2017,6,7,3,1848,3588,1764,-1824
2017,6,7,4,1819,3515,1743,-1772
2017,6,7,5,1749,3467,1714,-1753
2017,6,7,6,1715,3204,1696,-1508
2017,6,7,7,1470,2893,1344,-1549
2017,6,7,8,1138,2546,1132,-1414
2017,6,7,9,1068,2359,1042,-1317
2017,6,7,10,982,2222,964,-1258
2017,6,7,11,979,2206,963,-1243
2017,6,7,12,1029,2277,980,-1297
2017,6,7,13,1136,2545,1209,-1336
2017,6,7,14,1150,2801,1254,-1547
2017,6,7,15,1329,3048,1381,-1667
2017,6,7,16,1475,3115,1392,-1723
2017,6,7,17,1554,3192,1454,-1738
2017,6,7,18,1624,3392,1695,-1697
2017,6,7,19,1670,3436,1698,-1738
2017,6,7,20,1680,3496,1825,-1671
2017,6,7,21,1729,3530,1856,-1674
2017,6,7,22,1751,3561,1820,-1741
2017,6,7,23,1778,3590,1785,-1805
2017,6,8,0,1698,3606,1736,-1870
2017,6,8,1,1830,3621,1725,-1896
2017,6,8,2,1766,3574,1734,-1840
2017,6,8,3,1696,3509,1685,-1824
2017,6,8,4,1643,3475,1618,-1857
2017,6,8,5,1602,3416,1552,-1864
2017,6,8,6,1507,3150,1532,-1618
2017,6,8,7,1203,2633,1192,-1441
2017,6,8,8,1097,2447,1272,-1175
2017,6,8,9,1142,2322,1330,-992
2017,6,8,10,1206,2252,1395,-857
2017,6,8,11,1252,2179,1196,-983
2017,6,8,12,1100,2250,1133,-1117
2017,6,8,13,1140,2421,1280,-1141
2017,6,8,14,1185,2739,1301,-1438
2017,6,8,15,1264,2947,1271,-1676
2017,6,8,16,1383,2985,1241,-1744
2017,6,8,17,1380,3122,1196,-1926
2017,6,8,18,1383,3062,1105,-1957
2017,6,8,19,1384,3312,1306,-2006
2017,6,8,20,1447,3323,1415,-1908
2017,6,8,21,1399,3057,1187,-1870
2017,6,8,22,1356,3013,1144,-1869
2017,6,8,23,1362,3011,1126,-1885
2017,6,9,0,1372,3023,1260,-1763
2017,6,9,1,1383,3024,1282,-1742
2017,6,9,2,1392,3002,1304,-1698
2017,6,9,3,1396,2986,1398,-1588
2017,6,9,4,1398,2965,1348,-1617
2017,6,9,5,1394,2959,1351,-1608
2017,6,9,6,1336,2767,1371,-1396
2017,6,9,7,1097,2518,1392,-1126
2017,6,9,8,1217,2326,1247,-1079
2017,6,9,9,1201,2221,1225,-996
2017,6,9,10,1177,2200,1322,-878
2017,6,9,11,1176,2190,1277,-913
2017,6,9,12,1196,2261,1226,-1035
2017,6,9,13,1163,2435,1206,-1229
2017,6,9,14,1094,2717,1142,-1575
2017,6,9,15,1310,2939,1105,-1834
2017,6,9,16,1276,3110,1211,-1899
2017,6,9,17,1254,3019,1121,-1898
2017,6,9,18,1281,3014,1138,-1876
2017,6,9,19,1300,2998,1131,-1867
2017,6,9,20,1301,2987,1098,-1889
2017,6,9,21,1282,2966,1077,-1889
2017,6,9,22,1246,2935,1072,-1863
2017,6,9,23,1238,2915,1072,-1843
2017,6,10,0,1353,2933,1057,-1876
2017,6,10,1,1346,2949,1096,-1853
2017,6,10,2,1288,2904,1235,-1669
2017,6,10,3,1296,2893,1265,-1628
2017,6,10,4,1217,2839,1314,-1525
2017,6,10,5,1232,2851,1243,-1608
2017,6,10,6,1381,2717,1188,-1529
2017,6,10,7,1184,2501,1198,-1303
2017,6,10,8,1167,2342,1234,-1108
2017,6,10,9,1084,2228,1144,-1084
2017,6,10,10,1077,2164,1136,-1028
2017,6,10,11,1047,2157,1109,-1048
2017,6,10,12,1025,2201,1121,-1080
2017,6,10,13,1013,2241,1068,-1173
2017,6,10,14,971,2353,938,-1415
2017,6,10,15,950,2536,950,-1586
2017,6,10,16,1060,2707,928,-1779
2017,6,10,17,1115,2819,912,-1907
2017,6,10,18,1162,2857,903,-1954
2017,6,10,19,1151,2835,887,-1948
2017,6,10,20,1144,2794,885,-1909
2017,6,10,21,1140,2749,936,-1813
2017,6,10,22,1141,2712,991,-1721
2017,6,10,23,1147,2712,1036,-1676
2017,6,11,0,1155,2792,1081,-1711
2017,6,11,1,1264,2740,1022,-1718
2017,6,11,2,1271,2749,1043,-1706
2017,6,11,3,1272,2730,1029,-1701
2017,6,11,4,1274,2752,1068,-1684
2017,6,11,5,1271,2859,1148,-1711
2017,6,11,6,1266,2858,1240,-1618
2017,6,11,7,1282,2517,1083,-1434
2017,6,11,8,1018,2346,1071,-1275
2017,6,11,9,995,2202,980,-1222
2017,6,11,10,996,2151,980,-1171
2017,6,11,11,1022,2165,998,-1167
2017,6,11,12,1040,2186,998,-1188
2017,6,11,13,1011,2185,975,-1210
2017,6,11,14,916,2253,908,-1345
2017,6,11,15,891,2414,884,-1530
2017,6,11,16,995,2605,878,-1727
2017,6,11,17,1113,2743,973,-1770
2017,6,11,18,1173,2786,992,-1794
2017,6,11,19,1168,2809,1048,-1761
2017,6,11,20,1163,2791,1023,-1768
2017,6,11,21,1133,2780,1023,-1757
2017,6,11,22,1108,2734,937,-1797
2017,6,11,23,1083,2743,916,-1827
2017,6,12,0,1134,2811,1023,-1788
2017,6,12,1,1185,2891,1034,-1857
2017,6,12,2,1206,3150,1279,-1871
2017,6,12,3,1204,3186,1311,-1875
2017,6,12,4,1214,3179,1343,-1836
2017,6,12,5,1196,3180,1351,-1829
2017,6,12,6,1438,2998,1367,-1631
2017,6,12,7,1322,2742,1400,-1342
2017,6,12,8,887,2293,1140,-1153
2017,6,12,9,935,2206,1098,-1108
2017,6,12,10,895,2140,1051,-1089
2017,6,12,11,961,2161,1060,-1101
2017,6,12,12,1042,2232,1038,-1194
2017,6,12,13,1335,2423,1133,-1290
2017,6,12,14,977,2693,1128,-1565
2017,6,12,15,1474,2931,1170,-1761
2017,6,12,16,1494,3145,1300,-1845
2017,6,12,17,1488,3125,1222,-1903
2017,6,12,18,1501,3067,1127,-1940
2017,6,12,19,1492,3064,1167,-1897
2017,6,12,20,1465,3070,1254,-1816
2017,6,12,21,1443,3038,1232,-1806
2017,6,12,22,1429,3001,1235,-1766
2017,6,12,23,1450,2997,1259,-1738
2017,6,13,0,1452,3009,1288,-1721
2017,6,13,1,1468,3066,1315,-1751
2017,6,13,2,1418,3093,1383,-1710
2017,6,13,3,1336,3073,1379,-1694
2017,6,13,4,1299,3044,1377,-1667
2017,6,13,5,1277,2985,1348,-1637
2017,6,13,6,1384,2765,1358,-1407
2017,6,13,7,1248,2493,1331,-1162
2017,6,13,8,1150,2328,1276,-1052
2017,6,13,9,1112,2247,1259,-988
2017,6,13,10,1115,2202,1258,-944
2017,6,13,11,1082,2214,1265,-949
2017,6,13,12,1118,2294,1255,-1039
2017,6,13,13,1100,2511,1248,-1263
2017,6,13,14,1075,2777,1217,-1560
2017,6,13,15,1300,3038,1297,-1741
2017,6,13,16,1349,3039,1311,-1728
2017,6,13,17,1368,3027,1327,-1700
2017,6,13,18,1370,3079,1344,-1735
2017,6,13,19,1373,3058,1350,-1708
2017,6,13,20,1421,3032,1339,-1693
2017,6,13,21,1403,3049,1422,-1627
2017,6,13,22,1435,3002,1380,-1622
2017,6,13,23,1437,2989,1386,-1603
2017,6,14,0,1439,3039,1501,-1538
2017,6,14,1,1440,3049,1515,-1534
2017,6,14,2,1440,3029,1601,-1428
2017,6,14,3,1439,3001,1617,-1384
2017,6,14,4,1438,2993,1578,-1415
2017,6,14,5,1436,2987,1600,-1387
2017,6,14,6,1459,2763,1591,-1172
2017,6,14,7,1209,2504,1543,-961
2017,6,14,8,1446,2326,1484,-842
2017,6,14,9,1377,2239,1488,-751
2017,6,14,10,1420,2202,1503,-699
2017,6,14,11,1353,2202,1506,-696
2017,6,14,12,1415,2299,1447,-852
2017,6,14,13,1124,2508,1211,-1297
2017,6,14,14,1014,2798,1149,-1649
2017,6,14,15,1171,3152,1328,-1824
2017,6,14,16,1197,3215,1306,-1909
2017,6,14,17,1271,3196,1404,-1792
2017,6,14,18,1302,3210,1395,-1815
2017,6,14,19,1310,3233,1415,-1818
2017,6,14,20,1315,3221,1345,-1876
2017,6,14,21,1312,3201,1328,-1873
2017,6,14,22,1295,3171,1267,-1904
2017,6,14,23,1290,3232,1316,-1916
2017,6,15,0,1337,3297,1340,-1957
2017,6,15,1,1399,3339,1369,-1970
2017,6,15,2,1419,3290,1325,-1965
2017,6,15,3,1425,3263,1316,-1947
2017,6,15,4,1425,3257,1335,-1922
2017,6,15,5,1439,3258,1377,-1881
2017,6,15,6,1749,3065,1350,-1715
2017,6,15,7,1723,2806,1413,-1393
2017,6,15,8,1315,2447,1220,-1227
2017,6,15,9,1337,2239,1189,-1050
2017,6,15,10,1229,2192,1185,-1007
2017,6,15,11,1187,2184,1086,-1098
2017,6,15,12,1177,2263,1116,-1147
2017,6,15,13,1197,2452,1062,-1390
2017,6,15,14,1430,2744,1043,-1701
2017,6,15,15,1523,3180,1265,-1915
2017,6,15,16,1542,3259,1317,-1942
2017,6,15,17,1569,3298,1386,-1912
2017,6,15,18,1405,3349,1411,-1938
2017,6,15,19,1458,3395,1475,-1920
2017,6,15,20,1467,3382,1514,-1868
2017,6,15,21,1479,3382,1510,-1872
2017,6,15,22,1487,3274,1365,-1909
2017,6,15,23,1564,3389,1542,-1847
2017,6,16,0,1568,3398,1586,-1812
2017,6,16,1,1570,3448,1564,-1884
2017,6,16,2,1517,3424,1578,-1846
2017,6,16,3,1475,3385,1469,-1916
2017,6,16,4,1435,3296,1399,-1897
2017,6,16,5,1458,3179,1337,-1842
2017,6,16,6,1551,2881,1294,-1587
2017,6,16,7,1526,2652,1385,-1267
2017,6,16,8,1294,2324,1334,-990
2017,6,16,9,1194,2202,1300,-902
2017,6,16,10,1302,2157,1376,-781
2017,6,16,11,1351,2147,1388,-759
2017,6,16,12,1369,2244,1458,-786
2017,6,16,13,1306,2410,1390,-1020
2017,6,16,14,1035,2666,1250,-1416
2017,6,16,15,1095,2894,1322,-1572
2017,6,16,16,1196,2970,1355,-1615
2017,6,16,17,1198,2991,1304,-1687
2017,6,16,18,1203,2997,1333,-1664
2017,6,16,19,1212,2985,1342,-1643
2017,6,16,20,1224,2976,1375,-1601
2017,6,16,21,1238,2942,1236,-1706
2017,6,16,22,1251,2919,1208,-1711
2017,6,16,23,1287,2905,1264,-1641
2017,6,17,0,1269,2897,1291,-1606
2017,6,17,1,1274,2897,1348,-1549
2017,6,17,2,1276,2851,1361,-1490
2017,6,17,3,1275,2790,1209,-1581
2017,6,17,4,1273,2760,1259,-1501
2017,6,17,5,1269,2768,1254,-1514
2017,6,17,6,1417,2676,1286,-1390
2017,6,17,7,1268,2455,1246,-1209
2017,6,17,8,1160,2292,1282,-1010
2017,6,17,9,1147,2204,1271,-933
2017,6,17,10,1058,2140,1243,-897
2017,6,17,11,1083,2124,1143,-981
2017,6,17,12,1093,2156,1064,-1092
2017,6,17,13,1045,2199,1007,-1192
2017,6,17,14,924,2294,973,-1321
2017,6,17,15,899,2485,1023,-1462
2017,6,17,16,1023,2707,1011,-1696
2017,6,17,17,1014,2772,911,-1861
2017,6,17,18,1041,2806,893,-1913
2017,6,17,19,1058,2779,882,-1897
2017,6,17,20,1072,2827,1080,-1747
2017,6,17,21,1036,2728,1020,-1708
2017,6,17,22,1032,2703,1031,-1672
2017,6,17,23,1076,2676,965,-1711
2017,6,18,0,1154,2693,1005,-1688
2017,6,18,1,1178,2696,886,-1810
2017,6,18,2,1189,2728,1039,-1689
2017,6,18,3,1167,2719,1105,-1614
2017,6,18,4,1147,2748,1099,-1649
2017,6,18,5,1175,2748,1119,-1629
2017,6,18,6,1416,2622,1067,-1555
2017,6,18,7,1168,2417,1015,-1402
2017,6,18,8,941,2242,986,-1256
2017,6,18,9,920,2140,958,-1182
2017,6,18,10,865,2089,990,-1099
2017,6,18,11,881,2068,982,-1086
2017,6,18,12,974,2086,1033,-1053
2017,6,18,13,1058,2099,953,-1146
2017,6,18,14,996,2182,950,-1232
2017,6,18,15,1051,2356,933,-1423
2017,6,18,16,1091,2582,1083,-1499
2017,6,18,17,1162,2726,1062,-1664
2017,6,18,18,1264,2823,1176,-1647
2017,6,18,19,1264,2839,1202,-1637
2017,6,18,20,1235,2836,1242,-1594
2017,6,18,21,1230,2824,1414,-1410
2017,6,18,22,1293,2797,1514,-1283
2017,6,18,23,1401,2782,1518,-1264
2017,6,19,0,1453,2812,1478,-1334
2017,6,19,1,1367,2853,1363,-1490
2017,6,19,2,1356,2874,1345,-1529
2017,6,19,3,1418,3035,1477,-1558
2017,6,19,4,1356,3045,1506,-1539
2017,6,19,5,1380,3062,1494,-1568
2017,6,19,6,1640,2878,1421,-1457
2017,6,19,7,1291,2628,1402,-1226
2017,6,19,8,1093,2261,1123,-1138
2017,6,19,9,1032,2159,987,-1172
2017,6,19,10,1007,2110,969,-1141
2017,6,19,11,1001,2143,1002,-1141
2017,6,19,12,1028,2223,973,-1250
2017,6,19,13,1103,2401,1012,-1389
2017,6,19,14,994,2635,986,-1649
2017,6,19,15,1256,2982,1203,-1779
2017,6,19,16,1428,3123,1478,-1645
2017,6,19,17,1492,3193,1507,-1686
2017,6,19,18,1711,3226,1595,-1631
2017,6,19,19,1703,3403,1848,-1555
2017,6,19,20,1656,3451,1868,-1583
2017,6,19,21,1799,3476,1842,-1634
2017,6,19,22,1869,3480,1885,-1595
2017,6,19,23,1889,3482,1837,-1645
2017,6,20,0,1769,3488,1779,-1709
2017,6,20,1,1795,3519,1752,-1767
2017,6,20,2,1754,3502,1749,-1753
2017,6,20,3,1726,3443,1747,-1696
2017,6,20,4,1652,3415,1724,-1691
2017,6,20,5,1594,3367,1652,-1715
2017,6,20,6,1874,3152,1699,-1453
2017,6,20,7,1495,2741,1511,-1230
2017,6,20,8,1122,2399,1205,-1194
2017,6,20,9,1012,2260,1179,-1081
2017,6,20,10,1201,2218,1255,-963
2017,6,20,11,1084,2182,1121,-1061
2017,6,20,12,1121,2262,1240,-1022
2017,6,20,13,1191,2428,1344,-1084
2017,6,20,14,1078,2657,1288,-1369
2017,6,20,15,1111,2884,1295,-1589
2017,6,20,16,1121,2978,1354,-1624
2017,6,20,17,1146,3042,1369,-1673
2017,6,20,18,1255,3308,1565,-1743
2017,6,20,19,1368,3411,1643,-1768
2017,6,20,20,1419,3455,1650,-1805
2017,6,20,21,1419,3457,1652,-1805
2017,6,20,22,1424,3438,1651,-1787
2017,6,20,23,1440,3413,1656,-1757
2017,6,21,0,1434,3414,1680,-1734
2017,6,21,1,1437,3433,1686,-1747
2017,6,21,2,1441,3376,1659,-1717
2017,6,21,3,1443,3320,1638,-1682
2017,6,21,4,1440,3187,1526,-1661
2017,6,21,5,1477,3199,1566,-1633
2017,6,21,6,1657,3095,1671,-1424
2017,6,21,7,1614,2683,1506,-1177
2017,6,21,8,1152,2386,1301,-1085
2017,6,21,9,1063,2246,1293,-953
2017,6,21,10,1098,2236,1351,-885
2017,6,21,11,1064,2198,1243,-955
2017,6,21,12,1105,2269,1207,-1062
2017,6,21,13,1120,2452,1207,-1245
2017,6,21,14,986,2789,1213,-1576
2017,6,21,15,1214,3080,1308,-1772
2017,6,21,16,1295,3262,1392,-1870
2017,6,21,17,1227,3291,1387,-1904
2017,6,21,18,1258,3303,1406,-1897
2017,6,21,19,1278,3316,1523,-1793
2017,6,21,20,1303,3178,1498,-1680
2017,6,21,21,1321,3145,1476,-1669
2017,6,21,22,1330,3176,1539,-1637
2017,6,21,23,1332,3177,1534,-1643
2017,6,22,0,1331,3077,1411,-1666
2017,6,22,1,1331,3097,1396,-1701
2017,6,22,2,1330,3075,1396,-1679
2017,6,22,3,1327,2999,1381,-1618
2017,6,22,4,1319,2970,1369,-1601
2017,6,22,5,1305,3067,1440,-1627
2017,6,22,6,1299,3015,1569,-1446
2017,6,22,7,1256,2577,1434,-1143
2017,6,22,8,872,2351,1195,-1156
2017,6,22,9,769,2249,1090,-1159
2017,6,22,10,797,2223,1062,-1161
2017,6,22,11,842,2220,1033,-1187
2017,6,22,12,825,2339,1092,-1247
2017,6,22,13,814,2548,1138,-1410
2017,6,22,14,839,2747,1100,-1647
2017,6,22,15,1038,3053,1317,-1736
2017,6,22,16,1088,3135,1361,-1774
2017,6,22,17,1150,3245,1435,-1810
2017,6,22,18,1204,3248,1410,-1838
2017,6,22,19,1430,3346,1467,-1879
2017,6,22,20,1281,3352,1551,-1801
2017,6,22,21,1302,3345,1571,-1774
2017,6,22,22,1238,3353,1578,-1775
2017,6,22,23,1238,3315,1503,-1812
2017,6,23,0,1238,3403,1616,-1787
2017,6,23,1,1238,3470,1644,-1826
2017,6,23,2,1238,3430,1627,-1803
2017,6,23,3,1243,3372,1594,-1778
2017,6,23,4,1315,3323,1575,-1748
2017,6,23,5,1291,3282,1548,-1734
2017,6,23,6,1600,3125,1592,-1533
2017,6,23,7,1324,2801,1476,-1325
2017,6,23,8,902,2522,1232,-1290
2017,6,23,9,823,2306,1082,-1224
2017,6,23,10,778,2246,1054,-1192
2017,6,23,11,764,2220,1007,-1213
2017,6,23,12,786,2286,1000,-1286
2017,6,23,13,826,2487,1054,-1433
2017,6,23,14,921,2815,1195,-1620
2017,6,23,15,1013,3044,1227,-1817
2017,6,23,16,1149,3241,1364,-1877
2017,6,23,17,1099,3231,1334,-1897
2017,6,23,18,1347,3313,1582,-1731
2017,6,23,19,1424,3437,1676,-1761
2017,6,23,20,1468,3439,1623,-1816
2017,6,23,21,1484,3452,1614,-1838
2017,6,23,22,1341,3514,1653,-1861
2017,6,23,23,1341,3558,1630,-1928
2017,6,24,0,1445,3591,1655,-1936
2017,6,24,1,1447,3613,1593,-2020
2017,6,24,2,1377,3567,1587,-1980
2017,6,24,3,1346,3485,1595,-1890
2017,6,24,4,1357,3389,1565,-1824
2017,6,24,5,1346,3348,1506,-1842
2017,6,24,6,1457,3201,1548,-1653
2017,6,24,7,1215,2938,1287,-1651
2017,6,24,8,964,2712,1236,-1476
2017,6,24,9,844,2455,1114,-1341
2017,6,24,10,753,2280,1015,-1265
2017,6,24,11,694,2193,969,-1224
2017,6,24,12,761,2194,973,-1221
2017,6,24,13,711,2200,967,-1233
2017,6,24,14,654,2336,985,-1351
2017,6,24,15,661,2500,987,-1513
2017,6,24,16,717,2713,985,-1728
2017,6,24,17,912,3001,1225,-1776
2017,6,24,18,972,3206,1346,-1860
2017,6,24,19,1100,3246,1272,-1974
2017,6,24,20,1088,3257,1286,-1971
2017,6,24,21,1095,3314,1322,-1992
2017,6,24,22,1096,3473,1328,-2145
2017,6,24,23,1161,3564,1383,-2181
2017,6,25,0,1220,3635,1399,-2236
2017,6,25,1,1265,3677,1417,-2260
2017,6,25,2,1249,3672,1417,-2255
2017,6,25,3,1206,3628,1357,-2271
2017,6,25,4,1264,3549,1331,-2218
2017,6,25,5,1238,3493,1341,-2152
2017,6,25,6,1267,3321,1351,-1970
2017,6,25,7,1494,3068,1330,-1738
2017,6,25,8,1151,2800,1314,-1486
2017,6,25,9,1012,2480,1194,-1286
2017,6,25,10,853,2314,1075,-1239
2017,6,25,11,829,2246,1081,-1165
2017,6,25,12,787,2215,1039,-1176
2017,6,25,13,751,2198,1001,-1197
2017,6,25,14,745,2291,964,-1327
2017,6,25,15,738,2469,932,-1537
2017,6,25,16,902,2822,1081,-1741
2017,6,25,17,961,3043,1323,-1720
2017,6,25,18,1264,3216,1504,-1712
2017,6,25,19,1350,3328,1584,-1744
2017,6,25,20,1257,3452,1605,-1847
2017,6,25,21,1263,3635,1697,-1938
2017,6,25,22,1269,3762,1704,-2058
2017,6,25,23,1461,3812,1628,-2184
2017,6,26,0,1615,3883,1635,-2248
2017,6,26,1,1662,3938,1665,-2273
2017,6,26,2,1663,3923,1626,-2297
2017,6,26,3,1591,3865,1663,-2202
2017,6,26,4,1492,3764,1592,-2172
2017,6,26,5,1485,3713,1663,-2050
2017,6,26,6,1557,3465,1668,-1797
2017,6,26,7,1470,3171,1674,-1497
2017,6,26,8,1073,2940,1510,-1430
2017,6,26,9,1175,2775,1470,-1305
2017,6,26,10,860,2552,1275,-1277
2017,6,26,11,834,2486,1232,-1254
2017,6,26,12,881,2545,1263,-1282
2017,6,26,13,939,2747,1376,-1371
2017,6,26,14,941,2898,1423,-1475
2017,6,26,15,1169,3149,1480,-1669
2017,6,26,16,1313,3206,1417,-1789
2017,6,26,17,1348,3351,1427,-1924
2017,6,26,18,1315,3392,1374,-2018
2017,6,26,19,1360,3461,1419,-2042
2017,6,26,20,1311,3503,1480,-2023
2017,6,26,21,1342,3527,1645,-1882
2017,6,26,22,1354,3527,1511,-2016
2017,6,26,23,1431,3560,1544,-2016
2017,6,27,0,1477,3573,1582,-1991
2017,6,27,1,1468,3577,1558,-2019
2017,6,27,2,1336,3445,1394,-2051
2017,6,27,3,1335,3366,1485,-1881
2017,6,27,4,1383,3316,1566,-1750
2017,6,27,5,1381,3225,1478,-1747
2017,6,27,6,1408,3048,1544,-1504
2017,6,27,7,1245,2724,1504,-1220
2017,6,27,8,1097,2540,1471,-1069
2017,6,27,9,1073,2324,1333,-991
2017,6,27,10,1218,2489,1349,-1140
2017,6,27,11,940,2493,1332,-1161
2017,6,27,12,1089,2563,1295,-1268
2017,6,27,13,1184,2699,1346,-1353
2017,6,27,14,927,2644,1049,-1595
2017,6,27,15,1147,2849,986,-1863
2017,6,27,16,1230,2981,1032,-1949
2017,6,27,17,1203,3065,1046,-2019
2017,6,27,18,1280,3151,1111,-2040
2017,6,27,19,1292,3184,1167,-2017
2017,6,27,20,1356,3272,1250,-2022
2017,6,27,21,1306,3359,1323,-2036
2017,6,27,22,1411,3493,1472,-2021
2017,6,27,23,1419,3512,1543,-1969
2017,6,28,0,1628,3586,1592,-1994
2017,6,28,1,1686,3637,1598,-2039
2017,6,28,2,1689,3612,1620,-1992
2017,6,28,3,1698,3572,1611,-1961
2017,6,28,4,1734,3511,1581,-1930
2017,6,28,5,1753,3484,1655,-1829
2017,6,28,6,1754,3313,1726,-1587
2017,6,28,7,1743,3053,1669,-1384
2017,6,28,8,1210,2839,1464,-1375
2017,6,28,9,1130,2622,1343,-1279
2017,6,28,10,969,2411,1215,-1196
2017,6,28,11,933,2341,1185,-1156
2017,6,28,12,1012,2400,1211,-1189
2017,6,28,13,1139,2623,1370,-1253
2017,6,28,14,935,2710,1235,-1475
2017,6,28,15,1220,2833,1174,-1659
2017,6,28,16,1234,3049,1333,-1716
2017,6,28,17,1268,3300,1448,-1852
2017,6,28,18,1316,3415,1532,-1883
2017,6,28,19,1280,3388,1506,-1882
2017,6,28,20,1353,3348,1440,-1908
2017,6,28,21,1313,3382,1547,-1835
2017,6,28,22,1522,3309,1593,-1716
2017,6,28,23,1463,3447,1790,-1657
2017,6,29,0,1562,3325,1771,-1554
2017,6,29,1,1573,3411,1827,-1584
2017,6,29,2,1578,3499,1894,-1605
2017,6,29,3,1575,3339,1736,-1603
2017,6,29,4,1563,3283,1663,-1620
2017,6,29,5,1541,3226,1548,-1678
2017,6,29,6,1608,3269,1815,-1454
2017,6,29,7,1364,2958,1645,-1313
2017,6,29,8,938,2532,1284,-1248
2017,6,29,9,937,2429,1237,-1192
2017,6,29,10,960,2349,1240,-1109
2017,6,29,11,936,2283,1149,-1134
2017,6,29,12,1063,2388,1224,-1164
2017,6,29,13,1085,2592,1306,-1286
2017,6,29,14,931,2692,1183,-1509
2017,6,29,15,1017,2862,1163,-1699
2017,6,29,16,1272,3069,1264,-1805
2017,6,29,17,1498,3124,1285,-1839
2017,6,29,18,1379,3310,1634,-1676
2017,6,29,19,1427,3391,1661,-1730
2017,6,29,20,1524,3452,1787,-1665
2017,6,29,21,1524,3496,1760,-1736
2017,6,29,22,1634,3551,1827,-1724
2017,6,29,23,1773,3695,1949,-1746
2017,6,30,0,1811,3745,1989,-1756
2017,6,30,1,1843,3763,1983,-1780
2017,6,30,2,1800,3751,1936,-1815
2017,6,30,3,1757,3723,1805,-1918
2017,6,30,4,1616,3667,1810,-1857
2017,6,30,5,1580,3615,1820,-1795
2017,6,30,6,1949,3455,1881,-1574
2017,6,30,7,1679,3156,1717,-1439
2017,6,30,8,1348,2923,1528,-1395
2017,6,30,9,1322,2815,1533,-1282
2017,6,30,10,1274,2742,1535,-1207
2017,6,30,11,1258,2721,1538,-1183
2017,6,30,12,1243,2773,1505,-1268
2017,6,30,13,1377,2871,1497,-1374
2017,6,30,14,1291,2854,1331,-1523
2017,6,30,15,1291,3096,1362,-1734
2017,6,30,16,1450,3407,1530,-1877
2017,6,30,17,1516,3538,1540,-1998
2017,6,30,18,1554,3629,1576,-2053
2017,6,30,19,1563,3709,1711,-1998
2017,6,30,20,1609,3754,1813,-1941
2017,6,30,21,1751,3838,1978,-1860
2017,6,30,22,1893,3879,2024,-1855
2017,6,30,23,1916,3924,1962,-1962
2017,7,1,0,1946,3969,1915,-2054
2017,7,1,1,1940,3994,1934,-2060
2017,7,1,2,1866,3939,1936,-2003
2017,7,1,3,1773,3823,1803,-2020
2017,7,1,4,1695,3714,1706,-2008
2017,7,1,5,1636,3651,1709,-1942
2017,7,1,6,2109,3494,1734,-1760
2017,7,1,7,1722,3107,1760,-1347
2017,7,1,8,1310,2776,1602,-1174
2017,7,1,9,1146,2626,1488,-1138
2017,7,1,10,1054,2554,1560,-994
2017,7,1,11,1085,2482,1508,-974
2017,7,1,12,1152,2509,1463,-1046
2017,7,1,13,1123,2360,1318,-1042
2017,7,1,14,1046,2416,1258,-1158
2017,7,1,15,1046,2551,1244,-1307
2017,7,1,16,1178,2725,1409,-1316
2017,7,1,17,1357,2862,1501,-1361
2017,7,1,18,1453,3073,1614,-1459
2017,7,1,19,1451,3144,1719,-1425
2017,7,1,20,1336,3115,1699,-1416
2017,7,1,21,1340,3081,1770,-1311
2017,7,1,22,1337,3072,1768,-1304
2017,7,1,23,1352,3098,1793,-1305
2017,7,2,0,1439,3136,1822,-1314
2017,7,2,1,1579,3224,1910,-1314
2017,7,2,2,1559,3245,1901,-1344
2017,7,2,3,1510,3257,1696,-1561
2017,7,2,4,1620,3214,1690,-1524
2017,7,2,5,1583,3257,1768,-1489
2017,7,2,6,1446,3182,1774,-1408
2017,7,2,7,1246,2972,1513,-1459
2017,7,2,8,1284,2820,1471,-1349
2017,7,2,9,1270,2673,1609,-1064
2017,7,2,10,1151,2600,1586,-1014
2017,7,2,11,1105,2482,1515,-967
2017,7,2,12,1194,2547,1500,-1047
2017,7,2,13,1324,2493,1452,-1041
2017,7,2,14,1004,2511,1319,-1192
2017,7,2,15,813,2387,1207,-1180
2017,7,2,16,1057,2840,1275,-1565
2017,7,2,17,1184,3077,1454,-1623
2017,7,2,18,1316,3145,1400,-1745
2017,7,2,19,1350,3176,1493,-1683
2017,7,2,20,1295,3196,1525,-1671
2017,7,2,21,1303,3225,1600,-1625
2017,7,2,22,1317,3284,1652,-1632
2017,7,2,23,1270,3327,1682,-1645
2017,7,3,0,1333,3412,1689,-1723
2017,7,3,1,1453,3504,1755,-1749
2017,7,3,2,1469,3521,1829,-1692
2017,7,3,3,1439,3506,1832,-1674
2017,7,3,4,1535,3451,1825,-1626
2017,7,3,5,1524,3431,1897,-1534
2017,7,3,6,1509,3320,1962,-1358
2017,7,3,7,1368,2909,1768,-1141
2017,7,3,8,1408,2632,1681,-951
2017,7,3,9,1220,2498,1536,-962
2017,7,3,10,1012,2302,1427,-875
2017,7,3,11,1045,2322,1421,-901
2017,7,3,12,1250,2394,1476,-918
2017,7,3,13,1374,2526,1454,-1072
2017,7,3,14,1080,2522,1181,-1341
2017,7,3,15,912,2661,1142,-1519
2017,7,3,16,1132,3033,1472,-1561
2017,7,3,17,1418,3136,1510,-1626
2017,7,3,18,1237,3257,1531,-1726
2017,7,3,19,1527,3200,1668,-1532
2017,7,3,20,1661,3228,1863,-1365
2017,7,3,21,1705,3257,1863,-1394
2017,7,3,22,1752,3271,1965,-1306
2017,7,3,23,1801,3263,2043,-1220
2017,7,4,0,1851,3273,2060,-1213
2017,7,4,1,1913,3294,2009,-1285
2017,7,4,2,1924,3266,1973,-1293
2017,7,4,3,1879,3194,1916,-1278
2017,7,4,4,1856,3128,1872,-1256
2017,7,4,5,1814,3164,1917,-1247
2017,7,4,6,1827,3052,1960,-1092
2017,7,4,7,1459,2868,1945,-923
2017,7,4,8,1448,2673,1809,-864
2017,7,4,9,1319,2457,1665,-792
2017,7,4,10,1307,2454,1617,-837
2017,7,4,11,1321,2404,1604,-800
2017,7,4,12,1371,2406,1628,-778
2017,7,4,13,1336,2389,1635,-754
2017,7,4,14,1135,2391,1285,-1106
2017,7,4,15,1209,2454,1315,-1139
2017,7,4,16,1537,2717,1386,-1331
2017,7,4,17,1584,2918,1487,-1431
2017,7,4,18,1676,3064,1698,-1366
2017,7,4,19,1715,3273,1923,-1350
2017,7,4,20,1716,3315,1952,-1363
2017,7,4,21,1699,3355,1990,-1365
2017,7,4,22,1693,3351,2056,-1295
2017,7,4,23,1691,3361,2046,-1315
2017,7,5,0,1619,3396,1979,-1417
2017,7,5,1,1633,3434,1888,-1546
2017,7,5,2,1633,3294,1780,-1514
2017,7,5,3,1585,3166,1700,-1466
2017,7,5,4,1542,3086,1612,-1474
2017,7,5,5,1427,3045,1550,-1495
2017,7,5,6,1689,2938,1782,-1156
2017,7,5,7,1570,2828,1733,-1095
2017,7,5,8,1402,2656,1685,-971
2017,7,5,9,1406,2567,1699,-868
2017,7,5,10,1463,2465,1684,-781
2017,7,5,11,1382,2496,1645,-851
2017,7,5,12,1402,2567,1655,-912
2017,7,5,13,1457,2781,1789,-992
2017,7,5,14,1351,2867,1583,-1284
2017,7,5,15,1322,3165,1691,-1474
2017,7,5,16,1347,3301,1739,-1562
2017,7,5,17,1466,3417,1746,-1671
2017,7,5,18,1548,3476,1814,-1662
2017,7,5,19,1605,3605,1948,-1657
2017,7,5,20,1786,3678,2100,-1578
2017,7,5,21,1926,3704,2258,-1446
2017,7,5,22,1960,3792,2289,-1503
2017,7,5,23,1989,3844,2266,-1578
2017,7,6,0,2018,3916,2319,-1597
2017,7,6,1,2034,3975,2301,-1674
2017,7,6,2,1996,3955,2360,-1595
2017,7,6,3,1949,3930,2352,-1578
2017,7,6,4,1932,3828,2345,-1483
2017,7,6,5,1877,3670,2277,-1393
2017,7,6,6,1969,3438,2292,-1146
2017,7,6,7,1821,3047,2029,-1018
2017,7,6,8,1815,2868,1874,-994
2017,7,6,9,1585,2702,1784,-918
2017,7,6,10,1451,2695,1837,-858
2017,7,6,11,1387,2731,1880,-851
2017,7,6,12,1520,2740,1805,-935
2017,7,6,13,1384,2885,1743,-1142
2017,7,6,14,1246,3046,1755,-1291
2017,7,6,15,1167,3101,1693,-1408
2017,7,6,16,1363,3274,1644,-1630
2017,7,6,17,1478,3546,1685,-1861
2017,7,6,18,1495,3594,1692,-1902
2017,7,6,19,1580,3685,1811,-1874
2017,7,6,20,1701,3776,1860,-1916
2017,7,6,21,1806,3824,1955,-1869
2017,7,6,22,1845,3844,2056,-1788
2017,7,6,23,1896,3930,2139,-1791
2017,7,7,0,1911,4000,2174,-1826
2017,7,7,1,1927,4051,2241,-1810
2017,7,7,2,1864,4016,2236,-1780
2017,7,7,3,1790,3928,2180,-1748
2017,7,7,4,1779,3806,2114,-1692
2017,7,7,5,1735,3695,2060,-1635
2017,7,7,6,2040,3567,2209,-1358
2017,7,7,7,1941,3143,2059,-1084
2017,7,7,8,1936,2886,2013,-873
2017,7,7,9,1938,2715,2008,-707
2017,7,7,10,1829,2643,1913,-730
2017,7,7,11,1604,2620,1811,-809
2017,7,7,12,1630,2669,1888,-781
2017,7,7,13,1564,2803,1953,-850
2017,7,7,14,1754,3051,1991,-1060
2017,7,7,15,1793,3243,2002,-1241
2017,7,7,16,1891,3417,2056,-1361
2017,7,7,17,1990,3517,2169,-1348
2017,7,7,18,2106,3589,2238,-1351
2017,7,7,19,1980,3620,2297,-1323
2017,7,7,20,1910,3631,2290,-1341
2017,7,7,21,2026,3627,2266,-1361
2017,7,7,22,2020,3605,2233,-1372
2017,7,7,23,2028,3505,2028,-1477
2017,7,8,0,2213,3427,1984,-1443
2017,7,8,1,2226,3442,1952,-1490
2017,7,8,2,2231,3375,1940,-1435
2017,7,8,3,1986,3366,2060,-1306
2017,7,8,4,2221,3287,1874,-1413
2017,7,8,5,1983,3273,2002,-1271
2017,7,8,6,2196,3182,2149,-1033
2017,7,8,7,1781,2812,1962,-850
2017,7,8,8,1319,2593,1851,-742
2017,7,8,9,1430,2475,1739,-736
2017,7,8,10,1523,2408,1750,-658
2017,7,8,11,1517,2355,1747,-608
2017,7,8,12,1594,2378,1861,-517
2017,7,8,13,1578,2383,1902,-481
2017,7,8,14,1377,2469,1859,-610
2017,7,8,15,1593,2703,1859,-844
2017,7,8,16,1838,2962,2084,-878
2017,7,8,17,1912,3145,2094,-1051
2017,7,8,18,1976,3236,2159,-1077
2017,7,8,19,2041,3282,2162,-1120
2017,7,8,20,1922,3334,2029,-1305
2017,7,8,21,2007,3352,2259,-1093
2017,7,8,22,2110,3366,2359,-1007
2017,7,8,23,2116,3420,2420,-1000
2017,7,9,0,2154,3462,2447,-1015
2017,7,9,1,2191,3521,2334,-1187
2017,7,9,2,2171,3519,2261,-1258
2017,7,9,3,2123,3476,2366,-1110
2017,7,9,4,2268,3396,2469,-927
2017,7,9,5,2260,3354,2483,-871
2017,7,9,6,2319,3187,2568,-619
2017,7,9,7,1978,2951,2226,-725
2017,7,9,8,1787,2637,1866,-771
2017,7,9,9,1789,2592,1902,-690
2017,7,9,10,1764,2511,1800,-711
2017,7,9,11,1824,2473,1801,-672
2017,7,9,12,1531,2411,1677,-734
2017,7,9,13,1467,2322,1509,-813
2017,7,9,14,1299,2310,1554,-756
2017,7,9,15,1419,2525,1738,-787
2017,7,9,16,1687,2728,1684,-1044
2017,7,9,17,1704,2892,1781,-1111
2017,7,9,18,1883,3023,1814,-1209
2017,7,9,19,1977,3097,1958,-1139
2017,7,9,20,1953,3176,2144,-1032
2017,7,9,21,2153,3206,2218,-988
2017,7,9,22,2120,3223,2228,-995
2017,7,9,23,2288,3303,2346,-957
2017,7,10,0,2137,3354,2334,-1020
2017,7,10,1,2197,3518,2416,-1102
2017,7,10,2,2330,3453,2285,-1168
2017,7,10,3,2336,3385,2206,-1179
2017,7,10,4,2333,3412,2373,-1039
2017,7,10,5,2340,3423,2412,-1011
2017,7,10,6,2182,3298,2455,-843
2017,7,10,7,1769,3004,2166,-838
2017,7,10,8,1485,2703,1797,-906
2017,7,10,9,1360,2502,1666,-836
2017,7,10,10,1418,2521,1801,-720
2017,7,10,11,1416,2518,1842,-676
2017,7,10,12,1369,2591,1830,-761
2017,7,10,13,1351,2633,1672,-961
2017,7,10,14,1325,2810,1627,-1183
2017,7,10,15,1469,3196,1805,-1391
2017,7,10,16,1498,3360,1852,-1508
2017,7,10,17,1606,3444,2021,-1423
2017,7,10,18,1797,3457,2127,-1330
2017,7,10,19,1938,3487,2028,-1459
2017,7,10,20,1801,3604,2288,-1316
2017,7,10,21,1833,3650,2342,-1308
2017,7,10,22,1911,3584,2357,-1227
2017,7,10,23,1968,3680,2487,-1193
2017,7,11,0,2053,3721,2486,-1235
2017,7,11,1,2127,3747,2430,-1317
2017,7,11,2,2160,3702,2412,-1290
2017,7,11,3,2133,3638,2453,-1185
2017,7,11,4,2093,3555,2495,-1060
2017,7,11,5,2034,3425,2365,-1060
2017,7,11,6,1982,3332,2349,-983
2017,7,11,7,1564,2863,2022,-841
2017,7,11,8,1693,2706,1822,-884
2017,7,11,9,1635,2539,1701,-838
2017,7,11,10,1332,2523,1719,-804
2017,7,11,11,1265,2533,1776,-757
2017,7,11,12,1618,2594,1799,-795
2017,7,11,13,1463,2878,1857,-1021
2017,7,11,14,1304,2920,1660,-1260
2017,7,11,15,1247,3038,1703,-1335
2017,7,11,16,1235,3222,1594,-1628
2017,7,11,17,1358,3319,1661,-1658
2017,7,11,18,1471,3465,1955,-1510
2017,7,11,19,1567,3534,2017,-1517
2017,7,11,20,1643,3574,1996,-1578
2017,7,11,21,1816,3621,2132,-1489
2017,7,11,22,1863,3626,2148,-1478
2017,7,11,23,1908,3659,2170,-1489
2017,7,12,0,1950,3700,2159,-1541
2017,7,12,1,2001,3750,2164,-1586
2017,7,12,2,1992,3733,2195,-1538
2017,7,12,3,1864,3681,2197,-1484
2017,7,12,4,1841,3621,2187,-1434
2017,7,12,5,1798,3572,2118,-1454
2017,7,12,6,2307,3377,2190,-1187
2017,7,12,7,2107,3018,2039,-979
2017,7,12,8,1727,2808,1919,-889
2017,7,12,9,1597,2694,1977,-717
2017,7,12,10,1669,2625,1889,-736
2017,7,12,11,1641,2620,1880,-740
2017,7,12,12,1696,2686,1946,-740
2017,7,12,13,1754,2881,2001,-880
2017,7,12,14,1636,3096,1962,-1134
2017,7,12,15,1954,3290,2007,-1283
2017,7,12,16,1988,3353,1913,-1440
2017,7,12,17,2076,3449,2115,-1334
2017,7,12,18,2150,3556,2297,-1259
2017,7,12,19,2208,3604,2362,-1242
2017,7,12,20,2073,3653,2375,-1278
2017,7,12,21,2219,3678,2467,-1211
2017,7,12,22,2243,3715,2496,-1219
2017,7,12,23,2264,3750,2501,-1249
2017,7,13,0,2290,3802,2487,-1315
2017,7,13,1,2327,3841,2464,-1377
2017,7,13,2,2295,3834,2509,-1325
2017,7,13,3,2243,3788,2562,-1226
2017,7,13,4,2276,3686,2483,-1203
2017,7,13,5,2137,3631,2390,-1241
2017,7,13,6,2300,3427,2398,-1029
2017,7,13,7,2023,3076,2150,-926
2017,7,13,8,1865,2860,2070,-790
2017,7,13,9,1698,2742,1944,-798
2017,7,13,10,1627,2673,1969,-704
2017,7,13,11,1614,2654,1984,-670
2017,7,13,12,1618,2682,1837,-845
2017,7,13,13,1565,2848,1766,-1082
2017,7,13,14,1552,3101,1973,-1128
2017,7,13,15,1555,3171,2053,-1118
2017,7,13,16,1699,3420,2332,-1088
2017,7,13,17,1765,3480,2355,-1125
2017,7,13,18,1734,3536,2335,-1201
2017,7,13,19,1800,3585,2365,-1220
2017,7,13,20,1724,3602,2420,-1182
2017,7,13,21,1880,3610,2379,-1231
2017,7,13,22,1904,3618,2334,-1284
2017,7,13,23,1901,3616,2280,-1336
2017,7,14,0,1903,3629,2284,-1345
2017,7,14,1,1912,3657,2227,-1430
2017,7,14,2,1920,3671,2254,-1417
2017,7,14,3,1904,3556,2019,-1537
2017,7,14,4,1935,3486,2078,-1408
2017,7,14,5,1803,3443,1990,-1453
2017,7,14,6,2015,3237,2061,-1176
2017,7,14,7,1851,2946,2059,-887
2017,7,14,8,1851,2817,2070,-747
2017,7,14,9,1641,2663,2001,-662
2017,7,14,10,1651,2604,1919,-685
2017,7,14,11,1647,2586,1929,-657
2017,7,14,12,1748,2627,1830,-797
2017,7,14,13,1724,2743,1757,-986
2017,7,14,14,1741,2924,1775,-1149
2017,7,14,15,1810,3078,1987,-1091
2017,7,14,16,2044,3196,2028,-1168
2017,7,14,17,2240,3268,2114,-1154
2017,7,14,18,2295,3336,2171,-1165
2017,7,14,19,2305,3369,2226,-1143
2017,7,14,20,2318,3456,2322,-1134
2017,7,14,21,2386,3560,2312,-1248
2017,7,14,22,2272,3632,2315,-1317
2017,7,14,23,2386,3664,2290,-1374
2017,7,15,0,2381,3701,2396,-1305
2017,7,15,1,2381,3753,2531,-1222
2017,7,15,2,2341,3718,2502,-1216
2017,7,15,3,2386,3661,2460,-1201
2017,7,15,4,2392,3572,2455,-1117
2017,7,15,5,2266,3564,2402,-1162
2017,7,15,6,2204,3402,2429,-973
2017,7,15,7,2056,3064,2169,-895
2017,7,15,8,1729,2760,1967,-793
2017,7,15,9,1511,2659,2113,-546
2017,7,15,10,1477,2623,2034,-589
2017,7,15,11,1461,2599,1732,-867
2017,7,15,12,1353,2566,1601,-965
2017,7,15,13,1477,2494,1749,-745
2017,7,15,14,1238,2451,1397,-1054
2017,7,15,15,1230,2624,1558,-1066
2017,7,15,16,1393,2895,1666,-1229
2017,7,15,17,1536,3204,1667,-1537
2017,7,15,18,1610,3291,1834,-1457
2017,7,15,19,1650,3335,1858,-1477
2017,7,15,20,1680,3368,1718,-1650
2017,7,15,21,1560,3380,1879,-1501
2017,7,15,22,1623,3362,1896,-1466
2017,7,15,23,1734,3403,1891,-1512
2017,7,16,0,1762,3452,2025,-1427
2017,7,16,1,1759,3463,1970,-1493
2017,7,16,2,1762,3384,1982,-1402
2017,7,16,3,1760,3220,1891,-1329
2017,7,16,4,1762,3171,1898,-1273
2017,7,16,5,1460,3198,1921,-1277
2017,7,16,6,1775,3101,1857,-1244
2017,7,16,7,1695,2952,1933,-1019
2017,7,16,8,1428,2681,1731,-950
2017,7,16,9,1270,2545,1630,-915
2017,7,16,10,1313,2388,1544,-844
2017,7,16,11,1302,2322,1522,-800
2017,7,16,12,1294,2317,1498,-819
2017,7,16,13,1262,2358,1543,-815
2017,7,16,14,1236,2470,1578,-892
2017,7,16,15,1215,2551,1457,-1094
2017,7,16,16,1374,2897,1694,-1203
2017,7,16,17,1408,3096,1861,-1235
2017,7,16,18,1618,3173,1786,-1387
2017,7,16,19,1702,3222,1849,-1373
2017,7,16,20,1682,3248,1997,-1251
2017,7,16,21,1664,3249,2212,-1037
2017,7,16,22,1681,3287,2243,-1044
2017,7,16,23,1833,3348,2379,-969
2017,7,17,0,1846,3399,2391,-1008
2017,7,17,1,1933,3467,2310,-1157
2017,7,17,2,1975,3495,2323,-1172
2017,7,17,3,1974,3479,2358,-1121
2017,7,17,4,2032,3433,2417,-1016
2017,7,17,5,1937,3419,2432,-987
2017,7,17,6,2042,3184,2190,-994
2017,7,17,7,1861,2901,2104,-797
2017,7,17,8,1734,2768,2114,-654
2017,7,17,9,1676,2665,2077,-588
2017,7,17,10,1614,2612,2093,-519
2017,7,17,11,1661,2621,2050,-571
2017,7,17,12,1731,2731,2014,-717
2017,7,17,13,1895,2845,1956,-889
2017,7,17,14,1785,3019,1929,-1090
2017,7,17,15,1784,3256,2068,-1188
2017,7,17,16,1767,3364,2063,-1301
2017,7,17,17,1881,3450,2133,-1317
2017,7,17,18,1966,3502,2185,-1317
2017,7,17,19,2021,3581,2305,-1276
2017,7,17,20,2176,3602,2449,-1153
2017,7,17,21,2312,3628,2432,-1196
2017,7,17,22,2316,3640,2494,-1146
2017,7,17,23,2338,3655,2511,-1144
2017,7,18,0,2381,3710,2551,-1159
2017,7,18,1,2414,3769,2543,-1226
2017,7,18,2,2391,3753,2545,-1208
2017,7,18,3,2327,3696,2510,-1186
2017,7,18,4,2262,3614,2478,-1136
2017,7,18,5,2118,3558,2448,-1110
2017,7,18,6,2340,3350,2449,-901
2017,7,18,7,2068,3078,2311,-767
2017,7,18,8,1647,2877,2184,-693
2017,7,18,9,1556,2760,2046,-714
2017,7,18,10,1497,2694,2018,-676
2017,7,18,11,1498,2694,2008,-686
2017,7,18,12,1566,2741,2005,-736
2017,7,18,13,1709,2874,2082,-792
2017,7,18,14,1713,3030,1831,-1199
2017,7,18,15,1717,3209,2111,-1098
2017,7,18,16,1848,3245,2071,-1174
2017,7,18,17,1942,3339,2124,-1215
2017,7,18,18,2025,3404,2190,-1214
2017,7,18,19,2079,3471,2244,-1227
2017,7,18,20,2021,3520,2326,-1194
2017,7,18,21,2172,3570,2343,-1227
2017,7,18,22,2203,3592,2420,-1172
2017,7,18,23,2220,3648,2436,-1212
2017,7,19,0,2163,3700,2451,-1249
2017,7,19,1,2188,3750,2450,-1300
2017,7,19,2,2152,3720,2429,-1291
2017,7,19,3,2084,3643,2345,-1298
2017,7,19,4,2189,3546,2332,-1214
2017,7,19,5,2042,3474,2250,-1224
2017,7,19,6,2234,3234,2246,-988
2017,7,19,7,1942,2900,2047,-853
2017,7,19,8,1482,2700,1682,-1018
2017,7,19,9,1333,2577,1676,-901
2017,7,19,10,1379,2501,1719,-782
2017,7,19,11,1334,2497,1578,-919
2017,7,19,12,1291,2552,1560,-992
2017,7,19,13,1284,2671,1578,-1093
2017,7,19,14,1328,2842,1508,-1334
2017,7,19,15,1315,3116,1643,-1473
2017,7,19,16,1427,3226,1638,-1588
2017,7,19,17,1586,3330,1605,-1725
2017,7,19,18,1725,3404,1674,-1730
2017,7,19,19,1821,3453,2028,-1425
2017,7,19,20,1761,3487,2173,-1314
2017,7,19,21,1926,3518,2190,-1328
2017,7,19,22,1956,3545,2251,-1294
2017,7,19,23,1980,3582,2240,-1342
2017,7,20,0,2016,3646,2252,-1394
2017,7,20,1,2040,3686,2269,-1417
2017,7,20,2,2003,3635,2251,-1384
2017,7,20,3,1934,3570,2237,-1333
2017,7,20,4,2121,3483,2298,-1185
2017,7,20,5,1968,3462,2341,-1121
2017,7,20,6,1932,3223,2310,-913
2017,7,20,7,1569,2959,1904,-1055
2017,7,20,8,1511,2693,1652,-1041
2017,7,20,9,1327,2577,1642,-935
2017,7,20,10,1459,2431,1544,-887
2017,7,20,11,1232,2418,1501,-917
2017,7,20,12,1396,2542,1592,-950
2017,7,20,13,1505,2695,1747,-948
2017,7,20,14,1262,2879,1537,-1342
2017,7,20,15,1354,3015,1714,-1301
2017,7,20,16,1352,3113,1834,-1279
2017,7,20,17,1302,3167,1795,-1372
2017,7,20,18,1351,3242,1682,-1560
2017,7,20,19,1382,3324,1752,-1572
2017,7,20,20,1408,3349,1754,-1595
2017,7,20,21,1539,3366,1867,-1499
2017,7,20,22,1539,3376,1837,-1539
2017,7,20,23,1566,3422,1812,-1610
2017,7,21,0,1600,3452,1907,-1545
2017,7,21,1,1600,3536,1977,-1559
2017,7,21,2,1617,3507,1982,-1525
2017,7,21,3,1594,3448,2046,-1402
2017,7,21,4,1621,3389,2053,-1336
2017,7,21,5,1618,3383,2024,-1359
2017,7,21,6,1656,3182,2018,-1164
2017,7,21,7,1501,2889,1980,-909
2017,7,21,8,1385,2615,1840,-775
2017,7,21,9,1389,2492,1691,-801
2017,7,21,10,1357,2413,1621,-792
2017,7,21,11,1330,2394,1618,-776
2017,7,21,12,1551,2555,1773,-782
2017,7,21,13,1708,2666,1645,-1021
2017,7,21,14,1473,2962,1827,-1135
2017,7,21,15,1575,3102,1777,-1325
2017,7,21,16,1652,3275,1955,-1320
2017,7,21,17,1932,3367,2060,-1307
2017,7,21,18,1916,3433,2201,-1232
2017,7,21,19,1829,3568,2246,-1322
2017,7,21,20,1985,3617,2325,-1292
2017,7,21,21,2134,3632,2384,-1248
2017,7,21,22,2141,3646,2383,-1263
2017,7,21,23,2156,3682,2392,-1290
2017,7,22,0,2181,3713,2385,-1328
2017,7,22,1,2208,3724,2419,-1305
2017,7,22,2,2158,3656,2409,-1247
2017,7,22,3,2137,3571,2407,-1164
2017,7,22,4,2063,3519,2395,-1124
2017,7,22,5,1884,3496,2264,-1232
2017,7,22,6,2249,3339,2306,-1033
2017,7,22,7,2052,3095,2286,-809
2017,7,22,8,1854,2925,2253,-672
2017,7,22,9,1719,2798,2220,-578
2017,7,22,10,1909,2582,2124,-458
2017,7,22,11,1938,2518,2072,-446
2017,7,22,12,1882,2538,2089,-449
2017,7,22,13,1882,2591,2126,-465
2017,7,22,14,1724,2645,2075,-570
2017,7,22,15,1690,2838,2163,-675
2017,7,22,16,1820,3036,2197,-839
2017,7,22,17,1896,3226,2271,-955
2017,7,22,18,1988,3362,2254,-1108
2017,7,22,19,2046,3474,2272,-1202
2017,7,22,20,2121,3531,2359,-1172
2017,7,22,21,2138,3609,2436,-1173
2017,7,22,22,2253,3674,2537,-1137
2017,7,22,23,2405,3741,2723,-1018
2017,7,23,0,2462,3810,2775,-1035
2017,7,23,1,2501,3853,2755,-1098
2017,7,23,2,2489,3826,2809,-1017
2017,7,23,3,2437,3756,2838,-918
2017,7,23,4,2343,3657,2699,-958
2017,7,23,5,2221,3627,2529,-1098
2017,7,23,6,2375,3461,2525,-936
2017,7,23,7,2161,3218,2492,-726
2017,7,23,8,2053,3000,2335,-665
2017,7,23,9,1953,2859,2282,-577
2017,7,23,10,1828,2739,2234,-505
2017,7,23,11,1776,2705,2189,-516
2017,7,23,12,1813,2657,2161,-496
2017,7,23,13,1779,2674,2096,-578
2017,7,23,14,1777,2612,1955,-657
2017,7,23,15,1908,2829,2078,-751
2017,7,23,16,2096,3068,2268,-800
2017,7,23,17,2218,3231,2412,-819
2017,7,23,18,2276,3336,2486,-850
2017,7,23,19,2320,3396,2529,-867
2017,7,23,20,2356,3454,2626,-828
2017,7,23,21,2372,3473,2658,-815
2017,7,23,22,2524,3514,2777,-737
2017,7,23,23,2668,3553,2805,-748
2017,7,24,0,2693,3616,2830,-786
2017,7,24,1,2730,3684,2858,-826
2017,7,24,2,2765,3701,2882,-819
2017,7,24,3,2781,3662,2871,-791
2017,7,24,4,2777,3580,2895,-685
2017,7,24,5,2780,3550,2761,-789
2017,7,24,6,2511,3340,2597,-743
2017,7,24,7,2101,3072,2255,-817
2017,7,24,8,1697,2872,2194,-678
2017,7,24,9,1654,2759,2131,-628
2017,7,24,10,1661,2697,1995,-702
2017,7,24,11,1681,2647,1937,-710
2017,7,24,12,1839,2706,1927,-779
2017,7,24,13,1777,2780,1873,-907
2017,7,24,14,1724,2979,1875,-1104
2017,7,24,15,1926,3220,2049,-1171
2017,7,24,16,1954,3381,2179,-1202
2017,7,24,17,2049,3504,2207,-1297
2017,7,24,18,2151,3620,2270,-1350
2017,7,24,19,2249,3710,2363,-1347
2017,7,24,20,2242,3769,2375,-1394
2017,7,24,21,2446,3815,2471,-1344
2017,7,24,22,2477,3854,2524,-1330
2017,7,24,23,2477,3921,2652,-1269
2017,7,25,0,2535,3966,2693,-1273
2017,7,25,1,2510,4015,2678,-1337
2017,7,25,2,2468,3993,2705,-1288
2017,7,25,3,2510,3911,2745,-1166
2017,7,25,4,2468,3804,2633,-1171
2017,7,25,5,2426,3741,2462,-1279
2017,7,25,6,2398,3471,2409,-1062
2017,7,25,7,2205,3061,2127,-934
2017,7,25,8,1732,2857,1921,-936
2017,7,25,9,1599,2735,1932,-803
2017,7,25,10,1646,2627,1870,-757
2017,7,25,11,1645,2634,1908,-726
2017,7,25,12,1648,2654,1927,-727
2017,7,25,13,1697,2855,1953,-902
2017,7,25,14,1657,2942,1812,-1130
2017,7,25,15,1858,3203,2058,-1145
2017,7,25,16,1939,3360,2160,-1200
2017,7,25,17,2088,3419,2166,-1253
2017,7,25,18,2157,3594,2225,-1369
2017,7,25,19,2237,3656,2245,-1411
2017,7,25,20,2319,3755,2349,-1406
2017,7,25,21,2298,3857,2449,-1408
2017,7,25,22,2351,3938,2481,-1457
2017,7,25,23,2292,4036,2473,-1563
2017,7,26,0,2383,4103,2517,-1586
2017,7,26,1,2334,4140,2510,-1630
2017,7,26,2,2325,4105,2514,-1591
2017,7,26,3,2200,4021,2480,-1541
2017,7,26,4,2169,3921,2493,-1428
2017,7,26,5,2183,3841,2372,-1469
2017,7,26,6,2171,3555,2374,-1181
2017,7,26,7,2036,3130,1993,-1137
2017,7,26,8,1821,2844,1906,-938
2017,7,26,9,1685,2732,1911,-821
2017,7,26,10,1654,2673,1907,-766
2017,7,26,11,1626,2636,1877,-759
2017,7,26,12,1617,2726,1953,-773
2017,7,26,13,1707,2938,2014,-924
2017,7,26,14,1676,3059,1836,-1223
2017,7,26,15,1805,3195,1814,-1381
2017,7,26,16,1884,3378,1960,-1418
2017,7,26,17,1984,3482,1928,-1554
2017,7,26,18,1992,3575,2128,-1447
2017,7,26,19,2061,3622,2155,-1467
2017,7,26,20,2105,3681,2214,-1467
2017,7,26,21,2139,3760,2259,-1501
2017,7,26,22,2159,3830,2375,-1455
2017,7,26,23,2342,3964,2547,-1417
2017,7,27,0,2323,4026,2604,-1422
2017,7,27,1,2451,4062,2625,-1437
2017,7,27,2,2414,3996,2641,-1355
2017,7,27,3,2387,3939,2716,-1223
2017,7,27,4,2381,3810,2777,-1033
2017,7,27,5,2377,3726,2602,-1124
2017,7,27,6,2388,3471,2608,-863
2017,7,27,7,2133,3017,2133,-884
2017,7,27,8,1976,2888,2278,-610
2017,7,27,9,1908,2751,2240,-511
2017,7,27,10,1726,2665,2112,-553
2017,7,27,11,1606,2627,2085,-542
2017,7,27,12,1689,2698,2141,-557
2017,7,27,13,1824,2895,2262,-633
2017,7,27,14,1794,3065,2138,-927
2017,7,27,15,2140,3238,2199,-1039
2017,7,27,16,1901,3366,2144,-1222
2017,7,27,17,2034,3380,2126,-1254
2017,7,27,18,2058,3419,2126,-1293
2017,7,27,19,2188,3450,2270,-1180
2017,7,27,20,2327,3454,2463,-991
2017,7,27,21,2175,3568,2461,-1107
2017,7,27,22,2123,3524,2382,-1142
2017,7,27,23,2131,3549,2399,-1150
2017,7,28,0,2060,3571,2360,-1211
2017,7,28,1,2362,3609,2568,-1041
2017,7,28,2,2345,3599,2503,-1096
2017,7,28,3,2205,3565,2553,-1012
2017,7,28,4,2213,3522,2486,-1036
2017,7,28,5,2188,3527,2434,-1093
2017,7,28,6,2186,3314,2450,-864
2017,7,28,7,2042,3035,2281,-754
2017,7,28,8,1625,2768,2167,-601
2017,7,28,9,1640,2633,2053,-580
2017,7,28,10,1539,2559,2077,-482
2017,7,28,11,1533,2574,2012,-562
2017,7,28,12,1627,2636,1922,-714
2017,7,28,13,1841,2795,1990,-805
2017,7,28,14,1706,2999,1914,-1085
2017,7,28,15,1889,3201,2099,-1102
2017,7,28,16,1952,3355,2123,-1232
2017,7,28,17,2097,3458,2158,-1300
2017,7,28,18,1690,3501,2280,-1221
2017,7,28,19,1856,3563,2238,-1325
2017,7,28,20,2239,3611,2434,-1177
2017,7,28,21,2440,3628,2490,-1138
2017,7,28,22,2377,3663,2618,-1045
2017,7,28,23,2421,3698,2662,-1036
2017,7,29,0,2386,3733,2652,-1081
2017,7,29,1,2499,3774,2691,-1083
2017,7,29,2,2453,3727,2721,-1006
2017,7,29,3,2435,3597,2705,-892
2017,7,29,4,2359,3555,2485,-1070
2017,7,29,5,2281,3519,2558,-961
2017,7,29,6,2194,3250,2360,-890
2017,7,29,7,2091,3033,2371,-662
2017,7,29,8,1997,2811,2270,-541
2017,7,29,9,1832,2629,2219,-410
2017,7,29,10,1788,2552,2239,-313
2017,7,29,11,1837,2602,2190,-412
2017,7,29,12,1793,2579,2208,-371
2017,7,29,13,1830,2560,2030,-530
2017,7,29,14,1779,2550,1913,-637
2017,7,29,15,1780,2768,2045,-723
2017,7,29,16,1889,2911,2024,-887
2017,7,29,17,1978,3066,2015,-1051
2017,7,29,18,2061,3197,2126,-1071
2017,7,29,19,2127,3320,2287,-1033
2017,7,29,20,2001,3328,2295,-1033
2017,7,29,21,2142,3256,2241,-1015
2017,7,29,22,2133,3292,2333,-959
2017,7,29,23,2309,3334,2401,-933
2017,7,30,0,2398,3400,2467,-933
2017,7,30,1,2432,3456,2488,-968
2017,7,30,2,2437,3452,2586,-866
2017,7,30,3,2287,3393,2535,-858
2017,7,30,4,2342,3315,2492,-823
2017,7,30,5,2283,3300,2352,-948
2017,7,30,6,2367,3118,2327,-791
2017,7,30,7,2129,2892,2275,-617
2017,7,30,8,1982,2775,2313,-462
2017,7,30,9,1805,2622,2245,-377
2017,7,30,10,1907,2534,2174,-360
2017,7,30,11,1825,2492,2082,-410
2017,7,30,12,1935,2491,2141,-350
2017,7,30,13,1800,2506,2133,-373
2017,7,30,14,1885,2551,2061,-490
2017,7,30,15,1871,2676,2088,-588
2017,7,30,16,2205,2887,2125,-762
2017,7,30,17,2285,3057,2134,-923
2017,7,30,18,2303,3114,2136,-978
2017,7,30,19,2324,3190,2246,-944
2017,7,30,20,2209,3276,2270,-1006
2017,7,30,21,2258,3380,2564,-816
2017,7,30,22,2351,3511,2657,-854
2017,7,30,23,2467,3570,2681,-889
2017,7,31,0,2525,3634,2670,-964
2017,7,31,1,2456,3728,2681,-1047
2017,7,31,2,2468,3754,2738,-1016
2017,7,31,3,2512,3700,2680,-1020
2017,7,31,4,2480,3627,2620,-1007
2017,7,31,5,2428,3529,2508,-1021
2017,7,31,6,2203,3227,2376,-851
2017,7,31,7,1995,2894,2114,-780
2017,7,31,8,1800,2787,2237,-550
2017,7,31,9,1774,2648,2237,-411
2017,7,31,10,1814,2582,2101,-481
2017,7,31,11,2011,2550,2119,-431
2017,7,31,12,1968,2635,2109,-526
2017,7,31,13,1814,2794,2056,-738
2017,7,31,14,1912,3006,1847,-1159
2017,7,31,15,1650,3229,1977,-1252
2017,7,31,16,1837,3398,2017,-1381
2017,7,31,17,1884,3538,2067,-1471
2017,7,31,18,2017,3596,1867,-1729
2017,7,31,19,2062,3742,2092,-1650
2017,7,31,20,2313,3836,2454,-1382
2017,7,31,21,2488,3899,2623,-1276
2017,7,31,22,2516,3970,2692,-1278
2017,7,31,23,2538,4019,2788,-1231
2017,8,1,0,2595,4075,2776,-1299
2017,8,1,1,2602,4118,2771,-1347
2017,8,1,2,2579,4122,2789,-1333
2017,8,1,3,2449,4055,2788,-1267
2017,8,1,4,2373,3940,2741,-1199
2017,8,1,5,2280,3854,2510,-1344
2017,8,1,6,2246,3555,2444,-1111
2017,8,1,7,2099,3195,2335,-860
2017,8,1,8,1828,2932,2292,-640
2017,8,1,9,1757,2759,2192,-567
2017,8,1,10,1819,2683,2183,-500
2017,8,1,11,1905,2658,2202,-456
2017,8,1,12,1968,2710,2264,-446
2017,8,1,13,1954,2836,2294,-542
2017,8,1,14,1868,2972,2046,-926
2017,8,1,15,2047,3180,2234,-946
2017,8,1,16,2170,3356,2312,-1044
2017,8,1,17,2233,3548,2367,-1181
2017,8,1,18,2238,3744,2459,-1285
2017,8,1,19,2308,3860,2558,-1302
2017,8,1,20,2249,3909,2495,-1414
2017,8,1,21,2278,4038,2622,-1416
2017,8,1,22,2321,4112,2633,-1479
2017,8,1,23,2376,4167,2599,-1568
2017,8,2,0,2477,4217,2699,-1518
2017,8,2,1,2489,4236,2734,-1502
2017,8,2,2,2380,4226,2762,-1464
2017,8,2,3,2361,4130,2756,-1374
2017,8,2,4,2505,4035,2770,-1265
2017,8,2,5,2363,3929,2674,-1255
2017,8,2,6,2385,3642,2628,-1014
2017,8,2,7,2056,3293,2194,-1099
2017,8,2,8,1853,2941,2052,-889
2017,8,2,9,1770,2793,1962,-831
2017,8,2,10,1766,2713,1852,-861
2017,8,2,11,1813,2684,1891,-793
2017,8,2,12,1696,2736,1954,-782
2017,8,2,13,1821,2869,1951,-918
2017,8,2,14,1824,3031,1751,-1280
2017,8,2,15,1922,3218,2005,-1213
2017,8,2,16,1962,3403,2226,-1177
2017,8,2,17,2091,3543,2314,-1229
2017,8,2,18,2260,3719,2449,-1270
2017,8,2,19,2418,3889,2637,-1252
2017,8,2,20,2318,3968,2602,-1366
2017,8,2,21,2464,4223,2759,-1464
2017,8,2,22,2523,4250,2799,-1451
2017,8,2,23,2578,4306,2782,-1524
2017,8,3,0,2689,4353,2850,-1503
2017,8,3,1,2651,4353,2893,-1460
2017,8,3,2,2570,4320,2900,-1420
2017,8,3,3,2502,4214,2823,-1391
2017,8,3,4,2532,4135,2848,-1287
2017,8,3,5,2582,4061,2862,-1199
2017,8,3,6,2502,3661,2711,-950
2017,8,3,7,2317,3397,2445,-952
2017,8,3,8,1818,3141,2107,-1034
2017,8,3,9,2009,3038,2104,-934
2017,8,3,10,1980,2916,2011,-905
2017,8,3,11,1928,2779,1915,-864
2017,8,3,12,1985,2831,2013,-818
2017,8,3,13,2031,3089,2081,-1008
2017,8,3,14,2074,3220,2015,-1205
2017,8,3,15,2067,3398,2073,-1325
2017,8,3,16,2296,3644,2220,-1424
2017,8,3,17,2302,3800,2391,-1409
2017,8,3,18,2205,3936,2550,-1386
2017,8,3,19,2154,4048,2706,-1342
2017,8,3,20,2176,4093,2886,-1207
2017,8,3,21,2306,4183,2857,-1326
2017,8,3,22,2298,4242,2830,-1412
2017,8,3,23,2302,4303,2888,-1415
2017,8,4,0,2290,4443,2929,-1514
2017,8,4,1,2315,4460,2944,-1516
2017,8,4,2,2297,4408,2987,-1421
2017,8,4,3,2270,4262,3002,-1260
2017,8,4,4,2325,4097,2936,-1161
2017,8,4,5,2297,4028,2884,-1144
2017,8,4,6,2434,3730,2717,-1013
2017,8,4,7,2531,3362,2569,-793
2017,8,4,8,2274,3084,2294,-790
2017,8,4,9,2191,2924,2114,-810
2017,8,4,10,2042,2820,2018,-802
2017,8,4,11,1945,2785,2014,-771
2017,8,4,12,1992,2858,2063,-795
2017,8,4,13,2169,3036,2196,-840
2017,8,4,14,1929,3205,2033,-1172
2017,8,4,15,2050,3369,2060,-1309
2017,8,4,16,2313,3489,2059,-1430
2017,8,4,17,2268,3771,2355,-1416
2017,8,4,18,2341,3921,2496,-1425
2017,8,4,19,2442,4041,2599,-1442
2017,8,4,20,2371,4136,2636,-1500
2017,8,4,21,2490,4155,2752,-1403
2017,8,4,22,2585,4198,2753,-1445
2017,8,4,23,2676,4309,2756,-1553
2017,8,5,0,2676,4343,2744,-1599
2017,8,5,1,2681,4350,2779,-1571
2017,8,5,2,2614,4304,2852,-1452
2017,8,5,3,2478,4175,2796,-1379
2017,8,5,4,2590,4083,2734,-1349
2017,8,5,5,2517,3992,2745,-1247
2017,8,5,6,2795,3733,2780,-953
2017,8,5,7,2608,3419,2546,-873
2017,8,5,8,2072,3157,2270,-887
2017,8,5,9,1912,2969,2211,-758
2017,8,5,10,1794,2921,2221,-700
2017,8,5,11,1877,2792,2131,-661
2017,8,5,12,1738,2751,2093,-658
2017,8,5,13,1768,2703,2007,-696
2017,8,5,14,1713,2742,1828,-914
2017,8,5,15,1712,2887,1816,-1071
2017,8,5,16,1891,3124,1900,-1224
2017,8,5,17,2224,3391,2234,-1157
2017,8,5,18,2485,3510,2225,-1285
2017,8,5,19,2485,3570,2298,-1272
2017,8,5,20,2282,3506,2248,-1258
2017,8,5,21,2348,3536,2415,-1121
2017,8,5,22,2408,3568,2407,-1161
2017,8,5,23,2472,3634,2395,-1239
2017,8,6,0,2488,3727,2446,-1281
2017,8,6,1,2531,3853,2612,-1241
2017,8,6,2,2507,3818,2612,-1206
2017,8,6,3,2426,3754,2615,-1139
2017,8,6,4,2587,3719,2680,-1039
2017,8,6,5,2549,3676,2658,-1018
2017,8,6,6,2752,3454,2680,-774
2017,8,6,7,2566,3062,2435,-627
2017,8,6,8,1980,2890,2204,-686
2017,8,6,9,2103,2722,2128,-594
2017,8,6,10,2018,2640,2001,-639
2017,8,6,11,1915,2595,1963,-632
2017,8,6,12,1938,2570,1944,-626
2017,8,6,13,1983,2606,1971,-635
2017,8,6,14,1821,2619,1824,-795
2017,8,6,15,1936,2631,1833,-798
2017,8,6,16,2145,2962,2014,-948
2017,8,6,17,2121,3141,2025,-1116
2017,8,6,18,2257,3277,2071,-1206
2017,8,6,19,2345,3396,2136,-1260
2017,8,6,20,2223,3435,2133,-1302
2017,8,6,21,2240,3583,2335,-1248
2017,8,6,22,2240,3623,2358,-1265
2017,8,6,23,2283,3741,2520,-1221
2017,8,7,0,2454,3836,2683,-1153
2017,8,7,1,2564,3907,2623,-1284
2017,8,7,2,2536,3883,2546,-1337
2017,8,7,3,2503,3838,2482,-1356
2017,8,7,4,2614,3752,2533,-1219
2017,8,7,5,2563,3671,2485,-1186
2017,8,7,6,2584,3436,2554,-882
2017,8,7,7,2182,3146,2348,-798
2017,8,7,8,1811,2881,2108,-773
2017,8,7,9,1804,2768,2023,-745
2017,8,7,10,1886,2642,1860,-782
2017,8,7,11,1864,2647,1895,-752
2017,8,7,12,1965,2707,1976,-731
2017,8,7,13,2033,2880,2036,-844
2017,8,7,14,1871,2990,1921,-1069
2017,8,7,15,1776,3166,2065,-1101
2017,8,7,16,1832,3394,2196,-1198
2017,8,7,17,1975,3551,2357,-1194
2017,8,7,18,2116,3617,2387,-1230
2017,8,7,19,2179,3715,2378,-1337
2017,8,7,20,2413,3695,2208,-1487
2017,8,7,21,2485,3802,2401,-1401
2017,8,7,22,2539,3937,2594,-1343
2017,8,7,23,2602,3950,2534,-1416
2017,8,8,0,2671,4089,2615,-1474
2017,8,8,1,2707,4158,2666,-1492
2017,8,8,2,2652,4071,2740,-1331
2017,8,8,3,2554,3999,2642,-1357
2017,8,8,4,2474,3958,2535,-1423
2017,8,8,5,2388,3851,2504,-1347
2017,8,8,6,2761,3543,2512,-1031
2017,8,8,7,2448,3213,2458,-755
2017,8,8,8,1939,2998,2402,-596
2017,8,8,9,1821,2761,2109,-652
2017,8,8,10,1833,2675,1933,-742
2017,8,8,11,1867,2297,1585,-712
2017,8,8,12,1830,2360,1709,-651
2017,8,8,13,1953,2546,1711,-835
2017,8,8,14,1748,2707,1750,-957
2017,8,8,15,1907,2871,1728,-1143
2017,8,8,16,1926,2999,1686,-1313
2017,8,8,17,2047,3105,1842,-1263
2017,8,8,18,2057,3210,1885,-1325
2017,8,8,19,2263,3371,2042,-1329
2017,8,8,20,2327,3668,2310,-1358
2017,8,8,21,2400,3753,2311,-1442
2017,8,8,22,2459,3833,2340,-1493
2017,8,8,23,2518,3912,2212,-1700
2017,8,9,0,2608,3976,2247,-1729
2017,8,9,1,2629,4021,2358,-1663
2017,8,9,2,2573,3994,2314,-1680
2017,8,9,3,2504,3862,2316,-1546
2017,8,9,4,2503,3855,2417,-1438
2017,8,9,5,2423,3806,2382,-1424
2017,8,9,6,2582,3488,2436,-1052
2017,8,9,7,2263,3196,2358,-838
2017,8,9,8,1690,2967,2232,-735
2017,8,9,9,1758,2853,2140,-713
2017,8,9,10,1805,2803,2053,-750
2017,8,9,11,1829,2827,2086,-741
2017,8,9,12,1919,2862,2070,-792
2017,8,9,13,1913,3011,2237,-774
2017,8,9,14,1742,3185,2198,-987
2017,8,9,15,1741,3251,2054,-1197
2017,8,9,16,1869,3397,2056,-1341
2017,8,9,17,1978,3525,2178,-1347
2017,8,9,18,1882,3721,2283,-1438
2017,8,9,19,1843,3886,2368,-1518
2017,8,9,20,1811,3985,2384,-1601
2017,8,9,21,2003,4106,2524,-1582
2017,8,9,22,2065,4225,2585,-1640
2017,8,9,23,2131,4301,2652,-1649
2017,8,10,0,2196,4361,2659,-1702
2017,8,10,1,2230,4371,2616,-1755
2017,8,10,2,2159,4319,2706,-1613
2017,8,10,3,2066,4213,2686,-1527
2017,8,10,4,2230,4118,2609,-1509
2017,8,10,5,2133,4022,2499,-1523
2017,8,10,6,2286,3700,2491,-1209
2017,8,10,7,1980,3405,2362,-1043
2017,8,10,8,2240,3050,2394,-656
2017,8,10,9,2025,3007,2447,-560
2017,8,10,10,2002,2898,2417,-481
2017,8,10,11,2139,2864,2311,-553
2017,8,10,12,2162,2903,2288,-615
2017,8,10,13,2224,3039,2306,-733
2017,8,10,14,1737,3188,2096,-1092
2017,8,10,15,1987,3277,2061,-1216
2017,8,10,16,1983,3413,1999,-1414
2017,8,10,17,2101,3558,2080,-1478
2017,8,10,18,2052,3695,2101,-1594
2017,8,10,19,2292,3821,2183,-1638
2017,8,10,20,2219,3955,2318,-1637
2017,8,10,21,2277,4054,2391,-1663
2017,8,10,22,2343,4151,2471,-1680
2017,8,10,23,2412,4209,2455,-1754
2017,8,11,0,2545,4275,2445,-1830
2017,8,11,1,2548,4264,2445,-1808
2017,8,11,2,2459,4175,2505,-1670
2017,8,11,3,2344,4127,2517,-1610
2017,8,11,4,2424,4063,2694,-1369
2017,8,11,5,2320,3940,2547,-1393
2017,8,11,6,2811,3658,2695,-963
2017,8,11,7,2533,3282,2396,-886
2017,8,11,8,2077,2967,2066,-901
2017,8,11,9,1986,2818,2020,-798
2017,8,11,10,1951,2804,2136,-668
2017,8,11,11,2016,2781,2151,-630
2017,8,11,12,2034,2875,2296,-579
2017,8,11,13,2178,2926,2239,-687
2017,8,11,14,2140,3115,2275,-840
2017,8,11,15,2163,3292,2261,-1031
2017,8,11,16,2133,3442,2309,-1133
2017,8,11,17,2147,3559,2282,-1277
2017,8,11,18,1993,3630,2251,-1379
2017,8,11,19,1979,3692,2248,-1444
2017,8,11,20,2216,3813,2411,-1402
2017,8,11,21,2391,3856,2551,-1305
2017,8,11,22,2466,4028,2706,-1322
2017,8,11,23,2459,3939,2683,-1256
2017,8,12,0,2560,3984,2740,-1244
2017,8,12,1,2473,3968,2724,-1244
2017,8,12,2,2427,3884,2711,-1173
2017,8,12,3,2345,3778,2687,-1091
2017,8,12,4,2250,3740,2483,-1257
2017,8,12,5,2099,3664,2369,-1295
2017,8,12,6,2331,3441,2404,-1037
2017,8,12,7,2073,3185,2235,-950
2017,8,12,8,1785,2999,2208,-791
2017,8,12,9,1609,2856,2103,-753
2017,8,12,10,1616,2773,2081,-692
2017,8,12,11,1744,2620,2021,-599
2017,8,12,12,1569,2560,1899,-661
2017,8,12,13,1754,2618,1853,-765
2017,8,12,14,1423,2666,1701,-965
2017,8,12,15,1408,2771,1659,-1112
2017,8,12,16,1603,2947,1638,-1309
2017,8,12,17,1601,3078,1748,-1330
2017,8,12,18,1447,3250,1906,-1344
2017,8,12,19,1480,3304,1978,-1326
2017,8,12,20,1622,3330,1990,-1340
2017,8,12,21,1565,3365,1946,-1419
2017,8,12,22,1531,3385,1981,-1404
2017,8,12,23,1661,3416,2023,-1393
2017,8,13,0,1694,3451,2031,-1420
2017,8,13,1,1795,3520,2065,-1455
2017,8,13,2,1798,3491,2096,-1395
2017,8,13,3,1645,3439,2143,-1296
2017,8,13,4,1594,3441,2157,-1284
2017,8,13,5,1559,3383,2153,-1230
2017,8,13,6,1888,3208,2248,-960
2017,8,13,7,1729,2993,1986,-1007
2017,8,13,8,1301,2440,1509,-931
2017,8,13,9,1253,2331,1430,-901
2017,8,13,10,1317,2359,1437,-922
2017,8,13,11,1324,2325,1445,-880
2017,8,13,12,1480,2467,1608,-859
2017,8,13,13,1461,2588,1654,-934
2017,8,13,14,1499,2567,1503,-1064
2017,8,13,15,1509,2787,1645,-1142
2017,8,13,16,1516,3006,1703,-1303
2017,8,13,17,1692,3177,1714,-1463
2017,8,13,18,1783,3283,1794,-1489
2017,8,13,19,1766,3323,1996,-1327
2017,8,13,20,1778,3346,2054,-1292
2017,8,13,21,1778,3343,2058,-1285
2017,8,13,22,1794,3353,2254,-1099
2017,8,13,23,1958,3368,2277,-1091
2017,8,14,0,2036,3327,2181,-1146
2017,8,14,1,2104,3365,2329,-1036
2017,8,14,2,2129,3311,2274,-1037
2017,8,14,3,2088,3354,2321,-1033
2017,8,14,4,2091,3394,2423,-971
2017,8,14,5,2020,3340,2340,-1000
2017,8,14,6,1881,3117,2224,-893
2017,8,14,7,1563,2812,1709,-1103
2017,8,14,8,1347,2537,1557,-980
2017,8,14,9,1185,2393,1523,-870
2017,8,14,10,1223,2341,1483,-858
2017,8,14,11,1276,2391,1492,-899
2017,8,14,12,1462,2618,1606,-1012
2017,8,14,13,1625,2795,1740,-1055
2017,8,14,14,1317,2919,1660,-1259
2017,8,14,15,1528,3114,1587,-1527
2017,8,14,16,1673,3245,1693,-1552
2017,8,14,17,1754,3347,1865,-1482
2017,8,14,18,1703,3458,1883,-1575
2017,8,14,19,1792,3394,1861,-1533
2017,8,14,20,1812,3418,1730,-1688
2017,8,14,21,1978,3531,1911,-1620
2017,8,14,22,2011,3570,1992,-1578
2017,8,14,23,2031,3568,2146,-1422
2017,8,15,0,2078,3467,2105,-1362
2017,8,15,1,2104,3615,2233,-1382
2017,8,15,2,2082,3602,2227,-1375
2017,8,15,3,2037,3549,2244,-1305
2017,8,15,4,2234,3565,2291,-1274
2017,8,15,5,2149,3501,2271,-1230
2017,8,15,6,2239,3261,2245,-1016
2017,8,15,7,1879,3010,2156,-854
2017,8,15,8,1617,2838,2060,-778
2017,8,15,9,1583,2706,2008,-698
2017,8,15,10,1635,2625,1904,-721
2017,8,15,11,1641,2621,1879,-742
2017,8,15,12,1753,2635,1824,-811
2017,8,15,13,1919,2856,1986,-870
2017,8,15,14,1845,3059,1911,-1148
2017,8,15,15,1759,3202,1882,-1320
2017,8,15,16,1861,3332,1885,-1447
2017,8,15,17,1921,3403,1974,-1429
2017,8,15,18,1924,3449,1926,-1523
2017,8,15,19,1912,3487,1936,-1551
2017,8,15,20,1900,3528,1890,-1638
2017,8,15,21,2018,3555,1926,-1629
2017,8,15,22,2023,3583,1968,-1615
2017,8,15,23,2037,3615,1982,-1633
2017,8,16,0,2058,3660,1996,-1664
2017,8,16,1,2081,3703,2051,-1652
2017,8,16,2,2049,3681,2192,-1489
2017,8,16,3,1985,3662,2461,-1201
2017,8,16,4,2144,3653,2495,-1158
2017,8,16,5,2060,3566,2493,-1073
2017,8,16,6,2151,3317,2374,-943
2017,8,16,7,1740,3050,1998,-1052
2017,8,16,8,1517,2869,1847,-1022
2017,8,16,9,1292,2767,1850,-917
2017,8,16,10,1517,2687,1804,-883
2017,8,16,11,1420,2595,1701,-894
2017,8,16,12,1460,2644,1659,-985
2017,8,16,13,1609,2818,1756,-1062
2017,8,16,14,1527,2993,1763,-1230
2017,8,16,15,1600,3197,1667,-1530
2017,8,16,16,1687,3277,1727,-1550
2017,8,16,17,1751,3434,1802,-1632
2017,8,16,18,1755,3513,1799,-1714
2017,8,16,19,1819,3483,1741,-1742
2017,8,16,20,1822,3484,1735,-1749
2017,8,16,21,1974,3516,1808,-1708
2017,8,16,22,2009,3533,1997,-1536
2017,8,16,23,2017,3588,2219,-1369
2017,8,17,0,1934,3640,2230,-1410
2017,8,17,1,1919,3696,2240,-1456
2017,8,17,2,1895,3694,2186,-1508
2017,8,17,3,1837,3640,2147,-1493
2017,8,17,4,1969,3704,2189,-1515
2017,8,17,5,1843,3616,2113,-1503
2017,8,17,6,1760,3364,1980,-1384
2017,8,17,7,1362,3055,1870,-1185
2017,8,17,8,1645,2849,1900,-949
2017,8,17,9,1558,2684,1701,-983
2017,8,17,10,1417,2615,1533,-1082
2017,8,17,11,1337,2599,1445,-1154
2017,8,17,12,1480,2649,1552,-1097
2017,8,17,13,1685,2864,1732,-1132
2017,8,17,14,1572,3035,1570,-1465
2017,8,17,15,1686,3281,1593,-1688
2017,8,17,16,1817,3338,1614,-1724
2017,8,17,17,1936,3424,1688,-1736
2017,8,17,18,2039,3469,1838,-1631
2017,8,17,19,2128,3537,1986,-1551
2017,8,17,20,2040,3544,1970,-1574
2017,8,17,21,2216,3635,2243,-1392
2017,8,17,22,2264,3640,2305,-1335
2017,8,17,23,2317,3695,2400,-1295
2017,8,18,0,2361,3759,2367,-1392
2017,8,18,1,2388,3811,2465,-1346
2017,8,18,2,2346,3766,2556,-1210
2017,8,18,3,2290,3707,2513,-1194
2017,8,18,4,2422,3699,2536,-1163
2017,8,18,5,2328,3607,2497,-1110
2017,8,18,6,2232,3355,2448,-907
2017,8,18,7,2034,2986,2178,-808
2017,8,18,8,1886,2821,2054,-767
2017,8,18,9,1715,2686,1961,-725
2017,8,18,10,1529,2583,1840,-743
2017,8,18,11,1657,2570,1815,-755
2017,8,18,12,1695,2585,1790,-795
2017,8,18,13,1768,2745,1915,-830
2017,8,18,14,1686,2899,1890,-1009
2017,8,18,15,1774,3074,2017,-1057
2017,8,18,16,1896,3220,2024,-1196
2017,8,18,17,1957,3340,2072,-1268
2017,8,18,18,1973,3420,2085,-1335
2017,8,18,19,1984,3472,2113,-1359
2017,8,18,20,2090,3519,2179,-1340
2017,8,18,21,2227,3620,2348,-1272
2017,8,18,22,2074,3654,2282,-1372
2017,8,18,23,2069,3657,2251,-1406
2017,8,19,0,2278,3672,2301,-1371
2017,8,19,1,2295,3687,2363,-1324
2017,8,19,2,2059,3577,2390,-1187
2017,8,19,3,2195,3496,2399,-1097
2017,8,19,4,2216,3551,2335,-1216
2017,8,19,5,1951,3488,2340,-1148
2017,8,19,6,2235,3216,2305,-911
2017,8,19,7,1821,2895,2155,-740
2017,8,19,8,1763,2580,2052,-528
2017,8,19,9,1620,2230,1724,-506
2017,8,19,10,1467,2085,1535,-550
2017,8,19,11,1456,2059,1486,-573
2017,8,19,12,1427,2132,1354,-778
2017,8,19,13,1534,2307,1457,-850
2017,8,19,14,1213,2530,1497,-1033
2017,8,19,15,1327,2700,1542,-1158
2017,8,19,16,1498,2892,1565,-1327
2017,8,19,17,1663,3068,1681,-1387
2017,8,19,18,1770,3178,1696,-1482
2017,8,19,19,1812,3206,1686,-1520
2017,8,19,20,1788,3235,1739,-1496
2017,8,19,21,1802,3281,1919,-1362
2017,8,19,22,1692,3294,1958,-1336
2017,8,19,23,1831,3343,2051,-1292
2017,8,20,0,1976,3419,2226,-1193
2017,8,20,1,2068,3393,2385,-1008
2017,8,20,2,2190,3427,2403,-1024
2017,8,20,3,2164,3391,2452,-939
2017,8,20,4,2214,3399,2350,-1049
2017,8,20,5,1984,3292,2204,-1088
2017,8,20,6,1884,3120,2100,-1020
2017,8,20,7,1767,2850,1856,-994
2017,8,20,8,1798,2669,1786,-883
2017,8,20,9,1715,2562,1760,-802
2017,8,20,10,1686,2495,1765,-730
2017,8,20,11,1687,2473,1750,-723
2017,8,20,12,1683,2485,1748,-737
2017,8,20,13,1721,2524,1742,-782
2017,8,20,14,1499,2562,1702,-860
2017,8,20,15,1608,2637,1605,-1032
2017,8,20,16,1792,2814,1652,-1162
2017,8,20,17,1823,3003,1770,-1233
2017,8,20,18,1873,3088,1775,-1313
2017,8,20,19,1885,3200,1951,-1249
2017,8,20,20,1919,3232,1889,-1343
2017,8,20,21,1931,3253,1945,-1308
2017,8,20,22,1963,3264,2002,-1262
2017,8,20,23,2039,3312,2124,-1188
2017,8,21,0,2200,3375,2397,-978
2017,8,21,1,2370,3489,2450,-1039
2017,8,21,2,2381,3528,2515,-1013
2017,8,21,3,2367,3497,2560,-937
2017,8,21,4,2404,3536,2661,-875
2017,8,21,5,2316,3415,2535,-880
2017,8,21,6,2229,3229,2339,-890
2017,8,21,7,1971,2939,2041,-898
2017,8,21,8,1743,2660,1897,-763
2017,8,21,9,1714,2540,1767,-773
2017,8,21,10,1676,2502,1751,-751
2017,8,21,11,1691,2499,1742,-757
2017,8,21,12,1772,2557,1758,-799
2017,8,21,13,1926,2750,1815,-935
2017,8,21,14,1717,2925,1807,-1118
2017,8,21,15,1894,3082,1790,-1292
2017,8,21,16,2023,3257,1849,-1408
2017,8,21,17,2137,3353,1911,-1442
2017,8,21,18,2175,3391,1954,-1437
2017,8,21,19,2158,3449,1984,-1465
2017,8,21,20,2274,3522,2105,-1417
2017,8,21,21,2427,3630,2216,-1414
2017,8,21,22,2465,3628,2230,-1398
2017,8,21,23,2505,3756,2339,-1417
2017,8,22,0,2545,3854,2550,-1304
2017,8,22,1,2589,3910,2596,-1314
2017,8,22,2,2548,3887,2589,-1298
2017,8,22,3,2491,3802,2575,-1227
2017,8,22,4,2514,3788,2453,-1335
2017,8,22,5,2359,3653,2505,-1148
2017,8,22,6,2425,3382,2386,-996
2017,8,22,7,2031,3098,2182,-916
2017,8,22,8,1820,2899,2078,-821
2017,8,22,9,1776,2769,1932,-837
2017,8,22,10,1775,2638,1811,-827
2017,8,22,11,1720,2641,1750,-891
2017,8,22,12,1825,2682,1774,-908
2017,8,22,13,1960,2832,1880,-952
2017,8,22,14,1728,2950,1803,-1147
2017,8,22,15,1890,3119,1835,-1284
2017,8,22,16,1846,3346,2028,-1318
2017,8,22,17,1961,3450,2032,-1418
2017,8,22,18,2032,3607,2003,-1604
2017,8,22,19,2213,3694,2272,-1422
2017,8,22,20,2304,3806,2372,-1434
2017,8,22,21,2370,3887,2457,-1430
2017,8,22,22,2419,3964,2499,-1465
2017,8,22,23,2449,4016,2448,-1568
2017,8,23,0,2490,4070,2382,-1688
2017,8,23,1,2498,4090,2433,-1657
2017,8,23,2,2439,4021,2311,-1710
2017,8,23,3,2372,3859,2263,-1596
2017,8,23,4,2440,3828,2385,-1443
2017,8,23,5,2285,3641,2278,-1363
2017,8,23,6,2324,3436,2268,-1168
2017,8,23,7,1968,3145,2171,-974
2017,8,23,8,1994,2900,2119,-781
2017,8,23,9,1893,2812,2015,-797
2017,8,23,10,1859,2657,1981,-676
2017,8,23,11,1778,2629,1969,-660
2017,8,23,12,1891,2644,1923,-721
2017,8,23,13,2022,2842,1979,-863
2017,8,23,14,2018,3032,2024,-1008
2017,8,23,15,2108,3170,2110,-1060
2017,8,23,16,2177,3425,2204,-1221
2017,8,23,17,2300,3520,2266,-1254
2017,8,23,18,2375,3541,2309,-1232
2017,8,23,19,2468,3612,2353,-1259
2017,8,23,20,2563,3687,2369,-1318
2017,8,23,21,2561,3779,2536,-1243
2017,8,23,22,2563,3782,2414,-1368
2017,8,23,23,2599,3837,2537,-1300
2017,8,24,0,2640,3865,2587,-1278
2017,8,24,1,2667,3838,2538,-1300
2017,8,24,2,2641,3799,2747,-1052
2017,8,24,3,2617,3673,2554,-1119
2017,8,24,4,2642,3672,2554,-1118
2017,8,24,5,2580,3493,2475,-1018
2017,8,24,6,2386,3220,2461,-759
2017,8,24,7,2178,2942,2294,-648
2017,8,24,8,1919,2762,2199,-563
2017,8,24,9,1782,2638,2070,-568
2017,8,24,10,1736,2570,1937,-633
2017,8,24,11,1713,2561,1945,-616
2017,8,24,12,1748,2616,1947,-669
2017,8,24,13,1899,2835,2066,-769
2017,8,24,14,2029,3053,2116,-937
2017,8,24,15,2074,3124,1945,-1179
2017,8,24,16,2144,3268,2073,-1195
2017,8,24,17,2200,3314,2195,-1119
2017,8,24,18,2253,3369,2190,-1179
2017,8,24,19,2397,3391,2170,-1221
2017,8,24,20,2589,3397,2129,-1268
2017,8,24,21,2624,3408,2159,-1249
2017,8,24,22,2629,3470,2304,-1166
2017,8,24,23,2641,3462,2365,-1097
2017,8,25,0,2669,3506,2463,-1043
2017,8,25,1,2729,3553,2550,-1003
2017,8,25,2,2740,3560,2670,-890
2017,8,25,3,2745,3554,2693,-861
2017,8,25,4,2733,3599,2680,-919
2017,8,25,5,2692,3517,2533,-984
2017,8,25,6,2632,3241,2523,-718
2017,8,25,7,2393,2994,2461,-533
2017,8,25,8,1232,2706,1856,-850
2017,8,25,9,1096,2608,1660,-948
2017,8,25,10,1069,2537,1582,-955
2017,8,25,11,1138,2526,1639,-887
2017,8,25,12,1137,2582,1661,-921
2017,8,25,13,1412,2768,1875,-893
2017,8,25,14,1396,2976,1779,-1197
2017,8,25,15,1546,3128,1872,-1256
2017,8,25,16,1561,3200,1851,-1349
2017,8,25,17,1793,3338,1924,-1414
2017,8,25,18,1792,3508,1994,-1514
2017,8,25,19,1843,3491,1941,-1550
2017,8,25,20,1826,3492,1979,-1513
2017,8,25,21,1990,3510,2090,-1420
2017,8,25,22,1992,3602,2325,-1277
2017,8,25,23,1993,3620,2285,-1335
2017,8,26,0,2052,3666,2392,-1274
2017,8,26,1,2018,3665,2297,-1368
2017,8,26,2,2089,3614,2377,-1237
2017,8,26,3,1951,3508,2243,-1265
2017,8,26,4,1949,3514,2189,-1325
2017,8,26,5,2019,3372,2122,-1250
2017,8,26,6,1718,3196,2266,-930
2017,8,26,7,1578,2842,2043,-799
2017,8,26,8,1318,2588,1878,-710
2017,8,26,9,1210,2475,1798,-677
2017,8,26,10,1034,2412,1694,-718
2017,8,26,11,1131,2396,1631,-765
2017,8,26,12,1110,2479,1686,-793
2017,8,26,13,1284,2539,1664,-875
2017,8,26,14,1118,2674,1665,-1009
2017,8,26,15,1148,2782,1644,-1138
2017,8,26,16,1389,2953,1609,-1344
2017,8,26,17,1604,3102,1731,-1371
2017,8,26,18,1680,3197,1810,-1387
2017,8,26,19,1708,3239,1817,-1422
2017,8,26,20,1546,3273,1886,-1387
2017,8,26,21,1546,3324,2020,-1304
2017,8,26,22,1557,3445,2178,-1267
2017,8,26,23,1694,3516,2263,-1253
2017,8,27,0,1901,3583,2314,-1269
2017,8,27,1,1916,3616,2322,-1294
2017,8,27,2,1985,3580,2366,-1214
2017,8,27,3,1831,3502,2403,-1099
2017,8,27,4,1835,3465,2347,-1118
2017,8,27,5,1792,3377,2361,-1016
2017,8,27,6,1782,3243,2400,-843
2017,8,27,7,1569,3034,2156,-878
2017,8,27,8,1433,2736,1933,-803
2017,8,27,9,1304,2602,1920,-682
2017,8,27,10,1239,2498,1884,-614
2017,8,27,11,1202,2472,1721,-751
2017,8,27,12,1198,2561,1797,-764
2017,8,27,13,1215,2602,1848,-754
2017,8,27,14,1242,2555,1698,-857
2017,8,27,15,1368,2700,1636,-1064
2017,8,27,16,1575,3008,1750,-1258
2017,8,27,17,1749,3187,1797,-1390
2017,8,27,18,1855,3307,1893,-1414
2017,8,27,19,1804,3416,2041,-1375
2017,8,27,20,1981,3472,2093,-1379
2017,8,27,21,1832,3567,2200,-1367
2017,8,27,22,1870,3630,2320,-1310
2017,8,27,23,2028,3721,2339,-1382
2017,8,28,0,2202,3830,2508,-1322
2017,8,28,1,2267,3871,2605,-1266
2017,8,28,2,2266,3738,2547,-1191
2017,8,28,3,2239,3672,2491,-1181
2017,8,28,4,2236,3675,2387,-1288
2017,8,28,5,2053,3586,2441,-1145
2017,8,28,6,1894,3369,2391,-978
2017,8,28,7,1640,3104,2203,-901
2017,8,28,8,1464,2813,1961,-852
2017,8,28,9,1354,2791,1890,-901
2017,8,28,10,1289,2596,1690,-906
2017,8,28,11,1283,2579,1677,-902
2017,8,28,12,1346,2646,1687,-959
2017,8,28,13,1519,2815,1762,-1053
2017,8,28,14,1490,3019,1728,-1291
2017,8,28,15,1666,3163,1743,-1420
2017,8,28,16,1918,3312,1783,-1529
2017,8,28,17,2098,3451,1843,-1608
2017,8,28,18,2179,3615,2051,-1564
2017,8,28,19,2131,3787,2098,-1689
2017,8,28,20,2323,3932,2273,-1659
2017,8,28,21,2495,4059,2499,-1560
2017,8,28,22,2560,4148,2548,-1600
2017,8,28,23,2607,4202,2644,-1558
2017,8,29,0,2641,4265,2884,-1381
2017,8,29,1,2666,4302,2907,-9999
2017,8,29,2,2614,4258,2883,-1375
2017,8,29,3,2540,4153,2864,-1289
2017,8,29,4,2509,4125,2791,-1334
2017,8,29,5,2298,3884,2647,-1237
2017,8,29,6,2130,3498,2482,-1016
2017,8,29,7,1960,3160,2288,-872
2017,8,29,8,1939,3160,2295,-653
2017,8,29,9,1941,2831,2095,-9999
2017,8,29,10,1972,2759,2058,-701
2017,8,29,11,1937,2789,2151,-638
2017,8,29,12,1987,2850,2187,-9999
2017,8,29,13,1855,2987,2263,-724
2017,8,29,14,1843,3179,2155,-1024
2017,8,29,15,1995,3337,2149,-1188
2017,8,29,16,2031,3503,2192,-1311
2017,8,29,17,2054,3634,2329,-1305
2017,8,29,18,2076,3747,2465,-1282
2017,8,29,19,2175,3856,2510,-1346
2017,8,29,20,2371,3950,2600,-1350
2017,8,29,21,2554,4033,2682,-1351
2017,8,29,22,2635,4107,2787,-1320
2017,8,29,23,2677,4169,2855,-1314
2017,8,30,0,2734,4118,2711,-1407
2017,8,30,1,2749,4201,2827,-1374
2017,8,30,2,2679,4133,2841,-1292
2017,8,30,3,2600,4024,2798,-1226
2017,8,30,4,2581,4000,2757,-1243
2017,8,30,5,2345,3767,2713,-1054
2017,8,30,6,2134,3457,2693,-764
2017,8,30,7,1912,3158,2412,-746
2017,8,30,8,2071,2966,2386,-580
2017,8,30,9,1769,2846,2309,-537
2017,8,30,10,2020,2784,2361,-423
2017,8,30,11,1799,2747,2358,-389
2017,8,30,12,2004,2790,2286,-504
2017,8,30,13,2162,2997,2380,-617
2017,8,30,14,2029,3181,2309,-872
2017,8,30,15,2033,3366,2310,-1056
2017,8,30,16,2055,3479,2361,-1118
2017,8,30,17,2248,3507,2395,-1112
2017,8,30,18,2047,3585,2397,-1188
2017,8,30,19,2245,3605,2389,-1216
2017,8,30,20,2197,3566,2516,-1050
2017,8,30,21,2355,3653,2674,-979
2017,8,30,22,2279,3697,2704,-993
2017,8,30,23,2301,3740,2833,-907
2017,8,31,0,2270,3797,2955,-842
2017,8,31,1,2445,3844,3048,-796
2017,8,31,2,2291,3830,3136,-694
2017,8,31,3,2382,3747,2937,-810
2017,8,31,4,2391,3811,2770,-1041
2017,8,31,5,2228,3659,2470,-1189
2017,8,31,6,2228,3371,2403,-968
2017,8,31,7,2101,3059,2145,-914
2017,8,31,8,1833,2792,1965,-827
2017,8,31,9,1682,2623,1883,-740
2017,8,31,10,1601,2611,1944,-667
2017,8,31,11,1615,2589,1997,-592
2017,8,31,12,1666,2737,2092,-645
2017,8,31,13,1872,2945,2322,-623
2017,8,31,14,1782,3240,2287,-953
2017,8,31,15,2125,3350,2426,-924
2017,8,31,16,2209,3471,2525,-946
2017,8,31,17,2266,3566,2428,-1138
2017,8,31,18,2341,3617,2462,-1155
2017,8,31,19,2363,3651,2501,-1150
2017,8,31,20,2579,3713,2681,-1032
2017,8,31,21,2757,3741,2854,-887
2017,8,31,22,2805,3776,2903,-873
2017,8,31,23,2874,3804,2983,-821
2017,9,1,0,2916,3918,3116,-802
2017,9,1,1,2955,3851,3166,-685
2017,9,1,2,2921,3831,3178,-653
2017,9,1,3,2859,3751,3093,-658
2017,9,1,4,2809,3783,3126,-657
2017,9,1,5,2780,3604,3016,-588
2017,9,1,6,2714,3341,2998,-343
2017,9,1,7,2349,3080,2668,-412
2017,9,1,8,1817,2807,2155,-652
2017,9,1,9,1687,2734,2077,-657
2017,9,1,10,1669,2712,1964,-748
2017,9,1,11,1663,2681,1963,-718
2017,9,1,12,1742,2709,1870,-839
2017,9,1,13,2058,2923,2068,-855
2017,9,1,14,1959,3090,2023,-1067
2017,9,1,15,1963,3231,2153,-1078
2017,9,1,16,2043,3350,2089,-1261
2017,9,1,17,2114,3488,2163,-1325
2017,9,1,18,2178,3587,2345,-1242
2017,9,1,19,2354,3619,2443,-1176
2017,9,1,20,2532,3678,2698,-980
2017,9,1,21,2573,3707,2708,-999
2017,9,1,22,2587,3757,2726,-1031
2017,9,1,23,2642,3805,2810,-995
2017,9,2,0,2683,3824,2687,-1137
2017,9,2,1,2689,3826,2547,-1279
2017,9,2,2,2616,3802,2787,-1015
2017,9,2,3,2560,3664,2704,-960
2017,9,2,4,2541,3699,2695,-1004
2017,9,2,5,2392,3474,2535,-939
2017,9,2,6,2525,3230,2530,-700
2017,9,2,7,2286,2953,2403,-550
2017,9,2,8,2000,2744,2169,-575
2017,9,2,9,1784,2648,2128,-520
2017,9,2,10,1797,2585,2020,-565
2017,9,2,11,1789,2537,1971,-566
2017,9,2,12,1791,2520,1914,-606
2017,9,2,13,1791,2557,1891,-666
2017,9,2,14,1791,2671,1864,-807
2017,9,2,15,1746,2823,2056,-767
2017,9,2,16,1895,3058,2099,-959
2017,9,2,17,2032,3252,2078,-1174
2017,9,2,18,2137,3377,2275,-1102
2017,9,2,19,2302,3475,2550,-925
2017,9,2,20,2531,3524,2512,-1012
2017,9,2,21,2560,3599,2631,-968
2017,9,2,22,2597,3675,2711,-964
2017,9,2,23,2654,3762,2861,-901
2017,9,3,0,2725,3839,2940,-899
2017,9,3,1,2735,3820,2736,-1084
2017,9,3,2,2748,3835,2863,-972
2017,9,3,3,2653,3691,2715,-976
2017,9,3,4,2644,3771,2905,-866
2017,9,3,5,2399,3629,2832,-797
2017,9,3,6,2557,3413,2857,-556
2017,9,3,7,2204,3168,2666,-502
2017,9,3,8,2030,2959,2559,-400
2017,9,3,9,1878,2833,2491,-342
2017,9,3,10,2009,2726,2392,-334
2017,9,3,11,1982,2663,2312,-351
2017,9,3,12,1989,2626,2229,-397
2017,9,3,13,2046,2579,2032,-547
2017,9,3,14,1990,2619,1920,-699
2017,9,3,15,2077,2726,1907,-819
2017,9,3,16,2196,2946,2026,-920
2017,9,3,17,2377,3167,2149,-1018
2017,9,3,18,2454,3292,2192,-1100
2017,9,3,19,2645,3431,2377,-1054
2017,9,3,20,2541,3554,2295,-1259
2017,9,3,21,2592,3580,2303,-1277
2017,9,3,22,2663,3663,2418,-1245
2017,9,3,23,2861,3773,2752,-1021
2017,9,4,0,2775,3814,2659,-1155
2017,9,4,1,2851,3887,2762,-1125
2017,9,4,2,2962,3870,2772,-1098
2017,9,4,3,2948,3785,2752,-1033
2017,9,4,4,2810,3691,2535,-1156
2017,9,4,5,2792,3577,2714,-863
2017,9,4,6,2715,3365,2635,-730
2017,9,4,7,2569,3127,2399,-728
2017,9,4,8,2112,2892,2281,-611
2017,9,4,9,1865,2763,2161,-602
2017,9,4,10,1802,2686,2046,-640
2017,9,4,11,1777,2636,1986,-650
2017,9,4,12,1981,2646,2007,-639
2017,9,4,13,1913,2687,2145,-542
2017,9,4,14,1832,2737,2179,-558
2017,9,4,15,1843,2853,2270,-583
2017,9,4,16,1947,3139,2374,-765
2017,9,4,17,2176,3357,2469,-888
2017,9,4,18,2329,3459,2436,-1023
2017,9,4,19,2401,3549,2395,-1154
2017,9,4,20,2327,3668,2507,-1161
2017,9,4,21,2437,3657,2534,-1123
2017,9,4,22,2569,3714,2520,-1194
2017,9,4,23,2679,3779,2532,-1247
2017,9,5,0,2682,3845,2553,-1292
2017,9,5,1,2612,3888,2623,-1265
2017,9,5,2,2737,3847,2631,-1216
2017,9,5,3,2843,3969,2751,-1218
2017,9,5,4,2752,3956,2783,-1173
2017,9,5,5,2723,3729,2759,-970
2017,9,5,6,2682,3394,2691,-703
2017,9,5,7,2270,3026,2366,-660
2017,9,5,8,1875,2844,2105,-739
2017,9,5,9,1819,2734,2114,-620
2017,9,5,10,1873,2697,2107,-590
2017,9,5,11,1851,2666,2061,-605
2017,9,5,12,1915,2773,2142,-631
2017,9,5,13,2075,2974,2254,-720
2017,9,5,14,1991,3234,2225,-1009
2017,9,5,15,1984,3497,2356,-1141
2017,9,5,16,2100,3611,2320,-1291
2017,9,5,17,2178,3583,2277,-1306
2017,9,5,18,2254,3799,2343,-1456
2017,9,5,19,2333,3888,2401,-1487
2017,9,5,20,2359,3970,2435,-1535
2017,9,5,21,2475,4036,2593,-1443
2017,9,5,22,2552,4082,2677,-1405
2017,9,5,23,2616,4113,2834,-1279
2017,9,6,0,2633,4137,2906,-1231
2017,9,6,1,2669,4157,2932,-1225
2017,9,6,2,2618,4133,2882,-1251
2017,9,6,3,2645,4122,2748,-1374
2017,9,6,4,2694,4062,2900,-1162
2017,9,6,5,2445,3810,2764,-1046
2017,9,6,6,2703,3513,2755,-758
2017,9,6,7,2382,3219,2497,-722
2017,9,6,8,1781,3029,2181,-848
2017,9,6,9,1674,2898,2058,-840
2017,9,6,10,1825,2769,1986,-783
2017,9,6,11,1850,2744,1959,-785
2017,9,6,12,1925,2779,1997,-782
2017,9,6,13,2018,3030,2279,-751
2017,9,6,14,1921,3215,2158,-1057
2017,9,6,15,2032,3408,2287,-1121
2017,9,6,16,2114,3492,2305,-1187
2017,9,6,17,2168,3578,2313,-1265
2017,9,6,18,2239,3692,2347,-1345
2017,9,6,19,2304,3737,2322,-1415
2017,9,6,20,2369,3805,2459,-1346
2017,9,6,21,2455,3888,2576,-1312
2017,9,6,22,2522,3921,2680,-1241
2017,9,6,23,2570,3946,2688,-1258
2017,9,7,0,2497,3973,2681,-1292
2017,9,7,1,2515,4006,2672,-1334
2017,9,7,2,2595,3990,2698,-1292
2017,9,7,3,2586,3980,2686,-1294
2017,9,7,4,2777,3975,2727,-1248
2017,9,7,5,2556,3742,2551,-1191
2017,9,7,6,2264,3467,2389,-1078
2017,9,7,7,2049,3156,2281,-875
2017,9,7,8,1726,2993,2159,-834
2017,9,7,9,1678,2839,1989,-850
2017,9,7,10,1776,2721,1797,-924
2017,9,7,11,1639,2680,1732,-948
2017,9,7,12,1700,2741,1914,-827
2017,9,7,13,1948,2926,2089,-837
2017,9,7,14,2086,3192,2117,-1075
2017,9,7,15,2256,3282,2211,-1071
2017,9,7,16,2264,3268,2096,-1172
2017,9,7,17,2305,3385,2080,-1305
2017,9,7,18,2299,3471,2149,-1322
2017,9,7,19,2354,3527,2151,-1376
2017,9,7,20,2390,3526,2071,-1455
2017,9,7,21,2336,3634,2289,-1345
2017,9,7,22,2253,3635,2326,-1309
2017,9,7,23,2280,3614,2346,-1268
2017,9,8,0,2310,3665,2398,-1267
2017,9,8,1,2326,3673,2383,-1290
2017,9,8,2,2325,3671,2415,-1256
2017,9,8,3,2362,3677,2454,-1223
2017,9,8,4,2501,3730,2627,-1103
2017,9,8,5,2165,3555,2343,-1212
2017,9,8,6,1897,3255,2259,-996
2017,9,8,7,1567,2953,1842,-1111
2017,9,8,8,1195,2803,1710,-1093
2017,9,8,9,1300,2734,1641,-1093
2017,9,8,10,1295,2615,1609,-1006
2017,9,8,11,1455,2548,1507,-1041
2017,9,8,12,1615,2665,1468,-1197
2017,9,8,13,1837,2941,1659,-1282
2017,9,8,14,1701,3233,1821,-1412
2017,9,8,15,1789,3385,1858,-1527
2017,9,8,16,1834,3426,1916,-1510
2017,9,8,17,1848,3459,1794,-1665
2017,9,8,18,1869,3485,1878,-1607
2017,9,8,19,1888,3538,1983,-1555
2017,9,8,20,1985,3470,1811,-1659
2017,9,8,21,2098,3547,2027,-1520
2017,9,8,22,2107,3576,2017,-1559
2017,9,8,23,2118,3462,2113,-1349
2017,9,9,0,2140,3489,2175,-1314
2017,9,9,1,2138,3518,2238,-1280
2017,9,9,2,2158,3471,2342,-1129
2017,9,9,3,2059,3522,2368,-1154
2017,9,9,4,1958,3452,2193,-1259
2017,9,9,5,1895,3293,2103,-1190
2017,9,9,6,1639,3098,2090,-1008
2017,9,9,7,1329,2833,1789,-1044
2017,9,9,8,1397,2636,1569,-1067
2017,9,9,9,1199,2511,1538,-973
2017,9,9,10,1069,2455,1366,-1089
2017,9,9,11,1018,2429,1176,-1253
2017,9,9,12,1030,2445,1156,-1289
2017,9,9,13,1066,2496,1141,-1355
2017,9,9,14,1002,2590,1184,-1406
2017,9,9,15,992,2670,1131,-1539
2017,9,9,16,1119,2974,1312,-1662
2017,9,9,17,1233,3104,1253,-1851
2017,9,9,18,1285,3169,1176,-1993
2017,9,9,19,1169,3247,1145,-2102
2017,9,9,20,1295,3244,1172,-2072
2017,9,9,21,1112,3227,1326,-1901
2017,9,9,22,1258,3236,1379,-1857
2017,9,9,23,1148,3271,1451,-1820
2017,9,10,0,1288,3180,1340,-1840
2017,9,10,1,1343,3190,1386,-1804
2017,9,10,2,1198,3202,1461,-1741
2017,9,10,3,1423,3240,1585,-1655
2017,9,10,4,1300,3250,1640,-1610
2017,9,10,5,1375,3176,1579,-1597
2017,9,10,6,1353,3034,1527,-1507
2017,9,10,7,1363,2795,1303,-1492
2017,9,10,8,1040,2717,1302,-1415
2017,9,10,9,1008,2633,1296,-1337
2017,9,10,10,1050,2560,1309,-1251
2017,9,10,11,1047,2574,1377,-1197
2017,9,10,12,1087,2566,1401,-1165
2017,9,10,13,1207,2563,1465,-1098
2017,9,10,14,1167,2619,1588,-1031
2017,9,10,15,1326,2762,1654,-1108
2017,9,10,16,1476,2872,1627,-1245
2017,9,10,17,1539,3035,1618,-1417
2017,9,10,18,1575,3174,1708,-1466
2017,9,10,19,1629,3204,1635,-1569
2017,9,10,20,1797,3309,1860,-1449
2017,9,10,21,1805,3349,2057,-1292
2017,9,10,22,1808,3363,2099,-1264
2017,9,10,23,1807,3381,2144,-1237
2017,9,11,0,1879,3453,2133,-1320
2017,9,11,1,1977,3542,2157,-1385
2017,9,11,2,2007,3534,2183,-1351
2017,9,11,3,2035,3561,2210,-1351
2017,9,11,4,1892,3575,2267,-1308
2017,9,11,5,1721,3336,2017,-1319
2017,9,11,6,1614,2996,1854,-1142
2017,9,11,7,1389,2755,1792,-963
2017,9,11,8,1521,2600,1760,-840
2017,9,11,9,1430,2507,1681,-826
2017,9,11,10,1512,2454,1685,-769
2017,9,11,11,1522,2456,1609,-847
2017,9,11,12,1608,2570,1785,-785
2017,9,11,13,1833,2832,1963,-869
2017,9,11,14,1862,3167,1991,-1176
2017,9,11,15,1805,3324,1930,-1394
2017,9,11,16,1801,3395,1927,-1468
2017,9,11,17,1823,3422,2103,-1319
2017,9,11,18,1865,3477,2109,-1368
2017,9,11,19,1895,3519,2244,-1275
2017,9,11,20,2273,3580,2352,-1228
2017,9,11,21,2417,3625,2470,-1155
2017,9,11,22,2450,3663,2554,-1109
2017,9,11,23,2478,3684,2550,-1134
2017,9,12,0,2517,3748,2647,-1101
2017,9,12,1,2570,3820,2560,-1260
2017,9,12,2,2558,3782,2533,-1249
2017,9,12,3,2595,3779,2606,-1173
2017,9,12,4,2327,3732,2605,-1127
2017,9,12,5,1989,3474,2412,-1062
2017,9,12,6,1866,3173,2327,-846
2017,9,12,7,1593,2862,2164,-698
2017,9,12,8,1782,2671,2028,-643
2017,9,12,9,1684,2564,2006,-558
2017,9,12,10,1713,2519,2053,-466
2017,9,12,11,1624,2511,1984,-527
2017,9,12,12,1782,2584,2040,-544
2017,9,12,13,1834,2836,1969,-867
2017,9,12,14,1827,3127,2006,-1121
2017,9,12,15,2013,3330,2236,-1094
2017,9,12,16,2030,3324,2221,-1103
2017,9,12,17,2066,3471,2289,-1182
2017,9,12,18,2115,3513,2098,-1415
2017,9,12,19,2150,3601,2315,-1286
2017,9,12,20,2292,3631,2464,-1167
2017,9,12,21,2432,3665,2426,-1239
2017,9,12,22,2436,3655,2368,-1287
2017,9,12,23,2413,3710,2432,-1278
2017,9,13,0,2412,3696,2441,-1255
2017,9,13,1,2424,3668,2393,-1275
2017,9,13,2,2399,3666,2437,-1229
2017,9,13,3,2396,3676,2381,-1295
2017,9,13,4,2277,3664,2278,-1386
2017,9,13,5,1971,3387,2011,-1376
2017,9,13,6,1665,3176,2020,-1156
2017,9,13,7,1366,2753,1699,-1054
2017,9,13,8,1521,2515,1580,-935
2017,9,13,9,1460,2401,1547,-854
2017,9,13,10,1468,2335,1531,-804
2017,9,13,11,1508,2338,1509,-829
2017,9,13,12,1566,2417,1502,-915
2017,9,13,13,1747,2670,1725,-945
2017,9,13,14,1452,3155,1785,-1370
2017,9,13,15,1614,3244,1679,-1565
2017,9,13,16,1599,3339,1712,-1627
2017,9,13,17,1573,3352,1632,-1720
2017,9,13,18,1727,3382,1654,-1728
2017,9,13,19,1757,3428,1633,-1795
2017,9,13,20,1590,3402,1553,-1849
2017,9,13,21,1739,3387,1739,-1648
2017,9,13,22,1774,3399,1733,-1666
2017,9,13,23,1813,3416,1818,-1598
2017,9,14,0,1777,3469,1888,-1581
2017,9,14,1,1847,3528,1936,-1592
2017,9,14,2,1935,3501,1934,-1567
2017,9,14,3,1938,3542,1914,-1628
2017,9,14,4,2057,3571,1923,-1648
2017,9,14,5,1763,3306,1754,-1552
2017,9,14,6,1976,3077,1748,-1329
2017,9,14,7,1833,2771,1689,-1082
2017,9,14,8,1453,2617,1574,-1043
2017,9,14,9,1403,2490,1641,-849
2017,9,14,10,1298,2367,1580,-787
2017,9,14,11,1551,2323,1523,-800
2017,9,14,12,1518,2411,1552,-859
2017,9,14,13,1673,2777,1731,-1046
2017,9,14,14,1452,3050,1708,-1342
2017,9,14,15,1515,3270,1716,-1554
2017,9,14,16,1557,3231,1575,-1656
2017,9,14,17,1573,3260,1651,-1609
2017,9,14,18,1597,3285,1664,-1621
2017,9,14,19,1608,3410,1751,-1659
2017,9,14,20,1614,3439,1756,-1683
2017,9,14,21,1692,3425,1691,-1734
2017,9,14,22,1704,3473,1727,-1746
2017,9,14,23,1693,3458,1562,-1896
2017,9,15,0,1730,3511,1590,-1921
2017,9,15,1,1760,3547,1797,-1750
2017,9,15,2,1754,3452,1962,-1490
2017,9,15,3,1803,3516,1920,-1596
2017,9,15,4,1769,3539,1870,-1669
2017,9,15,5,1488,2870,1379,-1491
2017,9,15,6,1660,2558,1380,-1178
2017,9,15,7,1451,2281,1311,-970
2017,9,15,8,1228,2040,1232,-808
2017,9,15,9,1293,1971,1213,-758
2017,9,15,10,1302,1969,1171,-798
2017,9,15,11,1246,1999,1138,-861
2017,9,15,12,1287,2111,1195,-916
2017,9,15,13,1302,2313,1142,-1171
2017,9,15,14,1339,2661,1248,-1413
2017,9,15,15,1212,2840,1335,-1505
2017,9,15,16,1444,2891,1375,-1516
2017,9,15,17,1435,2887,1399,-1488
2017,9,15,18,1427,2888,1443,-1445
2017,9,15,19,1203,2915,1566,-1349
2017,9,15,20,1265,2957,1537,-1420
2017,9,15,21,1507,3007,1670,-1337
2017,9,15,22,1354,3102,1879,-1223
2017,9,15,23,1480,3151,1938,-1213
2017,9,16,0,1492,3198,1780,-1418
2017,9,16,1,1489,3252,1855,-1397
2017,9,16,2,1492,3222,1979,-1243
2017,9,16,3,1496,3234,2041,-1193
2017,9,16,4,1330,3194,2028,-1166
2017,9,16,5,1372,3011,1897,-1114
2017,9,16,6,1513,2789,1956,-833
2017,9,16,7,1469,2619,1720,-899
2017,9,16,8,1311,2475,1371,-1104
2017,9,16,9,1188,2435,1368,-1067
2017,9,16,10,1132,2276,1084,-1192
2017,9,16,11,1145,2259,1060,-1199
2017,9,16,12,1151,2283,1064,-1219
2017,9,16,13,1069,2392,1159,-1233
2017,9,16,14,1029,2508,1070,-1438
2017,9,16,15,983,2681,1071,-1610
2017,9,16,16,1328,2908,1231,-1677
2017,9,16,17,1281,2964,1239,-1725
2017,9,16,18,1369,2983,1262,-1721
2017,9,16,19,1293,3025,1299,-1726
2017,9,16,20,1250,2937,1207,-1730
2017,9,16,21,1237,2914,1183,-1731
2017,9,16,22,1247,2901,1300,-1601
2017,9,16,23,1246,2890,1390,-1500
2017,9,17,0,1458,2946,1517,-1429
2017,9,17,1,1499,2994,1476,-1518
2017,9,17,2,1525,3006,1490,-1516
2017,9,17,3,1570,3070,1568,-1502
2017,9,17,4,1432,3124,1630,-1494
2017,9,17,5,1275,3063,1684,-1379
2017,9,17,6,1404,2889,1695,-1194
2017,9,17,7,1390,2619,1508,-1111
2017,9,17,8,1404,2521,1520,-1001
2017,9,17,9,1321,2442,1479,-963
2017,9,17,10,1272,2343,1419,-924
2017,9,17,11,1267,2326,1424,-902
2017,9,17,12,1204,2334,1374,-960
2017,9,17,13,1224,2386,1415,-971
2017,9,17,14,1195,2518,1481,-1037
2017,9,17,15,1216,2705,1471,-1234
2017,9,17,16,1340,2905,1572,-1333
2017,9,17,17,1491,2991,1537,-1454
2017,9,17,18,1555,3047,1526,-1521
2017,9,17,19,1566,3062,1545,-1517
2017,9,17,20,1565,3126,1562,-1564
2017,9,17,21,1523,3101,1498,-1603
2017,9,17,22,1445,3105,1485,-1620
2017,9,17,23,1369,3119,1546,-1573
2017,9,18,0,1336,3185,1602,-1583
2017,9,18,1,1353,3332,1748,-1584
2017,9,18,2,1370,3399,1853,-1546
2017,9,18,3,1435,3460,1903,-1557
2017,9,18,4,1417,3395,1817,-1578
2017,9,18,5,1307,3206,1616,-1590
2017,9,18,6,1200,2940,1472,-1468
2017,9,18,7,1071,2635,1396,-1239
2017,9,18,8,1354,2503,1420,-1083
2017,9,18,9,1224,2461,1487,-974
2017,9,18,10,1191,2437,1487,-950
2017,9,18,11,1161,2450,1406,-1044
2017,9,18,12,1229,2558,1387,-1171
2017,9,18,13,1366,2819,1548,-1271
2017,9,18,14,1304,3152,1578,-1574
2017,9,18,15,1451,3370,1643,-1727
2017,9,18,16,1453,3380,1579,-1801
2017,9,18,17,1435,3351,1551,-1800
2017,9,18,18,1422,3359,1545,-1814
2017,9,18,19,1384,3358,1460,-1898
2017,9,18,20,1406,3333,1390,-1943
2017,9,18,21,1503,3294,1274,-2020
2017,9,18,22,1476,3252,1298,-1954
2017,9,18,23,1467,3249,1445,-1804
2017,9,19,0,1502,3278,1445,-1833
2017,9,19,1,1592,3354,1474,-1880
2017,9,19,2,1607,3437,1616,-1821
2017,9,19,3,1674,3618,1831,-1787
2017,9,19,4,1649,3562,1805,-1757
2017,9,19,5,1456,3359,1659,-1700
2017,9,19,6,1398,3045,1574,-1471
2017,9,19,7,1020,2729,1317,-1412
2017,9,19,8,1070,2500,1075,-1425
2017,9,19,9,1003,2421,1047,-1374
2017,9,19,10,944,2412,1091,-1321
2017,9,19,11,960,2417,1029,-1388
2017,9,19,12,1059,2551,1087,-1464
2017,9,19,13,1201,2825,1151,-1674
2017,9,19,14,1197,3212,1218,-1994
2017,9,19,15,1264,3389,1328,-2061
2017,9,19,16,1419,3306,1254,-2052
2017,9,19,17,1415,3277,1181,-2096
2017,9,19,18,1252,3318,1074,-2244
2017,9,19,19,1264,3305,1119,-2186
2017,9,19,20,1305,3292,1185,-2107
2017,9,19,21,1396,3275,1219,-2056
2017,9,19,22,1492,3241,1168,-2073
2017,9,19,23,1428,3231,1151,-2080
2017,9,20,0,1536,3272,1287,-1985
2017,9,20,1,1522,3328,1383,-1945
2017,9,20,2,1428,3388,1600,-1788
2017,9,20,3,1632,3546,1673,-1873
2017,9,20,4,1544,3500,1753,-1747
2017,9,20,5,1401,3282,1558,-1724
2017,9,20,6,1478,3030,1577,-1453
2017,9,20,7,1372,2758,1445,-1313
2017,9,20,8,1246,2639,1388,-1251
2017,9,20,9,1172,2468,1312,-1156
2017,9,20,10,1253,2419,1238,-1181
2017,9,20,11,1250,2427,1316,-1111
2017,9,20,12,1365,2525,1383,-1142
2017,9,20,13,1560,2835,1554,-1281
2017,9,20,14,1613,3211,1658,-1553
2017,9,20,15,1723,3439,1741,-1698
2017,9,20,16,1712,3342,1584,-1758
2017,9,20,17,1703,3273,1503,-1770
2017,9,20,18,1549,3247,1406,-1841
2017,9,20,19,1506,3219,1420,-1799
2017,9,20,20,1634,3200,1456,-1744
2017,9,20,21,1728,3165,1476,-1689
2017,9,20,22,1580,3117,1385,-1732
2017,9,20,23,1590,3115,1404,-1711
2017,9,21,0,1760,3158,1536,-1622
2017,9,21,1,1642,3248,1757,-1491
2017,9,21,2,1852,3252,1987,-1265
2017,9,21,3,1944,3389,1952,-1437
2017,9,21,4,1777,3294,1879,-1415
2017,9,21,5,1566,3161,1678,-1483
2017,9,21,6,1704,2903,1523,-1380
2017,9,21,7,1512,2717,1391,-1326
2017,9,21,8,1282,2634,1435,-1199
2017,9,21,9,1193,2572,1487,-1085
2017,9,21,10,1204,2449,1334,-1115
2017,9,21,11,1190,2456,1331,-1125
2017,9,21,12,1327,2556,1354,-1202
2017,9,21,13,1553,2817,1477,-1340
2017,9,21,14,1391,3230,1712,-1518
2017,9,21,15,1609,3358,1597,-1761
2017,9,21,16,1655,3346,1630,-1716
2017,9,21,17,1649,3333,1570,-1763
2017,9,21,18,1638,3309,1585,-1724
2017,9,21,19,1625,3290,1499,-1791
2017,9,21,20,1704,3253,1437,-1816
2017,9,21,21,1759,3197,1393,-1804
2017,9,21,22,1754,3170,1432,-1738
2017,9,21,23,1752,3174,1516,-1658
2017,9,22,0,1750,3173,1480,-1693
2017,9,22,1,1620,3227,1571,-1656
2017,9,22,2,1836,3262,1628,-1634
2017,9,22,3,1864,3366,1649,-1717
2017,9,22,4,1867,3344,1657,-1687
2017,9,22,5,1746,3165,1512,-1653
2017,9,22,6,1828,2930,1620,-1310
2017,9,22,7,1708,2659,1482,-1177
2017,9,22,8,1508,2516,1469,-1047
2017,9,22,9,1497,2434,1482,-952
2017,9,22,10,1522,2409,1498,-911
2017,9,22,11,1574,2417,1465,-952
2017,9,22,12,1607,2522,1510,-1012
2017,9,22,13,1515,2796,1555,-1241
2017,9,22,14,1770,3142,1644,-1498
2017,9,22,15,1761,3333,1795,-1538
2017,9,22,16,1782,3387,1707,-1680
2017,9,22,17,1917,3305,1772,-1533
2017,9,22,18,1712,3307,1902,-1405
2017,9,22,19,1828,3277,1901,-1376
2017,9,22,20,1856,3250,1913,-1337
2017,9,22,21,1774,3229,1929,-1300
2017,9,22,22,1750,3252,1980,-1272
2017,9,22,23,1743,3240,1969,-1271
2017,9,23,0,1870,3205,1742,-1463
2017,9,23,1,1819,3212,1695,-1517
2017,9,23,2,1789,3194,1750,-1444
2017,9,23,3,1809,3231,1711,-1520
2017,9,23,4,1762,3185,1735,-1450
2017,9,23,5,1639,3060,1630,-1430
2017,9,23,6,1843,2867,1747,-1120
2017,9,23,7,1656,2656,1671,-985
2017,9,23,8,1375,2535,1526,-1009
2017,9,23,9,1304,2460,1585,-875
2017,9,23,10,1385,2406,1584,-822
2017,9,23,11,1347,2400,1579,-821
2017,9,23,12,1367,2416,1600,-816
2017,9,23,13,1450,2500,1555,-945
2017,9,23,14,1241,2651,1550,-1101
2017,9,23,15,1321,2800,1524,-1276
2017,9,23,16,1491,2979,1447,-1532
2017,9,23,17,1601,3114,1446,-1668
2017,9,23,18,1509,3150,1469,-1681
2017,9,23,19,1517,3126,1502,-1624
2017,9,23,20,1639,3120,1457,-1663
2017,9,23,21,1462,3092,1478,-1614
2017,9,23,22,1604,3061,1492,-1569
2017,9,23,23,1429,3069,1607,-1462
2017,9,24,0,1634,3098,1680,-1418
2017,9,24,1,1554,3154,1746,-1408
2017,9,24,2,1609,3149,1705,-1444
2017,9,24,3,1651,3224,1793,-1431
2017,9,24,4,1401,3220,1761,-1459
2017,9,24,5,1472,3093,1670,-1423
2017,9,24,6,1435,2929,1724,-1205
2017,9,24,7,1348,2750,1742,-1008
2017,9,24,8,1474,2592,1741,-851
2017,9,24,9,1474,2537,1735,-802
2017,9,24,10,1469,2392,1584,-808
2017,9,24,11,1433,2398,1574,-824
2017,9,24,12,1476,2352,1521,-831
2017,9,24,13,1563,2368,1455,-913
2017,9,24,14,1375,2536,1489,-1047
2017,9,24,15,1516,2701,1412,-1289
2017,9,24,16,1655,2919,1386,-1533
2017,9,24,17,1675,3025,1562,-1463
2017,9,24,18,1730,3033,1593,-1440
2017,9,24,19,1591,3033,1603,-1430
2017,9,24,20,1613,3025,1611,-1414
2017,9,24,21,1772,3047,1723,-1324
2017,9,24,22,1592,3059,1731,-1328
2017,9,24,23,1592,3079,1714,-1365
2017,9,25,0,1777,3144,1894,-1250
2017,9,25,1,1832,3245,1970,-1275
2017,9,25,2,1965,3282,2082,-1200
2017,9,25,3,2076,3390,2209,-1181
2017,9,25,4,2085,3284,2188,-1096
2017,9,25,5,1984,3107,2206,-901
2017,9,25,6,1980,2862,2165,-697
2017,9,25,7,1652,2569,1814,-755
2017,9,25,8,1395,2428,1795,-633
2017,9,25,9,1378,2346,1751,-595
2017,9,25,10,1470,2322,1706,-616
2017,9,25,11,1447,2339,1705,-634
2017,9,25,12,1537,2450,1768,-682
2017,9,25,13,1747,2658,1788,-870
2017,9,25,14,1763,2984,1819,-1165
2017,9,25,15,1950,3221,2008,-1213
2017,9,25,16,1986,3294,2013,-1281
2017,9,25,17,1898,3316,2017,-1299
2017,9,25,18,1903,3321,2018,-1303
2017,9,25,19,1904,3305,1945,-1360
2017,9,25,20,1983,3369,1987,-1382
2017,9,25,21,2080,3301,1959,-1342
2017,9,25,22,2011,3271,1983,-1288
2017,9,25,23,1986,3263,2078,-1185
2017,9,26,0,2026,3307,1987,-1320
2017,9,26,1,2102,3397,2260,-1137
2017,9,26,2,2143,3456,2374,-1082
2017,9,26,3,2253,3532,2419,-1113
2017,9,26,4,2168,3439,2267,-1172
2017,9,26,5,1933,3208,2121,-1087
2017,9,26,6,1998,2919,1968,-951
2017,9,26,7,1689,2697,1895,-802
2017,9,26,8,1554,2504,1704,-800
2017,9,26,9,1508,2418,1685,-733
2017,9,26,10,1480,2383,1678,-705
2017,9,26,11,1512,2377,1685,-692
2017,9,26,12,1627,2468,1693,-775
2017,9,26,13,1852,2721,1761,-960
2017,9,26,14,1711,3136,1922,-1214
2017,9,26,15,1830,3307,1919,-1388
2017,9,26,16,1777,3255,1758,-1497
2017,9,26,17,1775,3224,1789,-1435
2017,9,26,18,1788,3263,1837,-1426
2017,9,26,19,1800,3284,1791,-1493
2017,9,26,20,1870,3303,1823,-1480
2017,9,26,21,2016,3334,1857,-1477
2017,9,26,22,2019,3276,1772,-1504
2017,9,26,23,2025,3306,1823,-1483
2017,9,27,0,2124,3310,1916,-1394
2017,9,27,1,2177,3320,1932,-1388
2017,9,27,2,2201,3312,2054,-1258
2017,9,27,3,2296,3510,2080,-1430
2017,9,27,4,2214,3412,2099,-1313
2017,9,27,5,1982,3208,1979,-1229
2017,9,27,6,2036,2979,1947,-1032
2017,9,27,7,1956,2735,1897,-838
2017,9,27,8,1523,2542,1602,-940
2017,9,27,9,1378,2455,1502,-953
2017,9,27,10,1372,2407,1481,-926
2017,9,27,11,1366,2396,1439,-957
2017,9,27,12,1380,2569,1493,-1076
2017,9,27,13,1712,2756,1566,-1190
2017,9,27,14,1502,3121,1653,-1468
2017,9,27,15,1859,3251,1631,-1620
2017,9,27,16,1723,3273,1676,-1597
2017,9,27,17,1732,3280,1708,-1572
2017,9,27,18,1755,3282,1762,-1520
2017,9,27,19,1771,3275,1784,-1491
2017,9,27,20,1861,3283,1863,-1420
2017,9,27,21,2006,3287,1911,-1376
2017,9,27,22,2027,3299,2003,-1296
2017,9,27,23,2107,3362,2005,-1357
2017,9,28,0,2211,3414,2014,-1400
2017,9,28,1,2154,3516,2224,-1292
2017,9,28,2,2261,3514,2186,-1328
2017,9,28,3,2275,3614,2229,-1385
2017,9,28,4,2207,3518,2249,-1269
2017,9,28,5,1993,3275,2018,-1257
2017,9,28,6,2066,3010,1966,-1044
2017,9,28,7,1900,2722,1866,-856
2017,9,28,8,1499,2562,1638,-924
2017,9,28,9,1339,2494,1445,-1049
2017,9,28,10,1323,2414,1404,-1010
2017,9,28,11,1383,2420,1424,-996
2017,9,28,12,1425,2423,1436,-987
2017,9,28,13,1680,2635,1554,-1081
2017,9,28,14,1609,3037,1685,-1352
2017,9,28,15,1793,3171,1703,-1468
2017,9,28,16,1764,3210,1685,-1525
2017,9,28,17,1813,3252,1621,-1631
2017,9,28,18,1875,3312,1705,-1607
2017,9,28,19,1780,3372,1824,-1548
2017,9,28,20,1869,3402,1905,-1497
2017,9,28,21,2001,3505,2070,-1435
2017,9,28,22,2030,3547,2061,-1486
2017,9,28,23,2010,3575,2127,-1448
2017,9,29,0,2140,3616,2146,-1470
2017,9,29,1,2181,3655,2180,-1475
2017,9,29,2,2189,3615,2244,-1371
2017,9,29,3,2265,3639,2258,-1381
2017,9,29,4,2172,3559,2237,-1322
2017,9,29,5,1983,3334,2119,-1215
2017,9,29,6,2091,3051,2127,-924
2017,9,29,7,1811,2793,1949,-844
2017,9,29,8,1552,2585,1500,-1085
2017,9,29,9,1275,2527,1418,-1109
2017,9,29,10,1193,2409,1297,-1112
2017,9,29,11,1180,2414,1306,-1108
2017,9,29,12,1242,2486,1299,-1187
2017,9,29,13,1356,2652,1338,-1314
2017,9,29,14,1401,3020,1464,-1556
2017,9,29,15,1530,3198,1576,-1622
2017,9,29,16,1703,3246,1517,-1729
2017,9,29,17,1703,3290,1528,-1762
2017,9,29,18,1753,3313,1478,-1835
2017,9,29,19,1734,3344,1638,-1706
2017,9,29,20,1585,3356,1843,-1513
2017,9,29,21,1555,3325,1715,-1610
2017,9,29,22,1385,3305,1509,-1796
2017,9,29,23,1331,3230,1434,-1796
2017,9,30,0,1294,3241,1521,-1720
2017,9,30,1,1295,3244,1523,-1721
2017,9,30,2,1400,3236,1579,-1657
2017,9,30,3,1263,3314,1603,-1711
2017,9,30,4,1401,3200,1547,-1653
2017,9,30,5,1279,3064,1547,-1517
2017,9,30,6,1399,2940,1732,-1208
2017,9,30,7,1295,2650,1614,-1036
2017,9,30,8,1035,2474,1212,-1262
2017,9,30,9,956,2377,1112,-1265
2017,9,30,10,993,2319,1114,-1205
2017,9,30,11,1008,2302,1065,-1237
2017,9,30,12,980,2322,1071,-1251
2017,9,30,13,927,2401,1009,-1392
2017,9,30,14,1025,2539,999,-1540
2017,9,30,15,992,2685,1065,-1620
2017,9,30,16,974,2889,1062,-1827
2017,9,30,17,1087,3007,1077,-1930
2017,9,30,18,1122,3029,1074,-1955
2017,9,30,19,1118,3045,1087,-1958
2017,9,30,20,1089,3034,1108,-1926
2017,9,30,21,1053,2978,1135,-1843
2017,9,30,22,1020,2953,1162,-1791
2017,9,30,23,1086,2973,1154,-1819
2017,10,1,0,1128,2994,1155,-1839
2017,10,1,1,1005,3156,1427,-1729
2017,10,1,2,1056,3181,1402,-1779
2017,10,1,3,1232,3188,1361,-1827
2017,10,1,4,1101,3130,1291,-1839
2017,10,1,5,1126,3001,1265,-1736
2017,10,1,6,1265,2837,1388,-1449
2017,10,1,7,1107,2656,1383,-1273
2017,10,1,8,999,2535,1280,-1255
2017,10,1,9,1018,2467,1323,-1144
2017,10,1,10,982,2339,1192,-1147
2017,10,1,11,922,2347,1197,-1150
2017,10,1,12,870,2351,1113,-1238
2017,10,1,13,870,2490,1241,-1249
2017,10,1,14,858,2620,1106,-1514
2017,10,1,15,838,2768,1093,-1675
2017,10,1,16,1159,2992,1258,-1734
2017,10,1,17,1295,3126,1322,-1804
2017,10,1,18,1331,3130,1271,-1859
2017,10,1,19,1172,3117,1278,-1839
2017,10,1,20,1338,3153,1324,-1829
2017,10,1,21,1338,3122,1329,-1793
2017,10,1,22,1215,3080,1365,-1715
2017,10,1,23,1330,3062,1488,-1574
2017,10,2,0,1394,3165,1637,-1528
2017,10,2,1,1336,3198,1658,-1540
2017,10,2,2,1455,3251,1618,-1633
2017,10,2,3,1644,3370,1550,-1820
2017,10,2,4,1655,3246,1483,-1763
2017,10,2,5,1346,3096,1389,-1707
2017,10,2,6,1426,2864,1359,-1505
2017,10,2,7,1249,2626,1269,-1357
2017,10,2,8,1196,2483,1245,-1238
2017,10,2,9,1138,2395,1180,-1215
2017,10,2,10,1222,2389,1148,-1241
2017,10,2,11,1204,2410,1240,-1170
2017,10,2,12,1296,2512,1238,-1274
2017,10,2,13,1473,2769,1231,-1538
2017,10,2,14,1600,3156,1232,-1924
2017,10,2,15,1782,3386,1368,-2018
2017,10,2,16,1785,3425,1559,-1866
2017,10,2,17,1792,3465,1691,-1774
2017,10,2,18,1710,3404,1747,-1657
2017,10,2,19,1824,3302,1730,-1572
2017,10,2,20,1827,3204,1755,-1449
2017,10,2,21,1816,3185,1747,-1438
2017,10,2,22,1676,3170,1718,-1452
2017,10,2,23,1676,3255,1734,-1521
2017,10,3,0,1789,3319,1811,-1508
2017,10,3,1,1798,3392,1867,-1525
2017,10,3,2,1790,3492,1924,-1568
2017,10,3,3,1886,3621,1979,-1642
2017,10,3,4,1773,3519,1948,-1571
2017,10,3,5,1728,3301,1800,-1501
2017,10,3,6,1693,3043,1826,-1217
2017,10,3,7,1638,2820,1709,-1111
2017,10,3,8,1269,2594,1458,-1136
2017,10,3,9,1358,2608,1564,-1044
2017,10,3,10,1361,2586,1523,-1063
2017,10,3,11,1363,2628,1535,-1093
2017,10,3,12,1470,2733,1515,-1218
2017,10,3,13,1597,3054,1651,-1403
2017,10,3,14,1796,3458,1906,-1552
2017,10,3,15,1777,3622,1876,-1746
2017,10,3,16,1847,3604,1875,-1729
2017,10,3,17,1891,3413,1753,-1660
2017,10,3,18,1787,3328,1601,-1727
2017,10,3,19,1704,3271,1477,-1794
2017,10,3,20,1662,3223,1384,-1839
2017,10,3,21,1640,3200,1479,-1721
2017,10,3,22,1639,3164,1498,-1666
2017,10,3,23,1652,3154,1518,-1636
2017,10,4,0,1695,3192,1527,-1665
2017,10,4,1,1613,3243,1609,-1634
2017,10,4,2,1729,3388,1655,-1733
2017,10,4,3,1893,3557,1683,-1874
2017,10,4,4,1779,3466,1677,-1789
2017,10,4,5,1577,3264,1643,-1621
2017,10,4,6,1570,3017,1658,-1359
2017,10,4,7,1329,2791,1540,-1251
2017,10,4,8,1354,2660,1473,-1187
2017,10,4,9,1359,2604,1476,-1128
2017,10,4,10,1345,2596,1487,-1109
2017,10,4,11,1406,2552,1442,-1110
2017,10,4,12,1493,2721,1536,-1185
2017,10,4,13,1718,3044,1669,-1375
2017,10,4,14,1427,3463,1742,-1721
2017,10,4,15,1650,3668,1965,-1703
2017,10,4,16,1621,3607,1906,-1701
2017,10,4,17,1540,3485,1882,-1603
2017,10,4,18,1800,3383,1849,-1534
2017,10,4,19,1790,3316,1756,-1560
2017,10,4,20,1613,3239,1729,-1510
2017,10,4,21,1737,3246,1740,-1506
2017,10,4,22,1558,3179,1703,-1476
2017,10,4,23,1733,3192,1661,-1531
2017,10,5,0,1631,3219,1716,-1503
2017,10,5,1,1688,3316,1767,-1549
2017,10,5,2,1741,3363,1842,-1521
2017,10,5,3,1824,3548,1966,-1582
2017,10,5,4,1728,3469,1914,-1555
2017,10,5,5,1705,3274,1654,-1620
2017,10,5,6,1536,3038,1572,-1466
2017,10,5,7,1421,2761,1343,-1418
2017,10,5,8,1401,2660,1320,-1340
2017,10,5,9,1207,2649,1361,-1288
2017,10,5,10,1285,2558,1300,-1258
2017,10,5,11,1411,2549,1347,-1202
2017,10,5,12,1490,2702,1411,-1291
2017,10,5,13,1641,3033,1525,-1508
2017,10,5,14,1378,3427,1609,-1818
2017,10,5,15,1594,3659,1870,-1789
2017,10,5,16,1557,3611,1822,-1789
2017,10,5,17,1495,3501,1784,-1717
2017,10,5,18,1729,3380,1685,-1695
2017,10,5,19,1721,3289,1639,-1650
2017,10,5,20,1709,3241,1608,-1633
2017,10,5,21,1700,3239,1694,-1545
2017,10,5,22,1643,3221,1656,-1565
2017,10,5,23,1650,3169,1603,-1566
2017,10,6,0,1647,3193,1604,-1589
2017,10,6,1,1730,3308,1686,-1622
2017,10,6,2,1654,3376,1799,-1577
2017,10,6,3,1797,3484,1801,-1683
2017,10,6,4,1736,3348,1773,-1575
2017,10,6,5,1527,3116,1499,-1617
2017,10,6,6,1587,2847,1558,-1289
2017,10,6,7,1410,2594,1480,-1114
2017,10,6,8,1467,2486,1552,-934
2017,10,6,9,1250,2413,1516,-897
2017,10,6,10,1534,2386,1601,-785
2017,10,6,11,1439,2387,1502,-885
2017,10,6,12,1499,2526,1591,-935
2017,10,6,13,1616,2788,1562,-1226
2017,10,6,14,1602,3208,1834,-1374
2017,10,6,15,1834,3363,1792,-1571
2017,10,6,16,1895,3376,1734,-1642
2017,10,6,17,1811,3324,1794,-1530
2017,10,6,18,1749,3266,1776,-1490
2017,10,6,19,1512,3208,1601,-1607
2017,10,6,20,1499,3183,1726,-1457
2017,10,6,21,1406,3138,1706,-1432
2017,10,6,22,1397,3078,1672,-1406
2017,10,6,23,1388,2958,1533,-1425
2017,10,7,0,1534,3013,1576,-1437
2017,10,7,1,1589,3064,1512,-1552
2017,10,7,2,1647,3159,1606,-1553
2017,10,7,3,1690,3152,1499,-1653
2017,10,7,4,1588,3060,1454,-1606
2017,10,7,5,1435,2953,1425,-1528
2017,10,7,6,1393,2765,1437,-1328
2017,10,7,7,1200,2564,1302,-1262
2017,10,7,8,1118,2409,1154,-1255
2017,10,7,9,959,2278,952,-1326
2017,10,7,10,971,2224,871,-1353
2017,10,7,11,923,2212,956,-1256
2017,10,7,12,953,2234,999,-1235
2017,10,7,13,1051,2346,1065,-1281
2017,10,7,14,984,2530,1068,-1462
2017,10,7,15,1008,2729,1108,-1621
2017,10,7,16,1175,2908,1171,-1737
2017,10,7,17,1271,3063,1304,-1759
2017,10,7,18,1285,3014,1238,-1776
2017,10,7,19,1286,3041,1297,-1744
2017,10,7,20,1128,2958,1229,-1729
2017,10,7,21,1096,2896,1174,-1722
2017,10,7,22,1226,2961,1192,-1769
2017,10,7,23,1048,2966,1196,-1770
2017,10,8,0,1088,2978,1184,-1794
2017,10,8,1,1315,3039,1248,-1791
2017,10,8,2,1168,3118,1306,-1812
2017,10,8,3,1223,3110,1294,-1816
2017,10,8,4,1257,3071,1143,-1928
2017,10,8,5,1142,2884,1045,-1839
2017,10,8,6,1184,2749,1234,-1515
2017,10,8,7,1245,2521,1185,-1336
2017,10,8,8,1089,2375,1043,-1332
2017,10,8,9,1074,2287,1012,-1275
2017,10,8,10,965,2285,1025,-1260
2017,10,8,11,1077,2244,881,-1363
2017,10,8,12,1099,2342,1010,-1332
2017,10,8,13,1159,2452,1112,-1340
2017,10,8,14,977,2602,1191,-1411
2017,10,8,15,1267,2769,1244,-1525
2017,10,8,16,1433,2989,1357,-1632
2017,10,8,17,1685,2997,1402,-1595
2017,10,8,18,1734,3002,1449,-1553
2017,10,8,19,1749,2973,1576,-1397
2017,10,8,20,1641,2928,1596,-1332
2017,10,8,21,1676,2882,1635,-1247
2017,10,8,22,1678,2821,1730,-1091
2017,10,8,23,1635,2806,1678,-1128
2017,10,9,0,1641,2849,1604,-1245
2017,10,9,1,1856,2985,1773,-1212
2017,10,9,2,1955,3205,1920,-1285
2017,10,9,3,1871,3317,1840,-1477
2017,10,9,4,1992,3144,1624,-1520
2017,10,9,5,1804,2968,1463,-1505
2017,10,9,6,1744,2735,1393,-1342
2017,10,9,7,1558,2510,1328,-1182
2017,10,9,8,1233,2436,1315,-1121
2017,10,9,9,1210,2402,1324,-1078
2017,10,9,10,1255,2394,1332,-1062
2017,10,9,11,1334,2463,1362,-1101
2017,10,9,12,1392,2661,1443,-1218
2017,10,9,13,1691,2976,1657,-1319
2017,10,9,14,1731,3376,1745,-1631
2017,10,9,15,1794,3633,1909,-1724
2017,10,9,16,1828,3601,1797,-1804
2017,10,9,17,1822,3536,1904,-1632
2017,10,9,18,1805,3468,1937,-1531
2017,10,9,19,1765,3381,1941,-1440
2017,10,9,20,1962,3303,1968,-1335
2017,10,9,21,2002,3221,1870,-1351
2017,10,9,22,1787,3176,1806,-1370
2017,10,9,23,1808,3187,1750,-1437
2017,10,10,0,1981,3240,1760,-1480
2017,10,10,1,1939,3330,1802,-1528
2017,10,10,2,2063,3521,1910,-1611
2017,10,10,3,2104,3625,1964,-1661
2017,10,10,4,2003,3554,1974,-1580
2017,10,10,5,1820,3300,1675,-1625
2017,10,10,6,1710,3060,1723,-1337
2017,10,10,7,1488,2662,1597,-1065
2017,10,10,8,1503,2541,1526,-1015
2017,10,10,9,1490,2475,1458,-1017
2017,10,10,10,1358,2449,1443,-1006
2017,10,10,11,1397,2485,1479,-1006
2017,10,10,12,1448,2631,1428,-1203
2017,10,10,13,1791,2955,1536,-1419
2017,10,10,14,2051,3337,1558,-1779
2017,10,10,15,2173,3601,1704,-1897
2017,10,10,16,2085,3571,1713,-1858
2017,10,10,17,2025,3451,1621,-1830
2017,10,10,18,1926,3461,1590,-1871
2017,10,10,19,1802,3446,1597,-1849
2017,10,10,20,1673,3449,1747,-1702
2017,10,10,21,1679,3441,1830,-1611
2017,10,10,22,1628,3374,1942,-1432
2017,10,10,23,1605,3332,1975,-1357
2017,10,11,0,1773,3360,1820,-1540
2017,10,11,1,1868,3470,1817,-1653
2017,10,11,2,1812,3679,2153,-1526
2017,10,11,3,2041,3771,2213,-1558
2017,10,11,4,1978,3626,1887,-1739
2017,10,11,5,1752,3396,1699,-1697
2017,10,11,6,1491,3138,1774,-1364
2017,10,11,7,1258,2913,1601,-1312
2017,10,11,8,1438,2718,1765,-953
2017,10,11,9,1562,2595,1683,-912
2017,10,11,10,1489,2581,1675,-906
2017,10,11,11,1597,2618,1668,-950
2017,10,11,12,1819,2773,1705,-1068
2017,10,11,13,1949,3149,1785,-1364
2017,10,11,14,2000,3569,2012,-1557
2017,10,11,15,2051,3761,2082,-1679
2017,10,11,16,2040,3683,2024,-1659
2017,10,11,17,2006,3658,2127,-1531
2017,10,11,18,1949,3476,2013,-1463
2017,10,11,19,1902,3409,1825,-1584
2017,10,11,20,1871,3429,1858,-1571
2017,10,11,21,1856,3400,1885,-1515
2017,10,11,22,1829,3370,1853,-1517
2017,10,11,23,1845,3329,1877,-1452
2017,10,12,0,1707,3363,1838,-1525
2017,10,12,1,1802,3498,1891,-1607
2017,10,12,2,1942,3652,1982,-1670
2017,10,12,3,2097,3705,2011,-1694
2017,10,12,4,1874,3667,2042,-1625
2017,10,12,5,1748,3395,1923,-1472
2017,10,12,6,1752,3087,1818,-1269
2017,10,12,7,1497,2818,1659,-1159
2017,10,12,8,1396,2697,1671,-1026
2017,10,12,9,1315,2608,1602,-1006
2017,10,12,10,1301,2581,1593,-988
2017,10,12,11,1385,2651,1680,-971
2017,10,12,12,1546,2788,1706,-1082
2017,10,12,13,1676,3103,1746,-1357
2017,10,12,14,1582,3442,1688,-1754
2017,10,12,15,1799,3754,1880,-1874
2017,10,12,16,1810,3648,1661,-1987
2017,10,12,17,1779,3607,1672,-1935
2017,10,12,18,1740,3619,1705,-1914
2017,10,12,19,1712,3586,1617,-1969
2017,10,12,20,1709,3566,1680,-1886
2017,10,12,21,1544,3509,1680,-1829
2017,10,12,22,1740,3473,1703,-1770
2017,10,12,23,1784,3539,1779,-1760
2017,10,13,0,1823,3610,1832,-1778
2017,10,13,1,1869,3701,1997,-1704
2017,10,13,2,1975,3831,2009,-1822
2017,10,13,3,2044,3915,2121,-1794
2017,10,13,4,1909,3809,2046,-1763
2017,10,13,5,1640,3578,1832,-1746
2017,10,13,6,1617,3288,1800,-1488
2017,10,13,7,1438,2985,1631,-1354
2017,10,13,8,1334,2787,1516,-1271
2017,10,13,9,1298,2693,1520,-1173
2017,10,13,10,1199,2643,1501,-1142
2017,10,13,11,1171,2676,1521,-1155
2017,10,13,12,1236,2789,1557,-1232
2017,10,13,13,1683,3103,1689,-1414
2017,10,13,14,1766,3451,1863,-1588
2017,10,13,15,2006,3721,1916,-1805
2017,10,13,16,2045,3831,2059,-1772
2017,10,13,17,2035,3786,2092,-1694
2017,10,13,18,2006,3706,2015,-1691
2017,10,13,19,1783,3579,1762,-1817
2017,10,13,20,1776,3465,1654,-1811
2017,10,13,21,1790,3388,1694,-1694
2017,10,13,22,1793,3367,1884,-1483
2017,10,13,23,1810,3343,1842,-1501
2017,10,14,0,1868,3369,1781,-1588
2017,10,14,1,2047,3504,1955,-1549
2017,10,14,2,2121,3637,1998,-1639
2017,10,14,3,2125,3723,2095,-1628
2017,10,14,4,1989,3633,1990,-1643
2017,10,14,5,2021,3527,1995,-1532
2017,10,14,6,1885,3367,1989,-1378
2017,10,14,7,1662,3176,1825,-1351
2017,10,14,8,1584,2950,1676,-1274
2017,10,14,9,1587,2867,1594,-1273
2017,10,14,10,1538,2800,1451,-1349
2017,10,14,11,1600,2812,1477,-1335
2017,10,14,12,1663,2885,1555,-1330
2017,10,14,13,1747,3031,1859,-1172
2017,10,14,14,1669,3247,1784,-1463
2017,10,14,15,1922,3484,1880,-1604
2017,10,14,16,2068,3631,1923,-1708
2017,10,14,17,2103,3642,1904,-1738
2017,10,14,18,2048,3557,1841,-1716
2017,10,14,19,1915,3450,1681,-1769
2017,10,14,20,1838,3365,1618,-1747
2017,10,14,21,1741,3294,1612,-1682
2017,10,14,22,1638,3239,1550,-1689
2017,10,14,23,1623,3209,1535,-1674
2017,10,15,0,1700,3201,1536,-1665
2017,10,15,1,1834,3255,1809,-1446
2017,10,15,2,1974,3410,2117,-1293
2017,10,15,3,2034,3522,2293,-1229
2017,10,15,4,1950,3383,2159,-1224
2017,10,15,5,1751,3288,2002,-1286
2017,10,15,6,1989,3105,1992,-1113
2017,10,15,7,1631,2984,1837,-1147
2017,10,15,8,1373,2789,1428,-1361
2017,10,15,9,1372,2695,1404,-1291
2017,10,15,10,1349,2675,1442,-1233
2017,10,15,11,1359,2664,1439,-1225
2017,10,15,12,1400,2704,1410,-1294
2017,10,15,13,1556,2823,1419,-1404
2017,10,15,14,1576,3009,1468,-1541
2017,10,15,15,1781,3232,1481,-1751
2017,10,15,16,1948,3403,1640,-1763
2017,10,15,17,1847,3526,1776,-1750
2017,10,15,18,1807,3395,1620,-1775
2017,10,15,19,1731,3287,1559,-1728
2017,10,15,20,1644,3213,1575,-1638
2017,10,15,21,1792,3132,1674,-1458
2017,10,15,22,1544,3081,1691,-1390
2017,10,15,23,1537,3098,1709,-1389
2017,10,16,0,1711,3121,1727,-1394
2017,10,16,1,1737,3282,1833,-1449
2017,10,16,2,1881,3446,1806,-1640
2017,10,16,3,1931,3615,2012,-1603
2017,10,16,4,1833,3503,1951,-1552
2017,10,16,5,1809,3310,1810,-1500
2017,10,16,6,1697,3038,1744,-1294
2017,10,16,7,1481,2792,1559,-1233
2017,10,16,8,1278,2635,1473,-1162
2017,10,16,9,1216,2579,1395,-1184
2017,10,16,10,1255,2566,1389,-1177
2017,10,16,11,1269,2626,1403,-1223
2017,10,16,12,1468,2795,1485,-1310
2017,10,16,13,1635,3144,1625,-1519
2017,10,16,14,1840,3577,1761,-1816
2017,10,16,15,1928,3808,1794,-2014
2017,10,16,16,1804,3749,1750,-1999
2017,10,16,17,1953,3665,1771,-1894
2017,10,16,18,1942,3554,1678,-1876
2017,10,16,19,1872,3463,1679,-1784
2017,10,16,20,1658,3468,1820,-1648
2017,10,16,21,1756,3407,1841,-1566
2017,10,16,22,1712,3347,1773,-1574
2017,10,16,23,1631,3355,1789,-1566
2017,10,17,0,1822,3389,1827,-1562
2017,10,17,1,1786,3490,1767,-1723
2017,10,17,2,1886,3708,1944,-1764
2017,10,17,3,2011,3695,1984,-1711
2017,10,17,4,1898,3489,2050,-1439
2017,10,17,5,1538,3292,1970,-1322
2017,10,17,6,1618,3044,1827,-1217
2017,10,17,7,1362,2758,1672,-1086
2017,10,17,8,1366,2651,1629,-1022
2017,10,17,9,1481,2539,1498,-1041
2017,10,17,10,1485,2501,1418,-1083
2017,10,17,11,1509,2537,1527,-1010
2017,10,17,12,1617,2656,1624,-1032
2017,10,17,13,1838,2950,1813,-1137
2017,10,17,14,1799,3377,2029,-1348
2017,10,17,15,1893,3593,2049,-1544
2017,10,17,16,1919,3585,1909,-1676
2017,10,17,17,1822,3529,2000,-1529
2017,10,17,18,1887,3532,1891,-1641
2017,10,17,19,1708,3492,1844,-1648
2017,10,17,20,1688,3464,1897,-1567
2017,10,17,21,1652,3365,1912,-1453
2017,10,17,22,1619,3294,1724,-1570
2017,10,17,23,1622,3320,1707,-1613
2017,10,18,0,1670,3301,1761,-1540
2017,10,18,1,1649,3536,1928,-1608
2017,10,18,2,1841,3693,2072,-1621
2017,10,18,3,1935,3706,2072,-1634
2017,10,18,4,1958,3615,1980,-1635
2017,10,18,5,1740,3355,1787,-1568
2017,10,18,6,1911,3094,1783,-1311
2017,10,18,7,1553,2818,1612,-1206
2017,10,18,8,1298,2674,1428,-1246
2017,10,18,9,1244,2600,1497,-1103
2017,10,18,10,1353,2581,1432,-1149
2017,10,18,11,1424,2611,1445,-1166
2017,10,18,12,1572,2746,1472,-1274
2017,10,18,13,1975,3064,1515,-1549
2017,10,18,14,1712,3462,1577,-1885
2017,10,18,15,1944,3727,1844,-1883
2017,10,18,16,1899,3715,1712,-2003
2017,10,18,17,1944,3681,1762,-1919
2017,10,18,18,1808,3700,1713,-1987
2017,10,18,19,1702,3684,1805,-1879
2017,10,18,20,1770,3723,2017,-1706
2017,10,18,21,1723,3626,2035,-1591
2017,10,18,22,1681,3573,2031,-1542
2017,10,18,23,1664,3512,1958,-1554
2017,10,19,0,1621,3569,1922,-1647
2017,10,19,1,1838,3613,1863,-1750
2017,10,19,2,1920,3670,1980,-1690
2017,10,19,3,1860,3593,1931,-1662
2017,10,19,4,1889,3476,1851,-1625
2017,10,19,5,1653,3270,1758,-1512
2017,10,19,6,1704,3030,1834,-1196
2017,10,19,7,1449,2796,1572,-1224
2017,10,19,8,1607,2615,1640,-975
2017,10,19,9,1507,2526,1537,-989
2017,10,19,10,1549,2475,1513,-962
2017,10,19,11,1510,2513,1546,-967
2017,10,19,12,1608,2597,1616,-981
2017,10,19,13,1832,2897,1679,-1218
2017,10,19,14,1916,3267,1736,-1531
2017,10,19,15,2168,3563,1965,-1598
2017,10,19,16,1926,3480,1811,-1669
2017,10,19,17,1965,3546,1915,-1631
2017,10,19,18,1970,3467,1799,-1668
2017,10,19,19,1957,3489,1758,-1731
2017,10,19,20,2095,3464,1877,-1587
2017,10,19,21,2075,3424,1760,-1664
2017,10,19,22,1891,3465,1855,-1610
2017,10,19,23,1886,3503,1890,-1613
2017,10,20,0,2008,3600,2000,-1600
2017,10,20,1,2224,3731,2100,-1631
2017,10,20,2,2184,3840,2227,-1613
2017,10,20,3,2224,3801,2145,-1656
2017,10,20,4,2162,3693,2090,-1603
2017,10,20,5,1828,3423,1867,-1556
2017,10,20,6,1835,3131,1943,-1188
2017,10,20,7,1546,2874,1756,-1118
2017,10,20,8,1554,2702,1663,-1039
2017,10,20,9,1497,2622,1657,-965
2017,10,20,10,1674,2592,1600,-992
2017,10,20,11,1592,2618,1545,-1073
2017,10,20,12,1587,2741,1684,-1057
2017,10,20,13,1942,3033,1892,-1141
2017,10,20,14,1723,3395,1848,-1547
2017,10,20,15,1954,3625,1923,-1702
2017,10,20,16,1896,3656,1918,-1738
2017,10,20,17,1862,3671,1993,-1678
2017,10,20,18,1815,3617,1961,-1656
2017,10,20,19,1765,3567,1781,-1786
2017,10,20,20,1721,3540,1790,-1750
2017,10,20,21,1685,3501,1805,-1696
2017,10,20,22,1641,3450,1682,-1768
2017,10,20,23,1625,3433,1635,-1798
2017,10,21,0,1723,3480,1681,-1799
2017,10,21,1,1819,3542,1801,-1741
2017,10,21,2,1930,3729,2076,-1653
2017,10,21,3,1928,3684,2081,-1603
2017,10,21,4,1840,3599,1901,-1698
2017,10,21,5,1697,3437,1749,-1688
2017,10,21,6,2084,3249,2114,-1135
2017,10,21,7,1921,2973,1941,-1032
2017,10,21,8,1591,2759,1727,-1032
2017,10,21,9,1467,2660,1635,-1025
2017,10,21,10,1422,2612,1530,-1082
2017,10,21,11,1448,2603,1501,-1102
2017,10,21,12,1653,2648,1643,-1005
2017,10,21,13,1702,2768,1566,-1202
2017,10,21,14,1376,2963,1507,-1456
2017,10,21,15,1675,3173,1641,-1532
2017,10,21,16,1851,3367,1706,-1661
2017,10,21,17,1790,3584,1885,-1699
2017,10,21,18,1902,3671,2013,-1658
2017,10,21,19,1824,3641,1939,-1702
2017,10,21,20,1721,3559,1793,-1766
2017,10,21,21,1842,3513,1695,-1818
2017,10,21,22,1742,3452,1684,-1768
2017,10,21,23,1666,3499,1705,-1794
2017,10,22,0,1690,3612,1889,-1723
2017,10,22,1,1656,3690,1885,-1805
2017,10,22,2,1516,3724,1970,-1754
2017,10,22,3,1617,3585,1777,-1808
2017,10,22,4,1468,3419,1752,-1667
2017,10,22,5,1311,3254,1652,-1602
2017,10,22,6,1845,3063,1721,-1342
2017,10,22,7,1706,2835,1641,-1194
2017,10,22,8,1252,2660,1373,-1287
2017,10,22,9,1322,2573,1342,-1231
2017,10,22,10,1243,2501,1297,-1204
2017,10,22,11,1306,2487,1234,-1253
2017,10,22,12,1270,2514,1299,-1215
2017,10,22,13,1313,2620,1337,-1283
2017,10,22,14,1320,2733,1342,-1391
2017,10,22,15,1468,2917,1460,-1457
2017,10,22,16,1628,3127,1564,-1563
2017,10,22,17,1765,3252,1628,-1624
2017,10,22,18,1821,3304,1777,-1527
2017,10,22,19,1821,3297,1858,-1439
2017,10,22,20,1798,3282,1856,-1426
2017,10,22,21,1783,3261,1968,-1293
2017,10,22,22,1764,3188,1828,-1360
2017,10,22,23,1777,3137,1723,-1414
2017,10,23,0,1848,3220,1856,-1364
2017,10,23,1,2001,3409,2113,-1296
2017,10,23,2,2053,3585,2197,-1388
2017,10,23,3,2014,3632,2177,-1455
2017,10,23,4,2038,3465,2012,-1453
2017,10,23,5,1831,3238,1820,-1418
2017,10,23,6,1682,2988,1645,-1343
2017,10,23,7,1478,2770,1451,-1319
2017,10,23,8,1349,2636,1361,-1275
2017,10,23,9,1303,2584,1412,-1172
2017,10,23,10,1315,2534,1456,-1078
2017,10,23,11,1374,2578,1604,-974
2017,10,23,12,1590,2706,1760,-946
2017,10,23,13,1903,3084,1897,-1187
2017,10,23,14,1920,3478,1997,-1481
2017,10,23,15,2144,3729,2032,-1697
2017,10,23,16,2111,3694,1998,-1696
2017,10,23,17,2090,3576,1840,-1736
2017,10,23,18,2084,3539,1981,-1558
2017,10,23,19,1837,3448,1906,-1542
2017,10,23,20,1870,3384,1769,-1615
2017,10,23,21,1778,3379,1921,-1458
2017,10,23,22,1930,3415,1983,-1432
2017,10,23,23,1924,3377,2036,-1341
2017,10,24,0,1974,3414,2055,-1359
2017,10,24,1,2061,3514,2091,-1423
2017,10,24,2,2063,3669,2090,-1579
2017,10,24,3,2054,3709,2109,-1600
2017,10,24,4,1909,3523,1936,-1587
2017,10,24,5,1693,3279,1841,-1438
2017,10,24,6,1983,2942,1763,-1179
2017,10,24,7,1891,2624,1610,-1014
2017,10,24,8,1561,2465,1435,-1030
2017,10,24,9,1377,2358,1306,-1052
2017,10,24,10,1491,2344,1307,-1037
2017,10,24,11,1595,2392,1340,-1052
2017,10,24,12,1604,2540,1393,-1147
2017,10,24,13,1789,2976,1569,-1407
2017,10,24,14,1882,3528,1795,-1733
2017,10,24,15,1996,3840,1978,-1862
2017,10,24,16,1996,3727,1907,-1820
2017,10,24,17,1998,3637,1933,-1704
2017,10,24,18,1849,3503,1758,-1745
2017,10,24,19,1894,3401,1735,-1666
2017,10,24,20,1847,3340,1819,-1521
2017,10,24,21,1744,3343,1902,-1441
2017,10,24,22,1742,3341,1934,-1407
2017,10,24,23,1741,3274,1895,-1379
2017,10,25,0,1740,3326,1915,-1411
2017,10,25,1,1972,3513,2020,-1493
2017,10,25,2,1936,3641,1986,-1655
2017,10,25,3,1960,3624,2101,-1523
2017,10,25,4,1814,3514,2073,-1441
2017,10,25,5,1679,3272,1941,-1331
2017,10,25,6,1785,3006,1844,-1162
2017,10,25,7,1764,2666,1589,-1077
2017,10,25,8,1511,2591,1525,-1066
2017,10,25,9,1510,2404,1335,-1069
2017,10,25,10,1497,2402,1372,-1030
2017,10,25,11,1574,2445,1460,-985
2017,10,25,12,1702,2585,1509,-1076
2017,10,25,13,1812,2971,1707,-1264
2017,10,25,14,2115,3477,1928,-1549
2017,10,25,15,2125,3783,2192,-1591
2017,10,25,16,2091,3754,2188,-1566
2017,10,25,17,1933,3655,2091,-1564
2017,10,25,18,1814,3616,1938,-1678
2017,10,25,19,1658,3557,1889,-1668
2017,10,25,20,1678,3526,1966,-1560
2017,10,25,21,1670,3463,1933,-1530
2017,10,25,22,1820,3436,1833,-1603
2017,10,25,23,1836,3452,1804,-1648
2017,10,26,0,1869,3520,1753,-1767
2017,10,26,1,2026,3605,1666,-1939
2017,10,26,2,2112,3700,1940,-1760
2017,10,26,3,2041,3657,1957,-1700
2017,10,26,4,1866,3580,1837,-1743
2017,10,26,5,1819,3207,1556,-1651
2017,10,26,6,1680,2959,1635,-1324
2017,10,26,7,1518,2651,1403,-1248
2017,10,26,8,1318,2492,1331,-1161
2017,10,26,9,1250,2413,1335,-1078
2017,10,26,10,1291,2342,1356,-986
2017,10,26,11,1402,2362,1373,-989
2017,10,26,12,1469,2493,1449,-1044
2017,10,26,13,1815,2865,1588,-1277
2017,10,26,14,1648,3323,1532,-1791
2017,10,26,15,1726,3569,1664,-1905
2017,10,26,16,1972,3484,1699,-1785
2017,10,26,17,1968,3379,1662,-1717
2017,10,26,18,1934,3365,1661,-1704
2017,10,26,19,1888,3318,1607,-1711
2017,10,26,20,1844,3270,1552,-1718
2017,10,26,21,1682,3232,1627,-1605
2017,10,26,22,1767,3180,1631,-1549
2017,10,26,23,1653,3151,1621,-1530
2017,10,27,0,1710,3192,1600,-1592
2017,10,27,1,1832,3294,1617,-1677
2017,10,27,2,1939,3483,1601,-1882
2017,10,27,3,1940,3588,1857,-1731
2017,10,27,4,1763,3480,1847,-1633
2017,10,27,5,1767,3255,1801,-1454
2017,10,27,6,1919,3063,1814,-1249
2017,10,27,7,1680,2736,1500,-1236
2017,10,27,8,1537,2575,1506,-1069
2017,10,27,9,1432,2509,1437,-1072
2017,10,27,10,1443,2475,1430,-1045
2017,10,27,11,1503,2502,1417,-1085
2017,10,27,12,1542,2637,1498,-1139
2017,10,27,13,1584,2922,1563,-1359
2017,10,27,14,1720,3307,1709,-1598
2017,10,27,15,1942,3680,1949,-1731
2017,10,27,16,2028,3626,1845,-1781
2017,10,27,17,1951,3556,1715,-1841
2017,10,27,18,1817,3457,1749,-1708
2017,10,27,19,1845,3452,2046,-1406
2017,10,27,20,1641,3381,2010,-1371
2017,10,27,21,1790,3266,1761,-1505
2017,10,27,22,1589,3170,1792,-1378
2017,10,27,23,1606,3137,1857,-1280
2017,10,28,0,1603,3129,1718,-1411
2017,10,28,1,1892,3222,1788,-1434
2017,10,28,2,1915,3407,1961,-1446
2017,10,28,3,1892,3316,1798,-1518
2017,10,28,4,1675,3241,1801,-1440
2017,10,28,5,1686,3107,1790,-1317
2017,10,28,6,1910,2936,1845,-1091
2017,10,28,7,1586,2715,1716,-999
2017,10,28,8,1443,2549,1560,-989
2017,10,28,9,1380,2455,1485,-970
2017,10,28,10,1384,2413,1471,-942
2017,10,28,11,1373,2426,1471,-955
2017,10,28,12,1454,2475,1490,-985
2017,10,28,13,1627,2603,1510,-1093
2017,10,28,14,1455,2824,1480,-1344
2017,10,28,15,1690,3121,1645,-1476
2017,10,28,16,1812,3333,1681,-1652
2017,10,28,17,1806,3367,1677,-1690
2017,10,28,18,1853,3257,1576,-1681
2017,10,28,19,1605,3042,1382,-1660
2017,10,28,20,1733,2891,1373,-1518
2017,10,28,21,1558,2783,1346,-1437
2017,10,28,22,1639,2695,1356,-1339
2017,10,28,23,1639,2670,1352,-1318
2017,10,29,0,1680,2709,1420,-1289
2017,10,29,1,1573,2822,1551,-1271
2017,10,29,2,1843,2975,1619,-1356
2017,10,29,3,1794,3057,1796,-1261
2017,10,29,4,1526,2927,1678,-1249
2017,10,29,5,1530,2738,1570,-1168
2017,10,29,6,1531,2640,1617,-1023
2017,10,29,7,1544,2454,1550,-904
2017,10,29,8,1367,2343,1505,-838
2017,10,29,9,1365,2224,1399,-825
2017,10,29,10,1346,2181,1353,-828
2017,10,29,11,1301,2223,1370,-853
2017,10,29,12,1312,2287,1418,-869
2017,10,29,13,1407,2426,1468,-958
2017,10,29,14,1412,2620,1432,-1188
2017,10,29,15,1742,2839,1591,-1248
2017,10,29,16,1808,3008,1783,-1225
2017,10,29,17,1911,3206,1958,-1248
2017,10,29,18,1942,3193,1914,-1279
2017,10,29,19,1757,3173,1870,-1303
2017,10,29,20,1749,3170,1932,-1238
2017,10,29,21,1678,3115,1981,-1134
2017,10,29,22,1807,3069,2090,-979
2017,10,29,23,1700,2994,1987,-1007
2017,10,30,0,1699,3015,1942,-1073
2017,10,30,1,1773,3207,2060,-1147
2017,10,30,2,2060,3471,2156,-1315
2017,10,30,3,1838,3436,2165,-1271
2017,10,30,4,1803,3324,2115,-1209
2017,10,30,5,1649,3105,2064,-1041
2017,10,30,6,1490,2835,1863,-972
2017,10,30,7,1258,2600,1504,-1096
2017,10,30,8,1317,2453,1443,-1010
2017,10,30,9,1229,2390,1457,-933
2017,10,30,10,1251,2421,1489,-932
2017,10,30,11,1336,2440,1466,-974
2017,10,30,12,1551,2619,1525,-1094
2017,10,30,13,1741,2968,1588,-1380
2017,10,30,14,1705,3405,1664,-1741
2017,10,30,15,1625,3719,1890,-1829
2017,10,30,16,1772,3697,1781,-1916
2017,10,30,17,1716,3575,1701,-1874
2017,10,30,18,1786,3458,1730,-1728
2017,10,30,19,1611,3295,1603,-1692
2017,10,30,20,1582,3196,1625,-1571
2017,10,30,21,1574,3127,1552,-1575
2017,10,30,22,1574,3086,1696,-1390
2017,10,30,23,1765,3063,1557,-1506
2017,10,31,0,1707,3112,1560,-1552
2017,10,31,1,1780,3263,1618,-1645
2017,10,31,2,1905,3550,1909,-1641
2017,10,31,3,1911,3553,1943,-1610
2017,10,31,4,1668,3469,1964,-1505
2017,10,31,5,1676,3269,1845,-1424
2017,10,31,6,1914,3123,1939,-1184
2017,10,31,7,1589,2796,1648,-1148
2017,10,31,8,1118,2636,1442,-1194
2017,10,31,9,1351,2596,1410,-1186
2017,10,31,10,1377,2641,1433,-1208
2017,10,31,11,1242,2697,1460,-1237
2017,10,31,12,1460,2875,1546,-1329
2017,10,31,13,1637,3316,1742,-1574
2017,10,31,14,1864,3757,1860,-1897
2017,10,31,15,1998,4044,2170,-1874
2017,10,31,16,2005,4044,2162,-1882
2017,10,31,17,1920,3895,2055,-1840
2017,10,31,18,1896,3765,1963,-1802
2017,10,31,19,1724,3593,1971,-1622
2017,10,31,20,1739,3466,1927,-1539
2017,10,31,21,1576,3372,1762,-1610
2017,10,31,22,1385,3289,1624,-1665
2017,10,31,23,1331,3257,1482,-1775
2017,11,1,0,1401,3293,1453,-1840
2017,11,1,1,1564,3395,1527,-1868
2017,11,1,2,1698,3518,1550,-1968
2017,11,1,3,1698,3535,1634,-1901
2017,11,1,4,1595,3527,1575,-1952
2017,11,1,5,1396,3426,1445,-1981
2017,11,1,6,1380,3187,1612,-1575
2017,11,1,7,1313,2886,1477,-1409
2017,11,1,8,1386,2656,1525,-1131
2017,11,1,9,1325,2777,1647,-1130
2017,11,1,10,1382,2762,1671,-1091
2017,11,1,11,1351,2771,1651,-1120
2017,11,1,12,1410,2920,1670,-1250
2017,11,1,13,1536,3247,1715,-1532
2017,11,1,14,1481,3536,1611,-1925
2017,11,1,15,1493,3803,1604,-2199
2017,11,1,16,1589,3773,1570,-2203
2017,11,1,17,1456,3737,1593,-2144
2017,11,1,18,1549,3719,1603,-2116
2017,11,1,19,1371,3667,1608,-2059
2017,11,1,20,1655,3634,1719,-1915
2017,11,1,21,1682,3590,1755,-1835
2017,11,1,22,1454,3570,1755,-1815
2017,11,1,23,1669,3606,1778,-1828
2017,11,2,0,1503,3713,1836,-1877
2017,11,2,1,1618,3860,1819,-2041
2017,11,2,2,1636,4054,1941,-2113
2017,11,2,3,1578,4048,2128,-1920
2017,11,2,4,1534,3951,2059,-1892
2017,11,2,5,1384,3626,1856,-1770
2017,11,2,6,1606,3334,1700,-1634
2017,11,2,7,1383,3056,1625,-1431
2017,11,2,8,1496,2900,1514,-1386
2017,11,2,9,1424,2787,1402,-1385
2017,11,2,10,1322,2754,1406,-1348
2017,11,2,11,1419,2839,1452,-1387
2017,11,2,12,1672,3033,1641,-1392
2017,11,2,13,1828,3365,1794,-1571
2017,11,2,14,1786,3630,1677,-1953
2017,11,2,15,2063,3916,1946,-1970
2017,11,2,16,2009,3881,1954,-1927
2017,11,2,17,1930,3874,2132,-1742
2017,11,2,18,1896,3868,2136,-1732
2017,11,2,19,1838,3833,2191,-1642
2017,11,2,20,1805,3850,2127,-1723
2017,11,2,21,1716,3777,2021,-1756
2017,11,2,22,1743,3715,2005,-1710
2017,11,2,23,1846,3743,2040,-1703
2017,11,3,0,2020,3867,2173,-1694
2017,11,3,1,2123,4113,2278,-1835
2017,11,3,2,2269,4228,2328,-1900
2017,11,3,3,2210,4226,2324,-1902
2017,11,3,4,2236,4021,2194,-1827
2017,11,3,5,1874,3769,2085,-1684
2017,11,3,6,2120,3527,2147,-1380
2017,11,3,7,2091,3243,2128,-1115
2017,11,3,8,1867,3114,1942,-1172
2017,11,3,9,1723,3002,1898,-1104
2017,11,3,10,1732,2990,1849,-1141
2017,11,3,11,1964,3057,1822,-1235
2017,11,3,12,1945,3243,1852,-1391
2017,11,3,13,2290,3618,2254,-1364
2017,11,3,14,2432,4016,2194,-1822
2017,11,3,15,2510,4309,2428,-1881
2017,11,3,16,2528,4330,2420,-1910
2017,11,3,17,2539,4337,2464,-1873
2017,11,3,18,2536,4265,2390,-1875
2017,11,3,19,2485,4232,2253,-1979
2017,11,3,20,2299,4356,2200,-2156
2017,11,3,21,2247,4355,2221,-2134
2017,11,3,22,2436,4338,2422,-1916
2017,11,3,23,2308,4374,2541,-1833
2017,11,4,0,2477,4363,2459,-1904
2017,11,4,1,2560,4492,2555,-1937
2017,11,4,2,2541,4572,2650,-1922
2017,11,4,3,2435,4453,2605,-1848
2017,11,4,4,2500,4313,2395,-1918
2017,11,4,5,2369,4135,2403,-1732
2017,11,4,6,2403,3882,2479,-1403
2017,11,4,7,2297,3630,2324,-1306
2017,11,4,8,2091,3417,2106,-1311
2017,11,4,9,1999,3281,1989,-1292
2017,11,4,10,2139,3224,1956,-1268
2017,11,4,11,2069,3228,1941,-1287
2017,11,4,12,2086,3277,1939,-1338
2017,11,4,13,2155,3418,2046,-1372
2017,11,4,14,1931,3637,1938,-1699
2017,11,4,15,1997,3975,2021,-1954
2017,11,4,16,2305,4192,2225,-1967
2017,11,4,17,2304,4290,2359,-1931
2017,11,4,18,2172,4277,2339,-1938
2017,11,4,19,2118,4198,2261,-1937
2017,11,4,20,2129,4124,2195,-1929
2017,11,4,21,2032,4046,1990,-2056
2017,11,4,22,2007,3982,1924,-2058
2017,11,4,23,2027,3982,1949,-2033
2017,11,5,0,2152,4134,2287,-1847
2017,11,5,1,2067,4269,2326,-1943
2017,11,5,2,2272,4324,2313,-2011
2017,11,5,3,2191,4249,2290,-1959
2017,11,5,4,2281,4127,2134,-1993
2017,11,5,5,2186,3945,2081,-1864
2017,11,5,6,2202,3683,2044,-1639
2017,11,5,7,2195,3500,2020,-1480
2017,11,5,8,1831,3350,2078,-1272
2017,11,5,9,1838,3241,2065,-1176
2017,11,5,10,1812,3102,2008,-1094
2017,11,5,11,1809,3095,1833,-1262
2017,11,5,12,1759,3192,2078,-1114
2017,11,5,13,1848,3265,2180,-1085
2017,11,5,14,2029,3465,2239,-1226
2017,11,5,15,2121,3700,2423,-1277
2017,11,5,16,2341,3901,2408,-1493
2017,11,5,17,2384,4249,2606,-1643
2017,11,5,18,2484,4247,2476,-1771
2017,11,5,19,2503,4256,2526,-1730
2017,11,5,20,2492,4227,2453,-1774
2017,11,5,21,2519,4241,2483,-1758
2017,11,5,22,2515,4207,2528,-1679
2017,11,5,23,2494,4182,2530,-1652
2017,11,6,0,2516,4206,2548,-1658
2017,11,6,1,2695,4321,2612,-1709
2017,11,6,2,2913,4504,2620,-1884
2017,11,6,3,2866,4433,2500,-1933
2017,11,6,4,2787,4472,2444,-2028
2017,11,6,5,2647,4358,2509,-1849
2017,11,6,6,2392,3990,2174,-1816
2017,11,6,7,2308,3595,1964,-1631
2017,11,6,8,2044,3390,1846,-1544
2017,11,6,9,1795,3275,1797,-1478
2017,11,6,10,1812,3226,1684,-1542
2017,11,6,11,1841,3241,1677,-1564
2017,11,6,12,1907,3324,1765,-1559
2017,11,6,13,1906,3543,1889,-1654
2017,11,6,14,2226,3911,2121,-1790
2017,11,6,15,2532,4376,2355,-2021
2017,11,6,16,2573,4677,2506,-2171
2017,11,6,17,2395,4559,2513,-2046
2017,11,6,18,2478,4366,2402,-1964
2017,11,6,19,2279,4213,2326,-1887
2017,11,6,20,2546,4081,2227,-1854
2017,11,6,21,2558,4021,2331,-1690
2017,11,6,22,2500,3952,2276,-1676
2017,11,6,23,2399,3919,2304,-1615
2017,11,7,0,2548,3991,2228,-1763
2017,11,7,1,2653,4257,2383,-1874
2017,11,7,2,2855,4622,2547,-2075
2017,11,7,3,2863,4632,2503,-2129
2017,11,7,4,2799,4560,2483,-2077
2017,11,7,5,2586,4434,2500,-1934
2017,11,7,6,2472,4168,2423,-1745
2017,11,7,7,2495,3826,2434,-1392
2017,11,7,8,2087,3528,2189,-1339
2017,11,7,9,1748,3463,1969,-1494
2017,11,7,10,1573,3439,1994,-1445
2017,11,7,11,1669,3438,1998,-1440
2017,11,7,12,1767,3528,1944,-1584
2017,11,7,13,1867,3720,1955,-1765
2017,11,7,14,2122,4003,2081,-1922
2017,11,7,15,2126,4418,2309,-2109
2017,11,7,16,2265,4551,2399,-2152
2017,11,7,17,2230,4474,2377,-2097
2017,11,7,18,2230,4387,2271,-2116
2017,11,7,19,2087,4285,2275,-2010
2017,11,7,20,1959,4219,2162,-2057
2017,11,7,21,2038,4218,2281,-1937
2017,11,7,22,1972,4141,2171,-1970
2017,11,7,23,1957,4095,1968,-2127
2017,11,8,0,1902,4190,2118,-2072
2017,11,8,1,2127,4382,2266,-2116
2017,11,8,2,2329,4620,2449,-2171
2017,11,8,3,2367,4573,2354,-2219
2017,11,8,4,2290,4463,2333,-2130
2017,11,8,5,2121,4312,2286,-2026
2017,11,8,6,2046,4009,2115,-1894
2017,11,8,7,2065,3690,2007,-1683
2017,11,8,8,1738,3408,1719,-1689
2017,11,8,9,1536,3212,1515,-1697
2017,11,8,10,1447,3105,1466,-1639
2017,11,8,11,1467,3078,1449,-1629
2017,11,8,12,1577,3106,1473,-1633
2017,11,8,13,1667,3275,1668,-1607
2017,11,8,14,1676,3588,1698,-1890
2017,11,8,15,1578,3991,1617,-2374
2017,11,8,16,1638,4192,1560,-2632
2017,11,8,17,1626,4097,1465,-2632
2017,11,8,18,1547,3964,1456,-2508
2017,11,8,19,1287,3903,1527,-2376
2017,11,8,20,1355,3880,1668,-2212
2017,11,8,21,1304,3819,1651,-2168
2017,11,8,22,1275,3812,1607,-2205
2017,11,8,23,1289,3831,1622,-2209
2017,11,9,0,1374,3910,1553,-2357
2017,11,9,1,1456,4127,1542,-2585
2017,11,9,2,1635,4321,1771,-2550
2017,11,9,3,1653,4352,1723,-2629
2017,11,9,4,1546,4287,1764,-2523
2017,11,9,5,1594,4108,1702,-2406
2017,11,9,6,1352,3842,1673,-2169
2017,11,9,7,1788,3532,1751,-1781
2017,11,9,8,1686,3303,1771,-1532
2017,11,9,9,1474,3055,1566,-1489
2017,11,9,10,1334,2958,1575,-1383
2017,11,9,11,1279,2969,1549,-1420
2017,11,9,12,1321,3022,1565,-1457
2017,11,9,13,1490,3220,1631,-1589
2017,11,9,14,1506,3577,1751,-1826
2017,11,9,15,1569,3999,1854,-2145
2017,11,9,16,1598,4184,1812,-2372
2017,11,9,17,1543,4155,1616,-2539
2017,11,9,18,1489,4078,1655,-2423
2017,11,9,19,1440,4060,1669,-2391
2017,11,9,20,1447,3941,1379,-2562
2017,11,9,21,1451,3873,1272,-2601
2017,11,9,22,1196,3992,1476,-2516
2017,11,9,23,1184,3996,1600,-2396
2017,11,10,0,1406,3946,1599,-2347
2017,11,10,1,1498,4171,1700,-2471
2017,11,10,2,1553,4257,1688,-2569
2017,11,10,3,1577,4182,1726,-2456
2017,11,10,4,1466,4073,1738,-2335
2017,11,10,5,1412,3935,1762,-2173
2017,11,10,6,1350,3760,1813,-1947
2017,11,10,7,1695,3484,1794,-1690
2017,11,10,8,1658,3206,1697,-1509
2017,11,10,9,1256,3060,1539,-1521
2017,11,10,10,1239,2981,1375,-1606
2017,11,10,11,1255,2961,1327,-1634
2017,11,10,12,1303,3016,1327,-1689
2017,11,10,13,1312,3143,1352,-1791
2017,11,10,14,1470,3406,1366,-2040
2017,11,10,15,1346,3707,1408,-2299
2017,11,10,16,1434,4002,1609,-2393
2017,11,10,17,1517,4115,1723,-2392
2017,11,10,18,1641,4100,1625,-2475
2017,11,10,19,1524,4035,1554,-2481
2017,11,10,20,1451,3878,1411,-2467
2017,11,10,21,1428,3818,1473,-2345
2017,11,10,22,1391,3713,1411,-2302
2017,11,10,23,1389,3669,1402,-2267
2017,11,11,0,1238,3694,1378,-2316
2017,11,11,1,1491,3885,1562,-2323
2017,11,11,2,1625,4179,1720,-2459
2017,11,11,3,1584,4152,1727,-2425
2017,11,11,4,1575,4070,1651,-2419
2017,11,11,5,1372,3986,1621,-2365
2017,11,11,6,1219,3838,1544,-2294
2017,11,11,7,1495,3627,1351,-2276
2017,11,11,8,1281,3422,1289,-2133
2017,11,11,9,1037,3279,1313,-1966
2017,11,11,10,1016,3093,1138,-1955
2017,11,11,11,1054,3119,1309,-1810
2017,11,11,12,1057,3048,1109,-1939
2017,11,11,13,1041,3146,1138,-2008
2017,11,11,14,990,3311,1133,-2178
2017,11,11,15,911,3403,1021,-2382
2017,11,11,16,1067,3590,1091,-2499
2017,11,11,17,1057,3757,1100,-2657
2017,11,11,18,1151,3872,1143,-2729
2017,11,11,19,1117,3883,1119,-2764
2017,11,11,20,1189,3812,1121,-2691
2017,11,11,21,1145,3746,1063,-2683
2017,11,11,22,1055,3651,1090,-2561
2017,11,11,23,931,3627,1098,-2529
2017,11,12,0,949,3644,1117,-2527
2017,11,12,1,1191,3788,1275,-2513
2017,11,12,2,1290,3934,1335,-2599
2017,11,12,3,1290,3878,1317,-2561
2017,11,12,4,1220,3778,1265,-2513
2017,11,12,5,1114,3700,1307,-2393
2017,11,12,6,934,3570,1284,-2286
2017,11,12,7,1145,3417,1305,-2112
2017,11,12,8,1015,3216,1183,-2033
2017,11,12,9,1096,3069,1247,-1822
2017,11,12,10,1057,2951,1141,-1810
2017,11,12,11,1038,2904,1137,-1767
2017,11,12,12,1049,2890,1134,-1756
2017,11,12,13,1052,2973,1180,-1793
2017,11,12,14,1159,3088,1201,-1887
2017,11,12,15,982,3129,1043,-2086
2017,11,12,16,1154,3374,1143,-2231
2017,11,12,17,1209,3576,1263,-2313
2017,11,12,18,1287,3679,1343,-2336
2017,11,12,19,1294,3704,1359,-2345
2017,11,12,20,1399,3622,1356,-2266
2017,11,12,21,1407,3610,1392,-2218
2017,11,12,22,1197,3620,1414,-2206
2017,11,12,23,1147,3594,1350,-2244
2017,11,13,0,1372,3727,1356,-2371
2017,11,13,1,1351,3977,1485,-2492
2017,11,13,2,1571,4127,1572,-2555
2017,11,13,3,1527,4071,1601,-2470
2017,11,13,4,1446,3977,1531,-2446
2017,11,13,5,1472,3797,1570,-2227
2017,11,13,6,1148,3578,1555,-2023
2017,11,13,7,1322,3300,1360,-1940
2017,11,13,8,1267,3059,1294,-1765
2017,11,13,9,1258,2949,1221,-1728
2017,11,13,10,1297,2835,1183,-1652
2017,11,13,11,1244,2797,1194,-1603
2017,11,13,12,1238,2916,1289,-1627
2017,11,13,13,1294,3070,1308,-1762
2017,11,13,14,1296,3399,1523,-1876
2017,11,13,15,1595,3742,1724,-2018
2017,11,13,16,1702,3961,1865,-2096
2017,11,13,17,1778,3968,1917,-2051
2017,11,13,18,1779,3940,1971,-1969
2017,11,13,19,1480,3902,1913,-1989
2017,11,13,20,1476,3944,1994,-1950
2017,11,13,21,1618,3933,1888,-2045
2017,11,13,22,1594,3923,1900,-2023
2017,11,13,23,1634,3966,1911,-2055
2017,11,14,0,1514,4054,1970,-2084
2017,11,14,1,1785,4265,1931,-2334
2017,11,14,2,1889,4344,1971,-2373
2017,11,14,3,1846,4225,1949,-2276
2017,11,14,4,1730,4121,1913,-2208
2017,11,14,5,1691,3989,1890,-2099
2017,11,14,6,1518,3717,1826,-1891
2017,11,14,7,1299,3472,1815,-1657
2017,11,14,8,1227,3244,1776,-1468
2017,11,14,9,1345,3137,1722,-1415
2017,11,14,10,1318,3059,1653,-1406
2017,11,14,11,1210,3039,1588,-1451
2017,11,14,12,1409,3120,1622,-1498
2017,11,14,13,1418,3294,1611,-1683
2017,11,14,14,1586,3574,1516,-2058
2017,11,14,15,1451,3903,1381,-2522
2017,11,14,16,1295,4054,1403,-2651
2017,11,14,17,1463,3980,1358,-2622
2017,11,14,18,1307,3904,1350,-2554
2017,11,14,19,1472,3868,1369,-2499
2017,11,14,20,1439,3822,1317,-2505
2017,11,14,21,1485,3807,1374,-2433
2017,11,14,22,1524,3810,1470,-2340
2017,11,14,23,1526,3902,1492,-2410
2017,11,15,0,1507,4026,1770,-2256
2017,11,15,1,1615,4236,1799,-2437
2017,11,15,2,1731,4404,1920,-2484
2017,11,15,3,1717,4326,1791,-2535
2017,11,15,4,1703,4259,1800,-2459
2017,11,15,5,1398,4026,1635,-2391
2017,11,15,6,1329,3801,1388,-2413
2017,11,15,7,1658,3480,1440,-2040
2017,11,15,8,1546,3202,1415,-1787
2017,11,15,9,1083,3072,1316,-1756
2017,11,15,10,1025,3007,1382,-1625
2017,11,15,11,1066,2969,1433,-1536
2017,11,15,12,1151,3060,1560,-1500
2017,11,15,13,1160,3138,1478,-1660
2017,11,15,14,1200,3459,1479,-1980
2017,11,15,15,1366,3890,1591,-2299
2017,11,15,16,1493,4172,1725,-2447
2017,11,15,17,1491,4171,1774,-2397
2017,11,15,18,1331,4078,1774,-2304
2017,11,15,19,1520,4065,1827,-2238
2017,11,15,20,1531,3960,1730,-2230
2017,11,15,21,1497,3932,1705,-2227
2017,11,15,22,1432,3874,1735,-2139
2017,11,15,23,1560,3868,1674,-2194
2017,11,16,0,1445,3923,1605,-2318
2017,11,16,1,1528,4130,1705,-2425
2017,11,16,2,1640,4430,1737,-2693
2017,11,16,3,1618,4428,1796,-2632
2017,11,16,4,1615,4349,1799,-2550
2017,11,16,5,1583,4221,1760,-2461
2017,11,16,6,1529,3953,1607,-2346
2017,11,16,7,1567,3607,1582,-2025
2017,11,16,8,1514,3329,1561,-1768
2017,11,16,9,1272,3100,1442,-1658
2017,11,16,10,1150,3024,1391,-1633
2017,11,16,11,1210,2944,1150,-1794
2017,11,16,12,1165,3041,1380,-1661
2017,11,16,13,1424,3191,1454,-1737
2017,11,16,14,1545,3562,1567,-1995
2017,11,16,15,1193,3928,1420,-2508
2017,11,16,16,1308,4099,1613,-2486
2017,11,16,17,1299,4054,1539,-2515
2017,11,16,18,1142,4105,1560,-2545
2017,11,16,19,1169,4070,1596,-2474
2017,11,16,20,1143,4047,1521,-2526
2017,11,16,21,1141,4023,1496,-2527
2017,11,16,22,1140,3924,1302,-2622
2017,11,16,23,1220,3906,1392,-2514
2017,11,17,0,1131,3976,1455,-2521
2017,11,17,1,1135,4167,1439,-2728
2017,11,17,2,1440,4325,1407,-2918
2017,11,17,3,1457,4333,1462,-2871
2017,11,17,4,1405,4263,1475,-2788
2017,11,17,5,1221,4145,1497,-2648
2017,11,17,6,1160,3909,1490,-2419
2017,11,17,7,1502,3664,1610,-2054
2017,11,17,8,1336,3384,1501,-1883
2017,11,17,9,1236,3305,1494,-1811
2017,11,17,10,1181,3196,1430,-1766
2017,11,17,11,1228,3084,1384,-1700
2017,11,17,12,1296,3111,1383,-1728
2017,11,17,13,1381,3266,1545,-1721
2017,11,17,14,1520,3722,1789,-1933
2017,11,17,15,1307,4044,1731,-2313
2017,11,17,16,1420,4318,1832,-2486
2017,11,17,17,1420,4314,1786,-2528
2017,11,17,18,1359,4173,1766,-2407
2017,11,17,19,1218,4073,1701,-2372
2017,11,17,20,1219,3990,1653,-2337
2017,11,17,21,1220,3834,1593,-2241
2017,11,17,22,1219,3745,1593,-2152
2017,11,17,23,1219,3743,1529,-2214
2017,11,18,0,1174,3772,1537,-2235
2017,11,18,1,1183,3976,1503,-2473
2017,11,18,2,1385,4158,1608,-2550
2017,11,18,3,1337,4104,1432,-2672
2017,11,18,4,1279,4009,1495,-2514
2017,11,18,5,1279,3873,1452,-2421
2017,11,18,6,1275,3703,1473,-2230
2017,11,18,7,1411,3472,1557,-1915
2017,11,18,8,1297,3214,1456,-1758
2017,11,18,9,1198,3020,1409,-1611
2017,11,18,10,1264,2889,1312,-1577
2017,11,18,11,1096,2840,1267,-1573
2017,11,18,12,1152,2850,1147,-1703
2017,11,18,13,1246,2914,1224,-1690
2017,11,18,14,1227,3101,1275,-1826
2017,11,18,15,1208,3377,1281,-2096
2017,11,18,16,1170,3520,1071,-2449
2017,11,18,17,1350,3705,1068,-2637
2017,11,18,18,1304,3763,1025,-2738
2017,11,18,19,1199,3796,1096,-2700
2017,11,18,20,1135,3719,1089,-2630
2017,11,18,21,1052,3624,1080,-2544
2017,11,18,22,974,3527,1090,-2437
2017,11,18,23,1133,3453,1154,-2299
2017,11,19,0,1181,3531,1225,-2306
2017,11,19,1,1133,3752,1368,-2384
2017,11,19,2,1354,3945,1346,-2599
2017,11,19,3,1351,3978,1390,-2588
2017,11,19,4,1260,3899,1442,-2457
2017,11,19,5,1191,3759,1398,-2361
2017,11,19,6,1054,3660,1408,-2252
2017,11,19,7,1497,3465,1399,-2066
2017,11,19,8,1488,3298,1494,-1804
2017,11,19,9,1442,3237,1625,-1612
2017,11,19,10,1434,3150,1590,-1560
2017,11,19,11,1424,3127,1560,-1567
2017,11,19,12,1414,3174,1570,-1604
2017,11,19,13,1409,3214,1596,-1618
2017,11,19,14,1514,3285,1570,-1715
2017,11,19,15,1339,3422,1486,-1936
2017,11,19,16,1527,3717,1677,-2040
2017,11,19,17,1574,3923,1657,-2266
2017,11,19,18,1515,4033,1656,-2377
2017,11,19,19,1512,4086,1678,-2408
2017,11,19,20,1493,4039,1666,-2373
2017,11,19,21,1669,4020,1632,-2388
2017,11,19,22,1565,3899,1532,-2367
2017,11,19,23,1525,3934,1620,-2314
2017,11,20,0,1567,4006,1676,-2330
2017,11,20,1,1673,4287,1766,-2521
2017,11,20,2,1825,4344,1734,-2610
2017,11,20,3,1713,4349,1789,-2560
2017,11,20,4,1550,4254,1762,-2492
2017,11,20,5,1638,4130,1811,-2319
2017,11,20,6,1461,3830,1709,-2121
2017,11,20,7,1551,3539,1703,-1836
2017,11,20,8,1462,3238,1538,-1700
2017,11,20,9,1276,3043,1435,-1608
2017,11,20,10,1227,2911,1328,-1583
2017,11,20,11,1304,2881,1344,-1537
2017,11,20,12,1243,2953,1341,-1612
2017,11,20,13,1423,3104,1330,-1774
2017,11,20,14,1537,3412,1375,-2037
2017,11,20,15,1468,3757,1379,-2378
2017,11,20,16,1303,4033,1464,-2569
2017,11,20,17,1344,4013,1415,-2598
2017,11,20,18,1251,4077,1469,-2608
2017,11,20,19,1292,3986,1506,-2480
2017,11,20,20,1324,3942,1528,-2414
2017,11,20,21,1344,3950,1737,-2213
2017,11,20,22,1383,3880,1663,-2217
2017,11,20,23,1383,3833,1596,-2237
2017,11,21,0,1394,3925,1636,-2289
2017,11,21,1,1394,4149,1697,-2452
2017,11,21,2,1396,4379,1818,-2561
2017,11,21,3,1387,4405,1882,-2523
2017,11,21,4,1354,4314,1855,-2459
2017,11,21,5,1305,4179,1795,-2384
2017,11,21,6,1252,3999,1840,-2159
2017,11,21,7,1409,3683,1729,-1954
2017,11,21,8,1441,3403,1683,-1720
2017,11,21,9,1501,3251,1572,-1679
2017,11,21,10,1618,3219,1591,-1628
2017,11,21,11,1551,3144,1532,-1612
2017,11,21,12,1577,3181,1538,-1643
2017,11,21,13,1630,3334,1598,-1736
2017,11,21,14,1663,3676,1746,-1930
2017,11,21,15,1776,4000,1615,-2385
2017,11,21,16,1964,4211,1702,-2509
2017,11,21,17,1887,4228,1817,-2411
2017,11,21,18,1791,4289,1893,-2396
2017,11,21,19,1754,4183,1782,-2401
2017,11,21,20,1797,4212,1752,-2460
2017,11,21,21,1540,4179,1681,-2498
2017,11,21,22,1483,4040,1626,-2414
2017,11,21,23,1484,4059,1726,-2333
2017,11,22,0,1486,4063,1744,-2319
2017,11,22,1,1648,4173,1956,-2217
2017,11,22,2,1845,4261,1978,-2283
2017,11,22,3,1849,4263,1983,-2280
2017,11,22,4,1762,4137,1959,-2178
2017,11,22,5,1700,3990,1996,-1994
2017,11,22,6,1488,3768,1875,-1893
2017,11,22,7,1729,3488,1935,-1553
2017,11,22,8,1427,3195,1843,-1352
2017,11,22,9,1417,2909,1728,-1181
2017,11,22,10,1520,2809,1690,-1119
2017,11,22,11,1391,2741,1601,-1140
2017,11,22,12,1350,2759,1606,-1153
2017,11,22,13,1544,2856,1632,-1224
2017,11,22,14,1535,3097,1719,-1378
2017,11,22,15,1673,3390,1635,-1755
2017,11,22,16,1703,3616,1657,-1959
2017,11,22,17,1613,3665,1633,-2032
2017,11,22,18,1639,3650,1702,-1948
2017,11,22,19,1640,3656,1749,-1907
2017,11,22,20,1617,3684,1863,-1821
2017,11,22,21,1624,3674,1851,-1823
2017,11,22,22,1637,3657,1961,-1696
2017,11,22,23,1640,3634,1899,-1735
2017,11,23,0,1681,3674,1889,-1785
2017,11,23,1,1906,3833,1943,-1890
2017,11,23,2,2081,3939,1920,-2019
2017,11,23,3,2053,3899,2012,-1887
2017,11,23,4,1945,3775,1867,-1908
2017,11,23,5,1762,3645,2000,-1645
2017,11,23,6,1703,3512,1858,-1654
2017,11,23,7,1712,3358,1864,-1494
2017,11,23,8,1414,3162,1923,-1239
2017,11,23,9,1473,2889,1821,-1068
2017,11,23,10,1487,2748,1696,-1052
2017,11,23,11,1351,2665,1697,-968
2017,11,23,12,1340,2645,1726,-919
2017,11,23,13,1430,2664,1559,-1105
2017,11,23,14,1421,2755,1572,-1183
2017,11,23,15,1342,2884,1382,-1502
2017,11,23,16,1366,3076,1359,-1717
2017,11,23,17,1442,3352,1238,-2114
2017,11,23,18,1642,3602,1346,-2256
2017,11,23,19,1380,3767,1367,-2400
2017,11,23,20,1391,3906,1365,-2541
2017,11,23,21,1397,3866,1224,-2642
2017,11,23,22,1316,3749,1250,-2499
2017,11,23,23,1309,3567,1297,-2270
2017,11,24,0,1307,3450,1406,-2044
2017,11,24,1,1305,3469,1382,-2087
2017,11,24,2,1304,3475,1393,-2082
2017,11,24,3,1309,3408,1404,-2004
2017,11,24,4,1315,3378,1456,-1922
2017,11,24,5,1318,3416,1473,-1943
2017,11,24,6,1319,3378,1413,-1965
2017,11,24,7,1315,3261,1499,-1762
2017,11,24,8,1309,3053,1432,-1621
2017,11,24,9,1321,2779,1296,-1483
2017,11,24,10,1216,2682,1317,-1365
2017,11,24,11,1443,2640,1297,-1343
2017,11,24,12,1320,2805,1470,-1335
2017,11,24,13,1324,2935,1439,-1496
2017,11,24,14,1544,3110,1520,-1590
2017,11,24,15,1563,3306,1570,-1736
2017,11,24,16,1345,3416,1487,-1929
2017,11,24,17,1279,3524,1387,-2137
2017,11,24,18,1262,3637,1438,-2199
2017,11,24,19,1244,3728,1631,-2097
2017,11,24,20,1234,3710,1557,-2153
2017,11,24,21,1225,3743,1603,-2140
2017,11,24,22,1247,3717,1578,-2139
2017,11,24,23,1222,3687,1454,-2233
2017,11,25,0,1225,3768,1550,-2218
2017,11,25,1,1476,3962,1586,-2376
2017,11,25,2,1585,4078,1605,-2473
2017,11,25,3,1554,3946,1485,-2461
2017,11,25,4,1458,3836,1462,-2374
2017,11,25,5,1381,3749,1537,-2212
2017,11,25,6,1258,3599,1498,-2101
2017,11,25,7,1722,3424,1593,-1831
2017,11,25,8,1682,3213,1569,-1644
2017,11,25,9,1408,3192,1632,-1560
2017,11,25,10,1380,2971,1491,-1480
2017,11,25,11,1370,3030,1564,-1466
2017,11,25,12,1335,2917,1300,-1617
2017,11,25,13,1416,2937,1257,-1680
2017,11,25,14,1531,3076,1247,-1829
2017,11,25,15,1348,3248,1199,-2049
2017,11,25,16,1412,3464,1209,-2255
2017,11,25,17,1601,3654,1236,-2418
2017,11,25,18,1704,3810,1408,-2402
2017,11,25,19,1679,3818,1526,-2292
2017,11,25,20,1410,3790,1560,-2230
2017,11,25,21,1414,3732,1480,-2252
2017,11,25,22,1486,3690,1505,-2185
2017,11,25,23,1418,3653,1490,-2163
2017,11,26,0,1418,3743,1438,-2305
2017,11,26,1,1673,3922,1478,-2444
2017,11,26,2,1763,3973,1493,-2480
2017,11,26,3,1631,3956,1413,-2543
2017,11,26,4,1540,3880,1477,-2403
2017,11,26,5,1463,3782,1524,-2258
2017,11,26,6,1423,3634,1490,-2144
2017,11,26,7,1811,3390,1524,-1866
2017,11,26,8,1814,3159,1475,-1684
2017,11,26,9,1393,2958,1332,-1626
2017,11,26,10,1321,2893,1281,-1612
2017,11,26,11,1366,2852,1344,-1508
2017,11,26,12,1416,2843,1549,-1294
2017,11,26,13,1356,2872,1652,-1220
2017,11,26,14,1422,2957,1717,-1240
2017,11,26,15,1334,3166,1848,-1318
2017,11,26,16,1616,3293,1790,-1503
2017,11,26,17,1551,3409,1701,-1708
2017,11,26,18,1731,3501,1696,-1805
2017,11,26,19,1708,3562,1797,-1765
2017,11,26,20,1849,3665,1799,-1866
2017,11,26,21,1650,3826,1838,-1988
2017,11,26,22,1831,3893,1956,-1937
2017,11,26,23,1846,3857,2040,-1817
2017,11,27,0,1615,3865,2031,-1834
2017,11,27,1,1644,4058,2074,-1984
2017,11,27,2,1900,4262,2084,-2178
2017,11,27,3,1870,4204,2113,-2091
2017,11,27,4,1759,4133,2066,-2067
2017,11,27,5,1753,4033,2107,-1926
2017,11,27,6,1651,3816,2035,-1781
2017,11,27,7,1811,3563,2027,-1536
2017,11,27,8,1588,3275,1898,-1377
2017,11,27,9,1691,3114,1811,-1303
2017,11,27,10,1712,3051,1864,-1187
2017,11,27,11,1752,3054,1881,-1173
2017,11,27,12,1811,3104,1861,-1243
2017,11,27,13,1828,3286,1897,-1389
2017,11,27,14,1988,3601,1975,-1626
2017,11,27,15,2025,4021,1938,-2083
2017,11,27,16,2067,4261,1947,-2314
2017,11,27,17,2063,4255,2081,-2174
2017,11,27,18,1986,4143,1992,-2151
2017,11,27,19,1747,4089,1840,-2249
2017,11,27,20,1873,3990,1956,-2034
2017,11,27,21,1834,3912,1895,-2017
2017,11,27,22,1806,3827,1753,-2074
2017,11,27,23,1734,3825,1716,-2109
2017,11,28,0,1787,3935,1898,-2037
2017,11,28,1,2036,4246,2150,-2096
2017,11,28,2,2202,4488,2257,-2231
2017,11,28,3,2188,4485,2194,-2291
2017,11,28,4,2098,4429,2097,-2332
2017,11,28,5,2016,4223,2006,-2217
2017,11,28,6,1999,3868,1862,-2006
2017,11,28,7,2030,3543,1817,-1726
2017,11,28,8,1815,3235,1758,-1477
2017,11,28,9,1567,3027,1559,-1468
2017,11,28,10,1466,2940,1541,-1399
2017,11,28,11,1534,2915,1513,-1402
2017,11,28,12,1556,2944,1468,-1476
2017,11,28,13,1461,3093,1515,-1578
2017,11,28,14,1704,3469,1606,-1863
2017,11,28,15,1717,3957,1675,-2282
2017,11,28,16,1818,4218,1775,-2443
2017,11,28,17,1706,4226,1787,-2439
2017,11,28,18,1825,4211,1782,-2429
2017,11,28,19,1660,4215,1815,-2400
2017,11,28,20,1810,4148,1784,-2364
2017,11,28,21,1609,4163,1807,-2356
2017,11,28,22,1693,4166,1854,-2312
2017,11,28,23,1901,4228,1932,-2296
2017,11,29,0,1943,4293,2016,-2277
2017,11,29,1,1969,4462,1984,-2478
2017,11,29,2,1895,4569,1918,-2651
2017,11,29,3,2013,4536,1955,-2581
2017,11,29,4,1803,4449,2106,-2343
2017,11,29,5,1807,4256,2063,-2193
2017,11,29,6,1619,3991,1841,-2150
2017,11,29,7,1790,3632,1786,-1846
2017,11,29,8,1693,3265,1642,-1623
2017,11,29,9,1349,3049,1531,-1518
2017,11,29,10,1274,2945,1375,-1570
2017,11,29,11,1269,2939,1381,-1558
2017,11,29,12,1540,3049,1432,-1617
2017,11,29,13,1500,3246,1473,-1773
2017,11,29,14,1488,3626,1491,-2135
2017,11,29,15,1719,4114,1585,-2529
2017,11,29,16,1671,4347,1675,-2672
2017,11,29,17,1480,4318,1619,-2699
2017,11,29,18,1635,4289,1573,-2716
2017,11,29,19,1730,4141,1630,-2511
2017,11,29,20,1505,4050,1605,-2445
2017,11,29,21,1534,4080,1689,-2391
2017,11,29,22,1790,3956,1588,-2368
2017,11,29,23,1823,3971,1752,-2219
2017,11,30,0,1818,4092,1826,-2266
2017,11,30,1,1733,4375,1816,-2559
2017,11,30,2,2020,4562,1877,-2685
2017,11,30,3,1939,4520,1905,-2615
2017,11,30,4,2025,4452,1905,-2547
2017,11,30,5,1651,4231,1874,-2357
2017,11,30,6,1567,3966,1769,-2197
2017,11,30,7,2019,3689,1882,-1807
2017,11,30,8,1926,3327,1756,-1571
2017,11,30,9,1522,3077,1444,-1633
2017,11,30,10,1485,2967,1340,-1627
2017,11,30,11,1507,2923,1404,-1519
2017,11,30,12,1561,2966,1467,-1499
2017,11,30,13,1616,3141,1542,-1599
2017,11,30,14,1674,3470,1634,-1836
2017,11,30,15,1658,4003,1817,-2186
2017,11,30,16,1771,4356,1929,-2427
2017,11,30,17,1762,4370,1942,-2428
2017,11,30,18,1750,4232,1722,-2510
2017,11,30,19,1713,4258,1788,-2470
2017,11,30,20,1837,4302,1875,-2427
2017,11,30,21,1646,4268,1943,-2325
2017,11,30,22,1794,4255,1990,-2265
2017,11,30,23,1618,4245,1886,-2359
2017,12,1,0,1842,4267,1814,-2453
2017,12,1,1,1923,4436,1842,-2594
2017,12,1,2,2127,4585,1863,-2722
2017,12,1,3,2073,4524,1816,-2708
2017,12,1,4,2056,4448,1990,-2458
2017,12,1,5,1884,4323,1950,-2373
2017,12,1,6,1943,4023,1809,-2214
2017,12,1,7,2024,3712,1725,-1987
2017,12,1,8,1739,3409,1583,-1826
2017,12,1,9,1209,3210,1285,-1925
2017,12,1,10,1090,3115,1112,-2003
2017,12,1,11,1013,3092,1171,-1921
2017,12,1,12,1239,3122,1186,-1936
2017,12,1,13,1160,3291,1212,-2079
2017,12,1,14,1242,3660,1210,-2450
2017,12,1,15,1239,4103,1334,-2769
2017,12,1,16,1301,4288,1204,-3084
2017,12,1,17,1164,4332,1273,-3059
2017,12,1,18,1220,4307,1373,-2934
2017,12,1,19,1288,4244,1382,-2862
2017,12,1,20,1224,4229,1429,-2800
2017,12,1,21,1113,4172,1439,-2733
2017,12,1,22,1007,4178,1462,-2716
2017,12,1,23,1010,4146,1399,-2747
2017,12,2,0,1308,4188,1430,-2758
2017,12,2,1,1484,4434,1509,-2925
2017,12,2,2,1626,4523,1619,-2904
2017,12,2,3,1559,4473,1668,-2805
2017,12,2,4,1461,4346,1641,-2705
2017,12,2,5,1385,4229,1643,-2586
2017,12,2,6,1279,4026,1652,-2374
2017,12,2,7,1579,3763,1541,-2222
2017,12,2,8,1398,3530,1524,-2006
2017,12,2,9,1134,3328,1336,-1992
2017,12,2,10,1112,3238,1362,-1876
2017,12,2,11,1038,3172,1241,-1931
2017,12,2,12,1100,3211,1390,-1821
2017,12,2,13,1125,3264,1401,-1863
2017,12,2,14,1251,3415,1385,-2030
2017,12,2,15,1014,3570,1328,-2242
2017,12,2,16,1121,3738,1256,-2482
2017,12,2,17,1207,3929,1208,-2721
2017,12,2,18,1282,4068,1230,-2838
2017,12,2,19,1306,4100,1227,-2873
2017,12,2,20,1378,4105,1224,-2881
2017,12,2,21,1361,4068,1220,-2848
2017,12,2,22,1352,4030,1209,-2821
2017,12,2,23,1145,4023,1205,-2818
2017,12,3,0,1177,4060,1208,-2852
2017,12,3,1,1369,4273,1359,-2914
2017,12,3,2,1494,4380,1492,-2888
2017,12,3,3,1444,4299,1426,-2873
2017,12,3,4,1349,4194,1455,-2739
2017,12,3,5,1282,4115,1433,-2682
2017,12,3,6,1139,3905,1204,-2701
2017,12,3,7,1460,3739,1358,-2381
2017,12,3,8,1329,3490,1337,-2153
2017,12,3,9,1275,3264,1298,-1966
2017,12,3,10,1141,3147,1281,-1866
2017,12,3,11,1239,3097,1225,-1872
2017,12,3,12,1208,3099,1277,-1822
2017,12,3,13,1146,3146,1269,-1877
2017,12,3,14,1025,3252,1212,-2040
2017,12,3,15,1027,3455,1181,-2274
2017,12,3,16,1025,3743,1214,-2529
2017,12,3,17,1022,3958,1314,-2644
2017,12,3,18,1023,4135,1459,-2676
2017,12,3,19,1030,4154,1515,-2639
2017,12,3,20,1043,4136,1579,-2557
2017,12,3,21,1057,4110,1587,-2523
2017,12,3,22,1068,3981,1267,-2714
2017,12,3,23,1073,4027,1430,-2597
2017,12,4,0,1070,4148,1538,-2610
2017,12,4,1,1062,4410,1497,-2913
2017,12,4,2,1317,4598,1551,-3047
2017,12,4,3,1300,4528,1587,-2941
2017,12,4,4,1284,4458,1575,-2883
2017,12,4,5,1246,4377,1553,-2824
2017,12,4,6,1061,4216,1500,-2716
2017,12,4,7,1253,3880,1437,-2443
2017,12,4,8,1248,3593,1436,-2157
2017,12,4,9,1179,3390,1387,-2003
2017,12,4,10,1202,3316,1346,-1970
2017,12,4,11,1285,3307,1395,-1912
2017,12,4,12,1370,3372,1424,-1948
2017,12,4,13,1476,3576,1553,-2023
2017,12,4,14,1525,3930,1583,-2347
2017,12,4,15,1582,4416,1485,-2931
2017,12,4,16,1558,4732,1639,-3093
2017,12,4,17,1556,4681,1663,-3018
2017,12,4,18,1556,4648,1732,-2916
2017,12,4,19,1554,4569,1648,-2921
2017,12,4,20,1485,4494,1514,-2980
2017,12,4,21,1253,4405,1519,-2886
2017,12,4,22,1224,4309,1424,-2885
2017,12,4,23,1394,4241,1426,-2815
2017,12,5,0,1540,4272,1432,-2840
2017,12,5,1,1548,4623,1721,-2902
2017,12,5,2,1808,4884,1779,-3105
2017,12,5,3,1826,4867,1812,-3055
2017,12,5,4,1766,4796,1842,-2954
2017,12,5,5,1670,4670,1871,-2799
2017,12,5,6,1438,4338,1715,-2623
2017,12,5,7,1779,4007,1915,-2092
2017,12,5,8,1650,3724,1875,-1849
2017,12,5,9,1539,3558,1780,-1778
2017,12,5,10,1408,3495,1665,-1830
2017,12,5,11,1511,3493,1651,-1842
2017,12,5,12,1493,3618,1706,-1912
2017,12,5,13,1583,3811,1720,-2091
2017,12,5,14,1613,4210,1919,-2291
2017,12,5,15,1747,4630,1907,-2723
2017,12,5,16,1726,4834,1813,-3021
2017,12,5,17,1743,4768,1712,-3056
2017,12,5,18,1624,4619,1560,-3059
2017,12,5,19,1618,4503,1620,-2883
2017,12,5,20,1563,4346,1611,-2735
2017,12,5,21,1445,4269,1635,-2634
2017,12,5,22,1391,4249,1541,-2708
2017,12,5,23,1562,4076,1558,-2518
2017,12,6,0,1637,4177,1573,-2604
2017,12,6,1,1821,4539,1729,-2810
2017,12,6,2,2069,4801,1780,-3021
2017,12,6,3,2075,4877,1936,-2941
2017,12,6,4,2011,4820,1936,-2884
2017,12,6,5,1876,4713,1968,-2745
2017,12,6,6,1640,4483,1958,-2525
2017,12,6,7,1899,4146,1996,-2150
2017,12,6,8,1853,3870,1974,-1896
2017,12,6,9,1519,3708,1837,-1871
2017,12,6,10,1539,3644,1795,-1849
2017,12,6,11,1628,3650,1798,-1852
2017,12,6,12,1643,3719,1841,-1878
2017,12,6,13,1680,3915,1876,-2039
2017,12,6,14,1899,4256,2017,-2239
2017,12,6,15,1851,4661,1990,-2671
2017,12,6,16,1868,4894,1999,-2895
2017,12,6,17,1867,4846,1956,-2890
2017,12,6,18,1864,4646,1797,-2849
2017,12,6,19,1759,4470,1709,-2761
2017,12,6,20,1579,4368,1792,-2576
2017,12,6,21,1483,4263,1745,-2518
2017,12,6,22,1435,4193,1895,-2298
2017,12,6,23,1489,4140,1864,-2276
2017,12,7,0,1555,4137,1788,-2349
2017,12,7,1,1959,4498,2000,-2498
2017,12,7,2,2211,4744,2004,-2740
2017,12,7,3,2133,4778,1981,-2797
2017,12,7,4,2189,4738,2025,-2713
2017,12,7,5,2189,4634,2044,-2590
2017,12,7,6,1852,4384,1994,-2390
2017,12,7,7,2069,4038,1981,-2057
2017,12,7,8,2053,3747,1883,-1864
2017,12,7,9,1613,3626,1740,-1886
2017,12,7,10,1518,3574,1730,-1844
2017,12,7,11,1638,3490,1643,-1847
2017,12,7,12,1682,3523,1673,-1850
2017,12,7,13,1780,3770,1733,-2037
2017,12,7,14,1951,4216,1863,-2353
2017,12,7,15,1915,4658,1873,-2785
2017,12,7,16,1989,4875,1963,-2912
2017,12,7,17,1893,4791,1839,-2952
2017,12,7,18,1843,4679,1844,-2835
2017,12,7,19,1617,4530,1821,-2709
2017,12,7,20,1504,4375,1807,-2568
2017,12,7,21,1640,4230,1668,-2562
2017,12,7,22,1590,4093,1653,-2440
2017,12,7,23,1575,4060,1706,-2354
2017,12,8,0,1461,4164,1792,-2372
2017,12,8,1,1755,4481,1822,-2659
2017,12,8,2,2003,4840,2011,-2829
2017,12,8,3,2023,4870,2016,-2854
2017,12,8,4,1954,4749,1900,-2849
2017,12,8,5,1865,4717,1993,-2724
2017,12,8,6,1814,4486,1970,-2516
2017,12,8,7,1984,4187,2014,-2173
2017,12,8,8,1798,3905,1861,-2044
2017,12,8,9,1392,3754,1741,-2013
2017,12,8,10,1359,3709,1720,-1989
2017,12,8,11,1412,3720,1718,-2002
2017,12,8,12,1379,3795,1732,-2063
2017,12,8,13,1703,3921,1800,-2121
2017,12,8,14,1694,4312,1856,-2456
2017,12,8,15,1669,4762,1873,-2889
2017,12,8,16,1702,5017,1875,-3142
2017,12,8,17,1721,5007,1934,-3073
2017,12,8,18,1679,4877,2022,-2855
2017,12,8,19,1551,4751,1917,-2834
2017,12,8,20,1591,4612,1866,-2746
2017,12,8,21,1497,4498,1834,-2664
2017,12,8,22,1431,4394,1845,-2549
2017,12,8,23,1397,4311,1827,-2484
2017,12,9,0,1503,4393,1830,-2563
2017,12,9,1,1755,4701,1943,-2758
2017,12,9,2,1983,4901,1999,-2902
2017,12,9,3,1937,4862,1944,-2918
2017,12,9,4,1872,4680,1708,-2972
2017,12,9,5,1746,4576,1689,-2887
2017,12,9,6,1564,4479,1828,-2651
2017,12,9,7,1714,4235,1879,-2356
2017,12,9,8,1566,3883,1698,-2185
2017,12,9,9,1433,3701,1428,-2273
2017,12,9,10,1237,3627,1364,-2263
2017,12,9,11,1254,3585,1338,-2247
2017,12,9,12,1219,3611,1267,-2344
2017,12,9,13,1243,3774,1330,-2444
2017,12,9,14,1374,3946,1338,-2608
2017,12,9,15,1414,4172,1249,-2923
2017,12,9,16,1510,4536,1499,-3037
2017,12,9,17,1370,4751,1661,-3090
2017,12,9,18,1355,4800,1658,-3142
2017,12,9,19,1370,4724,1558,-3166
2017,12,9,20,1306,4576,1541,-3035
2017,12,9,21,1370,4430,1460,-2970
2017,12,9,22,1111,4304,1473,-2831
2017,12,9,23,1111,4182,1472,-2710
2017,12,10,0,1267,4266,1542,-2724
2017,12,10,1,1490,4589,1593,-2996
2017,12,10,2,1640,4748,1662,-3086
2017,12,10,3,1635,4711,1638,-3073
2017,12,10,4,1632,4621,1661,-2960
2017,12,10,5,1632,4545,1660,-2885
2017,12,10,6,1477,4409,1629,-2780
2017,12,10,7,1638,4187,1646,-2541
2017,12,10,8,1665,3970,1628,-2342
2017,12,10,9,1198,3775,1559,-2216
2017,12,10,10,1134,3660,1539,-2121
2017,12,10,11,1230,3621,1539,-2082
2017,12,10,12,1269,3613,1550,-2063
2017,12,10,13,1339,3681,1674,-2007
2017,12,10,14,1472,3789,1599,-2190
2017,12,10,15,1626,3971,1736,-2235
2017,12,10,16,1697,4280,1947,-2333
2017,12,10,17,2045,4505,2033,-2472
2017,12,10,18,2012,4592,1972,-2620
2017,12,10,19,1962,4500,1937,-2563
2017,12,10,20,1968,4394,1915,-2479
2017,12,10,21,1786,4282,1855,-2427
2017,12,10,22,1670,4197,1851,-2346
2017,12,10,23,1712,4119,1818,-2301
2017,12,11,0,1697,4146,1831,-2315
2017,12,11,1,1921,4479,1913,-2566
2017,12,11,2,2058,4782,2085,-2697
2017,12,11,3,2074,4780,2115,-2665
2017,12,11,4,2039,4734,2061,-2673
2017,12,11,5,2055,4619,2064,-2555
2017,12,11,6,1893,4358,1862,-2496
2017,12,11,7,1911,4003,1722,-2281
2017,12,11,8,1763,3731,1567,-2164
2017,12,11,9,1366,3602,1503,-2099
2017,12,11,10,1505,3549,1447,-2102
2017,12,11,11,1290,3561,1446,-2115
2017,12,11,12,1290,3657,1493,-2164
2017,12,11,13,1290,3863,1540,-2323
2017,12,11,14,1575,4282,1779,-2503
2017,12,11,15,1495,4791,1887,-2904
2017,12,11,16,1471,5138,2189,-2949
2017,12,11,17,1445,5106,2174,-2932
2017,12,11,18,1444,4828,1918,-2910
2017,12,11,19,1488,4532,1707,-2825
2017,12,11,20,1260,4395,1785,-2610
2017,12,11,21,1052,4117,1656,-2461
2017,12,11,22,1053,4092,1623,-2469
2017,12,11,23,1095,3985,1653,-2332
2017,12,12,0,1144,4063,1653,-2410
2017,12,12,1,1443,4488,1987,-2501
2017,12,12,2,1441,4754,2117,-2637
2017,12,12,3,1445,4790,2172,-2618
2017,12,12,4,1440,4918,2343,-2575
2017,12,12,5,1440,4828,2315,-2513
2017,12,12,6,1440,4549,2274,-2275
2017,12,12,7,1516,4205,2320,-1885
2017,12,12,8,1441,3847,2176,-1671
2017,12,12,9,1840,3740,2131,-1609
2017,12,12,10,1786,3710,2237,-1473
2017,12,12,11,1845,3700,2123,-1577
2017,12,12,12,1833,3757,2125,-1632
2017,12,12,13,1979,3937,1916,-2021
2017,12,12,14,2152,4231,2004,-2227
2017,12,12,15,2172,4642,2236,-2406
2017,12,12,16,2390,4829,2152,-2677
2017,12,12,17,2307,4686,2026,-2660
2017,12,12,18,2223,4603,2078,-2525
2017,12,12,19,1958,4488,2015,-2473
2017,12,12,20,2062,4531,2138,-2393
2017,12,12,21,1804,4467,2167,-2300
2017,12,12,22,1783,4375,2164,-2211
2017,12,12,23,1925,4300,2112,-2188
2017,12,13,0,1991,4219,1812,-2407
2017,12,13,1,2105,4500,1932,-2568
2017,12,13,2,2348,4875,2163,-2712
2017,12,13,3,2344,4853,2166,-2687
2017,12,13,4,2265,4841,2279,-2562
2017,12,13,5,2123,4713,2256,-2457
2017,12,13,6,2075,4412,2230,-2182
2017,12,13,7,2261,4029,2125,-1904
2017,12,13,8,2057,3719,1957,-1762
2017,12,13,9,1821,3488,1699,-1789
2017,12,13,10,1827,3425,1711,-1714
2017,12,13,11,1894,3473,1788,-1685
2017,12,13,12,1879,3552,1845,-1707
2017,12,13,13,2028,3752,1930,-1822
2017,12,13,14,2195,4067,2044,-2023
2017,12,13,15,2177,4580,2256,-2324
2017,12,13,16,2305,4859,2427,-2432
2017,12,13,17,2246,4753,2237,-2516
2017,12,13,18,2253,4648,2342,-2306
2017,12,13,19,2148,4498,2257,-2241
2017,12,13,20,1918,4344,2221,-2123
2017,12,13,21,2043,4222,2170,-2052
2017,12,13,22,1969,4148,2129,-2019
2017,12,13,23,1934,4097,2116,-1981
2017,12,14,0,2061,4190,2112,-2078
2017,12,14,1,2194,4500,2232,-2268
2017,12,14,2,2406,4752,2369,-2383
2017,12,14,3,2404,4704,2359,-2345
2017,12,14,4,2330,4583,2285,-2298
2017,12,14,5,2401,4515,2333,-2182
2017,12,14,6,2052,4255,2166,-2089
2017,12,14,7,2412,3975,2222,-1753
2017,12,14,8,2157,3725,2090,-1635
2017,12,14,9,1998,3558,2043,-1515
2017,12,14,10,1947,3556,2115,-1441
2017,12,14,11,1958,3449,1944,-1505
2017,12,14,12,1952,3501,2017,-1484
2017,12,14,13,2123,3819,2217,-1602
2017,12,14,14,2336,4174,2423,-1751
2017,12,14,15,2369,4480,2430,-2050
2017,12,14,16,2369,4796,2612,-2184
2017,12,14,17,2389,4657,2487,-2170
2017,12,14,18,2388,4476,2415,-2061
2017,12,14,19,2226,4336,2150,-2186
2017,12,14,20,1967,4208,2047,-2161
2017,12,14,21,2067,3872,1823,-2049
2017,12,14,22,2007,3790,1887,-1903
2017,12,14,23,1824,3765,1854,-1911
2017,12,15,0,2086,3992,1958,-2034
2017,12,15,1,2192,4393,2209,-2184
2017,12,15,2,2373,4843,2480,-2363
2017,12,15,3,2351,4822,2514,-2308
2017,12,15,4,2427,4734,2508,-2226
2017,12,15,5,2209,4633,2443,-2190
2017,12,15,6,2157,4409,2366,-2043
2017,12,15,7,2452,4144,2458,-1686
2017,12,15,8,2097,3818,2232,-1586
2017,12,15,9,1976,3697,2200,-1497
2017,12,15,10,1996,3605,2210,-1395
2017,12,15,11,2078,3545,2196,-1349
2017,12,15,12,2027,3556,2188,-1368
2017,12,15,13,2121,3683,2225,-1458
2017,12,15,14,2280,4014,2144,-1870
2017,12,15,15,2285,4416,2207,-2209
2017,12,15,16,2285,4681,2232,-2449
2017,12,15,17,2291,4679,2207,-2472
2017,12,15,18,2082,4609,2214,-2395
2017,12,15,19,2023,4560,2246,-2314
2017,12,15,20,1980,4492,2289,-2203
2017,12,15,21,1824,4464,2147,-2317
2017,12,15,22,1863,4438,2061,-2377
2017,12,15,23,1794,4399,2082,-2317
2017,12,16,0,1942,4461,2256,-2205
2017,12,16,1,2041,4667,2387,-2280
2017,12,16,2,2247,4735,2324,-2411
2017,12,16,3,2160,4598,2200,-2398
2017,12,16,4,1973,4451,2002,-2449
2017,12,16,5,1858,4399,2194,-2205
2017,12,16,6,1793,4253,2196,-2057
2017,12,16,7,2230,4010,2285,-1725
2017,12,16,8,1936,3741,2238,-1503
2017,12,16,9,2027,3533,2137,-1396
2017,12,16,10,1963,3412,2070,-1342
2017,12,16,11,1894,3367,2117,-1250
2017,12,16,12,2010,3376,2278,-1098
2017,12,16,13,1984,3463,2322,-1141
2017,12,16,14,2100,3585,2249,-1336
2017,12,16,15,1888,3834,2197,-1637
2017,12,16,16,1905,4104,2191,-1913
2017,12,16,17,2091,4334,2297,-2037
2017,12,16,18,2181,4455,2405,-2050
2017,12,16,19,2202,4485,2400,-2085
2017,12,16,20,2167,4409,2374,-2035
2017,12,16,21,2271,4293,2369,-1924
2017,12,16,22,2238,4211,2395,-1816
2017,12,16,23,2011,4172,2385,-1787
2017,12,17,0,2061,4202,2402,-1800
2017,12,17,1,2205,4403,2353,-2050
2017,12,17,2,2401,4499,2473,-2026
2017,12,17,3,2209,4462,2524,-1938
2017,12,17,4,2099,4335,2483,-1852
2017,12,17,5,2240,4270,2381,-1889
2017,12,17,6,1971,4097,2249,-1848
2017,12,17,7,2352,3876,2374,-1502
2017,12,17,8,2028,3646,2356,-1290
2017,12,17,9,1963,3347,2035,-1312
2017,12,17,10,1809,3157,1957,-1200
2017,12,17,11,1906,3048,1918,-1130
2017,12,17,12,1835,3004,1917,-1087
2017,12,17,13,1816,3066,1928,-1138
2017,12,17,14,2061,3170,1862,-1308
2017,12,17,15,1799,3326,1751,-1575
2017,12,17,16,1846,3562,1880,-1682
2017,12,17,17,2062,3799,1943,-1856
2017,12,17,18,2190,3926,1894,-2032
2017,12,17,19,2160,3965,1883,-2082
2017,12,17,20,2156,3982,1912,-2070
2017,12,17,21,2160,3989,1932,-2057
2017,12,17,22,2239,3924,1903,-2021
2017,12,17,23,2056,3898,1852,-2046
2017,12,18,0,2060,3913,1783,-2130
2017,12,18,1,2152,4098,1793,-2305
2017,12,18,2,2287,4218,2067,-2151
2017,12,18,3,2156,4218,2143,-2075
2017,12,18,4,2026,4112,2184,-1928
2017,12,18,5,2002,4036,2337,-1699
2017,12,18,6,1764,3820,2033,-1787
2017,12,18,7,1922,3509,1964,-1545
2017,12,18,8,1639,3265,1906,-1359
2017,12,18,9,1508,3068,1847,-1221
2017,12,18,10,1480,2925,1693,-1232
2017,12,18,11,1419,2884,1685,-1199
2017,12,18,12,1609,2991,1793,-1198
2017,12,18,13,1699,3096,1839,-1257
2017,12,18,14,1885,3341,1876,-1465
2017,12,18,15,1804,3686,1733,-1953
2017,12,18,16,1884,3945,1743,-2202
2017,12,18,17,1785,4024,1760,-2264
2017,12,18,18,1812,4058,1834,-2224
2017,12,18,19,1882,4146,1916,-2230
2017,12,18,20,1643,4147,1947,-2200
2017,12,18,21,1828,4151,1846,-2305
2017,12,18,22,1805,4134,1846,-2288
2017,12,18,23,1654,4132,1823,-2309
2017,12,19,0,1865,4160,1799,-2361
2017,12,19,1,1814,4383,1988,-2395
2017,12,19,2,1990,4539,2037,-2502
2017,12,19,3,2006,4501,1982,-2519
2017,12,19,4,1960,4315,1877,-2438
2017,12,19,5,2033,4208,1890,-2318
2017,12,19,6,1939,3985,1930,-2055
2017,12,19,7,2078,3691,2062,-1629
2017,12,19,8,1896,3415,2038,-1377
2017,12,19,9,1449,3305,1911,-1394
2017,12,19,10,1505,3198,1798,-1400
2017,12,19,11,1426,3161,1721,-1440
2017,12,19,12,1471,3179,1700,-1479
2017,12,19,13,1518,3281,1687,-1594
2017,12,19,14,1658,3560,1632,-1928
2017,12,19,15,1298,3873,1604,-2269
2017,12,19,16,1488,4097,1720,-2377
2017,12,19,17,1541,4237,1733,-2504
2017,12,19,18,1601,4256,1785,-2471
2017,12,19,19,1425,4204,1635,-2569
2017,12,19,20,1623,4214,1694,-2520
2017,12,19,21,1823,4141,1700,-2441
2017,12,19,22,1875,4115,1675,-2440
2017,12,19,23,1656,4169,1686,-2483
2017,12,20,0,1855,4281,1832,-2449
2017,12,20,1,2020,4523,1869,-2654
2017,12,20,2,2101,4708,2008,-2700
2017,12,20,3,1880,4662,2019,-2643
2017,12,20,4,1812,4436,1707,-2729
2017,12,20,5,1771,4310,1639,-2671
2017,12,20,6,1590,4116,1694,-2422
2017,12,20,7,1817,3862,1839,-2023
2017,12,20,8,1692,3529,1847,-1682
2017,12,20,9,1685,3346,1927,-1419
2017,12,20,10,1571,3254,1868,-1386
2017,12,20,11,1680,3218,1699,-1519
2017,12,20,12,1590,3266,1668,-1598
2017,12,20,13,1654,3473,1764,-1709
2017,12,20,14,2012,3806,1815,-1991
2017,12,20,15,1453,4102,1712,-2390
2017,12,20,16,1525,4378,1789,-2589
2017,12,20,17,1664,4492,1836,-2656
2017,12,20,18,1690,4485,1761,-2724
2017,12,20,19,1708,4377,1778,-2599
2017,12,20,20,1714,4268,1859,-2409
2017,12,20,21,1714,4202,1685,-2517
2017,12,20,22,1650,4204,1899,-2305
2017,12,20,23,1627,4142,1942,-2200
2017,12,21,0,1686,4165,1960,-2205
2017,12,21,1,1867,4482,2189,-2293
2017,12,21,2,2064,4818,2400,-2418
2017,12,21,3,2082,4826,2512,-2314
2017,12,21,4,2071,4770,2406,-2364
2017,12,21,5,1956,4576,2360,-2216
2017,12,21,6,1768,4463,2469,-1994
2017,12,21,7,2442,4194,2405,-1789
2017,12,21,8,2174,3914,2268,-1646
2017,12,21,9,2163,3797,2188,-1609
2017,12,21,10,2217,3729,2267,-1462
2017,12,21,11,2270,3736,2251,-1485
2017,12,21,12,2291,3813,2344,-1469
2017,12,21,13,2425,4039,2427,-1612
2017,12,21,14,2544,4476,2613,-1863
2017,12,21,15,2372,4802,2650,-2152
2017,12,21,16,2447,5050,2770,-2280
2017,12,21,17,2323,5075,2561,-2514
2017,12,21,18,2465,5009,2581,-2428
2017,12,21,19,2465,4920,2594,-2326
2017,12,21,20,2403,4800,2423,-2377
2017,12,21,21,2120,4701,2352,-2349
2017,12,21,22,2078,4597,2285,-2312
2017,12,21,23,2204,4551,2286,-2265
2017,12,22,0,2246,4659,2398,-2261
2017,12,22,1,2508,4915,2621,-2294
2017,12,22,2,2588,5077,2834,-2243
2017,12,22,3,2616,4977,2704,-2273
2017,12,22,4,2515,4790,2587,-2203
2017,12,22,5,2203,4710,2486,-2224
2017,12,22,6,2167,4481,2372,-2109
2017,12,22,7,2430,4210,2524,-1686
2017,12,22,8,2267,3898,2377,-1521
2017,12,22,9,2140,3689,2248,-1441
2017,12,22,10,2114,3582,2240,-1342
2017,12,22,11,2182,3499,2144,-1355
2017,12,22,12,2151,3528,2177,-1351
2017,12,22,13,2139,3668,2220,-1448
2017,12,22,14,2266,3934,2199,-1735
2017,12,22,15,1983,4225,2205,-2020
2017,12,22,16,2275,4467,2266,-2201
2017,12,22,17,2418,4571,2240,-2331
2017,12,22,18,2414,4634,2323,-2311
2017,12,22,19,2380,4651,2539,-2112
2017,12,22,20,2349,4588,2430,-2158
2017,12,22,21,2291,4542,2354,-2188
2017,12,22,22,2251,4487,2459,-2028
2017,12,22,23,2242,4454,2502,-1952
2017,12,23,0,2288,4463,2478,-1985
2017,12,23,1,2530,4714,2508,-2206
2017,12,23,2,2668,4891,2634,-2257
2017,12,23,3,2540,4810,2586,-2224
2017,12,23,4,2421,4683,2496,-2187
2017,12,23,5,2294,4583,2521,-2062
2017,12,23,6,2134,4430,2436,-1994
2017,12,23,7,2606,4195,2513,-1682
2017,12,23,8,2531,3943,2509,-1434
2017,12,23,9,2288,3707,2455,-1252
2017,12,23,10,2343,3629,2416,-1213
2017,12,23,11,2327,3607,2439,-1168
2017,12,23,12,2422,3601,2397,-1204
2017,12,23,13,2418,3685,2410,-1275
2017,12,23,14,2484,3872,2459,-1413
2017,12,23,15,2375,4104,2421,-1683
2017,12,23,16,2458,4435,2528,-1907
2017,12,23,17,2510,4641,2491,-2150
2017,12,23,18,2493,4684,2518,-2166
2017,12,23,19,2501,4716,2458,-2258
2017,12,23,20,2463,4615,2434,-2181
2017,12,23,21,2459,4472,2350,-2122
2017,12,23,22,2447,4379,2341,-2038
2017,12,23,23,2336,4322,2360,-1962
2017,12,24,0,2283,4381,2363,-2018
2017,12,24,1,2538,4676,2413,-2263
2017,12,24,2,2676,4881,2478,-2403
2017,12,24,3,2603,4875,2541,-2334
2017,12,24,4,2546,4809,2568,-2241
2017,12,24,5,2462,4803,2516,-2287
2017,12,24,6,2329,4666,2522,-2144
2017,12,24,7,2679,4438,2558,-1880
2017,12,24,8,2557,4198,2504,-1694
2017,12,24,9,2494,4039,2491,-1548
2017,12,24,10,2486,3933,2458,-1475
2017,12,24,11,2512,3843,2452,-1391
2017,12,24,12,2464,3851,2408,-1443
2017,12,24,13,2399,3881,2294,-1587
2017,12,24,14,2334,4043,2371,-1672
2017,12,24,15,2404,4250,2483,-1767
2017,12,24,16,2665,4554,2568,-1986
2017,12,24,17,2658,4764,2581,-2183
2017,12,24,18,2511,4895,2587,-2308
2017,12,24,19,2473,4881,2569,-2312
2017,12,24,20,2404,4861,2586,-2275
2017,12,24,21,2569,4768,2566,-2202
2017,12,24,22,2520,4764,2599,-2165
2017,12,24,23,2450,4724,2571,-2153
2017,12,25,0,2622,4656,2407,-2249
2017,12,25,1,2743,4779,2481,-2298
2017,12,25,2,2897,4795,2440,-2355
2017,12,25,3,2880,4721,2445,-2276
2017,12,25,4,2803,4624,2431,-2193
2017,12,25,5,2686,4544,2422,-2122
2017,12,25,6,2457,4411,2402,-2009
2017,12,25,7,2665,4253,2500,-1753
2017,12,25,8,2517,4029,2463,-1566
2017,12,25,9,2280,3843,2403,-1440
2017,12,25,10,2158,3776,2401,-1375
2017,12,25,11,2194,3736,2318,-1418
2017,12,25,12,2235,3759,2436,-1323
2017,12,25,13,2287,3843,2423,-1420
2017,12,25,14,2487,3975,2433,-1542
2017,12,25,15,2228,4175,2321,-1854
2017,12,25,16,2482,4383,2428,-1955
2017,12,25,17,2471,4592,2519,-2073
2017,12,25,18,2531,4682,2576,-2106
2017,12,25,19,2507,4718,2539,-2179
2017,12,25,20,2431,4678,2405,-2273
2017,12,25,21,2367,4645,2361,-2284
2017,12,25,22,2481,4590,2365,-2225
2017,12,25,23,2332,4442,2301,-2141
2017,12,26,0,2262,4449,2242,-2207
2017,12,26,1,2574,4634,2296,-2338
2017,12,26,2,2548,4714,2261,-2453
2017,12,26,3,2474,4669,2112,-2557
2017,12,26,4,2442,4590,2283,-2307
2017,12,26,5,2419,4482,2328,-2154
2017,12,26,6,2264,4332,2331,-2001
2017,12,26,7,2416,4051,2274,-1777
2017,12,26,8,2236,3825,2285,-1540
2017,12,26,9,2101,3707,2291,-1416
2017,12,26,10,2118,3757,2406,-1351
2017,12,26,11,2145,3702,2333,-1369
2017,12,26,12,2203,3765,2419,-1346
2017,12,26,13,2306,3872,2393,-1479
2017,12,26,14,2398,4089,2366,-1723
2017,12,26,15,2262,4308,2150,-2158
2017,12,26,16,2329,4590,2365,-2225
2017,12,26,17,2418,4746,2522,-2224
2017,12,26,18,2444,4813,2595,-2218
2017,12,26,19,2407,4795,2457,-2338
2017,12,26,20,2329,4779,2440,-2339
2017,12,26,21,2266,4716,2407,-2309
2017,12,26,22,2203,4616,2341,-2275
2017,12,26,23,2158,4625,2324,-2301
2017,12,27,0,2238,4710,2375,-2335
2017,12,27,1,2457,4933,2583,-2350
2017,12,27,2,2686,5069,2713,-2356
2017,12,27,3,2646,4990,2582,-2408
2017,12,27,4,2561,4867,2543,-2324
2017,12,27,5,2466,4778,2544,-2234
2017,12,27,6,2366,4557,2447,-2110
2017,12,27,7,2515,4278,2472,-1806
2017,12,27,8,2483,3980,2419,-1561
2017,12,27,9,2137,3760,2367,-1393
2017,12,27,10,2082,3699,2298,-1401
2017,12,27,11,2164,3682,2320,-1362
2017,12,27,12,2256,3734,2273,-1461
2017,12,27,13,2280,3899,2304,-1595
2017,12,27,14,2450,4156,2400,-1756
2017,12,27,15,2178,4436,2297,-2139
2017,12,27,16,2478,4622,2396,-2226
2017,12,27,17,2388,4690,2314,-2376
2017,12,27,18,2357,4743,2332,-2411
2017,12,27,19,2319,4768,2373,-2395
2017,12,27,20,2274,4735,2295,-2440
2017,12,27,21,2061,4745,2353,-2392
2017,12,27,22,2122,4713,2354,-2359
2017,12,27,23,1974,4691,2222,-2469
2017,12,28,0,2030,4738,2248,-2490
2017,12,28,1,2266,4903,2370,-2533
2017,12,28,2,2465,5005,2417,-2588
2017,12,28,3,2434,4804,2287,-2517
2017,12,28,4,2325,4837,2437,-2400
2017,12,28,5,2206,4681,2429,-2252
2017,12,28,6,1978,4440,2264,-2176
2017,12,28,7,2298,4173,2400,-1773
2017,12,28,8,2108,3878,2157,-1721
2017,12,28,9,1707,3706,2111,-1595
2017,12,28,10,1654,3624,1981,-1643
2017,12,28,11,1600,3576,1847,-1729
2017,12,28,12,1756,3567,1881,-1686
2017,12,28,13,1650,3664,1904,-1760
2017,12,28,14,1764,3868,1996,-1872
2017,12,28,15,1640,4105,1874,-2231
2017,12,28,16,1777,4233,1943,-2290
2017,12,28,17,1824,4338,1922,-2416
2017,12,28,18,1918,4482,2013,-2469
2017,12,28,19,1851,4552,2023,-2529
2017,12,28,20,1680,4557,1956,-2601
2017,12,28,21,1617,4544,1927,-2617
2017,12,28,22,1568,4482,1943,-2539
2017,12,28,23,1539,4464,1943,-2521
2017,12,29,0,1581,4496,1956,-2540
2017,12,29,1,1796,4629,2057,-2572
2017,12,29,2,1969,4726,2093,-2633
2017,12,29,3,1906,4657,2063,-2594
2017,12,29,4,1791,4454,1972,-2482
2017,12,29,5,1647,4333,1898,-2435
2017,12,29,6,1410,4130,2028,-2102
2017,12,29,7,1788,3861,2078,-1783
2017,12,29,8,1556,3585,1796,-1789
2017,12,29,9,1451,3431,1662,-1769
2017,12,29,10,1373,3315,1648,-1667
2017,12,29,11,1423,3276,1653,-1623
2017,12,29,12,1502,3303,1637,-1666
2017,12,29,13,1468,3338,1504,-1834
2017,12,29,14,1505,3570,1487,-2083
2017,12,29,15,1148,3825,1459,-2366
2017,12,29,16,1154,4017,1482,-2535
2017,12,29,17,1466,4128,1471,-2657
2017,12,29,18,1353,4216,1436,-2780
2017,12,29,19,1505,4284,1442,-2842
2017,12,29,20,1352,4297,1446,-2851
2017,12,29,21,1295,4273,1513,-2760
2017,12,29,22,1331,4226,1504,-2722
2017,12,29,23,1197,4239,1515,-2724
2017,12,30,0,1198,4285,1583,-2702
2017,12,30,1,1496,4384,1623,-2761
2017,12,30,2,1417,4453,1647,-2806
2017,12,30,3,1469,4338,1400,-2938
2017,12,30,4,1283,4155,1306,-2849
2017,12,30,5,1162,4024,1328,-2696
2017,12,30,6,1177,3814,1228,-2586
2017,12,30,7,1358,3618,1258,-2360
2017,12,30,8,1251,3388,1302,-2086
2017,12,30,9,1207,3220,1279,-1941
2017,12,30,10,1243,3158,1301,-1857
2017,12,30,11,1189,3125,1283,-1842
2017,12,30,12,1200,3128,1257,-1871
2017,12,30,13,1281,3186,1249,-1937
2017,12,30,14,1324,3311,1257,-2054
2017,12,30,15,1088,3511,1271,-2240
2017,12,30,16,1071,3690,1240,-2450
2017,12,30,17,1126,3863,1374,-2489
2017,12,30,18,1266,3989,1448,-2541
2017,12,30,19,1286,4031,1417,-2614
2017,12,30,20,1316,4014,1412,-2602
2017,12,30,21,1286,3938,1382,-2556
2017,12,30,22,1217,3887,1390,-2497
2017,12,30,23,1114,3856,1359,-2497
2017,12,31,0,1089,3809,1425,-2384
2017,12,31,1,1332,3972,1442,-2530
2017,12,31,2,1527,4239,1674,-2565
2017,12,31,3,1522,4262,1771,-2491
2017,12,31,4,1472,4257,1865,-2392
2017,12,31,5,1441,4202,1891,-2311
2017,12,31,6,1385,3928,1857,-2071
2017,12,31,7,1768,3650,1724,-1926
2017,12,31,8,1549,3416,1628,-1788
2017,12,31,9,1378,3239,1450,-1789
2017,12,31,10,1393,3103,1317,-1786
2017,12,31,11,1289,3141,1435,-1706
2017,12,31,12,1321,3166,1491,-1675
2017,12,31,13,1470,3168,1507,-1661
2017,12,31,14,1597,3326,1480,-1846
2017,12,31,15,1595,3605,1501,-2104
2017,12,31,16,1642,3954,1725,-2229
2017,12,31,17,1788,4193,1902,-2291
2017,12,31,18,1910,4281,1828,-2453
2017,12,31,19,1864,4305,1805,-2500
2017,12,31,20,1792,4259,1780,-2479
2017,12,31,21,1848,4204,1759,-2445
2017,12,31,22,1734,4130,1718,-2412
2017,12,31,23,1690,4055,1623,-2432
2018,1,1,0,1746,4088,1650,-2438
2018,1,1,1,1862,4346,1730,-2616
2018,1,1,2,1859,4646,1940,-2706
2018,1,1,3,1669,4564,1899,-2665
2018,1,1,4,1860,4434,1768,-2666
2018,1,1,5,1838,4298,1687,-2611
2018,1,1,6,1789,4158,1840,-2318
2018,1,1,7,1768,3895,1964,-1931
2018,1,1,8,1740,3656,1845,-1811
2018,1,1,9,1639,3582,1854,-1728
2018,1,1,10,1733,3512,1912,-1600
2018,1,1,11,1658,3464,1779,-1685
2018,1,1,12,1657,3460,1757,-1703
2018,1,1,13,1635,3538,1676,-1862
2018,1,1,14,1681,3692,1686,-2006
2018,1,1,15,1580,3839,1645,-2194
2018,1,1,16,1675,3971,1641,-2330
2018,1,1,17,1751,4077,1643,-2434
2018,1,1,18,1791,4194,1680,-2514
2018,1,1,19,1787,4369,1796,-2573
2018,1,1,20,1779,4335,1762,-2573
2018,1,1,21,1796,4401,1830,-2571
2018,1,1,22,1778,4273,1873,-2400
2018,1,1,23,1767,4289,1986,-2303
2018,1,2,0,1734,4318,2044,-2274
2018,1,2,1,1903,4595,2107,-2488
2018,1,2,2,2097,4874,2292,-2582
2018,1,2,3,2080,4866,2319,-2547
2018,1,2,4,2035,4796,2228,-2568
2018,1,2,5,1950,4686,2218,-2468
2018,1,2,6,1896,4447,2149,-2298
2018,1,2,7,2053,4084,2059,-2025
2018,1,2,8,1947,3767,1785,-1982
2018,1,2,9,1768,3648,1646,-2002
2018,1,2,10,1672,3587,1613,-1974
2018,1,2,11,1738,3585,1615,-1970
2018,1,2,12,1775,3718,1778,-1940
2018,1,2,13,1952,3964,2053,-1911
2018,1,2,14,1938,4301,2106,-2195
2018,1,2,15,2079,4717,2132,-2585
2018,1,2,16,2048,4971,2266,-2705
2018,1,2,17,2016,4945,2234,-2711
2018,1,2,18,2055,4923,2320,-2603
2018,1,2,19,2073,4864,2218,-2646
2018,1,2,20,1978,4780,2206,-2574
2018,1,2,21,2001,4700,2180,-2520
2018,1,2,22,1932,4570,2077,-2493
2018,1,2,23,1872,4538,2124,-2414
2018,1,3,0,1925,4598,2127,-2471
2018,1,3,1,2075,4787,2265,-2522
2018,1,3,2,2139,4982,2302,-2680
2018,1,3,3,2032,4982,2302,-2680
2018,1,3,4,1917,4839,2264,-2575
2018,1,3,5,2037,4702,2138,-2564
2018,1,3,6,1819,4430,2041,-2389
2018,1,3,7,1796,4103,2099,-2004
2018,1,3,8,1760,3785,1984,-1801
2018,1,3,9,1702,3629,1919,-1710
2018,1,3,10,1806,3624,1883,-1741
2018,1,3,11,1950,3633,1856,-1777
2018,1,3,12,1918,3704,1838,-1866
2018,1,3,13,1856,3885,1965,-1920
2018,1,3,14,2116,4256,2195,-2061
2018,1,3,15,2173,4673,2220,-2453
2018,1,3,16,2160,4983,2306,-2677
2018,1,3,17,2094,4939,2338,-2601
2018,1,3,18,2182,4842,2299,-2543
2018,1,3,19,2016,4673,2252,-2421
2018,1,3,20,2031,4544,2251,-2293
2018,1,3,21,2009,4418,2161,-2257
2018,1,3,22,1738,4316,2124,-2192
2018,1,3,23,1702,4229,1996,-2233
2018,1,4,0,1749,4294,2047,-2247
2018,1,4,1,2014,4519,2010,-2509
2018,1,4,2,2220,4864,2236,-2628
2018,1,4,3,2240,4897,2268,-2629
2018,1,4,4,2168,4767,2285,-2482
2018,1,4,5,2114,4665,2243,-2422
2018,1,4,6,1801,4381,2021,-2360
2018,1,4,7,2137,4042,2052,-1990
2018,1,4,8,2073,3775,2058,-1717
2018,1,4,9,1619,3640,1889,-1751
2018,1,4,10,1627,3553,1860,-1693
2018,1,4,11,1686,3551,1902,-1649
2018,1,4,12,1838,3609,1913,-1696
2018,1,4,13,1845,3786,1971,-1815
2018,1,4,14,1869,4015,2013,-2002
2018,1,4,15,2074,4388,1941,-2447
2018,1,4,16,2202,4704,2098,-2606
2018,1,4,17,2188,4764,2158,-2606
2018,1,4,18,2092,4689,2142,-2547
2018,1,4,19,2006,4603,2188,-2415
2018,1,4,20,1993,4510,2153,-2357
2018,1,4,21,1978,4444,2139,-2305
2018,1,4,22,1771,4352,2059,-2293
2018,1,4,23,1748,4322,2069,-2253
2018,1,5,0,1771,4305,2053,-2252
2018,1,5,1,1890,4480,2097,-2383
2018,1,5,2,2144,4721,2212,-2509
2018,1,5,3,2125,4684,2136,-2548
2018,1,5,4,2032,4576,2099,-2477
2018,1,5,5,1919,4422,1974,-2448
2018,1,5,6,1668,4124,1792,-2332
2018,1,5,7,1938,3829,1921,-1908
2018,1,5,8,1651,3550,1810,-1740
2018,1,5,9,1561,3405,1827,-1578
2018,1,5,10,1404,3299,1578,-1721
2018,1,5,11,1386,3269,1581,-1688
2018,1,5,12,1380,3307,1583,-1724
2018,1,5,13,1390,3443,1630,-1813
2018,1,5,14,1406,3737,1670,-2067
2018,1,5,15,1391,4064,1605,-2459
2018,1,5,16,1371,4329,1679,-2650
2018,1,5,17,1561,4336,1623,-2713
2018,1,5,18,1536,4310,1614,-2696
2018,1,5,19,1572,4257,1558,-2699
2018,1,5,20,1504,4217,1609,-2608
2018,1,5,21,1461,4192,1628,-2564
2018,1,5,22,1404,4141,1638,-2503
2018,1,5,23,1367,4076,1633,-2443
2018,1,6,0,1393,4094,1640,-2454
2018,1,6,1,1492,4272,1701,-2571
2018,1,6,2,1594,4402,1732,-2670
2018,1,6,3,1646,4343,1689,-2654
2018,1,6,4,1550,4227,1696,-2531
2018,1,6,5,1520,4152,1705,-2447
2018,1,6,6,1244,3961,1666,-2295
2018,1,6,7,1676,3723,1732,-1991
2018,1,6,8,1689,3502,1676,-1826
2018,1,6,9,1350,3327,1661,-1666
2018,1,6,10,1367,3216,1685,-1531
2018,1,6,11,1444,3171,1616,-1555
2018,1,6,12,1383,3165,1603,-1562
2018,1,6,13,1449,3210,1594,-1616
2018,1,6,14,1476,3349,1607,-1742
2018,1,6,15,1154,3526,1678,-1848
2018,1,6,16,1301,3747,1771,-1976
2018,1,6,17,1501,3896,1775,-2121
2018,1,6,18,1620,4018,1834,-2184
2018,1,6,19,1635,4042,1748,-2294
2018,1,6,20,1639,4029,1753,-2276
2018,1,6,21,1487,3983,1685,-2298
2018,1,6,22,1593,4003,1769,-2234
2018,1,6,23,1387,3984,1711,-2273
2018,1,7,0,1474,4038,1778,-2260
2018,1,7,1,1555,4213,1847,-2366
2018,1,7,2,1762,4374,1995,-2379
2018,1,7,3,1719,4324,1991,-2333
2018,1,7,4,1637,4224,1855,-2369
2018,1,7,5,1640,4109,1824,-2285
2018,1,7,6,1517,3970,1800,-2170
2018,1,7,7,1861,3767,1908,-1859
2018,1,7,8,1667,3558,1779,-1779
2018,1,7,9,1315,3390,1625,-1765
2018,1,7,10,1203,3267,1476,-1791
2018,1,7,11,1188,3249,1390,-1859
2018,1,7,12,1157,3243,1367,-1876
2018,1,7,13,1119,3283,1431,-1852
2018,1,7,14,1376,3401,1550,-1851
2018,1,7,15,1029,3563,1465,-2098
2018,1,7,16,1174,3750,1540,-2210
2018,1,7,17,1264,3959,1566,-2393
2018,1,7,18,1410,4111,1578,-2533
2018,1,7,19,1498,4194,1604,-2590
2018,1,7,20,1491,4224,1629,-2595
2018,1,7,21,1470,4247,1627,-2620
2018,1,7,22,1428,4219,1623,-2596
2018,1,7,23,1347,4198,1605,-2593
2018,1,8,0,1391,4244,1705,-2539
2018,1,8,1,1393,4396,1758,-2638
2018,1,8,2,1619,4533,1769,-2764
2018,1,8,3,1584,4477,1775,-2702
2018,1,8,4,1496,4408,1824,-2584
2018,1,8,5,1421,4271,1654,-2617
2018,1,8,6,1275,4023,1664,-2359
2018,1,8,7,1724,3750,1669,-2081
2018,1,8,8,1489,3479,1655,-1824
2018,1,8,9,1388,3306,1660,-1646
2018,1,8,10,1382,3212,1672,-1540
2018,1,8,11,1298,3191,1578,-1613
2018,1,8,12,1315,3244,1618,-1626
2018,1,8,13,1324,3411,1721,-1690
2018,1,8,14,1737,3731,1867,-1864
2018,1,8,15,1668,4130,1869,-2261
2018,1,8,16,1916,4410,1968,-2442
2018,1,8,17,1675,4416,2005,-2411
2018,1,8,18,1653,4364,1912,-2452
2018,1,8,19,1635,4291,1891,-2400
2018,1,8,20,1562,4209,1883,-2326
2018,1,8,21,1553,4164,1901,-2263
2018,1,8,22,1568,4079,1903,-2176
2018,1,8,23,1568,4035,1896,-2139
2018,1,9,0,1568,4154,1916,-2238
2018,1,9,1,1733,4400,1950,-2450
2018,1,9,2,1996,4579,1970,-2609
2018,1,9,3,2004,4547,1994,-2553
2018,1,9,4,1900,4388,1922,-2466
2018,1,9,5,1786,4254,1874,-2380
2018,1,9,6,1534,3978,1778,-2200
2018,1,9,7,1573,3700,1839,-1861
2018,1,9,8,1448,3439,1556,-1883
2018,1,9,9,1307,3242,1486,-1756
2018,1,9,10,1270,3138,1403,-1735
2018,1,9,11,1269,3111,1409,-1702
2018,1,9,12,1274,3151,1489,-1662
2018,1,9,13,1386,3314,1553,-1761
2018,1,9,14,1557,3642,1714,-1928
2018,1,9,15,1674,4051,1833,-2218
2018,1,9,16,1686,4206,1642,-2564
2018,1,9,17,1678,4199,1755,-2444
2018,1,9,18,1707,4208,2030,-2178
2018,1,9,19,1767,4209,2034,-2175
2018,1,9,20,1807,4198,2034,-2164
2018,1,9,21,1761,4168,2004,-2164
2018,1,9,22,1703,4142,1982,-2160
2018,1,9,23,1673,4174,2009,-2165
2018,1,10,0,1688,4153,1792,-2361
2018,1,10,1,1776,4278,1797,-2481
2018,1,10,2,1949,4393,1803,-2590
2018,1,10,3,1875,4459,1902,-2557
2018,1,10,4,1715,4388,1785,-2603
2018,1,10,5,1514,4237,1573,-2664
2018,1,10,6,1436,4015,1766,-2249
2018,1,10,7,1438,3704,1799,-1905
2018,1,10,8,1280,3435,1800,-1635
2018,1,10,9,1220,3215,1646,-1569
2018,1,10,10,1150,3163,1477,-1686
2018,1,10,11,1136,3214,1543,-1671
2018,1,10,12,1183,3262,1481,-1781
2018,1,10,13,1206,3422,1455,-1967
2018,1,10,14,1582,3738,1699,-2039
2018,1,10,15,1476,4026,1661,-2365
2018,1,10,16,1571,4399,1858,-2541
2018,1,10,17,1593,4380,1902,-2478
2018,1,10,18,1686,4304,1889,-2415
2018,1,10,19,1619,4251,1944,-2307
2018,1,10,20,1555,4211,1843,-2368
2018,1,10,21,1533,4178,1833,-2345
2018,1,10,22,1520,4148,1815,-2333
2018,1,10,23,1541,4131,1764,-2367
2018,1,11,0,1490,4190,1763,-2427
2018,1,11,1,1474,4350,1739,-2611
2018,1,11,2,1749,4547,1696,-2851
2018,1,11,3,1787,4513,1643,-2870
2018,1,11,4,1732,4428,1657,-2771
2018,1,11,5,1619,4299,1655,-2644
2018,1,11,6,1515,4050,1661,-2389
2018,1,11,7,1907,3712,1584,-2128
2018,1,11,8,1660,3470,1593,-1877
2018,1,11,9,1138,3279,1316,-1963
2018,1,11,10,1100,3191,1296,-1895
2018,1,11,11,1083,3165,1304,-1861
2018,1,11,12,1084,3201,1305,-1896
2018,1,11,13,1161,3347,1377,-1970
2018,1,11,14,1180,3660,1445,-2215
2018,1,11,15,1198,4066,1454,-2612
2018,1,11,16,1447,4299,1437,-2862
2018,1,11,17,1439,4321,1443,-2878
2018,1,11,18,1386,4243,1442,-2801
2018,1,11,19,1426,4291,1506,-2785
2018,1,11,20,1485,4257,1497,-2760
2018,1,11,21,1425,4286,1534,-2752
2018,1,11,22,1301,4229,1601,-2628
2018,1,11,23,1162,4107,1531,-2576
2018,1,12,0,1108,4149,1530,-2619
2018,1,12,1,1153,4304,1572,-2732
2018,1,12,2,1338,4459,1585,-2874
2018,1,12,3,1312,4424,1572,-2852
2018,1,12,4,1217,4326,1562,-2764
2018,1,12,5,1074,4173,1453,-2720
2018,1,12,6,877,3960,1437,-2523
2018,1,12,7,1126,3661,1398,-2263
2018,1,12,8,873,3382,1364,-2018
2018,1,12,9,1109,3221,1342,-1879
2018,1,12,10,1034,3114,1324,-1790
2018,1,12,11,990,3080,1323,-1757
2018,1,12,12,1094,3110,1343,-1767
2018,1,12,13,1145,3324,1392,-1932
2018,1,12,14,1305,3550,1432,-2118
2018,1,12,15,1120,3919,1429,-2490
2018,1,12,16,1315,4187,1405,-2782
2018,1,12,17,1313,4192,1395,-2797
2018,1,12,18,1238,4135,1415,-2720
2018,1,12,19,1166,4118,1451,-2667
2018,1,12,20,1108,4102,1449,-2653
2018,1,12,21,1079,4143,1452,-2691
2018,1,12,22,1096,4134,1507,-2627
2018,1,12,23,1110,4121,1556,-2565
2018,1,13,0,1124,4164,1560,-2604
2018,1,13,1,1091,4276,1498,-2778
2018,1,13,2,1106,4422,1517,-2905
2018,1,13,3,1116,4334,1518,-2816
2018,1,13,4,1119,4171,1401,-2770
2018,1,13,5,1116,4070,1457,-2613
2018,1,13,6,1106,3842,1483,-2359
2018,1,13,7,1136,3650,1587,-2063
2018,1,13,8,1144,3389,1552,-1837
2018,1,13,9,1320,3219,1551,-1668
2018,1,13,10,1187,3104,1498,-1606
2018,1,13,11,1298,3105,1504,-1601
2018,1,13,12,1267,3109,1434,-1675
2018,1,13,13,1287,3160,1539,-1621
2018,1,13,14,1312,3216,1475,-1741
2018,1,13,15,1182,3416,1444,-1972
2018,1,13,16,1202,3536,1408,-2128
2018,1,13,17,1294,3747,1475,-2272
2018,1,13,18,1374,3919,1490,-2429
2018,1,13,19,1397,3900,1446,-2454
2018,1,13,20,1341,3862,1415,-2447
2018,1,13,21,1336,3739,1357,-2382
2018,1,13,22,1377,3667,1323,-2344
2018,1,13,23,1350,3622,1283,-2339
2018,1,14,0,1196,3727,1457,-2270
2018,1,14,1,1195,3836,1465,-2371
2018,1,14,2,1410,4068,1495,-2573
2018,1,14,3,1395,4059,1494,-2565
2018,1,14,4,1353,3939,1546,-2393
2018,1,14,5,1212,3798,1513,-2285
2018,1,14,6,1074,3586,1441,-2145
2018,1,14,7,1714,3500,1557,-1943
2018,1,14,8,1508,3302,1487,-1815
2018,1,14,9,1344,3274,1629,-1645
2018,1,14,10,1296,3185,1611,-1574
2018,1,14,11,1254,3146,1601,-1545
2018,1,14,12,1296,3125,1639,-1486
2018,1,14,13,1286,3209,1554,-1655
2018,1,14,14,1309,3282,1461,-1821
2018,1,14,15,1218,3492,1453,-2039
2018,1,14,16,993,3724,1535,-2189
2018,1,14,17,1181,3938,1599,-2339
2018,1,14,18,1305,4030,1628,-2402
2018,1,14,19,1336,4044,1644,-2400
2018,1,14,20,1344,3974,1625,-2349
2018,1,14,21,1321,3889,1605,-2284
2018,1,14,22,1143,3788,1507,-2281
2018,1,14,23,1066,3719,1474,-2245
2018,1,15,0,1114,3722,1456,-2266
2018,1,15,1,1304,3918,1615,-2303
2018,1,15,2,1564,4211,1670,-2541
2018,1,15,3,1538,4231,1722,-2509
2018,1,15,4,1457,4162,1743,-2419
2018,1,15,5,1329,4062,1723,-2339
2018,1,15,6,1117,3912,1696,-2216
2018,1,15,7,1748,3687,1675,-2012
2018,1,15,8,1496,3441,1607,-1834
2018,1,15,9,1171,3363,1655,-1708
2018,1,15,10,1239,3257,1614,-1643
2018,1,15,11,1228,3233,1607,-1626
2018,1,15,12,1297,3235,1670,-1565
2018,1,15,13,1343,3376,1718,-1658
2018,1,15,14,1355,3627,1750,-1877
2018,1,15,15,1419,3901,1750,-2151
2018,1,15,16,1443,4146,1766,-2380
2018,1,15,17,1482,4241,1732,-2509
2018,1,15,18,1472,4274,1716,-2558
2018,1,15,19,1429,4215,1674,-2541
2018,1,15,20,1332,4107,1599,-2508
2018,1,15,21,1234,3978,1544,-2434
2018,1,15,22,1129,3876,1612,-2264
2018,1,15,23,1114,3871,1647,-2224
2018,1,16,0,1111,3920,1688,-2232
2018,1,16,1,1102,4137,1646,-2491
2018,1,16,2,1254,4356,1626,-2730
2018,1,16,3,1290,4337,1709,-2628
2018,1,16,4,1200,4251,1670,-2581
2018,1,16,5,1152,4115,1568,-2547
2018,1,16,6,1018,3880,1540,-2340
2018,1,16,7,1194,3593,1524,-2069
2018,1,16,8,1178,3231,1489,-1742
2018,1,16,9,1228,3066,1449,-1617
2018,1,16,10,1219,2990,1483,-1507
2018,1,16,11,1233,2960,1439,-1521
2018,1,16,12,1224,3007,1371,-1636
2018,1,16,13,1223,3145,1358,-1787
2018,1,16,14,1238,3453,1525,-1928
2018,1,16,15,1224,3846,1446,-2400
2018,1,16,16,1379,4122,1518,-2604
2018,1,16,17,1349,4090,1494,-2596
2018,1,16,18,1237,4051,1451,-2600
2018,1,16,19,1188,3977,1553,-2424
2018,1,16,20,1163,3953,1716,-2237
2018,1,16,21,1151,3933,1677,-2256
2018,1,16,22,1123,3903,1664,-2239
2018,1,16,23,1117,3868,1622,-2246
2018,1,17,0,1156,3899,1606,-2293
2018,1,17,1,1122,4073,1602,-2471
2018,1,17,2,1371,4265,1490,-2775
2018,1,17,3,1377,4241,1422,-2819
2018,1,17,4,1411,4179,1422,-2757
2018,1,17,5,1377,4086,1405,-2681
2018,1,17,6,1151,3866,1367,-2499
2018,1,17,7,1498,3570,1397,-2173
2018,1,17,8,1250,3329,1379,-1950
2018,1,17,9,1049,3171,1373,-1798
2018,1,17,10,1087,3088,1360,-1728
2018,1,17,11,1067,3068,1367,-1701
2018,1,17,12,1109,3090,1358,-1732
2018,1,17,13,1178,3256,1387,-1869
2018,1,17,14,1369,3564,1478,-2086
2018,1,17,15,1297,3931,1484,-2447
2018,1,17,16,1478,4167,1480,-2687
2018,1,17,17,1398,4146,1466,-2680
2018,1,17,18,1356,4049,1496,-2553
2018,1,17,19,1277,4024,1502,-2522
2018,1,17,20,1204,3961,1439,-2522
2018,1,17,21,1205,3953,1438,-2515
2018,1,17,22,1206,3922,1439,-2483
2018,1,17,23,1083,3938,1439,-2499
2018,1,18,0,1076,4015,1444,-2571
2018,1,18,1,1209,4148,1480,-2668
2018,1,18,2,1423,4294,1480,-2814
2018,1,18,3,1414,4248,1431,-2817
2018,1,18,4,1293,4114,1397,-2717
2018,1,18,5,1146,3968,1378,-2590
2018,1,18,6,909,3709,1310,-2399
2018,1,18,7,1316,3442,1411,-2031
2018,1,18,8,1000,3167,1491,-1676
2018,1,18,9,1317,3015,1539,-1476
2018,1,18,10,1219,3006,1602,-1404
2018,1,18,11,1299,2955,1584,-1371
2018,1,18,12,1340,2999,1535,-1464
2018,1,18,13,1369,3162,1537,-1625
2018,1,18,14,1260,3470,1443,-2027
2018,1,18,15,1323,3890,1444,-2446
2018,1,18,16,1433,4204,1635,-2569
2018,1,18,17,1542,4165,1701,-2464
2018,1,18,18,1449,4088,1595,-2493
2018,1,18,19,1398,4057,1547,-2510
2018,1,18,20,1361,4006,1492,-2514
2018,1,18,21,1353,4013,1482,-2531
2018,1,18,22,1344,4009,1427,-2582
2018,1,18,23,1334,4011,1434,-2577
2018,1,19,0,1416,4098,1434,-2664
2018,1,19,1,1321,4329,1531,-2798
2018,1,19,2,1384,4537,1602,-2935
2018,1,19,3,1379,4567,1685,-2882
2018,1,19,4,1325,4499,1634,-2865
2018,1,19,5,1225,4373,1688,-2685
2018,1,19,6,981,4127,1756,-2371
2018,1,19,7,1480,3846,1831,-2015
2018,1,19,8,1134,3574,1774,-1800
2018,1,19,9,1443,3438,1671,-1767
2018,1,19,10,1413,3366,1663,-1703
2018,1,19,11,1339,3355,1584,-1771
2018,1,19,12,1260,3433,1544,-1889
2018,1,19,13,1292,3518,1511,-2007
2018,1,19,14,1421,3862,1563,-2299
2018,1,19,15,1370,4241,1483,-2758
2018,1,19,16,1322,4497,1542,-2955
2018,1,19,17,1446,4452,1529,-2923
2018,1,19,18,1366,4382,1525,-2857
2018,1,19,19,1376,4320,1556,-2764
2018,1,19,20,1300,4282,1528,-2754
2018,1,19,21,1298,4314,1637,-2677
2018,1,19,22,1296,4309,1674,-2635
2018,1,19,23,1294,4311,1620,-2691
2018,1,20,0,1294,4336,1615,-2721
2018,1,20,1,1317,4442,1628,-2814
2018,1,20,2,1482,4605,1657,-2948
2018,1,20,3,1462,4527,1651,-2876
2018,1,20,4,1329,4391,1570,-2821
2018,1,20,5,1186,4234,1595,-2639
2018,1,20,6,1126,4041,1657,-2384
2018,1,20,7,1725,3806,1703,-2103
2018,1,20,8,1498,3578,1720,-1858
2018,1,20,9,1408,3394,1623,-1771
2018,1,20,10,1269,3273,1482,-1791
2018,1,20,11,1234,3233,1383,-1850
2018,1,20,12,1240,3220,1390,-1830
2018,1,20,13,1348,3313,1501,-1812
2018,1,20,14,1367,3482,1510,-1972
2018,1,20,15,1365,3714,1568,-2146
2018,1,20,16,1233,3946,1603,-2343
2018,1,20,17,1394,4065,1661,-2404
2018,1,20,18,1486,4208,1702,-2506
2018,1,20,19,1488,4232,1641,-2591
2018,1,20,20,1429,4218,1620,-2598
2018,1,20,21,1373,4179,1599,-2580
2018,1,20,22,1361,4138,1579,-2559
2018,1,20,23,1352,4081,1473,-2608
2018,1,21,0,1422,4116,1525,-2591
2018,1,21,1,1417,4236,1510,-2726
2018,1,21,2,1590,4408,1508,-2900
2018,1,21,3,1584,4341,1451,-2890
2018,1,21,4,1487,4224,1537,-2687
2018,1,21,5,1461,4131,1588,-2543
2018,1,21,6,1212,3935,1562,-2373
2018,1,21,7,1816,3748,1584,-2164
2018,1,21,8,1620,3530,1661,-1869
2018,1,21,9,1439,3357,1663,-1694
2018,1,21,10,1451,3240,1624,-1616
2018,1,21,11,1433,3187,1648,-1539
2018,1,21,12,1460,3178,1613,-1565
2018,1,21,13,1430,3215,1601,-1614
2018,1,21,14,1430,3316,1576,-1740
2018,1,21,15,1277,3473,1406,-2067
2018,1,21,16,1085,3703,1520,-2183
2018,1,21,17,1419,3891,1638,-2253
2018,1,21,18,1419,4032,1646,-2386
2018,1,21,19,1465,4121,1638,-2483
2018,1,21,20,1465,4155,1661,-2494
2018,1,21,21,1466,4147,1616,-2531
2018,1,21,22,1366,4024,1526,-2498
2018,1,21,23,1306,4002,1598,-2404
2018,1,22,0,1474,4056,1520,-2536
2018,1,22,1,1423,4293,1637,-2656
2018,1,22,2,1558,4470,1693,-2777
2018,1,22,3,1530,4472,1604,-2868
2018,1,22,4,1461,4401,1613,-2788
2018,1,22,5,1476,4274,1636,-2638
2018,1,22,6,1240,4053,1692,-2361
2018,1,22,7,1594,3756,1682,-2074
2018,1,22,8,1373,3493,1567,-1926
2018,1,22,9,1234,3352,1535,-1817
2018,1,22,10,1191,3273,1531,-1742
2018,1,22,11,1182,3259,1566,-1693
2018,1,22,12,1311,3320,1572,-1748
2018,1,22,13,1297,3488,1635,-1853
2018,1,22,14,1410,3830,1638,-2192
2018,1,22,15,1332,4240,1656,-2584
2018,1,22,16,1456,4513,1736,-2777
2018,1,22,17,1510,4385,1348,-3037
2018,1,22,18,1530,4407,1427,-2980
2018,1,22,19,1543,4338,1675,-2663
2018,1,22,20,1557,4232,1713,-2519
2018,1,22,21,1564,4207,1734,-2473
2018,1,22,22,1471,4175,1754,-2421
2018,1,22,23,1337,4134,1706,-2428
2018,1,23,0,1545,4161,1548,-2613
2018,1,23,1,1499,4289,1615,-2674
2018,1,23,2,1511,4626,1651,-2975
2018,1,23,3,1503,4658,1521,-3137
2018,1,23,4,1550,4588,1547,-3041
2018,1,23,5,1640,4456,1549,-2907
2018,1,23,6,1596,4204,1536,-2668
2018,1,23,7,2016,3896,1576,-2320
2018,1,23,8,1681,3614,1496,-2118
2018,1,23,9,1181,3466,1535,-1931
2018,1,23,10,1093,3420,1531,-1889
2018,1,23,11,1205,3406,1504,-1902
2018,1,23,12,1205,3453,1497,-1956
2018,1,23,13,1260,3632,1474,-2158
2018,1,23,14,1322,3941,1501,-2440
2018,1,23,15,1321,4309,1509,-2800
2018,1,23,16,1322,4591,1572,-3019
2018,1,23,17,1338,4545,1539,-3006
2018,1,23,18,1396,4467,1513,-2954
2018,1,23,19,1341,4452,1469,-2983
2018,1,23,20,1341,4454,1478,-2976
2018,1,23,21,1340,4424,1486,-2938
2018,1,23,22,1199,4428,1489,-2939
2018,1,23,23,1094,4412,1492,-2920
2018,1,24,0,1139,4453,1495,-2958
2018,1,24,1,1217,4581,1488,-3093
2018,1,24,2,1417,4739,1590,-3149
2018,1,24,3,1409,4685,1588,-3097
2018,1,24,4,1337,4576,1588,-2988
2018,1,24,5,1228,4397,1580,-2817
2018,1,24,6,1017,4093,1376,-2717
2018,1,24,7,1324,3824,1603,-2221
2018,1,24,8,1017,3559,1603,-1956
2018,1,24,9,1246,3408,1534,-1874
2018,1,24,10,1276,3309,1499,-1810
2018,1,24,11,1210,3267,1524,-1743
2018,1,24,12,1266,3300,1549,-1751
2018,1,24,13,1287,3438,1535,-1903
2018,1,24,14,1404,3701,1597,-2104
2018,1,24,15,1175,4078,1540,-2538
2018,1,24,16,1364,4310,1525,-2785
2018,1,24,17,1412,4273,1541,-2732
2018,1,24,18,1362,4239,1593,-2646
2018,1,24,19,1359,4211,1592,-2619
2018,1,24,20,1356,4168,1597,-2571
2018,1,24,21,1355,4168,1586,-2582
2018,1,24,22,1362,4124,1550,-2574
2018,1,24,23,1219,4148,1570,-2578
2018,1,25,0,1260,4149,1582,-2567
2018,1,25,1,1399,4278,1554,-2724
2018,1,25,2,1591,4487,1519,-2968
2018,1,25,3,1583,4502,1522,-2980
2018,1,25,4,1511,4480,1574,-2906
2018,1,25,5,1403,4339,1547,-2792
2018,1,25,6,1136,4085,1548,-2537
2018,1,25,7,1438,3824,1610,-2214
2018,1,25,8,1280,3606,1557,-2049
2018,1,25,9,1152,3336,1447,-1889
2018,1,25,10,1144,3366,1553,-1813
2018,1,25,11,1217,3280,1570,-1710
2018,1,25,12,1298,3363,1625,-1738
2018,1,25,13,1353,3603,1571,-2032
2018,1,25,14,1527,3977,1528,-2449
2018,1,25,15,1431,4366,1449,-2917
2018,1,25,16,1425,4636,1529,-3107
2018,1,25,17,1399,4620,1541,-3079
2018,1,25,18,1442,4569,1509,-3060
2018,1,25,19,1398,4541,1513,-3028
2018,1,25,20,1326,4476,1487,-2989
2018,1,25,21,1319,4424,1444,-2980
2018,1,25,22,1211,4152,1143,-3009
2018,1,25,23,1267,4069,1156,-2913
2018,1,26,0,1278,4083,1087,-2996
2018,1,26,1,1365,4517,1535,-2982
2018,1,26,2,1429,4777,1704,-3073
2018,1,26,3,1387,4753,1629,-3124
2018,1,26,4,1244,4678,1591,-3087
2018,1,26,5,1107,4552,1617,-2935
2018,1,26,6,1064,4303,1479,-2824
2018,1,26,7,1268,3992,1564,-2428
2018,1,26,8,1145,3721,1558,-2163
2018,1,26,9,1250,3538,1536,-2002
2018,1,26,10,1313,3457,1606,-1851
2018,1,26,11,1340,3439,1634,-1805
2018,1,26,12,1398,3511,1597,-1914
2018,1,26,13,1326,3676,1597,-2079
2018,1,26,14,1435,4002,1742,-2260
2018,1,26,15,1258,4394,1717,-2677
2018,1,26,16,1429,4614,1705,-2909
2018,1,26,17,1419,4620,1696,-2924
2018,1,26,18,1407,4565,1622,-2943
2018,1,26,19,1396,4535,1592,-2943
2018,1,26,20,1387,4494,1599,-2895
2018,1,26,21,1244,4453,1616,-2837
2018,1,26,22,1103,4397,1642,-2755
2018,1,26,23,1145,4364,1637,-2727
2018,1,27,0,1227,4359,1530,-2829
2018,1,27,1,1175,4485,1552,-2933
2018,1,27,2,1441,4626,1536,-3090
2018,1,27,3,1448,4539,1423,-3116
2018,1,27,4,1365,4478,1534,-2944
2018,1,27,5,1258,4326,1614,-2712
2018,1,27,6,1086,4120,1657,-2463
2018,1,27,7,1764,3912,1669,-2243
2018,1,27,8,1556,3657,1600,-2057
2018,1,27,9,1291,3512,1626,-1886
2018,1,27,10,1371,3408,1623,-1785
2018,1,27,11,1314,3339,1542,-1797
2018,1,27,12,1309,3347,1542,-1805
2018,1,27,13,1231,3389,1520,-1869
2018,1,27,14,1335,3537,1518,-2019
2018,1,27,15,1282,3722,1514,-2208
2018,1,27,16,1308,3900,1499,-2401
2018,1,27,17,1421,4069,1507,-2562
2018,1,27,18,1452,4184,1562,-2622
2018,1,27,19,1416,4199,1673,-2526
2018,1,27,20,1427,4249,1831,-2418
2018,1,27,21,1316,4186,1870,-2316
2018,1,27,22,1161,4045,1808,-2237
2018,1,27,23,1143,3946,1697,-2249
2018,1,28,0,1128,3891,1634,-2257
2018,1,28,1,1192,4021,1634,-2387
2018,1,28,2,1388,4175,1611,-2564
2018,1,28,3,1363,4117,1614,-2503
2018,1,28,4,1271,4004,1647,-2357
2018,1,28,5,1174,3897,1665,-2232
2018,1,28,6,1154,3745,1655,-2090
2018,1,28,7,1330,3546,1656,-1890
2018,1,28,8,1162,3335,1511,-1824
2018,1,28,9,1168,3183,1418,-1765
2018,1,28,10,1177,3056,1370,-1686
2018,1,28,11,1174,2981,1346,-1635
2018,1,28,12,1146,2954,1299,-1655
2018,1,28,13,1147,3014,1310,-1704
2018,1,28,14,1176,3145,1306,-1839
2018,1,28,15,1172,3266,1089,-2177
2018,1,28,16,958,3556,1369,-2187
2018,1,28,17,1207,3734,1403,-2331
2018,1,28,18,1234,3831,1300,-2531
2018,1,28,19,1255,3881,1286,-2595
2018,1,28,20,1223,3894,1337,-2557
2018,1,28,21,1225,3900,1385,-2515
2018,1,28,22,1109,3840,1381,-2459
2018,1,28,23,1231,3741,1366,-2375
2018,1,29,0,1131,3754,1405,-2349
2018,1,29,1,1233,3850,1428,-2422
2018,1,29,2,1234,4054,1439,-2615
2018,1,29,3,1205,4057,1431,-2626
2018,1,29,4,1124,3975,1416,-2559
2018,1,29,5,982,3834,1429,-2405
2018,1,29,6,1143,3656,1421,-2235
2018,1,29,7,1545,3389,1421,-1968
2018,1,29,8,1350,3149,1411,-1738
2018,1,29,9,1056,2997,1411,-1586
2018,1,29,10,1110,2903,1428,-1475
2018,1,29,11,1107,2874,1448,-1426
2018,1,29,12,1214,2910,1448,-1462
2018,1,29,13,1183,3077,1480,-1597
2018,1,29,14,1266,3404,1468,-1936
2018,1,29,15,1245,3747,1455,-2292
2018,1,29,16,1346,3996,1466,-2530
2018,1,29,17,1331,4013,1507,-2506
2018,1,29,18,1327,3937,1446,-2491
2018,1,29,19,1354,3946,1449,-2497
2018,1,29,20,1324,3942,1494,-2448
2018,1,29,21,1303,3972,1561,-2411
2018,1,29,22,1296,3984,1547,-2437
2018,1,29,23,1314,3995,1553,-2442
2018,1,30,0,1334,4073,1581,-2492
2018,1,30,1,1458,4115,1330,-2785
2018,1,30,2,1617,4302,1487,-2815
2018,1,30,3,1573,4315,1735,-2580
2018,1,30,4,1391,4218,1657,-2561
2018,1,30,5,1307,4159,1545,-2614
2018,1,30,6,1102,3862,1600,-2262
2018,1,30,7,1258,3502,1616,-1886
2018,1,30,8,1121,3202,1356,-1846
2018,1,30,9,1375,3047,1420,-1627
2018,1,30,10,1351,3006,1501,-1505
2018,1,30,11,1363,2997,1551,-1446
2018,1,30,12,1376,3145,1663,-1482
2018,1,30,13,1407,3344,1753,-1591
2018,1,30,14,1479,3632,1648,-1984
2018,1,30,15,1482,4054,1591,-2463
2018,1,30,16,1608,4372,1715,-2657
2018,1,30,17,1624,4324,1699,-2625
2018,1,30,18,1623,4228,1685,-2543
2018,1,30,19,1569,4126,1641,-2485
2018,1,30,20,1521,4039,1619,-2420
2018,1,30,21,1493,3906,1545,-2361
2018,1,30,22,1488,3952,1619,-2333
2018,1,30,23,1497,3935,1641,-2294
2018,1,31,0,1569,3967,1640,-2327
2018,1,31,1,1686,4112,1765,-2347
2018,1,31,2,1809,4408,1752,-2656
2018,1,31,3,1844,4475,1748,-2727
2018,1,31,4,1752,4420,1769,-2651
2018,1,31,5,1622,4297,1778,-2519
2018,1,31,6,1639,4115,1850,-2265
2018,1,31,7,1894,3788,1816,-1972
2018,1,31,8,1619,3530,1751,-1779
2018,1,31,9,1319,3347,1653,-1694
2018,1,31,10,1294,3271,1580,-1691
2018,1,31,11,1296,3241,1570,-1671
2018,1,31,12,1369,3304,1611,-1693
2018,1,31,13,1341,3475,1606,-1869
2018,1,31,14,1607,3842,1549,-2293
2018,1,31,15,1486,4263,1442,-2821
2018,1,31,16,1705,4583,1683,-2900
2018,1,31,17,1629,4540,1650,-2890
2018,1,31,18,1539,4416,1533,-2883
2018,1,31,19,1451,4342,1558,-2784
2018,1,31,20,1432,4327,1676,-2651
2018,1,31,21,1415,4276,1680,-2596
2018,1,31,22,1403,4218,1670,-2548
2018,1,31,23,1393,4242,1683,-2559
2018,2,1,0,1415,4260,1644,-2616
2018,2,1,1,1405,4380,1597,-2783
2018,2,1,2,1545,4585,1551,-3034
2018,2,1,3,1599,4619,1530,-3089
2018,2,1,4,1518,4506,1511,-2995
2018,2,1,5,1456,4372,1516,-2856
2018,2,1,6,1157,4131,1534,-2597
2018,2,1,7,1641,3839,1682,-2157
2018,2,1,8,1574,3571,1695,-1876
2018,2,1,9,1227,3410,1712,-1698
2018,2,1,10,1209,3320,1616,-1704
2018,2,1,11,1218,3266,1587,-1679
2018,2,1,12,1307,3310,1600,-1710
2018,2,1,13,1246,3459,1627,-1832
2018,2,1,14,1348,3780,1602,-2178
2018,2,1,15,1310,4152,1525,-2627
2018,2,1,16,1327,4382,1534,-2848
2018,2,1,17,1182,4345,1511,-2834
2018,2,1,18,1298,4278,1552,-2726
2018,2,1,19,1340,4245,1548,-2697
2018,2,1,20,1277,4214,1546,-2668
2018,2,1,21,1229,4146,1502,-2644
2018,2,1,22,1187,4121,1493,-2628
2018,2,1,23,1172,4119,1469,-2650
2018,2,2,0,1229,4177,1476,-2701
2018,2,2,1,1150,4318,1484,-2834
2018,2,2,2,1383,4532,1488,-3044
2018,2,2,3,1406,4545,1487,-3058
2018,2,2,4,1318,4431,1502,-2929
2018,2,2,5,1170,4339,1540,-2799
2018,2,2,6,1127,4086,1543,-2543
2018,2,2,7,1368,3786,1578,-2208
2018,2,2,8,1257,3513,1607,-1906
2018,2,2,9,1403,3336,1613,-1723
2018,2,2,10,1362,3253,1538,-1715
2018,2,2,11,1379,3203,1636,-1567
2018,2,2,12,1266,3217,1684,-1533
2018,2,2,13,1451,3354,1705,-1649
2018,2,2,14,1605,3639,1689,-1950
2018,2,2,15,1446,4021,1716,-2305
2018,2,2,16,1783,4234,1647,-2587
2018,2,2,17,1680,4239,1612,-2627
2018,2,2,18,1594,4167,1597,-2570
2018,2,2,19,1425,4141,1643,-2498
2018,2,2,20,1334,4095,1743,-2352
2018,2,2,21,1275,3883,1693,-2190
2018,2,2,22,1279,3695,1582,-2113
2018,2,2,23,1301,3617,1557,-2060
2018,2,3,0,1283,3696,1587,-2109
2018,2,3,1,1311,3858,1546,-2312
2018,2,3,2,1525,4201,1704,-2497
2018,2,3,3,1548,4198,1798,-2400
2018,2,3,4,1449,4129,1843,-2286
2018,2,3,5,1347,3812,1619,-2193
2018,2,3,6,1344,3546,1518,-2028
2018,2,3,7,1691,3317,1543,-1774
2018,2,3,8,1452,2988,1429,-1559
2018,2,3,9,1148,2804,1396,-1408
2018,2,3,10,1099,2718,1343,-1375
2018,2,3,11,1043,2672,1263,-1409
2018,2,3,12,1007,2671,1220,-1451
2018,2,3,13,944,2697,1231,-1466
2018,2,3,14,997,2787,1290,-1497
2018,2,3,15,973,2977,1391,-1586
2018,2,3,16,1426,3221,1432,-1789
2018,2,3,17,1351,3371,1396,-1975
2018,2,3,18,1468,3636,1609,-2027
2018,2,3,19,1411,3468,1442,-2026
2018,2,3,20,1381,3366,1352,-2014
2018,2,3,21,1395,3405,1414,-1991
2018,2,3,22,1395,3319,1323,-1996
2018,2,3,23,1383,3340,1362,-1978
2018,2,4,0,1372,3412,1451,-1961
2018,2,4,1,1380,3567,1541,-2026
2018,2,4,2,1552,4025,1865,-2160
2018,2,4,3,1549,4054,1883,-2171
2018,2,4,4,1450,3665,1586,-2079
2018,2,4,5,1393,3452,1448,-2004
2018,2,4,6,1405,3265,1403,-1862
2018,2,4,7,1532,3154,1514,-1640
2018,2,4,8,1394,2878,1448,-1430
2018,2,4,9,1113,2720,1405,-1315
2018,2,4,10,1033,2620,1345,-1275
2018,2,4,11,913,2569,1281,-1288
2018,2,4,12,911,2542,1232,-1310
2018,2,4,13,974,2546,1281,-1265
2018,2,4,14,1111,2633,1297,-1336
2018,2,4,15,1053,2745,1376,-1369
2018,2,4,16,1344,3103,1581,-1522
2018,2,4,17,1421,3226,1470,-1756
2018,2,4,18,1554,3402,1503,-1899
2018,2,4,19,1611,3418,1460,-1958
2018,2,4,20,1605,3516,1548,-1968
2018,2,4,21,1586,3536,1583,-1953
2018,2,4,22,1545,3431,1499,-1932
2018,2,4,23,1521,3367,1548,-1819
2018,2,5,0,1509,3270,1556,-1714
2018,2,5,1,1602,3441,1707,-1734
2018,2,5,2,1795,3791,1871,-1920
2018,2,5,3,1808,3799,1845,-1954
2018,2,5,4,1752,3952,1994,-1958
2018,2,5,5,1664,3948,1960,-1988
2018,2,5,6,1472,3559,1675,-1884
2018,2,5,7,1384,3235,1576,-1659
2018,2,5,8,1294,2774,1216,-1558
2018,2,5,9,884,2635,1186,-1449
2018,2,5,10,939,2571,1187,-1384
2018,2,5,11,923,2542,1246,-1296
2018,2,5,12,1044,2575,1334,-1241
2018,2,5,13,1088,2788,1415,-1373
2018,2,5,14,1541,3559,1936,-1623
2018,2,5,15,1563,3939,1942,-1997
2018,2,5,16,1624,4180,2028,-2152
2018,2,5,17,1598,4162,2090,-2072
2018,2,5,18,1633,4131,2129,-2002
2018,2,5,19,1691,4124,2091,-2033
2018,2,5,20,1676,4089,2111,-1978
2018,2,5,21,1670,4009,2098,-1911
2018,2,5,22,1645,4027,2141,-1886
2018,2,5,23,1633,3955,2085,-1870
2018,2,6,0,1656,4039,2103,-1936
2018,2,6,1,1655,4144,2060,-2084
2018,2,6,2,1836,4355,2107,-2248
2018,2,6,3,1890,4392,2042,-2350
2018,2,6,4,1777,4356,1923,-2433
2018,2,6,5,1609,4207,1875,-2332
2018,2,6,6,1496,3971,1865,-2106
2018,2,6,7,1663,3656,1883,-1773
2018,2,6,8,1414,2962,1430,-1532
2018,2,6,9,1035,2791,1343,-1448
2018,2,6,10,996,2697,1342,-1355
2018,2,6,11,988,2672,1324,-1348
2018,2,6,12,983,2717,1311,-1406
2018,2,6,13,1443,2892,1382,-1510
2018,2,6,14,1522,3433,1578,-1855
2018,2,6,15,1358,4012,1714,-2298
2018,2,6,16,1620,4260,1768,-2492
2018,2,6,17,1609,4218,1771,-2447
2018,2,6,18,1563,4169,1760,-2409
2018,2,6,19,1503,4127,1676,-2451
2018,2,6,20,1438,4085,1738,-2347
2018,2,6,21,1415,4025,1770,-2255
2018,2,6,22,1379,4012,1712,-2300
2018,2,6,23,1358,3894,1682,-2212
2018,2,7,0,1429,3907,1709,-2198
2018,2,7,1,1433,4151,1863,-2288
2018,2,7,2,1687,4361,1873,-2488
2018,2,7,3,1742,4384,1881,-2503
2018,2,7,4,1676,4350,1871,-2479
2018,2,7,5,1515,4201,1875,-2326
2018,2,7,6,1427,3639,1539,-2100
2018,2,7,7,1690,3222,1453,-1769
2018,2,7,8,1402,2922,1372,-1550
2018,2,7,9,965,2765,1388,-1377
2018,2,7,10,977,2684,1386,-1298
2018,2,7,11,957,2652,1372,-1280
2018,2,7,12,1004,2684,1361,-1323
2018,2,7,13,1101,2932,1472,-1460
2018,2,7,14,1401,3555,1775,-1780
2018,2,7,15,1403,3978,1803,-2175
2018,2,7,16,1590,4195,1861,-2334
2018,2,7,17,1527,4164,1796,-2368
2018,2,7,18,1448,4110,1788,-2322
2018,2,7,19,1374,4056,1782,-2274
2018,2,7,20,1311,3896,1675,-2221
2018,2,7,21,1273,3803,1638,-2165
2018,2,7,22,1241,3724,1606,-2118
2018,2,7,23,1240,3653,1556,-2097
2018,2,8,0,1233,3708,1544,-2164
2018,2,8,1,1225,3980,1626,-2354
2018,2,8,2,1451,4218,1661,-2557
2018,2,8,3,1537,4264,1731,-2533
2018,2,8,4,1453,4197,1780,-2417
2018,2,8,5,1333,4078,1716,-2362
2018,2,8,6,1244,3566,1400,-2166
2018,2,8,7,1454,3249,1414,-1835
2018,2,8,8,1197,2875,1288,-1587
2018,2,8,9,1000,2716,1292,-1424
2018,2,8,10,952,2655,1305,-1350
2018,2,8,11,960,2615,1299,-1316
2018,2,8,12,976,2651,1331,-1320
2018,2,8,13,1053,2943,1436,-1507
2018,2,8,14,1305,3410,1618,-1792
2018,2,8,15,1334,3907,1713,-2194
2018,2,8,16,1552,4119,1661,-2458
2018,2,8,17,1511,4118,1639,-2479
2018,2,8,18,1447,4064,1676,-2388
2018,2,8,19,1411,4009,1673,-2336
2018,2,8,20,1372,3837,1601,-2236
2018,2,8,21,1344,3779,1603,-2176
2018,2,8,22,1305,3733,1591,-2142
2018,2,8,23,1295,3675,1544,-2131
2018,2,9,0,1283,3698,1555,-2143
2018,2,9,1,1327,3999,1746,-2253
2018,2,9,2,1516,4260,1736,-2524
2018,2,9,3,1535,4336,1765,-2571
2018,2,9,4,1495,4268,1766,-2502
2018,2,9,5,1461,4180,1783,-2397
2018,2,9,6,1310,3967,1671,-2296
2018,2,9,7,1417,3548,1614,-1934
2018,2,9,8,1367,3129,1452,-1677
2018,2,9,9,907,2838,1266,-1572
2018,2,9,10,839,2746,1250,-1496
2018,2,9,11,927,2749,1286,-1463
2018,2,9,12,916,2801,1256,-1545
2018,2,9,13,1099,3224,1462,-1762
2018,2,9,14,1250,3729,1627,-2102
2018,2,9,15,1247,4150,1594,-2556
2018,2,9,16,1226,4394,1540,-2854
2018,2,9,17,1226,4386,1496,-2890
2018,2,9,18,1477,4305,1493,-2812
2018,2,9,19,1218,4239,1499,-2740
2018,2,9,20,1180,4125,1477,-2648
2018,2,9,21,1177,4083,1508,-2575
2018,2,9,22,1174,4012,1508,-2504
2018,2,9,23,1165,3963,1523,-2440
2018,2,10,0,1161,3986,1520,-2466
2018,2,10,1,1220,4097,1527,-2570
2018,2,10,2,1304,4337,1543,-2794
2018,2,10,3,1377,4385,1546,-2839
2018,2,10,4,1294,4286,1560,-2726
2018,2,10,5,1280,4195,1591,-2604
2018,2,10,6,1293,4023,1591,-2432
2018,2,10,7,1683,3823,1616,-2207
2018,2,10,8,1474,3605,1575,-2030
2018,2,10,9,1231,3460,1567,-1893
2018,2,10,10,1204,3421,1516,-1905
2018,2,10,11,1218,3392,1505,-1887
2018,2,10,12,1260,3449,1518,-1931
2018,2,10,13,1264,3552,1534,-2018
2018,2,10,14,1234,3717,1522,-2195
2018,2,10,15,1221,3969,1468,-2501
2018,2,10,16,1238,4174,1413,-2761
2018,2,10,17,1288,4320,1354,-2966
2018,2,10,18,1388,4329,1377,-2952
2018,2,10,19,1253,4165,1305,-2860
2018,2,10,20,1254,4175,1474,-2701
2018,2,10,21,1264,3971,1356,-2615
2018,2,10,22,1175,3728,1241,-2487
2018,2,10,23,1179,3625,1264,-2361
2018,2,11,0,1196,3649,1360,-2289
2018,2,11,1,1306,3876,1502,-2374
2018,2,11,2,1355,4251,1716,-2535
2018,2,11,3,1459,4400,1718,-2682
2018,2,11,4,1438,4345,1744,-2601
2018,2,11,5,1424,4281,1752,-2529
2018,2,11,6,1446,4135,1832,-2303
2018,2,11,7,1811,3919,1692,-2227
2018,2,11,8,1619,3720,1728,-1992
2018,2,11,9,1313,3403,1514,-1889
2018,2,11,10,1268,3315,1392,-1923
2018,2,11,11,1193,3295,1467,-1828
2018,2,11,12,1271,3506,1630,-1876
2018,2,11,13,1295,3574,1603,-1971
2018,2,11,14,1409,3694,1569,-2125
2018,2,11,15,1141,3906,1565,-2341
2018,2,11,16,1315,4149,1576,-2573
2018,2,11,17,1499,4328,1601,-2727
2018,2,11,18,1564,4384,1664,-2720
2018,2,11,19,1534,4287,1730,-2557
2018,2,11,20,1432,4176,1693,-2483
2018,2,11,21,1339,4115,1648,-2467
2018,2,11,22,1257,4059,1731,-2328
2018,2,11,23,1228,4044,1713,-2331
2018,2,12,0,1250,4075,1680,-2395
2018,2,12,1,1262,4188,1700,-2488
2018,2,12,2,1377,4428,1770,-2658
2018,2,12,3,1476,4580,1842,-2738
2018,2,12,4,1458,4523,1898,-2625
2018,2,12,5,1422,4440,1934,-2506
2018,2,12,6,1400,4202,1900,-2302
2018,2,12,7,1622,3895,1921,-1974
2018,2,12,8,1434,3530,1801,-1729
2018,2,12,9,1401,3361,1748,-1613
2018,2,12,10,1310,3226,1578,-1648
2018,2,12,11,1358,3288,1673,-1615
2018,2,12,12,1508,3287,1716,-1571
2018,2,12,13,1824,3694,2029,-1665
2018,2,12,14,2080,4231,2321,-1910
2018,2,12,15,1999,4705,2313,-2392
2018,2,12,16,2150,4952,2197,-2755
2018,2,12,17,2007,4886,2252,-2634
2018,2,12,18,1877,4698,2317,-2381
2018,2,12,19,1765,4536,2226,-2310
2018,2,12,20,1663,4393,1976,-2417
2018,2,12,21,1583,4282,1983,-2299
2018,2,12,22,1504,4180,2011,-2169
2018,2,12,23,1494,4095,1979,-2116
2018,2,13,0,1481,4100,1861,-2239
2018,2,13,1,1609,4216,1999,-2217
2018,2,13,2,1898,4501,2075,-2426
2018,2,13,3,2066,4766,2166,-2600
2018,2,13,4,2043,4752,2184,-2568
2018,2,13,5,1896,4672,2174,-2498
2018,2,13,6,1653,4449,2085,-2364
2018,2,13,7,1790,4146,2053,-2093
2018,2,13,8,1640,3892,2028,-1864
2018,2,13,9,1681,3776,2018,-1758
2018,2,13,10,1679,3740,2009,-1731
2018,2,13,11,1715,3762,2080,-1682
2018,2,13,12,1798,3848,2113,-1735
2018,2,13,13,1998,4039,2140,-1899
2018,2,13,14,2168,4432,2272,-2160
2018,2,13,15,1989,4876,2260,-2616
2018,2,13,16,2092,5104,2361,-2743
2018,2,13,17,1952,4986,2312,-2674
2018,2,13,18,1916,4775,2263,-2512
2018,2,13,19,1890,4577,2236,-2341
2018,2,13,20,1729,4404,2122,-2282
2018,2,13,21,1596,4322,2001,-2321
2018,2,13,22,1488,4203,1901,-2302
2018,2,13,23,1420,4122,1928,-2194
2018,2,14,0,1434,4087,1889,-2198
2018,2,14,1,1551,4228,1891,-2337
2018,2,14,2,1820,4491,2114,-2377
2018,2,14,3,1977,4558,2149,-2409
2018,2,14,4,1926,4484,2103,-2381
2018,2,14,5,1821,4367,2132,-2235
2018,2,14,6,1682,4141,2101,-2040
2018,2,14,7,1856,3861,2077,-1784
2018,2,14,8,1596,3597,1827,-1770
2018,2,14,9,1400,3469,1526,-1943
2018,2,14,10,1230,3406,1502,-1904
2018,2,14,11,1265,3399,1552,-1847
2018,2,14,12,1284,3468,1593,-1875
2018,2,14,13,1395,3642,1689,-1953
2018,2,14,14,1517,4016,1881,-2135
2018,2,14,15,1487,4359,1802,-2557
2018,2,14,16,1542,4613,1886,-2727
2018,2,14,17,1479,4541,1760,-2781
2018,2,14,18,1470,4468,1798,-2670
2018,2,14,19,1296,4414,1615,-2799
2018,2,14,20,1327,4350,1627,-2723
2018,2,14,21,1274,4307,1515,-2792
2018,2,14,22,1262,4256,1484,-2772
2018,2,14,23,1267,4241,1516,-2725
2018,2,15,0,1353,4246,1510,-2736
2018,2,15,1,1354,4321,1483,-2838
2018,2,15,2,1634,4529,1610,-2919
2018,2,15,3,1789,4623,1735,-2888
2018,2,15,4,1724,4540,1807,-2733
2018,2,15,5,1639,4403,1776,-2627
2018,2,15,6,1404,4151,1806,-2345
2018,2,15,7,1777,3881,1811,-2070
2018,2,15,8,1526,3611,1647,-1964
2018,2,15,9,1174,3235,1331,-1904
2018,2,15,10,1135,3061,1280,-1781
2018,2,15,11,1063,3014,1220,-1794
2018,2,15,12,1265,3175,1340,-1835
2018,2,15,13,1251,3358,1378,-1980
2018,2,15,14,1663,3969,1827,-2142
2018,2,15,15,1541,4404,1872,-2532
2018,2,15,16,1780,4577,1816,-2761
2018,2,15,17,1709,4526,1823,-2703
2018,2,15,18,1618,4419,1766,-2653
2018,2,15,19,1542,4321,1587,-2734
2018,2,15,20,1450,4206,1488,-2718
2018,2,15,21,1385,4138,1509,-2629
2018,2,15,22,1328,4103,1542,-2561
2018,2,15,23,1298,4065,1501,-2564
2018,2,16,0,1351,4165,1571,-2594
2018,2,16,1,1463,4308,1697,-2611
2018,2,16,2,1696,4511,1831,-2680
2018,2,16,3,1800,4565,1868,-2697
2018,2,16,4,1681,4491,1954,-2537
2018,2,16,5,1486,4372,1776,-2596
2018,2,16,6,1274,4016,1475,-2541
2018,2,16,7,1275,3708,1544,-2164
2018,2,16,8,1344,3327,1453,-1874
2018,2,16,9,1107,3131,1381,-1750
2018,2,16,10,987,2961,1289,-1672
2018,2,16,11,962,2934,1151,-1783
2018,2,16,12,875,2981,1015,-1966
2018,2,16,13,1028,3358,1239,-2119
2018,2,16,14,1215,3808,1400,-2408
2018,2,16,15,1351,4233,1477,-2756
2018,2,16,16,1391,4455,1465,-2990
2018,2,16,17,1367,4478,1518,-2960
2018,2,16,18,1405,4459,1576,-2883
2018,2,16,19,1358,4433,1694,-2739
2018,2,16,20,1363,4376,1728,-2648
2018,2,16,21,1315,4215,1657,-2558
2018,2,16,22,1315,4127,1586,-2541
2018,2,16,23,1317,4019,1485,-2534
2018,2,17,0,1314,4020,1492,-2528
2018,2,17,1,1313,4159,1567,-2592
2018,2,17,2,1320,4384,1673,-2711
2018,2,17,3,1422,4424,1687,-2737
2018,2,17,4,1325,4314,1651,-2663
2018,2,17,5,1287,4167,1665,-2502
2018,2,17,6,1273,3985,1578,-2407
2018,2,17,7,1428,3741,1555,-2186
2018,2,17,8,1256,3370,1397,-1973
2018,2,17,9,1117,3200,1355,-1845
2018,2,17,10,1058,3041,1271,-1770
2018,2,17,11,1001,3017,1268,-1749
2018,2,17,12,1143,3183,1398,-1785
2018,2,17,13,1204,3286,1404,-1882
2018,2,17,14,1197,3450,1416,-2034
2018,2,17,15,1226,3645,1405,-2240
2018,2,17,16,1253,3871,1428,-2443
2018,2,17,17,1528,4096,1504,-2592
2018,2,17,18,1627,4248,1577,-2671
2018,2,17,19,1405,4240,1612,-2628
2018,2,17,20,1380,4166,1703,-2463
2018,2,17,21,1338,4054,1705,-2349
2018,2,17,22,1299,3705,1491,-2214
2018,2,17,23,1270,3567,1455,-2112
2018,2,18,0,1293,3365,1318,-2047
2018,2,18,1,1393,3730,1611,-2119
2018,2,18,2,1542,4114,1845,-2269
2018,2,18,3,1619,4231,1802,-2429
2018,2,18,4,1529,4183,1774,-2409
2018,2,18,5,1416,4107,1776,-2331
2018,2,18,6,1312,4007,1778,-2229
2018,2,18,7,1422,3824,1783,-2041
2018,2,18,8,1340,3494,1637,-1857
2018,2,18,9,936,3070,1321,-1749
2018,2,18,10,938,2983,1196,-1787
2018,2,18,11,886,2971,1219,-1752
2018,2,18,12,836,2993,1233,-1760
2018,2,18,13,960,3087,1283,-1804
2018,2,18,14,1032,3432,1451,-1981
2018,2,18,15,1207,3810,1509,-2301
2018,2,18,16,1213,3822,1317,-2505
2018,2,18,17,1283,4278,1531,-2747
2018,2,18,18,1463,4336,1522,-2814
2018,2,18,19,1582,4425,1626,-2799
2018,2,18,20,1698,4368,1668,-2700
2018,2,18,21,1575,4199,1617,-2582
2018,2,18,22,1573,4190,1838,-2352
2018,2,18,23,1548,4115,1855,-2260
2018,2,19,0,1550,4121,2011,-2110
2018,2,19,1,1757,4331,2189,-2142
2018,2,19,2,1728,4600,2322,-2278
2018,2,19,3,1830,4780,2392,-2388
2018,2,19,4,1819,4715,2432,-2283
2018,2,19,5,1807,4631,2500,-2131
2018,2,19,6,1931,4458,2561,-1897
2018,2,19,7,2254,4117,2647,-1470
2018,2,19,8,2021,3903,2668,-1235
2018,2,19,9,1944,3778,2411,-1367
2018,2,19,10,1947,3729,2439,-1290
2018,2,19,11,1925,3742,2465,-1277
2018,2,19,12,1912,3810,2512,-1298
2018,2,19,13,1930,3959,2504,-1455
2018,2,19,14,1950,4279,2458,-1821
2018,2,19,15,1808,4559,2391,-2168
2018,2,19,16,1840,4771,2531,-2240
2018,2,19,17,1953,4839,2468,-2371
2018,2,19,18,1969,4805,2334,-2471
2018,2,19,19,2238,4756,2449,-2307
2018,2,19,20,2090,4670,2322,-2348
2018,2,19,21,2004,4564,2239,-2325
2018,2,19,22,1936,4482,2295,-2187
2018,2,19,23,1900,4417,2255,-2162
2018,2,20,0,1873,4407,2286,-2121
2018,2,20,1,1892,4431,2316,-2115
2018,2,20,2,2109,4811,2580,-2231
2018,2,20,3,2299,5008,2671,-2337
2018,2,20,4,2228,4974,2668,-2306
2018,2,20,5,2183,4863,2638,-2225
2018,2,20,6,1927,4620,2550,-2070
2018,2,20,7,2201,4330,2461,-1869
2018,2,20,8,2103,4072,2572,-1500
2018,2,20,9,1947,3944,2424,-1520
2018,2,20,10,1969,3896,2441,-1455
2018,2,20,11,1992,3904,2481,-1423
2018,2,20,12,2103,3978,2556,-1422
2018,2,20,13,2186,4157,2571,-1586
2018,2,20,14,2303,4509,2599,-1910
2018,2,20,15,2280,4884,2638,-2246
2018,2,20,16,2384,5075,2811,-2264
2018,2,20,17,2298,5071,2751,-2320
2018,2,20,18,2148,4996,2524,-2472
2018,2,20,19,2340,4925,2700,-2225
2018,2,20,20,2197,4841,2453,-2388
2018,2,20,21,2113,4778,2526,-2252
2018,2,20,22,2038,4707,2421,-2286
2018,2,20,23,1996,4669,2340,-2329
2018,2,21,0,2002,4697,2439,-2258
2018,2,21,1,2068,4777,2533,-2244
2018,2,21,2,2332,4981,2770,-2211
2018,2,21,3,2517,5117,2865,-2252
2018,2,21,4,2452,5061,2750,-2311
2018,2,21,5,2313,4937,2673,-2264
2018,2,21,6,2065,4704,2611,-2093
2018,2,21,7,2181,4382,2610,-1772
2018,2,21,8,2029,4141,2438,-1703
2018,2,21,9,2281,4011,2522,-1489
2018,2,21,10,2270,3989,2450,-1539
2018,2,21,11,2311,4021,2471,-1550
2018,2,21,12,2335,4132,2536,-1596
2018,2,21,13,2461,4333,2779,-1554
2018,2,21,14,2888,4701,2753,-1948
2018,2,21,15,2736,5101,2858,-2243
2018,2,21,16,2937,5292,2963,-2329
2018,2,21,17,2798,5268,2867,-2401
2018,2,21,18,2624,5120,2767,-2353
2018,2,21,19,2580,5020,2798,-2222
2018,2,21,20,2417,4863,2778,-2085
2018,2,21,21,2333,4816,2749,-2067
2018,2,21,22,2248,4804,2679,-2125
2018,2,21,23,2195,4803,2665,-2138
2018,2,22,0,2241,4831,2713,-2118
2018,2,22,1,2448,4923,2765,-2158
2018,2,22,2,2710,5123,2933,-2190
2018,2,22,3,2889,5217,2925,-2292
2018,2,22,4,2829,5136,2893,-2243
2018,2,22,5,2654,4995,2853,-2142
2018,2,22,6,2393,4742,2544,-2198
2018,2,22,7,2583,4393,2672,-1721
2018,2,22,8,2322,4134,2506,-1628
2018,2,22,9,2366,3978,2545,-1433
2018,2,22,10,2315,3921,2510,-1411
2018,2,22,11,2255,3929,2414,-1515
2018,2,22,12,2362,4015,2488,-1527
2018,2,22,13,2456,4216,2570,-1646
2018,2,22,14,2728,4532,2606,-1926
2018,2,22,15,2585,4928,2672,-2256
2018,2,22,16,2783,5126,2818,-2308
2018,2,22,17,2681,5124,2805,-2319
2018,2,22,18,2528,5093,2831,-2262
2018,2,22,19,2622,4845,2743,-2102
2018,2,22,20,2472,4721,2702,-2019
2018,2,22,21,2368,4622,2601,-2021
2018,2,22,22,2277,4522,2455,-2067
2018,2,22,23,2228,4452,2426,-2026
2018,2,23,0,2268,4462,2515,-1947
2018,2,23,1,2368,4523,2522,-2001
2018,2,23,2,2660,4772,2631,-2141
2018,2,23,3,2851,4953,2588,-2365
2018,2,23,4,2811,4938,2440,-2498
2018,2,23,5,2655,4860,2442,-2418
2018,2,23,6,2379,4651,2342,-2309
2018,2,23,7,2500,4393,2411,-1982
2018,2,23,8,2320,4155,2339,-1816
2018,2,23,9,2150,4049,2386,-1663
2018,2,23,10,2085,4038,2321,-1717
2018,2,23,11,2093,4068,2329,-1739
2018,2,23,12,2160,4157,2325,-1832
2018,2,23,13,2206,4358,2443,-1915
2018,2,23,14,2628,4689,2553,-2136
2018,2,23,15,2482,5090,2649,-2441
2018,2,23,16,2679,5257,2695,-2562
2018,2,23,17,2596,5231,2511,-2720
2018,2,23,18,2427,5173,2462,-2711
2018,2,23,19,2151,5096,2463,-2633
2018,2,23,20,2002,5009,2467,-2542
2018,2,23,21,1887,4935,2317,-2618
2018,2,23,22,1788,4869,2275,-2594
2018,2,23,23,1729,4802,2196,-2606
2018,2,24,0,1760,4808,2172,-2636
2018,2,24,1,1826,4880,2194,-2686
2018,2,24,2,1984,4996,2216,-2780
2018,2,24,3,2064,5064,2179,-2885
2018,2,24,4,1896,4927,1925,-3002
2018,2,24,5,1714,4773,1961,-2812
2018,2,24,6,1584,4570,2025,-2545
2018,2,24,7,2092,4287,2048,-2239
2018,2,24,8,1847,4042,2037,-2005
2018,2,24,9,1501,3877,1876,-2001
2018,2,24,10,1517,3772,1796,-1976
2018,2,24,11,1398,3743,1783,-1960
2018,2,24,12,1393,3740,1743,-1997
2018,2,24,13,1462,3807,1732,-2075
2018,2,24,14,1440,3941,1766,-2175
2018,2,24,15,1459,4139,1767,-2372
2018,2,24,16,1454,4364,1673,-2691
2018,2,24,17,1436,4540,1788,-2752
2018,2,24,18,1432,4599,1809,-2790
2018,2,24,19,1403,4536,1861,-2675
2018,2,24,20,1455,4428,1833,-2595
2018,2,24,21,1449,4036,1507,-2529
2018,2,24,22,1394,3879,1475,-2404
2018,2,24,23,1327,3795,1404,-2391
2018,2,25,0,1323,3637,1377,-2260
2018,2,25,1,1423,3866,1627,-2239
2018,2,25,2,1656,4270,1918,-2352
2018,2,25,3,1773,4508,2010,-2498
2018,2,25,4,1666,4457,1970,-2487
2018,2,25,5,1505,4365,2008,-2357
2018,2,25,6,1360,4056,1793,-2263
2018,2,25,7,1844,3976,1877,-2099
2018,2,25,8,1633,3772,1664,-2108
2018,2,25,9,1316,3646,1708,-1938
2018,2,25,10,1295,3510,1695,-1815
2018,2,25,11,1248,3478,1703,-1775
2018,2,25,12,1270,3476,1683,-1793
2018,2,25,13,1369,3574,1697,-1877
2018,2,25,14,1299,3678,1723,-1955
2018,2,25,15,1142,3677,1540,-2137
2018,2,25,16,1057,3861,1533,-2328
2018,2,25,17,1229,4152,1614,-2538
2018,2,25,18,1334,4279,1539,-2740
2018,2,25,19,1358,4321,1571,-2750
2018,2,25,20,1351,4180,1435,-2745
2018,2,25,21,1344,4087,1405,-2682
2018,2,25,22,1316,3949,1348,-2601
2018,2,25,23,1280,3905,1351,-2554
2018,2,26,0,1275,3926,1344,-2582
2018,2,26,1,1329,4047,1340,-2707
2018,2,26,2,1456,4519,1587,-2932
2018,2,26,3,1619,4722,1601,-3121
2018,2,26,4,1583,4662,1718,-2944
2018,2,26,5,1563,4564,1727,-2837
2018,2,26,6,1361,4363,1758,-2605
2018,2,26,7,1787,4098,1748,-2350
2018,2,26,8,1561,3844,1759,-2085
2018,2,26,9,1435,3709,1757,-1952
2018,2,26,10,1391,3653,1741,-1912
2018,2,26,11,1419,3666,1758,-1908
2018,2,26,12,1476,3740,1912,-1828
2018,2,26,13,1581,3929,1881,-2048
2018,2,26,14,1920,4291,2099,-2192
2018,2,26,15,1895,4712,2126,-2586
2018,2,26,16,1909,4900,2188,-2712
2018,2,26,17,1914,4856,2184,-2672
2018,2,26,18,1802,4699,2143,-2556
2018,2,26,19,1761,4570,2126,-2444
2018,2,26,20,1719,4437,2024,-2413
2018,2,26,21,1809,4329,1972,-2357
2018,2,26,22,1753,4222,2019,-2203
2018,2,26,23,1694,4138,1956,-2182
2018,2,27,0,1729,4122,2047,-2075
2018,2,27,1,1836,4199,2108,-2091
2018,2,27,2,1923,4410,2165,-2245
2018,2,27,3,2084,4694,2263,-2431
2018,2,27,4,2097,4694,2252,-2442
2018,2,27,5,2068,4602,2269,-2333
2018,2,27,6,1794,4382,2232,-2150
2018,2,27,7,2088,4075,2294,-1781
2018,2,27,8,1901,3811,2267,-1544
2018,2,27,9,1702,3667,2030,-1637
2018,2,27,10,1555,3584,1913,-1671
2018,2,27,11,1512,3572,1860,-1712
2018,2,27,12,1668,3578,1781,-1797
2018,2,27,13,1441,3678,1749,-1929
2018,2,27,14,1680,4109,1860,-2249
2018,2,27,15,1515,4505,1921,-2584
2018,2,27,16,1633,4708,1832,-2876
2018,2,27,17,1603,4651,1729,-2922
2018,2,27,18,1536,4538,1720,-2818
2018,2,27,19,1604,4449,1711,-2738
2018,2,27,20,1498,4377,1760,-2617
2018,2,27,21,1444,4313,1587,-2726
2018,2,27,22,1380,4234,1542,-2692
2018,2,27,23,1324,4163,1556,-2607
2018,2,28,0,1342,4187,1505,-2682
2018,2,28,1,1404,4316,1558,-2758
2018,2,28,2,1668,4522,1794,-2728
2018,2,28,3,1883,4662,1909,-2753
2018,2,28,4,1802,4602,1932,-2670
2018,2,28,5,1672,4488,1944,-2544
2018,2,28,6,1412,4210,1756,-2454
2018,2,28,7,1541,3899,1903,-1996
2018,2,28,8,1383,3424,1717,-1707
2018,2,28,9,1377,3286,1705,-1581
2018,2,28,10,1377,3209,1745,-1464
2018,2,28,11,1417,3202,1707,-1495
2018,2,28,12,1512,3267,1790,-1477
2018,2,28,13,1592,3634,2048,-1586
2018,2,28,14,1875,3988,2305,-1683
2018,2,28,15,1780,4387,2195,-2192
2018,2,28,16,2030,4559,2142,-2417
2018,2,28,17,2000,4515,2102,-2413
2018,2,28,18,1930,4437,2053,-2384
2018,2,28,19,1808,4294,1976,-2318
2018,2,28,20,1768,4323,1988,-2335
2018,2,28,21,1740,4299,1994,-2305
2018,2,28,22,1705,4242,2008,-2234
2018,2,28,23,1662,4253,1951,-2302
2018,3,1,0,1707,4313,2014,-2299
2018,3,1,1,1748,4423,1936,-2487
2018,3,1,2,1914,4569,2063,-2506
2018,3,1,3,2055,4667,2089,-2578
2018,3,1,4,1980,4575,2098,-2477
2018,3,1,5,1807,4433,2099,-2334
2018,3,1,6,1667,4186,2102,-2084
2018,3,1,7,1913,3869,2132,-1737
2018,3,1,8,1653,3590,2114,-1476
2018,3,1,9,1553,3281,1893,-1388
2018,3,1,10,1434,3142,1783,-1359
2018,3,1,11,1521,3127,1669,-1458
2018,3,1,12,1553,3205,1785,-1420
2018,3,1,13,1706,3568,1941,-1627
2018,3,1,14,1924,3952,1995,-1957
2018,3,1,15,1734,4391,2014,-2377
2018,3,1,16,1973,4591,2094,-2497
2018,3,1,17,1981,4479,2074,-2405
2018,3,1,18,1854,4298,1938,-2360
2018,3,1,19,1746,4180,1966,-2214
2018,3,1,20,1671,4074,1896,-2178
2018,3,1,21,1615,3988,1848,-2140
2018,3,1,22,1570,3895,1751,-2144
2018,3,1,23,1523,3821,1675,-2146
2018,3,2,0,1541,3771,1657,-2114
2018,3,2,1,1603,3816,1587,-2229
2018,3,2,2,1758,4105,1945,-2160
2018,3,2,3,1953,4372,2123,-2249
2018,3,2,4,1937,4396,2140,-2256
2018,3,2,5,1854,4346,2069,-2277
2018,3,2,6,1658,4153,2052,-2101
2018,3,2,7,2122,3866,2081,-1785
2018,3,2,8,1868,3605,2071,-1534
2018,3,2,9,1632,3465,2077,-1388
2018,3,2,10,1550,3398,2059,-1339
2018,3,2,11,1569,3381,2056,-1325
2018,3,2,12,1625,3427,1976,-1451
2018,3,2,13,1650,3609,1917,-1692
2018,3,2,14,1686,3922,1826,-2096
2018,3,2,15,1655,4352,1965,-2387
2018,3,2,16,1763,4539,2171,-2368
2018,3,2,17,1740,4532,2252,-2280
2018,3,2,18,1602,4449,2014,-2435
2018,3,2,19,1492,4358,1813,-2545
2018,3,2,20,1431,4278,1734,-2544
2018,3,2,21,1408,4214,1768,-2446
2018,3,2,22,1399,4172,1662,-2510
2018,3,2,23,1411,4132,1701,-2431
2018,3,3,0,1419,4122,1736,-2386
2018,3,3,1,1525,4207,1815,-2392
2018,3,3,2,1719,4323,2059,-2264
2018,3,3,3,1904,4466,2062,-2404
2018,3,3,4,1854,4404,2026,-2378
2018,3,3,5,1736,4319,1959,-2360
2018,3,3,6,1579,4146,1945,-2201
2018,3,3,7,1956,3857,1883,-1974
2018,3,3,8,1745,3612,1885,-1727
2018,3,3,9,1519,3400,1908,-1492
2018,3,3,10,1516,3334,1851,-1483
2018,3,3,11,1542,3338,1842,-1496
2018,3,3,12,1545,3416,1885,-1531
2018,3,3,13,1595,3531,1902,-1629
2018,3,3,14,1728,3759,1992,-1767
2018,3,3,15,1462,4012,1953,-2059
2018,3,3,16,1703,4232,1942,-2290
2018,3,3,17,1944,4332,1911,-2421
2018,3,3,18,1963,4295,2020,-2275
2018,3,3,19,1862,4166,1936,-2230
2018,3,3,20,1722,4014,1839,-2175
2018,3,3,21,1585,3877,1804,-2073
2018,3,3,22,1491,3723,1776,-1947
2018,3,3,23,1371,3653,1812,-1841
2018,3,4,0,1362,3629,1811,-1818
2018,3,4,1,1395,3710,1725,-1985
2018,3,4,2,1580,3860,1813,-2047
2018,3,4,3,1764,4112,1992,-2120
2018,3,4,4,1743,4134,1972,-2162
2018,3,4,5,1634,4095,1962,-2133
2018,3,4,6,1495,4004,1959,-2045
2018,3,4,7,1794,3828,1976,-1852
2018,3,4,8,1718,3670,2006,-1664
2018,3,4,9,1593,3546,1990,-1556
2018,3,4,10,1511,3498,1967,-1531
2018,3,4,11,1490,3487,1968,-1519
2018,3,4,12,1515,3515,1931,-1584
2018,3,4,13,1630,3597,1870,-1727
2018,3,4,14,1643,3725,1931,-1794
2018,3,4,15,1483,3931,1886,-2045
2018,3,4,16,1648,4144,1870,-2274
2018,3,4,17,1751,4314,1929,-2385
2018,3,4,18,1751,4367,1762,-2605
2018,3,4,19,1676,4236,1561,-2675
2018,3,4,20,1564,4165,1401,-2764
2018,3,4,21,1454,4024,1404,-2620
2018,3,4,22,1312,3976,1502,-2474
2018,3,4,23,1236,3887,1509,-2378
2018,3,5,0,1254,4039,1656,-2383
2018,3,5,1,1413,4163,1777,-2386
2018,3,5,2,1571,4249,1898,-2351
2018,3,5,3,1713,4404,1980,-2424
2018,3,5,4,1713,4433,1966,-2467
2018,3,5,5,1611,4336,1912,-2424
2018,3,5,6,1389,4131,2031,-2100
2018,3,5,7,1551,3836,2080,-1756
2018,3,5,8,1446,3503,1908,-1595
2018,3,5,9,1676,3335,1893,-1442
2018,3,5,10,1585,3303,1973,-1330
2018,3,5,11,1582,3323,1969,-1354
2018,3,5,12,1696,3382,2069,-1313
2018,3,5,13,1807,3530,2015,-1515
2018,3,5,14,1971,3890,2223,-1667
2018,3,5,15,1908,4327,2258,-2069
2018,3,5,16,2078,4451,2089,-2362
2018,3,5,17,2093,4409,2053,-2356
2018,3,5,18,2032,4324,2094,-2230
2018,3,5,19,1953,4217,1814,-2403
2018,3,5,20,1884,4104,1787,-2317
2018,3,5,21,1869,4037,1730,-2307
2018,3,5,22,1831,4018,1829,-2189
2018,3,5,23,1785,3982,1909,-2073
2018,3,6,0,1816,4034,2027,-2007
2018,3,6,1,1761,4170,2114,-2056
2018,3,6,2,1918,4365,2304,-2061
2018,3,6,3,2172,4521,2383,-2138
2018,3,6,4,2172,4486,2418,-2068
2018,3,6,5,2032,4363,2392,-1971
2018,3,6,6,1796,4096,2236,-1860
2018,3,6,7,2131,3758,2195,-1563
2018,3,6,8,1893,3492,2147,-1345
2018,3,6,9,1660,3359,2116,-1243
2018,3,6,10,1793,3309,2119,-1190
2018,3,6,11,1886,3312,2185,-1127
2018,3,6,12,2129,3371,2211,-1160
2018,3,6,13,2092,3592,2386,-1206
2018,3,6,14,2279,3964,2609,-1355
2018,3,6,15,2452,4453,2691,-1762
2018,3,6,16,2511,4620,2575,-2045
2018,3,6,17,2427,4494,2563,-1931
2018,3,6,18,2389,4286,2476,-1810
2018,3,6,19,2242,4122,2298,-1824
2018,3,6,20,2116,4010,2115,-1895
2018,3,6,21,2026,3894,1941,-1953
2018,3,6,22,1945,3759,1857,-1902
2018,3,6,23,1900,3746,1974,-1772
2018,3,7,0,1865,3723,2009,-1714
2018,3,7,1,1992,3824,2174,-1650
2018,3,7,2,2174,4012,2464,-1548
2018,3,7,3,2424,4283,2551,-1732
2018,3,7,4,2442,4343,2562,-1781
2018,3,7,5,2341,4269,2526,-1743
2018,3,7,6,2119,4067,2380,-1687
2018,3,7,7,2149,3750,2353,-1397
2018,3,7,8,1891,3512,2330,-1182
2018,3,7,9,1791,3411,2350,-1061
2018,3,7,10,1836,3375,2358,-1017
2018,3,7,11,1944,3400,2401,-999
2018,3,7,12,2111,3485,2392,-1093
2018,3,7,13,2270,3695,2404,-1291
2018,3,7,14,2589,4067,2515,-1552
2018,3,7,15,2433,4498,2590,-1908
2018,3,7,16,2611,4653,2605,-2048
2018,3,7,17,2464,4496,2585,-1911
2018,3,7,18,2387,4350,2554,-1796
2018,3,7,19,2218,4227,2447,-1780
2018,3,7,20,2096,4103,2375,-1728
2018,3,7,21,2015,4011,2395,-1616
2018,3,7,22,1944,3947,2332,-1615
2018,3,7,23,1879,3904,2245,-1659
2018,3,8,0,1841,3969,2254,-1715
2018,3,8,1,1838,4058,2259,-1799
2018,3,8,2,2019,4245,2387,-1858
2018,3,8,3,2240,4410,2416,-1994
2018,3,8,4,2239,4355,2407,-1948
2018,3,8,5,2137,4233,2381,-1852
2018,3,8,6,1924,3993,2242,-1751
2018,3,8,7,2216,3641,2222,-1419
2018,3,8,8,1957,3379,2170,-1209
2018,3,8,9,1763,3216,2105,-1111
2018,3,8,10,1726,3155,2062,-1093
2018,3,8,11,1705,3139,2010,-1129
2018,3,8,12,1709,3163,2036,-1127
2018,3,8,13,1959,3331,2044,-1287
2018,3,8,14,1897,3744,2170,-1574
2018,3,8,15,2002,4110,2190,-1920
2018,3,8,16,2161,4341,2202,-2139
2018,3,8,17,1985,4331,2063,-2268
2018,3,8,18,1840,4269,1990,-2279
2018,3,8,19,1670,4235,1994,-2241
2018,3,8,20,1564,4143,1721,-2422
2018,3,8,21,1461,4127,1635,-2492
2018,3,8,22,1366,4089,1626,-2463
2018,3,8,23,1407,4044,1636,-2408
2018,3,9,0,1431,3938,1672,-2266
2018,3,9,1,1534,4127,1762,-2365
2018,3,9,2,1561,4330,1976,-2354
2018,3,9,3,1668,4443,2016,-2427
2018,3,9,4,1616,4375,2017,-2358
2018,3,9,5,1499,4240,1764,-2476
2018,3,9,6,1347,3990,1754,-2236
2018,3,9,7,1648,3701,1766,-1935
2018,3,9,8,1407,3262,1582,-1680
2018,3,9,9,1099,2939,1363,-1576
2018,3,9,10,1069,2892,1328,-1564
2018,3,9,11,1044,2886,1321,-1565
2018,3,9,12,1196,3098,1500,-1598
2018,3,9,13,1141,3280,1502,-1778
2018,3,9,14,1520,3801,1588,-2213
2018,3,9,15,1325,4201,1610,-2591
2018,3,9,16,1376,4371,1539,-2832
2018,3,9,17,1265,4312,1621,-2691
2018,3,9,18,1162,4032,1461,-2571
2018,3,9,19,1282,3946,1470,-2476
2018,3,9,20,1245,3850,1528,-2322
2018,3,9,21,1311,3685,1449,-2236
2018,3,9,22,1312,3463,1339,-2124
2018,3,9,23,1331,3478,1395,-2083
2018,3,10,0,1366,3516,1480,-2036
2018,3,10,1,1431,3655,1553,-2102
2018,3,10,2,1598,3970,1792,-2178
2018,3,10,3,1798,4184,1876,-2308
2018,3,10,4,1780,4188,1813,-2375
2018,3,10,5,1595,4121,1799,-2322
2018,3,10,6,1441,3989,1802,-2187
2018,3,10,7,1805,3799,1828,-1971
2018,3,10,8,1687,3595,1817,-1778
2018,3,10,9,1401,3478,1740,-1738
2018,3,10,10,1341,3424,1708,-1716
2018,3,10,11,1367,3419,1675,-1744
2018,3,10,12,1464,3464,1675,-1789
2018,3,10,13,1390,3565,1729,-1836
2018,3,10,14,1462,3750,1727,-2023
2018,3,10,15,1356,4001,1701,-2300
2018,3,10,16,1540,4215,1770,-2445
2018,3,10,17,1833,4303,1774,-2529
2018,3,10,18,1820,4226,1786,-2440
2018,3,10,19,1828,4080,1697,-2383
2018,3,10,20,1711,3902,1703,-2199
2018,3,10,21,1624,3753,1675,-2078
2018,3,10,22,1477,3631,1686,-1945
2018,3,10,23,1404,3424,1613,-1811
2018,3,11,0,1414,3375,1572,-1803
2018,3,11,1,1150,3330,1527,-1803
2018,3,11,2,1287,3437,1552,-1885
2018,3,11,3,1517,3841,1761,-2080
2018,3,11,4,1550,3896,1698,-2198
2018,3,11,5,1374,3809,1711,-2098
2018,3,11,6,1257,3693,1695,-1998
2018,3,11,7,1612,3540,1694,-1846
2018,3,11,8,1434,3363,1672,-1691
2018,3,11,9,1261,3287,1652,-1635
2018,3,11,10,1353,3238,1637,-1601
2018,3,11,11,1353,3253,1636,-1617
2018,3,11,12,1457,3281,1710,-1571
2018,3,11,13,1274,3392,1708,-1684
2018,3,11,14,1482,3554,1675,-1879
2018,3,11,15,1592,3748,1673,-2075
2018,3,11,16,1554,3898,1764,-2134
2018,3,11,17,1535,3945,1828,-2117
2018,3,11,18,1442,3872,1797,-2075
2018,3,11,19,1351,3774,1660,-2114
2018,3,11,20,1231,3626,1585,-2041
2018,3,11,21,1178,3512,1569,-1943
2018,3,11,22,1176,3399,1503,-1896
2018,3,11,23,1407,3357,1497,-1860
2018,3,12,0,1464,3361,1415,-1946
2018,3,12,1,1528,3479,1546,-1933
2018,3,12,2,1561,3598,1620,-1978
2018,3,12,3,1498,3795,1759,-2036
2018,3,12,4,1337,3834,1730,-2104
2018,3,12,5,1580,3703,1722,-1981
2018,3,12,6,1340,3438,1713,-1725
2018,3,12,7,1145,3180,1604,-1576
2018,3,12,8,1234,3073,1615,-1458
2018,3,12,9,1217,2986,1621,-1365
2018,3,12,10,1298,2992,1599,-1393
2018,3,12,11,1366,3056,1628,-1428
2018,3,12,12,1425,3263,1696,-1567
2018,3,12,13,1675,3574,1768,-1806
2018,3,12,14,1715,4002,1944,-2058
2018,3,12,15,1953,4198,2011,-2187
2018,3,12,16,1867,4135,2005,-2130
2018,3,12,17,1749,4014,2048,-1966
2018,3,12,18,1827,3867,2088,-1779
2018,3,12,19,1710,3697,1929,-1768
2018,3,12,20,1626,3605,1757,-1848
2018,3,12,21,1560,3510,1749,-1761
2018,3,12,22,1499,3455,1777,-1678
2018,3,12,23,1488,3511,1948,-1563
2018,3,13,0,1681,3495,1847,-1648
2018,3,13,1,1543,3549,1837,-1712
2018,3,13,2,1590,3619,1970,-1649
2018,3,13,3,1714,3770,2036,-1734
2018,3,13,4,1726,3759,2105,-1654
2018,3,13,5,1488,3491,1957,-1534
2018,3,13,6,1470,3211,1941,-1270
2018,3,13,7,1264,2844,1818,-1026
2018,3,13,8,1685,2799,2092,-707
2018,3,13,9,1577,2693,1804,-889
2018,3,13,10,1704,2691,1871,-820
2018,3,13,11,1719,2697,1765,-932
2018,3,13,12,1670,2804,1782,-1022
2018,3,13,13,1606,3080,1678,-1402
2018,3,13,14,1465,3406,1603,-1803
2018,3,13,15,1702,3693,1877,-1816
2018,3,13,16,1670,3792,2043,-1749
2018,3,13,17,1623,3777,2133,-1644
2018,3,13,18,1562,3743,2077,-1666
2018,3,13,19,1539,3762,2054,-1708
2018,3,13,20,1600,3776,1995,-1781
2018,3,13,21,1587,3782,1823,-1959
2018,3,13,22,1426,3778,1761,-2017
2018,3,13,23,1398,3840,1831,-2009
2018,3,14,0,1297,3869,1676,-2193
2018,3,14,1,1355,3960,1655,-2305
2018,3,14,2,1565,4039,1738,-2301
2018,3,14,3,1584,4146,1877,-2269
2018,3,14,4,1592,4066,1721,-2345
2018,3,14,5,1316,3860,2102,-1758
2018,3,14,6,1818,3578,2199,-1379
2018,3,14,7,1494,3279,1827,-1452
2018,3,14,8,1381,3131,1709,-1422
2018,3,14,9,1416,3062,1705,-1357
2018,3,14,10,1419,2971,1640,-1331
2018,3,14,11,1417,2993,1725,-1268
2018,3,14,12,1496,3145,1771,-1374
2018,3,14,13,1601,3472,1750,-1722
2018,3,14,14,1613,3837,1758,-2079
2018,3,14,15,1581,4161,1950,-2211
2018,3,14,16,1519,4136,1935,-2201
2018,3,14,17,1445,4084,1905,-2179
2018,3,14,18,1477,4087,1897,-2190
2018,3,14,19,1489,3928,1836,-2092
2018,3,14,20,1380,3842,1833,-2009
2018,3,14,21,1353,3608,1661,-1947
2018,3,14,22,1315,3547,1577,-1970
2018,3,14,23,1313,3517,1528,-1989
2018,3,15,0,1280,3559,1534,-2025
2018,3,15,1,1315,3794,1762,-2032
2018,3,15,2,1411,3923,1841,-2082
2018,3,15,3,1603,4102,1869,-2233
2018,3,15,4,1652,4125,1915,-2210
2018,3,15,5,1487,3994,1825,-2169
2018,3,15,6,1866,3733,1806,-1927
2018,3,15,7,1633,3478,1764,-1714
2018,3,15,8,1265,3339,1555,-1784
2018,3,15,9,1328,3290,1530,-1760
2018,3,15,10,1344,3307,1545,-1762
2018,3,15,11,1415,3381,1539,-1842
2018,3,15,12,1494,3521,1569,-1952
2018,3,15,13,1777,3566,1509,-2057
2018,3,15,14,1744,3996,1719,-2277
2018,3,15,15,1978,4306,1806,-2500
2018,3,15,16,1910,4245,1873,-2372
2018,3,15,17,1868,4023,1804,-2219
2018,3,15,18,1771,3804,1533,-2271
2018,3,15,19,1619,3658,1542,-2116
2018,3,15,20,1525,3474,1397,-2077
2018,3,15,21,1476,3394,1445,-1949
2018,3,15,22,1476,3311,1294,-2017
2018,3,15,23,1352,3178,1173,-2005
2018,3,16,0,1324,3226,1304,-1922
2018,3,16,1,1502,3397,1418,-1979
2018,3,16,2,1502,3640,1732,-1908
2018,3,16,3,1690,3876,1800,-2076
2018,3,16,4,1746,3976,1825,-2151
2018,3,16,5,1573,3850,1835,-2015
2018,3,16,6,1865,3621,1908,-1713
2018,3,16,7,1585,3405,1855,-1550
2018,3,16,8,1111,2960,1557,-1403
2018,3,16,9,1119,2916,1530,-1386
2018,3,16,10,1508,3039,1587,-1452
2018,3,16,11,1466,3113,1755,-1358
2018,3,16,12,1678,3229,1787,-1442
2018,3,16,13,1700,3611,1884,-1727
2018,3,16,14,1737,4060,2006,-2054
2018,3,16,15,1755,4337,2041,-2296
2018,3,16,16,1722,4329,2010,-2319
2018,3,16,17,1743,4192,2019,-2173
2018,3,16,18,1887,4074,2027,-2047
2018,3,16,19,1855,3943,1996,-1947
2018,3,16,20,1763,3777,1888,-1889
2018,3,16,21,1668,3704,1902,-1802
2018,3,16,22,1563,3609,1781,-1828
2018,3,16,23,1507,3552,1680,-1872
2018,3,17,0,1595,3554,1673,-1881
2018,3,17,1,1536,3543,1615,-1928
2018,3,17,2,1600,3636,1826,-1810
2018,3,17,3,1742,3809,1968,-1841
2018,3,17,4,1781,3853,1979,-1874
2018,3,17,5,1652,3742,1952,-1790
2018,3,17,6,1829,3573,1968,-1605
2018,3,17,7,1598,3368,1692,-1676
2018,3,17,8,1324,3204,1632,-1572
2018,3,17,9,1296,3142,1624,-1518
2018,3,17,10,1256,3129,1628,-1501
2018,3,17,11,1314,3164,1632,-1532
2018,3,17,12,1338,3240,1631,-1609
2018,3,17,13,1435,3389,1632,-1757
2018,3,17,14,1208,3619,1614,-2005
2018,3,17,15,1463,3903,1656,-2247
2018,3,17,16,1520,4056,1613,-2443
2018,3,17,17,1533,4102,1625,-2477
2018,3,17,18,1643,4057,1550,-2507
2018,3,17,19,1517,3980,1515,-2465
2018,3,17,20,1387,3886,1482,-2404
2018,3,17,21,1267,3760,1548,-2212
2018,3,17,22,1254,3706,1542,-2164
2018,3,17,23,1084,3607,1562,-2045
2018,3,18,0,1168,3581,1406,-2175
2018,3,18,1,1148,3484,1484,-2000
2018,3,18,2,1211,3503,1504,-1999
2018,3,18,3,1411,3750,1678,-2072
2018,3,18,4,1425,3636,1623,-2013
2018,3,18,5,1359,3579,1589,-1990
2018,3,18,6,1374,3413,1481,-1932
2018,3,18,7,1169,3111,1374,-1737
2018,3,18,8,1267,3029,1602,-1427
2018,3,18,9,1278,2892,1550,-1342
2018,3,18,10,1224,2876,1507,-1369
2018,3,18,11,1246,2890,1551,-1339
2018,3,18,12,1279,2928,1485,-1443
2018,3,18,13,1556,3189,1677,-1512
2018,3,18,14,1294,3364,1489,-1875
2018,3,18,15,1238,3578,1544,-2034
2018,3,18,16,1338,3706,1378,-2328
2018,3,18,17,1470,3798,1431,-2367
2018,3,18,18,1486,3772,1479,-2293
2018,3,18,19,1382,3734,1500,-2234
2018,3,18,20,1466,3647,1470,-2177
2018,3,18,21,1268,3528,1349,-2179
2018,3,18,22,1221,3467,1323,-2144
2018,3,18,23,1230,3369,1304,-2065
2018,3,19,0,1266,3416,1407,-2009
2018,3,19,1,1500,3537,1574,-1963
2018,3,19,2,1678,3600,1703,-1897
2018,3,19,3,1853,3828,2046,-1782
2018,3,19,4,1796,3965,2057,-1908
2018,3,19,5,1791,3829,2045,-1784
2018,3,19,6,1882,3534,2018,-1516
2018,3,19,7,1633,3286,1965,-1321
2018,3,19,8,1309,2971,1803,-1168
2018,3,19,9,1334,2891,1764,-1127
2018,3,19,10,1493,2903,1802,-1101
2018,3,19,11,1372,3198,2007,-1191
2018,3,19,12,1734,3411,1977,-1434
2018,3,19,13,1899,3703,1951,-1752
2018,3,19,14,1697,4118,1863,-2255
2018,3,19,15,1950,4454,2050,-2404
2018,3,19,16,1880,4373,1982,-2391
2018,3,19,17,1728,4238,1918,-2320
2018,3,19,18,1818,4104,1897,-2207
2018,3,19,19,1673,3956,1835,-2121
2018,3,19,20,1566,3831,1793,-2038
2018,3,19,21,1482,3733,1599,-2134
2018,3,19,22,1400,3638,1408,-2230
2018,3,19,23,1371,3636,1517,-2119
2018,3,20,0,1477,3716,1835,-1881
2018,3,20,1,1394,3786,1792,-1994
2018,3,20,2,1510,3835,1960,-1875
2018,3,20,3,1692,4001,2066,-1935
2018,3,20,4,1674,4082,2084,-1998
2018,3,20,5,1511,3908,2036,-1872
2018,3,20,6,1730,3650,2036,-1614
2018,3,20,7,1510,3392,2025,-1367
2018,3,20,8,1419,3237,1903,-1334
2018,3,20,9,1481,3173,1791,-1382
2018,3,20,10,1496,3204,1859,-1345
2018,3,20,11,1500,3296,1854,-1442
2018,3,20,12,1604,3500,1974,-1526
2018,3,20,13,1808,3857,2041,-1816
2018,3,20,14,1744,4295,2046,-2249
2018,3,20,15,1871,4532,2072,-2460
2018,3,20,16,1790,4475,2070,-2405
2018,3,20,17,1634,4314,2045,-2269
2018,3,20,18,1674,4150,1962,-2188
2018,3,20,19,1535,4012,1944,-2068
2018,3,20,20,1525,3867,1919,-1948
2018,3,20,21,1421,3647,1809,-1838
2018,3,20,22,1333,3535,1771,-1764
2018,3,20,23,1277,3482,1737,-1745
2018,3,21,0,1308,3468,1662,-1806
2018,3,21,1,1396,3547,1663,-1884
2018,3,21,2,1494,3592,1687,-1905
2018,3,21,3,1648,3822,1766,-2056
2018,3,21,4,1714,3897,1787,-2110
2018,3,21,5,1548,3734,1786,-1948
2018,3,21,6,1827,3469,1802,-1667
2018,3,21,7,1554,3240,1816,-1424
2018,3,21,8,1387,3111,1829,-1282
2018,3,21,9,1483,3027,1824,-1203
2018,3,21,10,1535,3039,1738,-1301
2018,3,21,11,1530,3116,1757,-1359
2018,3,21,12,1705,3321,1816,-1505
2018,3,21,13,1731,3556,1754,-1802
2018,3,21,14,1977,3994,1942,-2052
2018,3,21,15,1969,4283,2008,-2275
2018,3,21,16,1875,4287,2027,-2260
2018,3,21,17,1879,4108,1899,-2209
2018,3,21,18,1772,3985,1866,-2119
2018,3,21,19,1741,3822,1805,-2017
2018,3,21,20,1617,3665,1875,-1790
2018,3,21,21,1512,3560,1827,-1733
2018,3,21,22,1423,3480,1944,-1536
2018,3,21,23,1384,3464,1981,-1483
2018,3,22,0,1491,3524,1980,-1544
2018,3,22,1,1583,3666,1981,-1685
2018,3,22,2,1605,3760,2013,-1747
2018,3,22,3,1690,3861,2051,-1810
2018,3,22,4,1745,3830,2046,-1784
2018,3,22,5,1538,3640,1819,-1821
2018,3,22,6,1818,3332,1774,-1558
2018,3,22,7,1551,3102,1738,-1364
2018,3,22,8,1261,2836,1567,-1269
2018,3,22,9,1113,2744,1370,-1374
2018,3,22,10,1194,2676,1182,-1494
2018,3,22,11,1253,2681,1221,-1460
2018,3,22,12,1411,2962,1645,-1317
2018,3,22,13,1438,3307,1707,-1600
2018,3,22,14,1503,3715,1717,-1998
2018,3,22,15,1676,3961,1800,-2161
2018,3,22,16,1670,4002,1822,-2180
2018,3,22,17,1612,3998,1848,-2150
2018,3,22,18,1716,4010,1819,-2191
2018,3,22,19,1660,4020,1810,-2210
2018,3,22,20,1573,3999,1727,-2272
2018,3,22,21,1483,3925,1498,-2427
2018,3,22,22,1355,3881,1596,-2285
2018,3,22,23,1253,3835,1475,-2360
2018,3,23,0,1176,3771,1444,-2327
2018,3,23,1,1178,3823,1499,-2324
2018,3,23,2,1175,3985,1641,-2344
2018,3,23,3,1329,4173,1838,-2335
2018,3,23,4,1426,4162,1883,-2279
2018,3,23,5,1299,4003,1830,-2173
2018,3,23,6,1523,3693,1777,-1916
2018,3,23,7,1313,3418,1713,-1705
2018,3,23,8,1201,3257,1670,-1587
2018,3,23,9,1388,3255,1860,-1395
2018,3,23,10,1382,3268,1801,-1467
2018,3,23,11,1472,3351,1829,-1522
2018,3,23,12,1474,3519,1855,-1664
2018,3,23,13,1539,3829,1834,-1995
2018,3,23,14,1514,4198,1857,-2341
2018,3,23,15,1737,4452,1821,-2631
2018,3,23,16,1721,4471,1752,-2719
2018,3,23,17,1611,4472,1886,-2586
2018,3,23,18,1704,4459,1876,-2583
2018,3,23,19,1539,4391,1786,-2605
2018,3,23,20,1399,4253,1721,-2532
2018,3,23,21,1254,4092,1708,-2384
2018,3,23,22,1251,3839,1607,-2232
2018,3,23,23,1249,3825,1647,-2178
2018,3,24,0,1283,3834,1574,-2260
2018,3,24,1,1360,3891,1675,-2216
2018,3,24,2,1444,4126,1882,-2244
2018,3,24,3,1568,4216,1932,-2284
2018,3,24,4,1635,4218,1883,-2335
2018,3,24,5,1506,4057,1877,-2180
2018,3,24,6,1723,3845,1898,-1947
2018,3,24,7,1499,3602,1894,-1708
2018,3,24,8,1501,3425,1760,-1665
2018,3,24,9,1388,3326,1564,-1762
2018,3,24,10,1300,3307,1619,-1688
2018,3,24,11,1273,3258,1549,-1709
2018,3,24,12,1153,3317,1509,-1808
2018,3,24,13,1228,3519,1536,-1983
2018,3,24,14,1087,3756,1611,-2145
2018,3,24,15,1253,3996,1720,-2276
2018,3,24,16,1436,4202,1770,-2432
2018,3,24,17,1483,4233,1863,-2370
2018,3,24,18,1384,4048,1666,-2382
2018,3,24,19,1214,3780,1288,-2492
2018,3,24,20,1201,3679,1273,-2406
2018,3,24,21,1171,3354,1004,-2350
2018,3,24,22,1134,3208,948,-2260
2018,3,24,23,1109,3231,1066,-2165
2018,3,25,0,1149,3450,1247,-2203
2018,3,25,1,1309,3732,1499,-2233
2018,3,25,2,1436,3793,1561,-2232
2018,3,25,3,1602,3921,1687,-2234
2018,3,25,4,1656,3989,1685,-2304
2018,3,25,5,1571,3907,1607,-2300
2018,3,25,6,1742,3738,1613,-2125
2018,3,25,7,1542,3537,1666,-1871
2018,3,25,8,1349,3407,1649,-1758
2018,3,25,9,1324,3363,1686,-1677
2018,3,25,10,1301,3345,1631,-1714
2018,3,25,11,1360,3371,1643,-1728
2018,3,25,12,1433,3436,1623,-1813
2018,3,25,13,1367,3556,1642,-1914
2018,3,25,14,1216,3759,1689,-2070
2018,3,25,15,1227,3959,1697,-2262
2018,3,25,16,1406,4131,1639,-2492
2018,3,25,17,1323,4168,1525,-2643
2018,3,25,18,1211,3926,1327,-2599
2018,3,25,19,1048,3794,1349,-2445
2018,3,25,20,1068,3463,1186,-2277
2018,3,25,21,1095,3324,1056,-2268
2018,3,25,22,1121,3125,746,-2379
2018,3,25,23,1146,3064,784,-2280
2018,3,26,0,1170,3080,843,-2237
2018,3,26,1,1188,3225,1133,-2092
2018,3,26,2,1198,3337,1258,-2079
2018,3,26,3,1201,3743,1639,-2104
2018,3,26,4,1203,3835,1657,-2178
2018,3,26,5,1211,3680,1640,-2040
2018,3,26,6,1397,3455,1697,-1758
2018,3,26,7,1236,3134,1558,-1576
2018,3,26,8,1004,2858,1514,-1344
2018,3,26,9,904,2677,1398,-1279
2018,3,26,10,915,2657,1388,-1269
2018,3,26,11,993,2840,1484,-1356
2018,3,26,12,1171,3162,1627,-1535
2018,3,26,13,1386,3725,1802,-1923
2018,3,26,14,1449,4155,1812,-2343
2018,3,26,15,1399,4362,1757,-2605
2018,3,26,16,1371,4372,1583,-2789
2018,3,26,17,1274,4348,1491,-2857
2018,3,26,18,1250,4312,1537,-2775
2018,3,26,19,1193,4064,1289,-2775
2018,3,26,20,1157,4042,1252,-2790
2018,3,26,21,1180,3824,1118,-2706
2018,3,26,22,1194,3754,1020,-2734
2018,3,26,23,1212,3776,1039,-2737
2018,3,27,0,1155,3912,1085,-2827
2018,3,27,1,1171,4103,1441,-2662
2018,3,27,2,1192,4160,1545,-2615
2018,3,27,3,1211,4374,1831,-2543
2018,3,27,4,1234,4301,1772,-2529
2018,3,27,5,1252,3881,1558,-2323
2018,3,27,6,1324,3724,1827,-1897
2018,3,27,7,1320,3284,1668,-1616
2018,3,27,8,1549,3291,1882,-1409
2018,3,27,9,1604,3210,1866,-1344
2018,3,27,10,1676,3180,1897,-1283
2018,3,27,11,1688,3220,1862,-1358
2018,3,27,12,1466,3356,1912,-1444
2018,3,27,13,1753,3654,1901,-1753
2018,3,27,14,1600,4041,1842,-2199
2018,3,27,15,1675,4228,1804,-2424
2018,3,27,16,1665,4185,1820,-2365
2018,3,27,17,1598,4051,1755,-2296
2018,3,27,18,1541,4108,1706,-2402
2018,3,27,19,1517,4044,1645,-2399
2018,3,27,20,1455,3977,1515,-2462
2018,3,27,21,1398,3850,1431,-2419
2018,3,27,22,1351,3732,1402,-2330
2018,3,27,23,1344,3769,1416,-2353
2018,3,28,0,1368,3789,1359,-2430
2018,3,28,1,1446,3806,1318,-2488
2018,3,28,2,1489,3881,1499,-2382
2018,3,28,3,1573,4011,1633,-2378
2018,3,28,4,1594,4041,1666,-2375
2018,3,28,5,1380,3887,1660,-2227
2018,3,28,6,1666,3627,1692,-1935
2018,3,28,7,1393,3350,1652,-1698
2018,3,28,8,954,2857,1287,-1570
2018,3,28,9,977,2804,1302,-1502
2018,3,28,10,949,2793,1279,-1514
2018,3,28,11,1046,2866,1312,-1554
2018,3,28,12,1152,3121,1408,-1713
2018,3,28,13,1322,3601,1558,-2043
2018,3,28,14,1236,3983,1529,-2454
2018,3,28,15,1477,4240,1632,-2608
2018,3,28,16,1310,4190,1567,-2623
2018,3,28,17,1233,3903,1278,-2625
2018,3,28,18,1175,3875,1298,-2577
2018,3,28,19,1173,3745,1276,-2469
2018,3,28,20,1214,3705,1391,-2314
2018,3,28,21,1224,3612,1419,-2193
2018,3,28,22,1235,3507,1333,-2174
2018,3,28,23,1244,3442,1302,-2140
2018,3,29,0,1250,3530,1345,-2185
2018,3,29,1,1231,3630,1277,-2353
2018,3,29,2,1285,3861,1582,-2279
2018,3,29,3,1419,3986,1602,-2384
2018,3,29,4,1437,3965,1541,-2424
2018,3,29,5,1257,3779,1528,-2251
2018,3,29,6,1492,3483,1463,-2020
2018,3,29,7,1181,3201,1430,-1771
2018,3,29,8,1124,2985,1404,-1581
2018,3,29,9,1089,2854,1385,-1469
2018,3,29,10,1051,2855,1367,-1488
2018,3,29,11,1071,2899,1354,-1545
2018,3,29,12,1217,3132,1405,-1727
2018,3,29,13,1083,3456,1378,-2078
2018,3,29,14,1181,3848,1305,-2543
2018,3,29,15,1561,4035,1343,-2692
2018,3,29,16,1484,4014,1308,-2706
2018,3,29,17,1394,3940,1290,-2650
2018,3,29,18,1327,3864,1246,-2618
2018,3,29,19,1293,3776,1238,-2538
2018,3,29,20,1220,3686,1252,-2434
2018,3,29,21,1138,3595,1354,-2241
2018,3,29,22,1064,3542,1503,-2039
2018,3,29,23,1035,3515,1539,-1976
2018,3,30,0,1194,3559,1552,-2007
2018,3,30,1,1257,3625,1551,-2074
2018,3,30,2,1319,3689,1560,-2129
2018,3,30,3,1331,3806,1482,-2324
2018,3,30,4,1402,3832,1415,-2417
2018,3,30,5,1321,3657,1345,-2312
2018,3,30,6,1473,3393,1335,-2058
2018,3,30,7,1274,3140,1359,-1781
2018,3,30,8,990,2965,1352,-1613
2018,3,30,9,1002,2869,1249,-1620
2018,3,30,10,966,2748,1219,-1529
2018,3,30,11,992,2718,1215,-1503
2018,3,30,12,1066,2836,1323,-1513
2018,3,30,13,1068,3144,1356,-1788
2018,3,30,14,1089,3542,1380,-2162
2018,3,30,15,1178,3856,1462,-2394
2018,3,30,16,1126,3738,1273,-2465
2018,3,30,17,1086,3498,1065,-2433
2018,3,30,18,1129,3471,1061,-2410
2018,3,30,19,1133,3413,1099,-2314
2018,3,30,20,1134,3253,1015,-2238
2018,3,30,21,1137,3207,1063,-2144
2018,3,30,22,1138,3124,1071,-2053
2018,3,30,23,1139,3093,1148,-1945
2018,3,31,0,1137,3092,1212,-1880
2018,3,31,1,1067,3112,1211,-1901
2018,3,31,2,980,3135,1231,-1904
2018,3,31,3,1054,3300,1348,-1952
2018,3,31,4,1182,3417,1389,-2028
2018,3,31,5,1106,3383,1400,-1983
2018,3,31,6,1211,3214,1364,-1850
2018,3,31,7,1044,2960,1198,-1762
2018,3,31,8,735,2808,1145,-1663
2018,3,31,9,868,2731,1118,-1613
2018,3,31,10,843,2690,1103,-1587
2018,3,31,11,878,2709,1102,-1607
2018,3,31,12,801,2766,1124,-1642
2018,3,31,13,862,2857,1123,-1734
2018,3,31,14,708,3073,1184,-1889
2018,3,31,15,875,3270,1207,-2063
2018,3,31,16,932,3468,1219,-2249
2018,3,31,17,1004,3569,1229,-2340
2018,3,31,18,997,3518,1171,-2347
2018,3,31,19,880,3412,1073,-2339
2018,3,31,20,772,3290,1038,-2252
2018,3,31,21,829,3183,1025,-2158
2018,3,31,22,573,3094,989,-2105
2018,3,31,23,650,3045,1022,-2023
2018,4,1,0,606,2956,977,-1979
2018,4,1,1,763,3074,1027,-2047
2018,4,1,2,675,3107,1037,-2070
2018,4,1,3,659,3176,1038,-2138
2018,4,1,4,723,3319,1020,-2299
2018,4,1,5,658,3247,1024,-2223
2018,4,1,6,761,3044,1024,-2020
2018,4,1,7,738,2871,1067,-1804
2018,4,1,8,992,2678,1072,-1606
2018,4,1,9,819,2610,1117,-1493
2018,4,1,10,1007,2616,1175,-1441
2018,4,1,11,798,2646,1167,-1479
2018,4,1,12,858,2700,1200,-1500
2018,4,1,13,855,2776,1144,-1632
2018,4,1,14,1045,2956,1171,-1785
2018,4,1,15,839,3198,1291,-1907
2018,4,1,16,948,3498,1415,-2083
2018,4,1,17,1124,3661,1372,-2289
2018,4,1,18,1048,3638,1298,-2340
2018,4,1,19,999,3663,1403,-2260
2018,4,1,20,969,3624,1358,-2266
2018,4,1,21,1000,3555,1314,-2241
2018,4,1,22,1100,3463,1280,-2183
2018,4,1,23,858,3413,1273,-2140
2018,4,2,0,845,3393,1282,-2111
2018,4,2,1,840,3407,1343,-2064
2018,4,2,2,837,3476,1374,-2102
2018,4,2,3,884,3573,1357,-2216
2018,4,2,4,979,3693,1370,-2323
2018,4,2,5,880,3563,1344,-2219
2018,4,2,6,933,3330,1362,-1968
2018,4,2,7,822,3096,1342,-1754
2018,4,2,8,1133,2983,1374,-1609
2018,4,2,9,1104,2938,1361,-1577
2018,4,2,10,1085,2923,1239,-1684
2018,4,2,11,1056,2948,1147,-1801
2018,4,2,12,1059,3154,1255,-1899
2018,4,2,13,971,3537,1312,-2225
2018,4,2,14,1108,3852,1283,-2569
2018,4,2,15,1062,4129,1423,-2706
2018,4,2,16,1104,4050,1363,-2687
2018,4,2,17,1103,3879,1324,-2555
2018,4,2,18,1107,3823,1349,-2474
2018,4,2,19,1017,3651,1241,-2410
2018,4,2,20,961,3579,1234,-2345
2018,4,2,21,899,3379,1165,-2214
2018,4,2,22,775,3285,1115,-2170
2018,4,2,23,785,3264,1126,-2138
2018,4,3,0,792,3477,1257,-2220
2018,4,3,1,861,3563,1278,-2285
2018,4,3,2,961,3609,1319,-2290
2018,4,3,3,1058,3734,1329,-2405
2018,4,3,4,1116,3802,1325,-2477
2018,4,3,5,933,3587,1369,-2218
2018,4,3,6,1137,3308,1373,-1935
2018,4,3,7,857,3044,1348,-1696
2018,4,3,8,1000,2937,1339,-1598
2018,4,3,9,1038,2889,1377,-1512
2018,4,3,10,1207,2895,1556,-1339
2018,4,3,11,1158,2948,1658,-1290
2018,4,3,12,1438,3106,1788,-1318
2018,4,3,13,1478,3430,1958,-1472
2018,4,3,14,1471,3804,1946,-1858
2018,4,3,15,1560,3990,1898,-2092
2018,4,3,16,1564,3987,1832,-2155
2018,4,3,17,1474,3910,1817,-2093
2018,4,3,18,1617,3806,1791,-2015
2018,4,3,19,1527,3684,1750,-1934
2018,4,3,20,1449,3600,1678,-1922
2018,4,3,21,1370,3533,1662,-1871
2018,4,3,22,1300,3469,1612,-1857
2018,4,3,23,1261,3469,1533,-1936
2018,4,4,0,1346,3502,1625,-1877
2018,4,4,1,1409,3589,1634,-1955
2018,4,4,2,1498,3636,1735,-1901
2018,4,4,3,1583,3704,1817,-1887
2018,4,4,4,1642,3768,1819,-1949
2018,4,4,5,1462,3582,1710,-1872
2018,4,4,6,1644,3324,1678,-1646
2018,4,4,7,1365,3052,1612,-1440
2018,4,4,8,1406,2907,1626,-1281
2018,4,4,9,1182,2831,1586,-1245
2018,4,4,10,1207,2806,1608,-1198
2018,4,4,11,1336,2851,1633,-1218
2018,4,4,12,1404,3008,1773,-1235
2018,4,4,13,1432,3318,2007,-1311
2018,4,4,14,1603,3648,1954,-1694
2018,4,4,15,1840,3856,2051,-1805
2018,4,4,16,1802,3881,1977,-1904
2018,4,4,17,1737,3783,1853,-1930
2018,4,4,18,1660,3765,1906,-1859
2018,4,4,19,1613,3744,1899,-1845
2018,4,4,20,1572,3714,1924,-1790
2018,4,4,21,1524,3682,1656,-2026
2018,4,4,22,1479,3657,1643,-2014
2018,4,4,23,1473,3646,1644,-2002
2018,4,5,0,1655,3698,1689,-2009
2018,4,5,1,1706,3774,1782,-1992
2018,4,5,2,1777,3795,1974,-1821
2018,4,5,3,1847,3785,2027,-1758
2018,4,5,4,1900,3731,1890,-1841
2018,4,5,5,1734,3516,1785,-1731
2018,4,5,6,1809,3239,1811,-1428
2018,4,5,7,1560,3048,1798,-1250
2018,4,5,8,1527,2888,1655,-1233
2018,4,5,9,1432,2801,1883,-918
2018,4,5,10,1445,2780,1673,-1107
2018,4,5,11,1464,2806,1785,-1021
2018,4,5,12,1583,2958,1815,-1143
2018,4,5,13,1708,3163,1729,-1434
2018,4,5,14,1698,3501,1772,-1729
2018,4,5,15,1870,3718,1891,-1827
2018,4,5,16,1850,3742,1911,-1831
2018,4,5,17,1782,3722,1873,-1849
2018,4,5,18,1718,3700,1797,-1903
2018,4,5,19,1637,3658,1709,-1949
2018,4,5,20,1570,3597,1780,-1817
2018,4,5,21,1563,3492,1819,-1673
2018,4,5,22,1510,3425,1723,-1702
2018,4,5,23,1503,3407,1752,-1655
2018,4,6,0,1540,3447,1780,-1667
2018,4,6,1,1581,3552,1852,-1700
2018,4,6,2,1618,3580,1858,-1722
2018,4,6,3,1654,3639,1976,-1663
2018,4,6,4,1694,3620,1957,-1663
2018,4,6,5,1533,3441,1899,-1542
2018,4,6,6,1805,3156,1852,-1304
2018,4,6,7,1548,2894,1520,-1374
2018,4,6,8,1198,2775,1330,-1445
2018,4,6,9,1068,2686,1255,-1431
2018,4,6,10,1041,2636,1312,-1324
2018,4,6,11,957,2646,1313,-1333
2018,4,6,12,1057,2768,1305,-1463
2018,4,6,13,1166,3000,1401,-1599
2018,4,6,14,1008,3300,1383,-1917
2018,4,6,15,1192,3497,1427,-2070
2018,4,6,16,1188,3549,1360,-2189
2018,4,6,17,1136,3519,1350,-2169
2018,4,6,18,1080,3479,1354,-2125
2018,4,6,19,1036,3399,1357,-2042
2018,4,6,20,1001,3346,1359,-1987
2018,4,6,21,965,3280,1355,-1925
2018,4,6,22,914,3214,1334,-1880
2018,4,6,23,886,3172,1392,-1780
2018,4,7,0,896,3151,1347,-1804
2018,4,7,1,917,3156,1427,-1729
2018,4,7,2,913,3129,1385,-1744
2018,4,7,3,911,3155,1392,-1763
2018,4,7,4,936,3238,1452,-1786
2018,4,7,5,809,3144,1473,-1671
2018,4,7,6,1316,2952,1533,-1419
2018,4,7,7,1100,2757,1323,-1434
2018,4,7,8,891,2597,1209,-1388
2018,4,7,9,923,2453,1194,-1259
2018,4,7,10,918,2385,1179,-1206
2018,4,7,11,864,2380,1209,-1171
2018,4,7,12,892,2409,1172,-1237
2018,4,7,13,941,2497,1173,-1324
2018,4,7,14,795,2672,1177,-1495
2018,4,7,15,994,2867,1099,-1768
2018,4,7,16,952,3072,1154,-1918
2018,4,7,17,951,3224,1075,-2149
2018,4,7,18,924,3307,1113,-2194
2018,4,7,19,886,3294,1105,-2189
2018,4,7,20,857,3279,1099,-2180
2018,4,7,21,820,3271,1153,-2118
2018,4,7,22,793,3213,1189,-2024
2018,4,7,23,777,3179,1273,-1906
2018,4,8,0,783,3217,1330,-1887
2018,4,8,1,793,3276,1370,-1906
2018,4,8,2,806,3301,1408,-1893
2018,4,8,3,878,3334,1417,-1917
2018,4,8,4,973,3368,1388,-1980
2018,4,8,5,893,3262,1390,-1872
2018,4,8,6,1101,3098,1370,-1728
2018,4,8,7,863,2897,1251,-1646
2018,4,8,8,769,2557,1047,-1510
2018,4,8,9,664,2406,917,-1489
2018,4,8,10,593,2374,854,-1520
2018,4,8,11,547,2367,813,-1554
2018,4,8,12,568,2405,900,-1505
2018,4,8,13,690,2481,876,-1605
2018,4,8,14,442,2658,870,-1788
2018,4,8,15,586,3032,1008,-2024
2018,4,8,16,736,3145,897,-2248
2018,4,8,17,805,3293,946,-2347
2018,4,8,18,799,3410,1003,-2407
2018,4,8,19,771,3263,764,-2499
2018,4,8,20,744,3214,775,-2439
2018,4,8,21,690,3156,800,-2356
2018,4,8,22,687,3104,966,-2138
2018,4,8,23,683,2972,693,-2279
2018,4,9,0,731,3074,1020,-2054
2018,4,9,1,783,3379,1395,-1984
2018,4,9,2,783,3427,1438,-1989
2018,4,9,3,835,3538,1430,-2108
2018,4,9,4,914,3575,1492,-2083
2018,4,9,5,753,3247,1359,-1888
2018,4,9,6,966,3115,1382,-1733
2018,4,9,7,834,2845,1314,-1531
2018,4,9,8,873,2532,1165,-1367
2018,4,9,9,870,2478,1179,-1299
2018,4,9,10,830,2445,1172,-1273
2018,4,9,11,873,2480,1204,-1276
2018,4,9,12,956,2658,1324,-1334
2018,4,9,13,1182,3180,1606,-1574
2018,4,9,14,1310,3531,1548,-1983
2018,4,9,15,1388,3734,1532,-2202
2018,4,9,16,1429,3681,1512,-2169
2018,4,9,17,1383,3612,1469,-2143
2018,4,9,18,1329,3513,1455,-2058
2018,4,9,19,1254,3384,1382,-2002
2018,4,9,20,1178,3321,1376,-1945
2018,4,9,21,1096,3278,1447,-1831
2018,4,9,22,1032,3210,1479,-1731
2018,4,9,23,1016,3137,1484,-1653
2018,4,10,0,1033,3128,1448,-1680
2018,4,10,1,1093,3216,1434,-1782
2018,4,10,2,1127,3239,1435,-1804
2018,4,10,3,1149,3301,1488,-1813
2018,4,10,4,1210,3413,1511,-1902
2018,4,10,5,1039,3233,1426,-1807
2018,4,10,6,1262,2922,1407,-1515
2018,4,10,7,1170,2680,1205,-1475
2018,4,10,8,979,2561,1176,-1385
2018,4,10,9,982,2508,1208,-1300
2018,4,10,10,1005,2480,1230,-1250
2018,4,10,11,951,2519,1208,-1311
2018,4,10,12,989,2592,1161,-1431
2018,4,10,13,931,2842,1110,-1732
2018,4,10,14,999,3211,1072,-2139
2018,4,10,15,1196,3268,842,-2426
2018,4,10,16,1207,3421,1148,-2273
2018,4,10,17,1136,3402,1095,-2307
2018,4,10,18,1060,3412,1144,-2268
2018,4,10,19,1033,3387,1171,-2216
2018,4,10,20,981,3389,1183,-2206
2018,4,10,21,910,3318,1245,-2073
2018,4,10,22,1007,3249,1190,-2059
2018,4,10,23,814,3206,1214,-1992
2018,4,11,0,979,3199,1217,-1982
2018,4,11,1,979,3231,1209,-2022
2018,4,11,2,1091,3260,1286,-1974
2018,4,11,3,1142,3310,1248,-2062
2018,4,11,4,1022,3435,1267,-2168
2018,4,11,5,857,3319,1306,-2013
2018,4,11,6,1127,3075,1297,-1778
2018,4,11,7,888,2801,1257,-1544
2018,4,11,8,792,2660,1168,-1492
2018,4,11,9,778,2580,1108,-1472
2018,4,11,10,690,2448,1047,-1401
2018,4,11,11,816,2485,1041,-1444
2018,4,11,12,914,2723,1250,-1473
2018,4,11,13,950,3022,1384,-1638
2018,4,11,14,978,3367,1413,-1954
2018,4,11,15,1015,3537,1429,-2108
2018,4,11,16,1069,3523,1320,-2203
2018,4,11,17,1055,3452,1315,-2137
2018,4,11,18,1044,3479,1334,-2145
2018,4,11,19,1032,3488,1381,-2107
2018,4,11,20,1019,3493,1415,-2078
2018,4,11,21,1038,3467,1384,-2083
2018,4,11,22,1049,3444,1427,-2017
2018,4,11,23,1048,3458,1410,-2048
2018,4,12,0,1082,3512,1432,-2080
2018,4,12,1,1112,3588,1442,-2146
2018,4,12,2,1108,3625,1436,-2189
2018,4,12,3,1135,3675,1433,-2242
2018,4,12,4,1191,3696,1434,-2262
2018,4,12,5,1004,3521,1417,-2104
2018,4,12,6,1270,3250,1413,-1837
2018,4,12,7,953,3008,1341,-1667
2018,4,12,8,1141,2820,1446,-1374
2018,4,12,9,1140,2710,1372,-1338
2018,4,12,10,982,2740,1401,-1339
2018,4,12,11,920,2745,1380,-1365
2018,4,12,12,1002,2964,1440,-1524
2018,4,12,13,1097,3277,1495,-1782
2018,4,12,14,1125,3639,1429,-2210
2018,4,12,15,1169,3821,1472,-2349
2018,4,12,16,1151,3798,1480,-2318
2018,4,12,17,1061,3732,1459,-2273
2018,4,12,18,1061,3610,1374,-2236
2018,4,12,19,1000,3592,1358,-2234
2018,4,12,20,938,3646,1498,-2148
2018,4,12,21,885,3592,1459,-2133
2018,4,12,22,867,3519,1446,-2073
2018,4,12,23,870,3365,1216,-2149
2018,4,13,0,897,3403,1260,-2143
2018,4,13,1,939,3462,1420,-2042
2018,4,13,2,1011,3515,1502,-2013
2018,4,13,3,1081,3556,1520,-2036
2018,4,13,4,1187,3657,1502,-2155
2018,4,13,5,1023,3529,1489,-2040
2018,4,13,6,1281,3248,1499,-1749
2018,4,13,7,1026,3007,1504,-1503
2018,4,13,8,978,2851,1447,-1404
2018,4,13,9,931,2773,1414,-1359
2018,4,13,10,943,2745,1328,-1417
2018,4,13,11,868,2814,1318,-1496
2018,4,13,12,844,2907,1150,-1757
2018,4,13,13,870,3224,1101,-2123
2018,4,13,14,892,3562,1090,-2472
2018,4,13,15,933,3740,1164,-2576
2018,4,13,16,973,3782,1178,-2604
2018,4,13,17,944,3754,1165,-2589
2018,4,13,18,890,3689,1138,-2551
2018,4,13,19,845,3610,999,-2611
2018,4,13,20,856,3541,973,-2568
2018,4,13,21,788,3547,1088,-2459
2018,4,13,22,732,3515,993,-2522
2018,4,13,23,746,3482,1026,-2456
2018,4,14,0,756,3551,1039,-2512
2018,4,14,1,769,3578,1053,-2525
2018,4,14,2,830,3571,1192,-2379
2018,4,14,3,838,3480,1135,-2345
2018,4,14,4,843,3461,1248,-2213
2018,4,14,5,848,3272,1274,-1998
2018,4,14,6,1212,3095,1345,-1750
2018,4,14,7,982,2788,1172,-1616
2018,4,14,8,719,2572,1118,-1454
2018,4,14,9,730,2474,1120,-1354
2018,4,14,10,664,2424,1135,-1289
2018,4,14,11,645,2421,1090,-1331
2018,4,14,12,765,2461,1078,-1383
2018,4,14,13,727,2577,989,-1588
2018,4,14,14,460,2754,978,-1776
2018,4,14,15,672,2997,1005,-1992
2018,4,14,16,774,3296,1094,-2202
2018,4,14,17,859,3416,1160,-2256
2018,4,14,18,876,3424,1188,-2236
2018,4,14,19,894,3397,1225,-2172
2018,4,14,20,947,3408,1227,-2181
2018,4,14,21,928,3321,1216,-2105
2018,4,14,22,916,3280,1218,-2062
2018,4,14,23,911,3320,1196,-2124
2018,4,15,0,943,3365,1244,-2121
2018,4,15,1,1004,3411,1265,-2146
2018,4,15,2,998,3407,1367,-2040
2018,4,15,3,1024,3412,1319,-2093
2018,4,15,4,1061,3408,1325,-2083
2018,4,15,5,959,3308,1330,-1978
2018,4,15,6,1396,3112,1286,-1826
2018,4,15,7,1199,2911,1272,-1639
2018,4,15,8,1002,2781,1247,-1534
2018,4,15,9,855,2648,1209,-1439
2018,4,15,10,805,2599,1284,-1315
2018,4,15,11,818,2559,1249,-1310
2018,4,15,12,936,2681,1246,-1435
2018,4,15,13,895,2784,1241,-1543
2018,4,15,14,734,2954,1273,-1681
2018,4,15,15,681,3129,1192,-1937
2018,4,15,16,858,3330,1166,-2164
2018,4,15,17,947,3396,1159,-2237
2018,4,15,18,964,3347,1069,-2278
2018,4,15,19,951,3346,1143,-2203
2018,4,15,20,921,3333,1158,-2175
2018,4,15,21,852,3306,1187,-2119
2018,4,15,22,808,3265,1203,-2062
2018,4,15,23,737,3259,1200,-2059
2018,4,16,0,758,3311,1253,-2058
2018,4,16,1,816,3424,1243,-2181
2018,4,16,2,860,3450,1206,-2244
2018,4,16,3,916,3537,1217,-2320
2018,4,16,4,1025,3576,1192,-2384
2018,4,16,5,901,3417,1189,-2228
2018,4,16,6,904,3155,1207,-1948
2018,4,16,7,924,2904,1232,-1672
2018,4,16,8,924,2763,1285,-1478
2018,4,16,9,914,2689,1320,-1369
2018,4,16,10,921,2682,1428,-1254
2018,4,16,11,967,2609,1187,-1422
2018,4,16,12,1001,2897,1307,-1590
2018,4,16,13,957,3225,1300,-1925
2018,4,16,14,848,3640,1255,-2385
2018,4,16,15,1013,3883,1280,-2603
2018,4,16,16,1031,3912,1314,-2598
2018,4,16,17,981,3885,1373,-2512
2018,4,16,18,1064,3854,1425,-2429
2018,4,16,19,1040,3820,1427,-2393
2018,4,16,20,1015,3754,1369,-2385
2018,4,16,21,949,3721,1354,-2367
2018,4,16,22,903,3723,1306,-2417
2018,4,16,23,887,3746,1342,-2404
2018,4,17,0,915,3785,1336,-2449
2018,4,17,1,990,3857,1334,-2523
2018,4,17,2,973,3898,1350,-2548
2018,4,17,3,1028,3908,1368,-2540
2018,4,17,4,1071,3911,1352,-2559
2018,4,17,5,975,3695,1316,-2379
2018,4,17,6,1054,3375,1370,-2005
2018,4,17,7,957,3107,1406,-1701
2018,4,17,8,917,2897,1411,-1486
2018,4,17,9,878,2706,1311,-1395
2018,4,17,10,801,2578,1206,-1372
2018,4,17,11,834,2621,1163,-1458
2018,4,17,12,878,2779,1180,-1599
2018,4,17,13,1104,3366,1465,-1901
2018,4,17,14,1033,3752,1473,-2279
2018,4,17,15,1220,3939,1425,-2514
2018,4,17,16,1175,3851,1432,-2419
2018,4,17,17,1100,3730,1365,-2365
2018,4,17,18,1137,3648,1404,-2244
2018,4,17,19,1085,3469,1305,-2164
2018,4,17,20,1026,3394,1292,-2102
2018,4,17,21,975,3142,1135,-2007
2018,4,17,22,951,3014,1100,-1914
2018,4,17,23,956,3106,1088,-2018
2018,4,18,0,1122,3288,1205,-2083
2018,4,18,1,1228,3459,1447,-2012
2018,4,18,2,1276,3510,1462,-2048
2018,4,18,3,1336,3571,1449,-2122
2018,4,18,4,1433,3685,1462,-2223
2018,4,18,5,1327,3543,1448,-2095
2018,4,18,6,1306,3271,1436,-1835
2018,4,18,7,1267,3004,1391,-1613
2018,4,18,8,1079,2842,1214,-1628
2018,4,18,9,906,2798,1312,-1486
2018,4,18,10,1037,2783,1387,-1396
2018,4,18,11,1059,2776,1423,-1353
2018,4,18,12,1276,3000,1585,-1415
2018,4,18,13,1557,3321,1781,-1540
2018,4,18,14,1528,3695,1820,-1875
2018,4,18,15,1667,3891,1841,-2050
2018,4,18,16,1646,3793,1815,-1978
2018,4,18,17,1653,3665,1816,-1849
2018,4,18,18,1541,3563,1765,-1798
2018,4,18,19,1446,3441,1737,-1704
2018,4,18,20,1520,3364,1660,-1704
2018,4,18,21,1446,3264,1513,-1751
2018,4,18,22,1366,3211,1567,-1644
2018,4,18,23,1334,3187,1497,-1690
2018,4,19,0,1419,3199,1464,-1735
2018,4,19,1,1478,3308,1526,-1782
2018,4,19,2,1505,3327,1563,-1764
2018,4,19,3,1553,3369,1573,-1796
2018,4,19,4,1548,3491,1578,-1913
2018,4,19,5,1429,3379,1588,-1791
2018,4,19,6,1552,3125,1611,-1514
2018,4,19,7,1386,2879,1569,-1310
2018,4,19,8,1166,2600,1349,-1251
2018,4,19,9,885,2437,1240,-1197
2018,4,19,10,908,2448,1238,-1210
2018,4,19,11,900,2489,1223,-1266
2018,4,19,12,1143,2925,1507,-1418
2018,4,19,13,1139,3266,1486,-1780
2018,4,19,14,1253,3660,1548,-2112
2018,4,19,15,1243,3835,1516,-2319
2018,4,19,16,1248,3716,1449,-2267
2018,4,19,17,1238,3552,1352,-2200
2018,4,19,18,1317,3422,1373,-2049
2018,4,19,19,1382,3311,1359,-1952
2018,4,19,20,1286,3226,1330,-1896
2018,4,19,21,1220,3195,1378,-1817
2018,4,19,22,1153,3185,1442,-1743
2018,4,19,23,1117,3136,1440,-1696
2018,4,20,0,1259,3151,1494,-1657
2018,4,20,1,1304,3186,1581,-1605
2018,4,20,2,1318,3196,1597,-1599
2018,4,20,3,1318,3250,1628,-1622
2018,4,20,4,1447,3372,1664,-1708
2018,4,20,5,1346,3263,1674,-1589
2018,4,20,6,1446,3024,1722,-1302
2018,4,20,7,1227,2690,1455,-1235
2018,4,20,8,1010,2432,1353,-1079
2018,4,20,9,930,2327,1274,-1053
2018,4,20,10,857,2309,1209,-1100
2018,4,20,11,890,2401,1232,-1169
2018,4,20,12,1080,2757,1400,-1357
2018,4,20,13,1009,3103,1360,-1743
2018,4,20,14,922,3452,1330,-2122
2018,4,20,15,1139,3641,1252,-2389
2018,4,20,16,1120,3599,1245,-2354
2018,4,20,17,1028,3437,1091,-2346
2018,4,20,18,1201,3353,1093,-2260
2018,4,20,19,1149,3162,1033,-2129
2018,4,20,20,1100,3020,969,-2051
2018,4,20,21,1040,2924,846,-2078
2018,4,20,22,995,2889,914,-1975
2018,4,20,23,965,2897,1005,-1892
2018,4,21,0,971,2909,896,-2013
2018,4,21,1,1081,3098,1043,-2055
2018,4,21,2,988,3230,1457,-1773
2018,4,21,3,978,3245,1443,-1802
2018,4,21,4,1069,3290,1474,-1816
2018,4,21,5,995,3195,1522,-1673
2018,4,21,6,1414,3010,1589,-1421
2018,4,21,7,1247,2803,1604,-1199
2018,4,21,8,1095,2647,1411,-1236
2018,4,21,9,1080,2488,1330,-1158
2018,4,21,10,860,2277,1189,-1088
2018,4,21,11,879,2272,1203,-1069
2018,4,21,12,802,2328,1224,-1104
2018,4,21,13,823,2494,1256,-1238
2018,4,21,14,729,2662,1216,-1446
2018,4,21,15,820,2895,1194,-1701
2018,4,21,16,988,3048,1170,-1878
2018,4,21,17,1037,3302,1411,-1891
2018,4,21,18,1034,3063,1122,-1941
2018,4,21,19,1021,2895,1035,-1860
2018,4,21,20,970,2871,1140,-1731
2018,4,21,21,904,2796,1198,-1598
2018,4,21,22,870,2778,1234,-1544
2018,4,21,23,892,2788,1247,-1541
2018,4,22,0,911,3052,1463,-1589
2018,4,22,1,1024,3052,1495,-1557
2018,4,22,2,1007,3073,1499,-1574
2018,4,22,3,984,3097,1470,-1627
2018,4,22,4,1043,3214,1481,-1733
2018,4,22,5,1022,3184,1481,-1703
2018,4,22,6,1017,3042,1444,-1598
2018,4,22,7,951,2844,1389,-1455
2018,4,22,8,967,2625,1157,-1468
2018,4,22,9,836,2551,1135,-1416
2018,4,22,10,941,2618,1206,-1412
2018,4,22,11,906,2627,1183,-1444
2018,4,22,12,964,2689,1214,-1475
2018,4,22,13,961,2807,1187,-1620
2018,4,22,14,951,2994,1074,-1920
2018,4,22,15,1015,3195,1184,-2011
2018,4,22,16,1160,3332,1171,-2161
2018,4,22,17,1193,3362,1190,-2172
2018,4,22,18,1142,3300,1205,-2095
2018,4,22,19,1069,3212,1208,-2004
2018,4,22,20,1008,3128,1195,-1933
2018,4,22,21,935,3043,1212,-1831
2018,4,22,22,861,2973,1212,-1761
2018,4,22,23,850,2943,1207,-1736
2018,4,23,0,878,2930,1173,-1757
2018,4,23,1,966,3017,1252,-1765
2018,4,23,2,1010,3098,1423,-1675
2018,4,23,3,1059,3151,1420,-1731
2018,4,23,4,1182,3286,1438,-1848
2018,4,23,5,1093,3234,1443,-1791
2018,4,23,6,1273,2990,1454,-1536
2018,4,23,7,1049,2751,1439,-1312
2018,4,23,8,926,2362,1203,-1159
2018,4,23,9,901,2303,1265,-1038
2018,4,23,10,910,2319,1375,-944
2018,4,23,11,977,2415,1467,-948
2018,4,23,12,1287,2834,1799,-1035
2018,4,23,13,1410,3189,1932,-1257
2018,4,23,14,1569,3561,1951,-1610
2018,4,23,15,1614,3736,2005,-1731
2018,4,23,16,1693,3623,1776,-1847
2018,4,23,17,1712,3484,2001,-1483
2018,4,23,18,1687,3361,1967,-1394
2018,4,23,19,1575,3296,1923,-1373
2018,4,23,20,1593,3237,1903,-1334
2018,4,23,21,1532,3192,1943,-1249
2018,4,23,22,1490,3124,1874,-1250
2018,4,23,23,1459,3134,1876,-1258
2018,4,24,0,1556,3137,1866,-1271
2018,4,24,1,1624,3190,1870,-1320
2018,4,24,2,1641,3179,1880,-1299
2018,4,24,3,1655,3188,1823,-1365
2018,4,24,4,1658,3292,1797,-1495
2018,4,24,5,1545,3180,1811,-1369
2018,4,24,6,1233,2906,1581,-1325
2018,4,24,7,974,2621,1554,-1067
2018,4,24,8,1145,2492,1545,-947
2018,4,24,9,1088,2411,1410,-1001
2018,4,24,10,1133,2422,1486,-936
2018,4,24,11,1156,2469,1537,-932
2018,4,24,12,1221,2611,1584,-1027
2018,4,24,13,1213,2927,1621,-1306
2018,4,24,14,1251,3260,1601,-1659
2018,4,24,15,1481,3402,1515,-1887
2018,4,24,16,1457,3336,1341,-1995
2018,4,24,17,1369,3285,1447,-1838
2018,4,24,18,1387,3232,1601,-1631
2018,4,24,19,1356,3189,1495,-1694
2018,4,24,20,1363,3092,1439,-1653
2018,4,24,21,1363,2997,1430,-1567
2018,4,24,22,1365,3127,1528,-1599
2018,4,24,23,1372,3143,1552,-1591
2018,4,25,0,1403,3159,1506,-1653
2018,4,25,1,1455,3193,1468,-1725
2018,4,25,2,1425,3203,1421,-1782
2018,4,25,3,1416,3194,1451,-1743
2018,4,25,4,1453,3289,1511,-1778
2018,4,25,5,1311,3135,1485,-1650
2018,4,25,6,1426,2886,1527,-1359
2018,4,25,7,1147,2615,1501,-1114
2018,4,25,8,1256,2464,1534,-930
2018,4,25,9,1199,2370,1522,-848
2018,4,25,10,1110,2188,1352,-836
2018,4,25,11,1129,2203,1376,-827
2018,4,25,12,1258,2466,1604,-862
2018,4,25,13,1448,2735,1717,-1018
2018,4,25,14,1485,3048,1592,-1456
2018,4,25,15,1520,3221,1627,-1594
2018,4,25,16,1518,3195,1522,-1673
2018,4,25,17,1478,3163,1400,-1763
2018,4,25,18,1457,3136,1454,-1682
2018,4,25,19,1442,3149,1578,-1571
2018,4,25,20,1598,3135,1586,-1549
2018,4,25,21,1599,3134,1561,-1573
2018,4,25,22,1614,3111,1598,-1513
2018,4,25,23,1627,3142,1722,-1420
2018,4,26,0,1733,3152,1713,-1439
2018,4,26,1,1791,3178,1692,-1486
2018,4,26,2,1786,3171,1658,-1513
2018,4,26,3,1741,3174,1627,-1547
2018,4,26,4,1771,3243,1667,-1576
2018,4,26,5,1643,3134,1577,-1557
2018,4,26,6,1716,2885,1802,-1083
2018,4,26,7,1440,2597,1605,-992
2018,4,26,8,1249,2431,1474,-957
2018,4,26,9,1169,2370,1421,-949
2018,4,26,10,1136,2327,1439,-888
2018,4,26,11,1114,2283,1424,-859
2018,4,26,12,1222,2385,1428,-957
2018,4,26,13,1272,2691,1459,-1232
2018,4,26,14,1276,2999,1411,-1588
2018,4,26,15,1224,3193,1411,-1782
2018,4,26,16,1215,3217,1478,-1739
2018,4,26,17,1167,3156,1399,-1757
2018,4,26,18,1143,3185,1365,-1820
2018,4,26,19,1115,3139,1290,-1849
2018,4,26,20,1094,3039,1175,-1864
2018,4,26,21,1103,3126,1253,-1873
2018,4,26,22,1126,3187,1310,-1877
2018,4,26,23,1136,3233,1328,-1905
2018,4,27,0,1156,3256,1347,-1909
2018,4,27,1,1202,3268,1457,-1811
2018,4,27,2,1186,3263,1462,-1801
2018,4,27,3,1185,3224,1494,-1730
2018,4,27,4,1248,3273,1509,-1764
2018,4,27,5,1129,3177,1481,-1696
2018,4,27,6,1537,2924,1518,-1406
2018,4,27,7,1318,2628,1323,-1305
2018,4,27,8,789,2222,998,-1224
2018,4,27,9,1006,2300,1075,-1225
2018,4,27,10,919,2238,1207,-1031
2018,4,27,11,953,2237,1227,-1010
2018,4,27,12,1047,2394,1297,-1097
2018,4,27,13,961,2576,1314,-1262
2018,4,27,14,973,2834,1174,-1660
2018,4,27,15,965,3114,1358,-1756
2018,4,27,16,977,3212,1352,-1860
2018,4,27,17,999,3237,1353,-1884
2018,4,27,18,1036,3222,1301,-1921
2018,4,27,19,1018,3166,1297,-1869
2018,4,27,20,977,3171,1380,-1791
2018,4,27,21,960,3132,1350,-1782
2018,4,27,22,1001,3081,1342,-1739
2018,4,27,23,941,3003,1169,-1834
2018,4,28,0,916,2998,1141,-1857
2018,4,28,1,919,2944,1002,-1942
2018,4,28,2,948,3027,1348,-1679
2018,4,28,3,835,2873,1270,-1603
2018,4,28,4,841,2940,1299,-1641
2018,4,28,5,835,2813,1213,-1600
2018,4,28,6,978,2710,1331,-1379
2018,4,28,7,912,2414,1202,-1212
2018,4,28,8,863,2255,1191,-1064
2018,4,28,9,811,2146,1025,-1121
2018,4,28,10,701,2106,1043,-1063
2018,4,28,11,731,2089,1048,-1041
2018,4,28,12,849,2121,1014,-1107
2018,4,28,13,761,2231,983,-1248
2018,4,28,14,737,2395,1086,-1309
2018,4,28,15,734,2540,1108,-1432
2018,4,28,16,733,2762,1073,-1689
2018,4,28,17,739,2864,1009,-1855
2018,4,28,18,718,2928,1033,-1895
2018,4,28,19,720,2942,1026,-1916
2018,4,28,20,710,2916,910,-2006
2018,4,28,21,706,2828,1013,-1815
2018,4,28,22,698,2758,946,-1812
2018,4,28,23,694,2734,1032,-1702
2018,4,29,0,687,2758,1102,-1656
2018,4,29,1,822,2793,1120,-1673
2018,4,29,2,822,2828,1133,-1695
2018,4,29,3,826,2919,1203,-1716
2018,4,29,4,835,2999,1301,-1698
2018,4,29,5,891,2915,1313,-1602
2018,4,29,6,1313,2753,1299,-1454
2018,4,29,7,1170,2559,1277,-1282
2018,4,29,8,890,2381,1160,-1221
2018,4,29,9,923,2235,1146,-1089
2018,4,29,10,859,2151,1140,-1011
2018,4,29,11,894,2141,1158,-983
2018,4,29,12,884,2201,1166,-1035
2018,4,29,13,957,2271,1186,-1085
2018,4,29,14,878,2384,1073,-1311
2018,4,29,15,856,2575,1058,-1517
2018,4,29,16,869,2746,944,-1802
2018,4,29,17,924,2825,890,-1935
2018,4,29,18,914,2835,1021,-1814
2018,4,29,19,889,2801,956,-1845
2018,4,29,20,872,2754,947,-1807
2018,4,29,21,826,2710,965,-1745
2018,4,29,22,823,2668,979,-1689
2018,4,29,23,844,2680,1131,-1549
2018,4,30,0,892,2749,1198,-1551
2018,4,30,1,921,2833,1223,-1610
2018,4,30,2,963,2858,1221,-1637
2018,4,30,3,1009,2914,1201,-1713
2018,4,30,4,1096,3053,1258,-1795
2018,4,30,5,975,2960,1277,-1683
2018,4,30,6,1136,2624,1157,-1467
2018,4,30,7,851,2379,1129,-1250
2018,4,30,8,790,2214,1084,-1130
2018,4,30,9,750,2140,1062,-1078
2018,4,30,10,726,2125,1068,-1057
2018,4,30,11,778,2169,1036,-1133
2018,4,30,12,711,2285,993,-1292
2018,4,30,13,1001,2693,1091,-1602
2018,4,30,14,821,3044,1070,-1974
2018,4,30,15,780,3263,1029,-2234
2018,4,30,16,908,3302,1014,-2288
2018,4,30,17,836,3125,891,-2234
2018,4,30,18,770,3050,854,-2196
2018,4,30,19,778,3034,882,-2152
2018,4,30,20,783,3005,888,-2117
2018,4,30,21,766,2993,879,-2114
2018,4,30,22,751,2980,912,-2068
2018,4,30,23,765,2921,893,-2028
2018,5,1,0,802,3013,1008,-2005
2018,5,1,1,864,3118,1110,-2008
2018,5,1,2,882,3117,1116,-2001
2018,5,1,3,843,3091,1180,-1911
2018,5,1,4,890,3173,1235,-1938
2018,5,1,5,915,3030,1191,-1839
2018,5,1,6,990,2798,1174,-1624
2018,5,1,7,996,2438,1084,-1354
2018,5,1,8,848,2350,1194,-1156
2018,5,1,9,746,2206,1109,-1097
2018,5,1,10,790,2133,934,-1199
2018,5,1,11,941,2151,1044,-1107
2018,5,1,12,957,2402,1263,-1139
2018,5,1,13,1123,2734,1449,-1285
2018,5,1,14,1131,3045,1501,-1544
2018,5,1,15,1243,3253,1526,-1727
2018,5,1,16,1350,3278,1556,-1722
2018,5,1,17,1193,3208,1558,-1650
2018,5,1,18,1226,3168,1539,-1629
2018,5,1,19,1021,3112,1529,-1583
2018,5,1,20,1207,3072,1545,-1527
2018,5,1,21,1289,3010,1516,-1494
2018,5,1,22,1325,2871,1426,-1445
2018,5,1,23,1224,2940,1510,-1430
2018,5,2,0,1227,2960,1520,-1440
2018,5,2,1,1274,2984,1530,-1454
2018,5,2,2,1415,2987,1610,-1377
2018,5,2,3,1368,2994,1602,-1392
2018,5,2,4,1311,3093,1627,-1466
2018,5,2,5,1345,3030,1618,-1412
2018,5,2,6,1357,2792,1614,-1178
2018,5,2,7,1122,2542,1388,-1154
2018,5,2,8,1009,2401,1340,-1061
2018,5,2,9,934,2262,1268,-994
2018,5,2,10,894,2240,1260,-980
2018,5,2,11,953,2276,1298,-978
2018,5,2,12,1156,2520,1471,-1049
2018,5,2,13,1288,2836,1608,-1228
2018,5,2,14,1311,3167,1658,-1509
2018,5,2,15,1388,3345,1651,-1694
2018,5,2,16,1519,3394,1750,-1644
2018,5,2,17,1450,3304,1747,-1557
2018,5,2,18,1488,3254,1729,-1525
2018,5,2,19,1451,3202,1612,-1590
2018,5,2,20,1451,3169,1595,-1574
2018,5,2,21,1443,2967,1557,-1410
2018,5,2,22,1288,2939,1673,-1266
2018,5,2,23,1273,2989,1576,-1413
2018,5,3,0,1314,3032,1431,-1601
2018,5,3,1,1464,3147,1567,-1580
2018,5,3,2,1444,3151,1634,-1517
2018,5,3,3,1415,3164,1846,-1318
2018,5,3,4,1387,3221,1758,-1463
2018,5,3,5,1355,3162,1746,-1416
2018,5,3,6,1429,2919,1780,-1139
2018,5,3,7,1255,2595,1426,-1169
2018,5,3,8,947,2253,1152,-1101
2018,5,3,9,773,2140,1028,-1112
2018,5,3,10,716,2100,974,-1126
2018,5,3,11,730,2131,978,-1153
2018,5,3,12,878,2315,1168,-1147
2018,5,3,13,1188,2744,1444,-1300
2018,5,3,14,1186,3043,1464,-1579
2018,5,3,15,1268,3239,1446,-1793
2018,5,3,16,1237,3214,1368,-1846
2018,5,3,17,1257,3171,1330,-1841
2018,5,3,18,1194,3176,1479,-1697
2018,5,3,19,1188,3164,1453,-1711
2018,5,3,20,1170,3170,1374,-1796
2018,5,3,21,1193,3172,1414,-1758
2018,5,3,22,1225,3165,1476,-1689
2018,5,3,23,1221,3164,1472,-1692
2018,5,4,0,1213,3187,1482,-1705
2018,5,4,1,1234,3194,1473,-1721
2018,5,4,2,1229,3150,1462,-1688
2018,5,4,3,1220,3099,1442,-1657
2018,5,4,4,1265,3172,1424,-1748
2018,5,4,5,1297,3129,1458,-1671
2018,5,4,6,1151,2860,1490,-1370
2018,5,4,7,989,2552,1194,-1358
2018,5,4,8,689,2213,1163,-1050
2018,5,4,9,778,2090,933,-1157
2018,5,4,10,703,2047,988,-1059
2018,5,4,11,672,2086,1135,-951
2018,5,4,12,816,2166,1214,-952
2018,5,4,13,797,2367,1172,-1195
2018,5,4,14,1041,2678,1138,-1540
2018,5,4,15,1168,3121,1423,-1698
2018,5,4,16,1117,3212,1433,-1779
2018,5,4,17,1118,3221,1395,-1826
2018,5,4,18,1114,3237,1435,-1802
2018,5,4,19,1096,3168,1459,-1709
2018,5,4,20,1037,3143,1430,-1713
2018,5,4,21,1039,3113,1400,-1713
2018,5,4,22,1044,3093,1362,-1731
2018,5,4,23,1052,3066,1336,-1730
2018,5,5,0,1106,2985,1322,-1663
2018,5,5,1,1157,3043,1356,-1687
2018,5,5,2,1142,2978,1343,-1635
2018,5,5,3,1132,3013,1369,-1644
2018,5,5,4,1219,3050,1397,-1653
2018,5,5,5,1197,3042,1421,-1621
2018,5,5,6,1289,2870,1442,-1428
2018,5,5,7,1075,2630,1412,-1218
2018,5,5,8,882,2261,1176,-1085
2018,5,5,9,841,2159,1096,-1063
2018,5,5,10,803,2113,1054,-1059
2018,5,5,11,761,2112,1028,-1084
2018,5,5,12,803,2146,1036,-1110
2018,5,5,13,812,2250,1038,-1212
2018,5,5,14,774,2376,1041,-1335
2018,5,5,15,1019,2742,1213,-1529
2018,5,5,16,1043,2918,1235,-1683
2018,5,5,17,1119,2889,1163,-1726
2018,5,5,18,1134,2922,1154,-1768
2018,5,5,19,1105,2742,1030,-1712
2018,5,5,20,1021,2709,1046,-1663
2018,5,5,21,1022,2685,1054,-1631
2018,5,5,22,1022,2676,1071,-1605
2018,5,5,23,1023,2663,1074,-1589
2018,5,6,0,1038,2736,1130,-1606
2018,5,6,1,1081,2838,1214,-1624
2018,5,6,2,1084,2913,1289,-1624
2018,5,6,3,1066,2934,1284,-1650
2018,5,6,4,1154,2970,1259,-1711
2018,5,6,5,1112,2934,1267,-1667
2018,5,6,6,1129,2787,1293,-1494
2018,5,6,7,1018,2516,1254,-1262
2018,5,6,8,833,2194,1091,-1103
2018,5,6,9,850,2072,1040,-1032
2018,5,6,10,798,2027,1014,-1013
2018,5,6,11,769,1995,1015,-980
2018,5,6,12,805,2011,1039,-972
2018,5,6,13,762,2083,1108,-975
2018,5,6,14,760,2154,1067,-1087
2018,5,6,15,914,2429,1102,-1327
2018,5,6,16,1057,2587,1163,-1424
2018,5,6,17,1182,2901,1324,-1577
2018,5,6,18,851,2712,1031,-1681
2018,5,6,19,847,2723,1009,-1714
2018,5,6,20,828,2688,1016,-1672
2018,5,6,21,832,2669,945,-1724
2018,5,6,22,839,2699,963,-1736
2018,5,6,23,850,2719,1021,-1698
2018,5,7,0,856,2753,1136,-1617
2018,5,7,1,910,2968,1418,-1550
2018,5,7,2,918,2966,1314,-1652
2018,5,7,3,922,3079,1271,-1808
2018,5,7,4,931,3119,1287,-1832
2018,5,7,5,842,2925,1223,-1702
2018,5,7,6,1070,2656,1250,-1406
2018,5,7,7,1002,2390,1249,-1141
2018,5,7,8,848,2120,1061,-1059
2018,5,7,9,795,2024,969,-1055
2018,5,7,10,783,1987,964,-1023
2018,5,7,11,768,1997,1007,-990
2018,5,7,12,775,2096,1078,-1018
2018,5,7,13,823,2318,1138,-1180
2018,5,7,14,924,2590,1194,-1396
2018,5,7,15,1185,2944,1260,-1684
2018,5,7,16,1234,2906,1198,-1708
2018,5,7,17,1283,2967,1153,-1814
2018,5,7,18,1331,2972,1127,-1845
2018,5,7,19,1371,3106,1370,-1736
2018,5,7,20,1410,3144,1416,-1728
2018,5,7,21,1428,3123,1415,-1708
2018,5,7,22,1422,3098,1401,-1697
2018,5,7,23,1420,3101,1408,-1693
2018,5,8,0,1410,3131,1402,-1729
2018,5,8,1,1421,3170,1460,-1710
2018,5,8,2,1433,3185,1474,-1711
2018,5,8,3,1441,3073,1382,-1691
2018,5,8,4,1443,3064,1397,-1667
2018,5,8,5,1317,3003,1347,-1656
2018,5,8,6,1313,2722,1366,-1356
2018,5,8,7,1158,2463,1305,-1158
2018,5,8,8,960,2178,1176,-1002
2018,5,8,9,841,2079,1135,-944
2018,5,8,10,822,2028,1009,-1019
2018,5,8,11,838,2054,1169,-885
2018,5,8,12,1012,2266,1353,-913
2018,5,8,13,1326,2552,1571,-981
2018,5,8,14,1507,2890,1594,-1296
2018,5,8,15,1714,3097,1789,-1308
2018,5,8,16,1731,3117,1806,-1311
2018,5,8,17,1710,3122,1803,-1319
2018,5,8,18,1604,3144,1780,-1364
2018,5,8,19,1592,3155,1771,-1384
2018,5,8,20,1586,3176,1776,-1400
2018,5,8,21,1574,3199,1829,-1370
2018,5,8,22,1565,3216,1835,-1381
2018,5,8,23,1557,3223,1833,-1390
2018,5,9,0,1571,3250,1809,-1441
2018,5,9,1,1588,3271,1776,-1495
2018,5,9,2,1559,3261,1748,-1513
2018,5,9,3,1433,3143,1771,-1372
2018,5,9,4,1429,3079,1671,-1408
2018,5,9,5,1458,2986,1571,-1415
2018,5,9,6,1225,2721,1607,-1114
2018,5,9,7,941,2347,999,-1348
2018,5,9,8,624,2216,896,-1320
2018,5,9,9,750,2091,953,-1138
2018,5,9,10,842,2156,1023,-1133
2018,5,9,11,802,2134,1011,-1123
2018,5,9,12,782,2207,1046,-1161
2018,5,9,13,1027,2485,1116,-1369
2018,5,9,14,1091,2804,1159,-1645
2018,5,9,15,1280,3013,1260,-1753
2018,5,9,16,1281,3062,1260,-1802
2018,5,9,17,1270,2910,1104,-1806
2018,5,9,18,1255,3059,1190,-1869
2018,5,9,19,1212,2961,1088,-1873
2018,5,9,20,1140,2908,1056,-1852
2018,5,9,21,1134,2883,1122,-1761
2018,5,9,22,1120,2881,1190,-1691
2018,5,9,23,1117,2893,1102,-1791
2018,5,10,0,1138,2846,1101,-1745
2018,5,10,1,1180,3111,1373,-1738
2018,5,10,2,1186,3065,1350,-1715
2018,5,10,3,1183,2813,1177,-1636
2018,5,10,4,1288,2825,1133,-1692
2018,5,10,5,1164,2775,1108,-1667
2018,5,10,6,1025,2572,1149,-1423
2018,5,10,7,777,2346,1138,-1208
2018,5,10,8,790,2297,1024,-1273
2018,5,10,9,679,2107,909,-1198
2018,5,10,10,680,2066,905,-1161
2018,5,10,11,685,2067,897,-1170
2018,5,10,12,680,2235,946,-1289
2018,5,10,13,902,2816,1305,-1511
2018,5,10,14,928,2901,1090,-1811
2018,5,10,15,1010,3111,1113,-1998
2018,5,10,16,924,3216,1136,-2080
2018,5,10,17,1053,3187,1136,-2051
2018,5,10,18,1038,3127,1098,-2029
2018,5,10,19,1018,3084,1084,-2000
2018,5,10,20,1128,2950,987,-1963
2018,5,10,21,1139,2860,919,-1941
2018,5,10,22,1146,2860,974,-1886
2018,5,10,23,1155,2866,1204,-1662
2018,5,11,0,1028,2898,1281,-1617
2018,5,11,1,1026,2970,1351,-1619
2018,5,11,2,1039,2952,1300,-1652
2018,5,11,3,1046,2891,1240,-1651
2018,5,11,4,1160,3046,1374,-1672
2018,5,11,5,1154,2953,1226,-1727
2018,5,11,6,1257,2739,1280,-1459
2018,5,11,7,1115,2475,1256,-1219
2018,5,11,8,715,2213,915,-1298
2018,5,11,9,590,2097,952,-1145
2018,5,11,10,617,2063,1039,-1024
2018,5,11,11,660,2064,1129,-935
2018,5,11,12,710,2166,1101,-1065
2018,5,11,13,1256,2410,1166,-1244
2018,5,11,14,1139,2812,1228,-1584
2018,5,11,15,1364,3034,1490,-1544
2018,5,11,16,1413,3068,1407,-1661
2018,5,11,17,1402,3007,1397,-1610
2018,5,11,18,1381,2894,1132,-1762
2018,5,11,19,1367,2844,1228,-1616
2018,5,11,20,1331,2922,1420,-1502
2018,5,11,21,1292,2896,1473,-1423
2018,5,11,22,1261,2726,1307,-1419
2018,5,11,23,1234,2706,1271,-1435
2018,5,12,0,1235,2783,1339,-1444
2018,5,12,1,1255,2847,1353,-1494
2018,5,12,2,1225,2825,1458,-1367
2018,5,12,3,1192,2775,1519,-1256
2018,5,12,4,1218,2788,1498,-1290
2018,5,12,5,1214,2800,1469,-1331
2018,5,12,6,1448,2643,1514,-1129
2018,5,12,7,1222,2442,1506,-936
2018,5,12,8,1052,2262,1491,-771
2018,5,12,9,867,2047,1352,-695
2018,5,12,10,833,1990,1315,-675
2018,5,12,11,787,1991,1320,-671
2018,5,12,12,855,2030,1354,-676
2018,5,12,13,945,2120,1366,-754
2018,5,12,14,711,2237,1151,-1086
2018,5,12,15,916,2439,1128,-1311
2018,5,12,16,1092,2611,1094,-1517
2018,5,12,17,1166,2664,1149,-1515
2018,5,12,18,1166,2649,1209,-1440
2018,5,12,19,1118,2629,1174,-1455
2018,5,12,20,1078,2596,1180,-1416
2018,5,12,21,1031,2526,980,-1546
2018,5,12,22,1009,2507,1010,-1497
2018,5,12,23,1002,2515,1048,-1467
2018,5,13,0,1039,2565,1050,-1515
2018,5,13,1,1046,2621,1100,-1521
2018,5,13,2,1068,2747,1216,-1531
2018,5,13,3,1073,2729,1209,-1520
2018,5,13,4,1044,2728,1265,-1463
2018,5,13,5,1015,2734,1264,-1470
2018,5,13,6,1072,2588,1294,-1294
2018,5,13,7,1059,2373,1317,-1056
2018,5,13,8,964,2097,1198,-899
2018,5,13,9,927,1963,1207,-756
2018,5,13,10,830,1900,1092,-808
2018,5,13,11,895,1861,1035,-826
2018,5,13,12,895,1891,1097,-794
2018,5,13,13,936,1924,1092,-832
2018,5,13,14,806,2018,1050,-968
2018,5,13,15,793,2180,965,-1215
2018,5,13,16,1008,2393,989,-1404
2018,5,13,17,1011,2540,1036,-1504
2018,5,13,18,1039,2593,1016,-1577
2018,5,13,19,1044,2600,1003,-1597
2018,5,13,20,1110,2588,977,-1611
2018,5,13,21,1091,2586,1023,-1563
2018,5,13,22,1072,2610,1081,-1529
2018,5,13,23,1079,2668,1156,-1512
2018,5,14,0,1072,2858,1332,-1526
2018,5,14,1,1045,2942,1314,-1628
2018,5,14,2,1023,2959,1390,-1569
2018,5,14,3,1024,2958,1413,-1545
2018,5,14,4,981,2979,1447,-1532
2018,5,14,5,1021,2957,1461,-1496
2018,5,14,6,1008,2687,1454,-1233
2018,5,14,7,947,2408,1381,-1027
2018,5,14,8,1000,2095,1238,-857
2018,5,14,9,886,1962,1230,-732
2018,5,14,10,815,1905,1230,-675
2018,5,14,11,823,1902,1232,-670
2018,5,14,12,895,1971,1257,-714
2018,5,14,13,1136,2254,1340,-914
2018,5,14,14,1075,2514,1366,-1148
2018,5,14,15,1197,2752,1328,-1424
2018,5,14,16,1314,2868,1288,-1580
2018,5,14,17,1405,2947,1327,-1620
2018,5,14,18,1390,3016,1408,-1608
2018,5,14,19,1447,3069,1424,-1645
2018,5,14,20,1445,3128,1473,-1655
2018,5,14,21,1495,3159,1453,-1706
2018,5,14,22,1524,3209,1448,-1761
2018,5,14,23,1564,3275,1449,-1826
2018,5,15,0,1628,3343,1459,-1884
2018,5,15,1,1652,3396,1477,-1919
2018,5,15,2,1602,3366,1497,-1869
2018,5,15,3,1555,3295,1470,-1825
2018,5,15,4,1566,3227,1509,-1718
2018,5,15,5,1457,3144,1524,-1620
2018,5,15,6,1645,2827,1541,-1286
2018,5,15,7,1342,2510,1492,-1018
2018,5,15,8,1061,2306,1247,-1059
2018,5,15,9,860,2183,1158,-1025
2018,5,15,10,756,2090,1101,-989
2018,5,15,11,771,2021,1054,-967
2018,5,15,12,821,2086,1054,-1032
2018,5,15,13,949,2343,1179,-1164
2018,5,15,14,917,2594,1120,-1474
2018,5,15,15,937,2777,1104,-1673
2018,5,15,16,972,2856,1115,-1741
2018,5,15,17,1017,2880,1115,-1765
2018,5,15,18,1011,2911,1142,-1769
2018,5,15,19,1034,2915,1115,-1800
2018,5,15,20,1065,2954,1160,-1794
2018,5,15,21,1053,2981,1162,-1819
2018,5,15,22,1083,3023,1111,-1912
2018,5,15,23,1109,3118,1239,-1879
2018,5,16,0,1049,3155,1263,-1892
2018,5,16,1,1077,3235,1270,-1965
2018,5,16,2,1237,3222,1276,-1946
2018,5,16,3,1172,3170,1269,-1901
2018,5,16,4,1145,3139,1269,-1870
2018,5,16,5,1066,3102,1281,-1821
2018,5,16,6,1502,2867,1308,-1559
2018,5,16,7,1196,2550,1206,-1344
2018,5,16,8,875,2204,1014,-1190
2018,5,16,9,803,2062,954,-1108
2018,5,16,10,770,2011,943,-1068
2018,5,16,11,753,1987,909,-1078
2018,5,16,12,793,2057,892,-1165
2018,5,16,13,1015,2409,1039,-1370
2018,5,16,14,906,2537,963,-1574
2018,5,16,15,1076,2913,1241,-1672
2018,5,16,16,1133,3032,1317,-1715
2018,5,16,17,1145,3027,1310,-1717
2018,5,16,18,1165,3002,1292,-1710
2018,5,16,19,1180,2997,1282,-1715
2018,5,16,20,1161,3036,1305,-1731
2018,5,16,21,1161,3066,1334,-1732
2018,5,16,22,1161,3062,1306,-1756
2018,5,16,23,1172,3009,1304,-1705
2018,5,17,0,1205,3077,1375,-1702
2018,5,17,1,1249,3123,1407,-1716
2018,5,17,2,1228,3108,1452,-1656
2018,5,17,3,1200,3082,1453,-1629
2018,5,17,4,1254,3096,1382,-1714
2018,5,17,5,1189,3056,1384,-1672
2018,5,17,6,1305,2800,1304,-1496
2018,5,17,7,931,2348,1179,-1169
2018,5,17,8,751,2261,994,-1267
2018,5,17,9,624,2068,844,-1224
2018,5,17,10,578,2025,821,-1204
2018,5,17,11,572,2017,853,-1164
2018,5,17,12,575,2099,882,-1217
2018,5,17,13,847,2500,1094,-1406
2018,5,17,14,750,2554,959,-1595
2018,5,17,15,902,2726,1021,-1705
2018,5,17,16,925,2807,984,-1823
2018,5,17,17,936,2825,949,-1876
2018,5,17,18,1080,2893,1006,-1887
2018,5,17,19,1118,2838,961,-1877
2018,5,17,20,1084,2891,1109,-1782
2018,5,17,21,1120,2899,1153,-1746
2018,5,17,22,1152,2909,1090,-1819
2018,5,17,23,1183,2844,1103,-1741
2018,5,18,0,1140,2965,1210,-1755
2018,5,18,1,1165,2839,1074,-1765
2018,5,18,2,1164,3044,1357,-1687
2018,5,18,3,1134,3072,1418,-1654
2018,5,18,4,1128,3089,1482,-1607
2018,5,18,5,1172,3048,1483,-1565
2018,5,18,6,1166,2720,1276,-1444
2018,5,18,7,1125,2373,1082,-1291
2018,5,18,8,751,2189,1047,-1142
2018,5,18,9,628,2088,796,-1292
2018,5,18,10,587,2054,786,-1268
2018,5,18,11,565,2056,795,-1261
2018,5,18,12,561,2134,798,-1336
2018,5,18,13,799,2451,932,-1519
2018,5,18,14,864,2742,915,-1827
2018,5,18,15,1088,3020,1266,-1754
2018,5,18,16,1201,3113,1283,-1830
2018,5,18,17,1212,3127,1370,-1757
2018,5,18,18,1342,3131,1379,-1752
2018,5,18,19,1337,3106,1381,-1725
2018,5,18,20,1346,3085,1305,-1780
2018,5,18,21,1338,3057,1329,-1728
2018,5,18,22,1323,3013,1351,-1662
2018,5,18,23,1311,2994,1254,-1740
2018,5,19,0,1302,3001,1287,-1714
2018,5,19,1,1328,3018,1371,-1647
2018,5,19,2,1270,2988,1391,-1597
2018,5,19,3,1221,2946,1292,-1654
2018,5,19,4,1219,2958,1288,-1670
2018,5,19,5,1200,2939,1291,-1648
2018,5,19,6,1258,2771,1299,-1472
2018,5,19,7,1025,2552,1264,-1288
2018,5,19,8,897,2331,1243,-1088
2018,5,19,9,626,2084,1092,-992
2018,5,19,10,629,2020,1077,-943
2018,5,19,11,655,2022,847,-1175
2018,5,19,12,661,2045,833,-1212
2018,5,19,13,640,2116,838,-1278
2018,5,19,14,623,2185,773,-1412
2018,5,19,15,669,2385,774,-1611
2018,5,19,16,903,2557,923,-1634
2018,5,19,17,1106,2776,1004,-1772
2018,5,19,18,1303,2866,1109,-1757
2018,5,19,19,1295,2864,1113,-1751
2018,5,19,20,1266,2854,1171,-1683
2018,5,19,21,1215,2830,1134,-1696
2018,5,19,22,1200,2808,1140,-1668
2018,5,19,23,1201,2822,1215,-1607
2018,5,20,0,1193,2850,1225,-1625
2018,5,20,1,1203,2881,1189,-1692
2018,5,20,2,1202,2936,1339,-1597
2018,5,20,3,1169,2904,1328,-1576
2018,5,20,4,1160,2905,1349,-1556
2018,5,20,5,1146,2891,1351,-1540
2018,5,20,6,1222,2731,1337,-1394
2018,5,20,7,1015,2373,1171,-1202
2018,5,20,8,850,2135,1111,-1024
2018,5,20,9,743,2036,880,-1156
2018,5,20,10,685,1957,834,-1123
2018,5,20,11,678,1925,821,-1104
2018,5,20,12,650,1939,832,-1107
2018,5,20,13,617,1972,832,-1140
2018,5,20,14,617,2042,821,-1221
2018,5,20,15,617,2191,773,-1418
2018,5,20,16,819,2401,769,-1632
2018,5,20,17,944,2564,780,-1784
2018,5,20,18,984,2673,849,-1824
2018,5,20,19,979,2685,796,-1889
2018,5,20,20,954,2694,809,-1885
2018,5,20,21,919,2661,806,-1855
2018,5,20,22,899,2602,781,-1821
2018,5,20,23,942,2607,811,-1796
2018,5,21,0,1009,2696,938,-1758
2018,5,21,1,1037,2854,1183,-1671
2018,5,21,2,1054,2942,1315,-1627
2018,5,21,3,1044,2953,1352,-1601
2018,5,21,4,1049,2969,1392,-1577
2018,5,21,5,1029,2941,1363,-1578
2018,5,21,6,1257,2701,1358,-1343
2018,5,21,7,1007,2285,1131,-1154
2018,5,21,8,891,2097,1075,-1022
2018,5,21,9,841,1991,1025,-966
2018,5,21,10,864,1978,1024,-954
2018,5,21,11,838,1990,1027,-963
2018,5,21,12,844,2094,1073,-1021
2018,5,21,13,1045,2351,1151,-1200
2018,5,21,14,898,2588,1101,-1487
2018,5,21,15,1139,2947,1250,-1697
2018,5,21,16,1197,3096,1352,-1744
2018,5,21,17,1218,3108,1369,-1739
2018,5,21,18,1238,3126,1359,-1767
2018,5,21,19,1249,3113,1359,-1754
2018,5,21,20,1249,3116,1353,-1763
2018,5,21,21,1248,3104,1315,-1789
2018,5,21,22,1237,3090,1297,-1793
2018,5,21,23,1242,3090,1306,-1784
2018,5,22,0,1227,3112,1379,-1733
2018,5,22,1,1278,3158,1380,-1778
2018,5,22,2,1271,3151,1401,-1750
2018,5,22,3,1238,3134,1426,-1708
2018,5,22,4,1226,3116,1432,-1684
2018,5,22,5,1175,3099,1429,-1670
2018,5,22,6,1390,2861,1466,-1395
2018,5,22,7,1119,2541,1338,-1203
2018,5,22,8,989,2270,1248,-1022
2018,5,22,9,815,2080,1112,-968
2018,5,22,10,773,2036,1137,-899
2018,5,22,11,769,2041,1140,-901
2018,5,22,12,865,2138,1141,-997
2018,5,22,13,1101,2480,1289,-1191
2018,5,22,14,1082,2775,1281,-1494
2018,5,22,15,1229,2985,1272,-1713
2018,5,22,16,1252,3089,1367,-1722
2018,5,22,17,1270,3102,1361,-1741
2018,5,22,18,1314,3130,1422,-1708
2018,5,22,19,1245,3141,1423,-1718
2018,5,22,20,1330,3171,1458,-1713
2018,5,22,21,1342,3193,1499,-1694
2018,5,22,22,1348,3207,1489,-1718
2018,5,22,23,1376,3231,1493,-1738
2018,5,23,0,1407,3249,1457,-1792
2018,5,23,1,1449,3336,1586,-1750
2018,5,23,2,1441,3311,1588,-1723
2018,5,23,3,1419,3286,1665,-1621
2018,5,23,4,1330,3242,1678,-1564
2018,5,23,5,1272,3190,1642,-1548
2018,5,23,6,1383,2941,1640,-1301
2018,5,23,7,1179,2649,1438,-1211
2018,5,23,8,1132,2456,1378,-1078
2018,5,23,9,1167,2349,1386,-963
2018,5,23,10,956,2117,1221,-896
2018,5,23,11,932,2106,1207,-899
2018,5,23,12,977,2221,1253,-968
2018,5,23,13,1163,2493,1389,-1104
2018,5,23,14,1102,2758,1361,-1397
2018,5,23,15,1243,2857,1306,-1551
2018,5,23,16,1338,3071,1498,-1573
2018,5,23,17,1359,3124,1492,-1632
2018,5,23,18,1404,3168,1571,-1597
2018,5,23,19,1420,3207,1655,-1552
2018,5,23,20,1532,3240,1679,-1561
2018,5,23,21,1559,3277,1819,-1458
2018,5,23,22,1584,3297,1818,-1479
2018,5,23,23,1612,3357,1837,-1520
2018,5,24,0,1676,3383,1844,-1539
2018,5,24,1,1718,3425,2014,-1411
2018,5,24,2,1650,3392,1916,-1476
2018,5,24,3,1586,3325,1774,-1551
2018,5,24,4,1473,3217,1547,-1670
2018,5,24,5,1425,3193,1391,-1802
2018,5,24,6,1538,2937,1426,-1511
2018,5,24,7,1236,2597,1245,-1352
2018,5,24,8,933,2214,1130,-1084
2018,5,24,9,886,2091,1157,-934
2018,5,24,10,820,2037,1152,-885
2018,5,24,11,776,2021,1132,-889
2018,5,24,12,860,2088,1158,-930
2018,5,24,13,910,2268,1287,-981
2018,5,24,14,881,2506,1144,-1362
2018,5,24,15,894,2714,1137,-1577
2018,5,24,16,1017,2838,1293,-1545
2018,5,24,17,1102,2898,1276,-1622
2018,5,24,18,1135,2964,1297,-1667
2018,5,24,19,1184,2945,1314,-1631
2018,5,24,20,1216,3053,1409,-1644
2018,5,24,21,1273,3097,1403,-1694
2018,5,24,22,1304,3088,1393,-1695
2018,5,24,23,1344,3095,1397,-1698
2018,5,25,0,1318,3131,1413,-1718
2018,5,25,1,1365,3174,1453,-1721
2018,5,25,2,1354,3165,1422,-1743
2018,5,25,3,1331,3148,1496,-1652
2018,5,25,4,1344,3129,1465,-1664
2018,5,25,5,1316,3116,1470,-1646
2018,5,25,6,1551,2896,1448,-1448
2018,5,25,7,1275,2463,1344,-1119
2018,5,25,8,894,2194,1318,-876
2018,5,25,9,959,2086,1302,-784
2018,5,25,10,926,2031,1255,-776
2018,5,25,11,944,2018,1262,-756
2018,5,25,12,991,2087,1357,-730
2018,5,25,13,962,2229,1304,-925
2018,5,25,14,936,2474,1166,-1308
2018,5,25,15,1172,2698,1135,-1563
2018,5,25,16,1288,2911,1262,-1649
2018,5,25,17,1297,3066,1361,-1705
2018,5,25,18,1299,3074,1380,-1694
2018,5,25,19,1276,2831,1099,-1732
2018,5,25,20,1236,2802,1069,-1733
2018,5,25,21,1217,2792,1142,-1650
2018,5,25,22,1205,2783,1147,-1636
2018,5,25,23,1184,2868,1232,-1636
2018,5,26,0,1129,3011,1263,-1748
2018,5,26,1,1152,3034,1283,-1751
2018,5,26,2,1077,2807,1220,-1587
2018,5,26,3,996,2703,1193,-1510
2018,5,26,4,993,2686,1189,-1497
2018,5,26,5,997,2679,1187,-1492
2018,5,26,6,1278,2537,1205,-1332
2018,5,26,7,967,2314,1172,-1142
2018,5,26,8,887,2158,1164,-994
2018,5,26,9,805,2058,1117,-941
2018,5,26,10,854,2007,1114,-893
2018,5,26,11,849,1987,1020,-967
2018,5,26,12,856,2012,992,-1020
2018,5,26,13,800,2056,1030,-1026
2018,5,26,14,728,2142,926,-1216
2018,5,26,15,724,2312,885,-1427
2018,5,26,16,706,2478,879,-1599
2018,5,26,17,832,2572,825,-1747
2018,5,26,18,831,2606,799,-1807
2018,5,26,19,838,2595,800,-1795
2018,5,26,20,853,2577,856,-1721
2018,5,26,21,874,2551,901,-1650
2018,5,26,22,895,2519,947,-1572
2018,5,26,23,1012,2514,1036,-1478
2018,5,27,0,1063,2528,1068,-1460
2018,5,27,1,1068,2565,1119,-1446
2018,5,27,2,1066,2566,1107,-1459
2018,5,27,3,1058,2542,1120,-1422
2018,5,27,4,1045,2537,1071,-1466
2018,5,27,5,1023,2570,1064,-1506
2018,5,27,6,1276,2485,1086,-1399
2018,5,27,7,1071,2284,1003,-1281
2018,5,27,8,848,2135,952,-1183
2018,5,27,9,845,2036,909,-1127
2018,5,27,10,729,1996,906,-1090
2018,5,27,11,796,1973,897,-1076
2018,5,27,12,739,1990,877,-1113
2018,5,27,13,917,2026,862,-1164
2018,5,27,14,653,2111,856,-1255
2018,5,27,15,657,2270,784,-1486
2018,5,27,16,625,2426,754,-1672
2018,5,27,17,767,2529,750,-1779
2018,5,27,18,822,2547,764,-1783
2018,5,27,19,817,2560,784,-1776
2018,5,27,20,805,2554,798,-1756
2018,5,27,21,782,2515,835,-1680
2018,5,27,22,765,2500,815,-1685
2018,5,27,23,770,2523,810,-1713
2018,5,28,0,797,2638,886,-1752
2018,5,28,1,894,2901,1194,-1707
2018,5,28,2,944,2939,1373,-1566
2018,5,28,3,961,2908,1327,-1581
2018,5,28,4,972,2856,1277,-1579
2018,5,28,5,950,2890,1327,-1563
2018,5,28,6,1008,2699,1295,-1404
2018,5,28,7,1003,2387,1189,-1198
2018,5,28,8,795,2122,1040,-1082
2018,5,28,9,758,2008,1035,-973
2018,5,28,10,743,1963,1037,-926
2018,5,28,11,758,1927,1012,-915
2018,5,28,12,735,1973,1049,-924
2018,5,28,13,759,2049,1067,-982
2018,5,28,14,700,2075,927,-1148
2018,5,28,15,899,2243,1027,-1216
2018,5,28,16,972,2409,1084,-1325
2018,5,28,17,1112,2571,1159,-1412
2018,5,28,18,1198,2660,1166,-1494
2018,5,28,19,1224,2696,1171,-1525
2018,5,28,20,1223,2699,1177,-1522
2018,5,28,21,1208,2680,1164,-1516
2018,5,28,22,1232,2665,1177,-1488
2018,5,28,23,1232,2674,1180,-1494
2018,5,29,0,1245,2712,1175,-1537
2018,5,29,1,1244,2774,1196,-1578
2018,5,29,2,1168,2777,1184,-1593
2018,5,29,3,1162,2800,1265,-1535
2018,5,29,4,1164,2798,1216,-1582
2018,5,29,5,1052,2741,1201,-1540
2018,5,29,6,1052,2550,1210,-1340
2018,5,29,7,902,2280,1170,-1110
2018,5,29,8,840,2112,1139,-973
2018,5,29,9,851,2028,1070,-958
2018,5,29,10,830,1994,1048,-946
2018,5,29,11,741,2000,1028,-972
2018,5,29,12,765,2085,992,-1093
2018,5,29,13,863,2295,958,-1337
2018,5,29,14,744,2577,890,-1687
2018,5,29,15,986,2942,1049,-1893
2018,5,29,16,1000,3017,1061,-1956
2018,5,29,17,983,3005,1023,-1982
2018,5,29,18,979,3019,1038,-1981
2018,5,29,19,1007,2974,1026,-1948
2018,5,29,20,1061,2950,1135,-1815
2018,5,29,21,1101,2909,1201,-1708
2018,5,29,22,1168,2893,1227,-1666
2018,5,29,23,1183,2857,1192,-1665
2018,5,30,0,1188,2945,1272,-1673
2018,5,30,1,1231,2938,1219,-1719
2018,5,30,2,1231,2930,1213,-1717
2018,5,30,3,1232,2883,1191,-1692
2018,5,30,4,1232,2942,1246,-1696
2018,5,30,5,1232,2854,1183,-1671
2018,5,30,6,1231,2714,1276,-1438
2018,5,30,7,1225,2390,1210,-1180
2018,5,30,8,887,2214,1146,-1068
2018,5,30,9,918,2138,1111,-1027
2018,5,30,10,870,2094,1036,-1058
2018,5,30,11,759,2116,982,-1134
2018,5,30,12,794,2269,1007,-1262
2018,5,30,13,1025,2670,1193,-1477
2018,5,30,14,1052,2974,1209,-1765
2018,5,30,15,1244,3178,1221,-1957
2018,5,30,16,1306,3180,1309,-1871
2018,5,30,17,1284,3078,1260,-1818
2018,5,30,18,1263,3056,1294,-1762
2018,5,30,19,1234,3032,1264,-1768
2018,5,30,20,1273,3009,1275,-1734
2018,5,30,21,1257,3037,1268,-1769
2018,5,30,22,1231,3026,1244,-1782
2018,5,30,23,1222,3028,1287,-1741
2018,5,31,0,1238,3050,1260,-1790
2018,5,31,1,1280,3090,1460,-1630
2018,5,31,2,1268,3092,1349,-1743
2018,5,31,3,1232,3061,1374,-1687
2018,5,31,4,1236,3063,1364,-1699
2018,5,31,5,1238,3061,1396,-1665
2018,5,31,6,1400,2852,1381,-1471
2018,5,31,7,1317,2571,1310,-1261
2018,5,31,8,861,2233,1140,-1093
2018,5,31,9,849,2140,1135,-1005
2018,5,31,10,838,2103,1135,-968
2018,5,31,11,829,2110,1102,-1008
2018,5,31,12,839,2206,1143,-1063
2018,5,31,13,813,2414,1137,-1277
2018,5,31,14,1041,2851,1258,-1593
2018,5,31,15,1038,3181,1339,-1842
2018,5,31,16,1037,3234,1164,-2070
2018,5,31,17,999,3189,1068,-2121
2018,5,31,18,1013,3031,945,-2086
2018,5,31,19,930,2971,935,-2036
2018,5,31,20,916,2948,967,-1981
2018,5,31,21,940,2900,1102,-1798
2018,5,31,22,969,2855,1137,-1718
2018,5,31,23,1026,2848,1143,-1705
2018,6,1,0,1058,2871,1108,-1763
2018,6,1,1,1085,2962,1201,-1761
2018,6,1,2,1103,2943,1235,-1708
2018,6,1,3,1111,2887,1185,-1702
2018,6,1,4,1115,2885,1179,-1706
2018,6,1,5,1115,2878,1165,-1713
2018,6,1,6,1042,2686,1153,-1533
2018,6,1,7,856,2431,1123,-1308
2018,6,1,8,783,2255,948,-1307
2018,6,1,9,757,2176,982,-1194
2018,6,1,10,687,2156,1033,-1123
2018,6,1,11,758,2162,956,-1206
2018,6,1,12,708,2268,1020,-1248
2018,6,1,13,709,2462,1022,-1440
2018,6,1,14,716,2741,943,-1798
2018,6,1,15,628,2935,829,-2106
2018,6,1,16,581,2962,797,-2165
2018,6,1,17,573,2943,843,-2100
2018,6,1,18,607,2961,784,-2177
2018,6,1,19,606,2929,829,-2100
2018,6,1,20,639,2899,862,-2037
2018,6,1,21,616,2861,839,-2022
2018,6,1,22,592,2826,872,-1954
2018,6,1,23,600,2810,912,-1898
2018,6,2,0,639,2818,907,-1911
2018,6,2,1,611,2830,899,-1931
2018,6,2,2,641,2797,889,-1908
2018,6,2,3,630,2763,906,-1857
2018,6,2,4,667,2753,879,-1874
2018,6,2,5,696,2814,943,-1871
2018,6,2,6,869,2820,1140,-1680
2018,6,2,7,673,2435,933,-1502
2018,6,2,8,666,2258,914,-1344
2018,6,2,9,651,2152,944,-1208
2018,6,2,10,675,2102,1006,-1096
2018,6,2,11,675,2076,960,-1116
2018,6,2,12,663,2106,861,-1245
2018,6,2,13,793,2145,804,-1341
2018,6,2,14,613,2243,779,-1464
2018,6,2,15,596,2411,687,-1724
2018,6,2,16,939,2773,986,-1787
2018,6,2,17,1052,2934,1079,-1855
2018,6,2,18,1106,3007,1117,-1890
2018,6,2,19,1116,3019,1121,-1898
2018,6,2,20,1102,3006,1147,-1859
2018,6,2,21,1066,2987,1156,-1831
2018,6,2,22,1048,2960,1136,-1824
2018,6,2,23,1055,2963,1176,-1787
2018,6,3,0,1080,3005,1201,-1804
2018,6,3,1,1109,3052,1200,-1852
2018,6,3,2,1108,3065,1199,-1866
2018,6,3,3,1076,3031,1235,-1796
2018,6,3,4,1043,2984,1219,-1765
2018,6,3,5,933,2986,1246,-1740
2018,6,3,6,950,2852,1267,-1585
2018,6,3,7,949,2635,1205,-1430
2018,6,3,8,694,2275,905,-1370
2018,6,3,9,652,2115,858,-1257
2018,6,3,10,648,2045,850,-1195
2018,6,3,11,656,2020,854,-1166
2018,6,3,12,646,2032,853,-1179
2018,6,3,13,658,2029,858,-1171
2018,6,3,14,676,2102,844,-1258
2018,6,3,15,625,2254,759,-1495
2018,6,3,16,842,2449,790,-1659
2018,6,3,17,934,2626,877,-1749
2018,6,3,18,904,2875,1050,-1825
2018,6,3,19,899,2995,1147,-1848
2018,6,3,20,925,3025,1200,-1825
2018,6,3,21,954,3030,1304,-1726
2018,6,3,22,1006,3005,1229,-1776
2018,6,3,23,985,3015,1332,-1683
2018,6,4,0,962,3042,1416,-1626
2018,6,4,1,966,3078,1351,-1727
2018,6,4,2,912,3073,1352,-1721
2018,6,4,3,915,2986,1295,-1691
2018,6,4,4,916,2853,1214,-1639
2018,6,4,5,918,2794,1190,-1604
2018,6,4,6,1192,2597,1172,-1425
2018,6,4,7,1017,2361,1149,-1212
2018,6,4,8,856,2186,1069,-1117
2018,6,4,9,838,2120,1125,-995
2018,6,4,10,829,2089,1111,-978
2018,6,4,11,824,2111,1120,-991
2018,6,4,12,823,2217,1121,-1096
2018,6,4,13,814,2428,1145,-1283
2018,6,4,14,806,2720,1112,-1608
2018,6,4,15,1012,3167,1324,-1843
2018,6,4,16,1095,3228,1343,-1885
2018,6,4,17,1135,3237,1397,-1840
2018,6,4,18,1147,3025,1184,-1841
2018,6,4,19,1149,2969,1161,-1808
2018,6,4,20,1148,2931,1157,-1774
2018,6,4,21,1146,2905,1194,-1711
2018,6,4,22,1083,2940,1356,-1584
2018,6,4,23,1091,2936,1467,-1469
2018,6,5,0,1162,3123,1630,-1493
2018,6,5,1,1236,3155,1645,-1510
2018,6,5,2,1290,3135,1581,-1554
2018,6,5,3,1315,3095,1545,-1550
2018,6,5,4,1322,3080,1490,-1590
2018,6,5,5,1336,3056,1526,-1530
2018,6,5,6,1356,2865,1565,-1300
2018,6,5,7,1307,2596,1478,-1118
2018,6,5,8,932,2262,1218,-1044
2018,6,5,9,756,2167,1275,-892
2018,6,5,10,884,2132,1175,-957
2018,6,5,11,735,2126,1151,-975
2018,6,5,12,882,2247,1161,-1086
2018,6,5,13,1117,2689,1378,-1311
2018,6,5,14,1117,3004,1403,-1601
2018,6,5,15,1307,3201,1410,-1791
2018,6,5,16,1356,3221,1416,-1805
2018,6,5,17,1330,3207,1426,-1781
2018,6,5,18,1304,3197,1458,-1739
2018,6,5,19,1275,3183,1421,-1762
2018,6,5,20,1292,3165,1372,-1793
2018,6,5,21,1253,3113,1345,-1768
2018,6,5,22,1217,3075,1383,-1692
2018,6,5,23,1192,3071,1420,-1651
2018,6,6,0,1168,3089,1400,-1689
2018,6,6,1,1239,3124,1369,-1755
2018,6,6,2,1253,3099,1354,-1745
2018,6,6,3,1267,3073,1407,-1666
2018,6,6,4,1231,3059,1436,-1623
2018,6,6,5,1245,3040,1468,-1572
2018,6,6,6,1398,2882,1540,-1342
2018,6,6,7,1168,2609,1448,-1161
2018,6,6,8,982,2326,1340,-986
2018,6,6,9,961,2158,1261,-897
2018,6,6,10,902,2117,1197,-920
2018,6,6,11,928,2138,1179,-959
2018,6,6,12,977,2358,1266,-1092
2018,6,6,13,1091,2665,1361,-1304
2018,6,6,14,981,2938,1376,-1562
2018,6,6,15,1175,3119,1337,-1782
2018,6,6,16,1180,3100,1333,-1767
2018,6,6,17,1179,3091,1353,-1738
2018,6,6,18,1184,3098,1397,-1701
2018,6,6,19,1175,3114,1422,-1692
2018,6,6,20,1262,3130,1480,-1650
2018,6,6,21,1254,3130,1489,-1641
2018,6,6,22,1246,3138,1479,-1659
2018,6,6,23,1250,3157,1487,-1670
2018,6,7,0,1295,3203,1489,-1714
2018,6,7,1,1326,3330,1562,-1768
2018,6,7,2,1297,3312,1569,-1743
2018,6,7,3,1255,3261,1590,-1671
2018,6,7,4,1120,3216,1590,-1626
2018,6,7,5,1102,3191,1589,-1602
2018,6,7,6,1332,2987,1619,-1368
2018,6,7,7,1192,2703,1574,-1129
2018,6,7,8,1026,2408,1319,-1089
2018,6,7,9,869,2161,1157,-1004
2018,6,7,10,900,2096,1113,-983
2018,6,7,11,905,2092,1061,-1031
2018,6,7,12,916,2174,1077,-1097
2018,6,7,13,1222,2487,1225,-1262
2018,6,7,14,1207,2854,1352,-1502
2018,6,7,15,1342,3077,1541,-1536
2018,6,7,16,1328,3155,1541,-1614
2018,6,7,17,1333,3172,1512,-1660
2018,6,7,18,1352,3186,1529,-1657
2018,6,7,19,1360,3195,1534,-1661
2018,6,7,20,1361,3194,1564,-1630
2018,6,7,21,1364,3171,1547,-1624
2018,6,7,22,1350,3158,1551,-1607
2018,6,7,23,1364,3142,1539,-1603
2018,6,8,0,1456,3161,1548,-1613
2018,6,8,1,1460,3181,1622,-1559
2018,6,8,2,1416,3171,1720,-1451
2018,6,8,3,1321,3141,1594,-1547
2018,6,8,4,1212,3080,1426,-1654
2018,6,8,5,1208,2980,1292,-1688
2018,6,8,6,1062,2700,1215,-1485
2018,6,8,7,887,2428,1184,-1244
2018,6,8,8,804,2260,1184,-1076
2018,6,8,9,744,2149,1046,-1103
2018,6,8,10,695,2116,1000,-1116
2018,6,8,11,724,2113,1039,-1074
2018,6,8,12,696,2191,1090,-1101
2018,6,8,13,988,2503,1358,-1145
2018,6,8,14,880,2612,1131,-1481
2018,6,8,15,1158,2969,1348,-1621
2018,6,8,16,1275,2876,1284,-1592
2018,6,8,17,1374,3008,1378,-1630
2018,6,8,18,1454,3196,1508,-1688
2018,6,8,19,1493,3209,1539,-1670
2018,6,8,20,1459,3190,1536,-1654
2018,6,8,21,1447,3173,1537,-1636
2018,6,8,22,1415,3138,1536,-1602
2018,6,8,23,1375,3133,1563,-1570
2018,6,9,0,1358,3153,1583,-1570
2018,6,9,1,1346,3181,1669,-1512
2018,6,9,2,1300,3150,1691,-1459
2018,6,9,3,1239,3110,1637,-1473
2018,6,9,4,1239,3089,1665,-1424
2018,6,9,5,1217,3061,1601,-1460
2018,6,9,6,1449,2866,1524,-1342
2018,6,9,7,1189,2632,1291,-1341
2018,6,9,8,929,2376,1216,-1160
2018,6,9,9,815,2181,988,-1193
2018,6,9,10,774,2121,878,-1243
2018,6,9,11,679,2107,964,-1143
2018,6,9,12,664,2144,1085,-1059
2018,6,9,13,716,2198,1156,-1042
2018,6,9,14,713,2314,1120,-1194
2018,6,9,15,726,2577,1127,-1450
2018,6,9,16,883,2859,1296,-1563
2018,6,9,17,1005,2983,1342,-1641
2018,6,9,18,1011,2912,1207,-1705
2018,6,9,19,1015,2955,1286,-1669
2018,6,9,20,1019,2904,1196,-1708
2018,6,9,21,1026,2759,1130,-1629
2018,6,9,22,1036,2760,1137,-1623
2018,6,9,23,1050,2696,1153,-1543
2018,6,10,0,1065,2727,1186,-1541
2018,6,10,1,1076,2703,1155,-1548
2018,6,10,2,1083,2710,1163,-1547
2018,6,10,3,1086,2742,1179,-1563
2018,6,10,4,1087,2813,1245,-1568
2018,6,10,5,1085,2840,1253,-1587
2018,6,10,6,1082,2724,1251,-1473
2018,6,10,7,967,2429,1158,-1271
2018,6,10,8,943,2261,1141,-1120
2018,6,10,9,876,2177,1090,-1087
2018,6,10,10,809,2130,1112,-1018
2018,6,10,11,834,2120,1155,-965
2018,6,10,12,840,2146,1158,-988
2018,6,10,13,799,2178,1159,-1019
2018,6,10,14,795,2291,1165,-1126
2018,6,10,15,790,2445,989,-1456
2018,6,10,16,831,2593,933,-1660
2018,6,10,17,919,2724,1021,-1703
2018,6,10,18,931,2789,1086,-1703
2018,6,10,19,918,2801,1060,-1741
2018,6,10,20,894,2782,953,-1829
2018,6,10,21,840,2738,908,-1830
2018,6,10,22,842,2710,940,-1770
2018,6,10,23,851,2700,942,-1758
2018,6,11,0,863,2766,946,-1820
2018,6,11,1,948,2869,1117,-1752
2018,6,11,2,956,3014,1254,-1760
2018,6,11,3,960,3011,1373,-1638
2018,6,11,4,1073,3126,1373,-1753
2018,6,11,5,1072,3092,1456,-1636
2018,6,11,6,1411,2901,1424,-1477
2018,6,11,7,1191,2612,1298,-1314
2018,6,11,8,862,2364,1214,-1150
2018,6,11,9,806,2187,1122,-1065
2018,6,11,10,808,2156,1057,-1099
2018,6,11,11,737,2183,1106,-1077
2018,6,11,12,857,2380,1184,-1196
2018,6,11,13,1006,2722,1355,-1367
2018,6,11,14,1038,2913,1375,-1538
2018,6,11,15,1214,3069,1450,-1619
2018,6,11,16,1345,3094,1515,-1579
2018,6,11,17,1351,3062,1430,-1632
2018,6,11,18,1372,3060,1372,-1688
2018,6,11,19,1418,3044,1357,-1687
2018,6,11,20,1504,3032,1391,-1641
2018,6,11,21,1483,2995,1507,-1488
2018,6,11,22,1474,2980,1619,-1361
2018,6,11,23,1494,2960,1706,-1254
2018,6,12,0,1448,3064,1757,-1307
2018,6,12,1,1510,3240,1715,-1525
2018,6,12,2,1526,3239,1693,-1546
2018,6,12,3,1512,3198,1670,-1528
2018,6,12,4,1415,3179,1721,-1458
2018,6,12,5,1404,3168,1709,-1459
2018,6,12,6,1646,2982,1853,-1129
2018,6,12,7,1417,2703,1668,-1035
2018,6,12,8,1105,2339,1377,-962
2018,6,12,9,991,2191,1234,-957
2018,6,12,10,936,2199,1246,-953
2018,6,12,11,1010,2212,1239,-973
2018,6,12,12,1157,2457,1404,-1053
2018,6,12,13,1311,2692,1584,-1108
2018,6,12,14,1375,3010,1749,-1261
2018,6,12,15,1534,3201,1717,-1484
2018,6,12,16,1545,3220,1681,-1539
2018,6,12,17,1554,3208,1710,-1498
2018,6,12,18,1553,3213,1751,-1462
2018,6,12,19,1540,3219,1753,-1466
2018,6,12,20,1592,3222,1751,-1471
2018,6,12,21,1587,3214,1791,-1423
2018,6,12,22,1582,3175,1756,-1419
2018,6,12,23,1581,3164,1780,-1384
2018,6,13,0,1674,3179,1738,-1441
2018,6,13,1,1710,3220,1798,-1422
2018,6,13,2,1704,3219,1735,-1484
2018,6,13,3,1667,3197,1628,-1569
2018,6,13,4,1572,3187,1514,-1673
2018,6,13,5,1539,3138,1598,-1540
2018,6,13,6,1488,2947,1643,-1304
2018,6,13,7,1216,2693,1545,-1148
2018,6,13,8,1173,2510,1426,-1084
2018,6,13,9,1186,2421,1418,-1003
2018,6,13,10,1068,2277,1305,-972
2018,6,13,11,1117,2342,1337,-1005
2018,6,13,12,1097,2457,1391,-1066
2018,6,13,13,1153,2637,1402,-1235
2018,6,13,14,1197,2892,1385,-1507
2018,6,13,15,1277,3129,1428,-1701
2018,6,13,16,1262,3198,1420,-1778
2018,6,13,17,1313,3223,1434,-1789
2018,6,13,18,1286,3226,1536,-1690
2018,6,13,19,1304,3250,1613,-1637
2018,6,13,20,1353,3220,1613,-1607
2018,6,13,21,1333,3215,1700,-1515
2018,6,13,22,1295,3172,1693,-1479
2018,6,13,23,1402,3166,1714,-1452
2018,6,14,0,1384,3174,1687,-1487
2018,6,14,1,1412,3214,1703,-1511
2018,6,14,2,1413,3208,1727,-1481
2018,6,14,3,1388,3190,1728,-1462
2018,6,14,4,1357,3193,1741,-1452
2018,6,14,5,1349,3166,1746,-1420
2018,6,14,6,1353,2951,1761,-1190
2018,6,14,7,1171,2484,1543,-941
2018,6,14,8,1157,2277,1457,-820
2018,6,14,9,1151,2188,1477,-711
2018,6,14,10,1089,2137,1487,-650
2018,6,14,11,1160,2154,1513,-641
2018,6,14,12,1187,2324,1555,-769
2018,6,14,13,1075,2423,1525,-898
2018,6,14,14,892,2696,1477,-1219
2018,6,14,15,1137,3139,1793,-1346
2018,6,14,16,1269,3216,1698,-1518
2018,6,14,17,1320,3218,1765,-1453
2018,6,14,18,1387,3134,1708,-1426
2018,6,14,19,1456,3160,1760,-1400
2018,6,14,20,1536,3129,1733,-1396
2018,6,14,21,1535,3110,1785,-1325
2018,6,14,22,1572,3152,1821,-1331
2018,6,14,23,1721,3145,1843,-1302
2018,6,15,0,1694,3152,1894,-1258
2018,6,15,1,1744,3189,1906,-1283
2018,6,15,2,1723,3170,1933,-1237
2018,6,15,3,1678,3066,1860,-1206
2018,6,15,4,1643,3038,1878,-1160
2018,6,15,5,1638,3029,1777,-1252
2018,6,15,6,1876,2847,1760,-1087
2018,6,15,7,1622,2680,1779,-901
2018,6,15,8,1258,2528,1788,-740
2018,6,15,9,1058,2387,1658,-729
2018,6,15,10,1080,2310,1610,-700
2018,6,15,11,1183,2376,1657,-719
2018,6,15,12,1363,2366,1590,-776
2018,6,15,13,1331,2535,1555,-980
2018,6,15,14,1268,2801,1452,-1349
2018,6,15,15,1474,3002,1527,-1475
2018,6,15,16,1582,3064,1510,-1554
2018,6,15,17,1545,3072,1503,-1569
2018,6,15,18,1558,3084,1500,-1584
2018,6,15,19,1656,3207,1619,-1588
2018,6,15,20,1685,3205,1657,-1548
2018,6,15,21,1507,3183,1720,-1463
2018,6,15,22,1491,3163,1729,-1434
2018,6,15,23,1483,3157,1731,-1426
2018,6,16,0,1351,3164,1737,-1427
2018,6,16,1,1329,3169,1812,-1357
2018,6,16,2,1273,3129,1905,-1224
2018,6,16,3,1272,3079,1774,-1305
2018,6,16,4,1266,3058,1699,-1359
2018,6,16,5,1253,3049,1760,-1289
2018,6,16,6,1479,2928,1840,-1088
2018,6,16,7,1414,2707,1751,-956
2018,6,16,8,1277,2484,1634,-850
2018,6,16,9,1181,2371,1616,-755
2018,6,16,10,1089,2281,1530,-751
2018,6,16,11,1061,2253,1526,-727
2018,6,16,12,1069,2267,1537,-730
2018,6,16,13,1047,2287,1529,-758
2018,6,16,14,954,2446,1270,-1176
2018,6,16,15,1065,2632,1341,-1291
2018,6,16,16,1154,2864,1548,-1316
2018,6,16,17,1310,2995,1589,-1406
2018,6,16,18,1400,3029,1637,-1392
2018,6,16,19,1429,3034,1606,-1428
2018,6,16,20,1415,3016,1598,-1418
2018,6,16,21,1373,2978,1571,-1407
2018,6,16,22,1341,2961,1428,-1533
2018,6,16,23,1332,2927,1366,-1561
2018,6,17,0,1261,2913,1276,-1637
2018,6,17,1,1251,2961,1332,-1629
2018,6,17,2,1240,2993,1296,-1697
2018,6,17,3,1216,2994,1361,-1633
2018,6,17,4,1187,2937,1282,-1655
2018,6,17,5,1178,2931,1284,-1647
2018,6,17,6,1476,2826,1263,-1563
2018,6,17,7,1409,2632,1233,-1399
2018,6,17,8,1220,2449,1242,-1207
2018,6,17,9,1177,2323,1330,-993
2018,6,17,10,1047,2257,1232,-1025
2018,6,17,11,852,2286,1246,-1040
2018,6,17,12,928,2288,1350,-938
2018,6,17,13,911,2235,1288,-947
2018,6,17,14,953,2307,1198,-1109
2018,6,17,15,963,2311,1218,-1093
2018,6,17,16,985,2551,1239,-1312
2018,6,17,17,1148,2958,1503,-1455
2018,6,17,18,1237,3060,1476,-1584
2018,6,17,19,1270,3111,1441,-1670
2018,6,17,20,1299,3145,1538,-1607
2018,6,17,21,1313,3053,1269,-1784
2018,6,17,22,1328,3087,1368,-1719
2018,6,17,23,1393,3236,1508,-1728
2018,6,18,0,1352,3336,1560,-1776
2018,6,18,1,1425,3403,1536,-1867
2018,6,18,2,1459,3430,1671,-1759
2018,6,18,3,1452,3426,1673,-1753
2018,6,18,4,1426,3396,1744,-1652
2018,6,18,5,1418,3357,1737,-1620
2018,6,18,6,1595,3179,1886,-1293
2018,6,18,7,1457,2899,1925,-974
2018,6,18,8,1319,2724,1822,-902
2018,6,18,9,1244,2567,1729,-838
2018,6,18,10,1169,2409,1582,-827
2018,6,18,11,1046,2290,1513,-777
2018,6,18,12,1037,2321,1508,-813
2018,6,18,13,1224,2605,1667,-938
2018,6,18,14,1331,2704,1504,-1200
2018,6,18,15,1251,3041,1565,-1476
2018,6,18,16,1504,3311,1762,-1549
2018,6,18,17,1616,3427,1892,-1535
2018,6,18,18,1674,3519,1982,-1537
2018,6,18,19,1754,3614,1969,-1645
2018,6,18,20,1703,3698,1958,-1740
2018,6,18,21,1757,3757,2011,-1746
2018,6,18,22,1798,3800,2077,-1723
2018,6,18,23,1846,3858,2073,-1785
2018,6,19,0,1783,3892,2164,-1728
2018,6,19,1,1793,3924,2179,-1745
2018,6,19,2,1737,3874,2039,-1835
2018,6,19,3,1658,3831,2106,-1725
2018,6,19,4,1687,3732,2141,-1591
2018,6,19,5,1608,3637,2136,-1501
2018,6,19,6,1795,3381,1977,-1404
2018,6,19,7,1559,3055,1913,-1142
2018,6,19,8,1522,2763,1720,-1043
2018,6,19,9,1460,2596,1605,-992
2018,6,19,10,1372,2494,1585,-908
2018,6,19,11,1329,2515,1669,-846
2018,6,19,12,1370,2554,1657,-897
2018,6,19,13,1450,2705,1683,-1023
2018,6,19,14,1246,2947,1665,-1282
2018,6,19,15,1213,3171,1643,-1528
2018,6,19,16,1410,3287,1643,-1644
2018,6,19,17,1507,3369,1659,-1711
2018,6,19,18,1591,3424,1690,-1734
2018,6,19,19,1651,3510,1798,-1713
2018,6,19,20,1579,3556,1778,-1778
2018,6,19,21,1627,3609,1785,-1825
2018,6,19,22,1663,3670,1827,-1843
2018,6,19,23,1714,3754,1827,-1928
2018,6,20,0,1653,3875,1854,-2021
2018,6,20,1,1689,3907,1843,-2065
2018,6,20,2,1698,3900,1852,-2048
2018,6,20,3,1629,3827,1855,-1973
2018,6,20,4,1686,3748,1879,-1869
2018,6,20,5,1612,3666,1880,-1787
2018,6,20,6,1912,3431,1972,-1459
2018,6,20,7,1644,3107,1940,-1168
2018,6,20,8,1535,2874,1859,-1015
2018,6,20,9,1560,2750,1837,-913
2018,6,20,10,1475,2661,1772,-889
2018,6,20,11,1440,2629,1764,-865
2018,6,20,12,1482,2730,1819,-911
2018,6,20,13,1615,2847,1816,-1031
2018,6,20,14,1429,3064,1809,-1255
2018,6,20,15,1662,3276,1767,-1509
2018,6,20,16,1793,3445,1877,-1568
2018,6,20,17,1886,3534,1934,-1600
2018,6,20,18,1983,3649,2055,-1594
2018,6,20,19,2056,3771,2165,-1606
2018,6,20,20,1947,3825,2140,-1685
2018,6,20,21,2012,3913,2168,-1745
2018,6,20,22,2069,3978,2222,-1756
2018,6,20,23,2139,3987,2240,-1747
2018,6,21,0,2020,4027,2210,-1817
2018,6,21,1,2049,4012,2185,-1827
2018,6,21,2,2035,3973,2243,-1730
2018,6,21,3,1953,3951,2247,-1704
2018,6,21,4,2020,3839,2249,-1590
2018,6,21,5,1950,3742,2161,-1581
2018,6,21,6,2249,3499,2225,-1274
2018,6,21,7,1899,3029,2033,-996
2018,6,21,8,1396,2740,1882,-858
2018,6,21,9,1403,2619,1619,-1000
2018,6,21,10,932,2258,1185,-1073
2018,6,21,11,1018,2247,1137,-1110
2018,6,21,12,1035,2363,1170,-1193
2018,6,21,13,1227,2580,1337,-1243
2018,6,21,14,980,2828,1358,-1470
2018,6,21,15,1176,3140,1469,-1671
2018,6,21,16,1397,3302,1716,-1586
2018,6,21,17,1483,3341,1728,-1613
2018,6,21,18,1540,3410,1757,-1653
2018,6,21,19,1600,3341,1679,-1662
2018,6,21,20,1599,3408,1751,-1657
2018,6,21,21,1640,3399,1816,-1583
2018,6,21,22,1664,3376,1985,-1391
2018,6,21,23,1721,3336,2011,-1325
2018,6,22,0,1630,3308,1891,-1417
2018,6,22,1,1769,3424,1986,-1438
2018,6,22,2,1743,3406,1980,-1426
2018,6,22,3,1687,3347,1916,-1431
2018,6,22,4,1645,3277,1658,-1619
2018,6,22,5,1556,3298,1671,-1627
2018,6,22,6,1581,3065,1712,-1353
2018,6,22,7,1253,2629,1303,-1326
2018,6,22,8,963,2560,1346,-1214
2018,6,22,9,896,2278,1133,-1145
2018,6,22,10,806,2200,1083,-1117
2018,6,22,11,834,2192,1082,-1110
2018,6,22,12,875,2318,1145,-1173
2018,6,22,13,1093,2587,1312,-1275
2018,6,22,14,947,2780,1306,-1474
2018,6,22,15,1095,3103,1387,-1716
2018,6,22,16,1185,3230,1546,-1684
2018,6,22,17,1231,3310,1554,-1756
2018,6,22,18,1270,3357,1452,-1905
2018,6,22,19,1296,3390,1486,-1904
2018,6,22,20,1319,3366,1616,-1750
2018,6,22,21,1340,3343,1634,-1709
2018,6,22,22,1345,3305,1651,-1654
2018,6,22,23,1344,3306,1675,-1631
2018,6,23,0,1345,3319,1673,-1646
2018,6,23,1,1429,3253,1612,-1641
2018,6,23,2,1391,3208,1581,-1627
2018,6,23,3,1345,3129,1548,-1581
2018,6,23,4,1296,3110,1464,-1646
2018,6,23,5,1257,3080,1538,-1542
2018,6,23,6,1387,2929,1493,-1436
2018,6,23,7,1238,2523,1351,-1172
2018,6,23,8,1117,2290,1294,-996
2018,6,23,9,949,2179,1298,-881
2018,6,23,10,844,2111,1296,-815
2018,6,23,11,787,2075,1235,-840
2018,6,23,12,788,2106,1203,-903
2018,6,23,13,781,2134,1080,-1054
2018,6,23,14,666,2182,948,-1234
2018,6,23,15,621,2326,783,-1543
2018,6,23,16,766,2708,1034,-1674
2018,6,23,17,912,2962,1262,-1700
2018,6,23,18,993,2818,1123,-1695
2018,6,23,19,1048,2802,1233,-1569
2018,6,23,20,1079,2851,1360,-1491
2018,6,23,21,1091,2872,1417,-1455
2018,6,23,22,1111,2812,1416,-1396
2018,6,23,23,1255,2986,1613,-1373
2018,6,24,0,1272,2988,1602,-1386
2018,6,24,1,1313,3064,1609,-1455
2018,6,24,2,1316,3069,1605,-1464
2018,6,24,3,1287,3041,1394,-1647
2018,6,24,4,1252,2995,1330,-1665
2018,6,24,5,1137,3016,1440,-1576
2018,6,24,6,1174,2917,1431,-1486
2018,6,24,7,1182,2726,1530,-1196
2018,6,24,8,1055,2470,1440,-1030
2018,6,24,9,896,2168,1254,-914
2018,6,24,10,959,2138,1281,-857
2018,6,24,11,944,2128,1301,-827
2018,6,24,12,1065,2254,1440,-814
2018,6,24,13,932,2125,1283,-842
2018,6,24,14,715,2109,1213,-896
2018,6,24,15,819,2294,1181,-1113
2018,6,24,16,966,2494,1184,-1310
2018,6,24,17,1031,2703,1326,-1377
2018,6,24,18,1113,2866,1406,-1460
2018,6,24,19,1161,3015,1501,-1514
2018,6,24,20,1164,3030,1491,-1539
2018,6,24,21,1148,3061,1494,-1567
2018,6,24,22,1139,3090,1507,-1583
2018,6,24,23,1174,3151,1584,-1567
2018,6,25,0,1305,3216,1585,-1631
2018,6,25,1,1339,3298,1608,-1690
2018,6,25,2,1346,3302,1573,-1729
2018,6,25,3,1325,3247,1556,-1691
2018,6,25,4,1270,3175,1535,-1640
2018,6,25,5,1402,3154,1410,-1744
2018,6,25,6,1347,2975,1329,-1646
2018,6,25,7,1271,2734,1332,-1402
2018,6,25,8,1206,2561,1472,-1089
2018,6,25,9,1109,2354,1378,-976
2018,6,25,10,924,2189,1284,-905
2018,6,25,11,876,2159,1345,-814
2018,6,25,12,849,2211,1167,-1044
2018,6,25,13,791,2374,1320,-1054
2018,6,25,14,825,2552,1315,-1237
2018,6,25,15,1043,2775,1267,-1508
2018,6,25,16,1028,2888,1223,-1665
2018,6,25,17,1072,2978,1283,-1695
2018,6,25,18,1116,3042,1276,-1766
2018,6,25,19,1133,3090,1283,-1807
2018,6,25,20,1155,3201,1378,-1823
2018,6,25,21,1170,3150,1357,-1793
2018,6,25,22,1170,3154,1386,-1768
2018,6,25,23,1185,3125,1386,-1739
2018,6,26,0,1150,3122,1361,-1761
2018,6,26,1,1285,3383,1591,-1792
2018,6,26,2,1303,3390,1614,-1776
2018,6,26,3,1308,3331,1612,-1719
2018,6,26,4,1308,3104,1457,-1647
2018,6,26,5,1377,3109,1439,-1670
2018,6,26,6,1462,2792,1320,-1472
2018,6,26,7,1228,2538,1327,-1211
2018,6,26,8,852,2316,1279,-1037
2018,6,26,9,792,2213,1183,-1030
2018,6,26,10,792,2165,1176,-989
2018,6,26,11,782,2167,1148,-1019
2018,6,26,12,874,2339,1210,-1129
2018,6,26,13,874,2500,1199,-1301
2018,6,26,14,1092,2691,1145,-1546
2018,6,26,15,1095,2866,1125,-1741
2018,6,26,16,1088,2977,1099,-1878
2018,6,26,17,1098,3150,1219,-1931
2018,6,26,18,1133,3265,1291,-1974
2018,6,26,19,1105,3311,1331,-1980
2018,6,26,20,1102,3319,1338,-1981
2018,6,26,21,1105,3330,1334,-1996
2018,6,26,22,1112,3331,1342,-1989
2018,6,26,23,1135,3347,1353,-1994
2018,6,27,0,1178,3321,1319,-2002
2018,6,27,1,1195,3375,1325,-2050
2018,6,27,2,1200,3432,1420,-2012
2018,6,27,3,1200,3385,1467,-1918
2018,6,27,4,1193,3309,1468,-1841
2018,6,27,5,1192,3245,1456,-1789
2018,6,27,6,1196,3122,1494,-1628
2018,6,27,7,968,2803,1409,-1394
2018,6,27,8,763,2585,1297,-1288
2018,6,27,9,893,2385,1141,-1244
2018,6,27,10,806,2294,1175,-1119
2018,6,27,11,816,2289,1177,-1112
2018,6,27,12,877,2423,1240,-1183
2018,6,27,13,1025,2715,1355,-1360
2018,6,27,14,1028,2935,1380,-1555
2018,6,27,15,1081,3122,1381,-1741
2018,6,27,16,1245,3235,1414,-1821
2018,6,27,17,1287,3286,1419,-1867
2018,6,27,18,1300,3330,1407,-1923
2018,6,27,19,1296,3343,1475,-1868
2018,6,27,20,1297,3354,1464,-1890
2018,6,27,21,1330,3346,1460,-1886
2018,6,27,22,1308,3345,1484,-1861
2018,6,27,23,1283,3321,1531,-1790
2018,6,28,0,1286,3334,1580,-1754
2018,6,28,1,1300,3272,1536,-1736
2018,6,28,2,1338,3249,1576,-1673
2018,6,28,3,1293,3229,1550,-1679
2018,6,28,4,1289,3284,1663,-1621
2018,6,28,5,1301,3174,1474,-1700
2018,6,28,6,1236,2873,1279,-1594
2018,6,28,7,813,2549,1183,-1366
2018,6,28,8,804,2505,1267,-1238
2018,6,28,9,933,2332,1151,-1181
2018,6,28,10,677,2180,1137,-1043
2018,6,28,11,768,2179,1118,-1061
2018,6,28,12,858,2308,1080,-1228
2018,6,28,13,920,2454,1090,-1364
2018,6,28,14,961,2770,1157,-1613
2018,6,28,15,1069,3082,1295,-1787
2018,6,28,16,1117,3140,1305,-1835
2018,6,28,17,1182,3249,1367,-1882
2018,6,28,18,1226,3308,1382,-1926
2018,6,28,19,1248,3324,1420,-1904
2018,6,28,20,1277,3316,1629,-1687
2018,6,28,21,1282,3298,1662,-1636
2018,6,28,22,1285,3283,1679,-1604
2018,6,28,23,1295,3283,1667,-1616
2018,6,29,0,1297,3287,1695,-1592
2018,6,29,1,1305,3332,1676,-1656
2018,6,29,2,1295,3325,1658,-1667
2018,6,29,3,1284,3300,1661,-1639
2018,6,29,4,1289,3273,1685,-1588
2018,6,29,5,1196,3182,1591,-1591
2018,6,29,6,1175,2946,1589,-1357
2018,6,29,7,943,2661,1451,-1210
2018,6,29,8,655,2252,1065,-1187
2018,6,29,9,630,2134,977,-1157
2018,6,29,10,634,2088,990,-1098
2018,6,29,11,618,2084,987,-1097
2018,6,29,12,535,2236,1050,-1186
2018,6,29,13,761,2383,1084,-1299
2018,6,29,14,662,2574,1053,-1521
2018,6,29,15,785,2851,1066,-1785
2018,6,29,16,836,2939,1033,-1906
2018,6,29,17,893,3099,1128,-1971
2018,6,29,18,951,3136,1075,-2061
2018,6,29,19,980,3187,1119,-2068
2018,6,29,20,1008,3181,1178,-2003
2018,6,29,21,1027,3184,1287,-1897
2018,6,29,22,1026,3160,1333,-1827
2018,6,29,23,1041,3156,1392,-1764
2018,6,30,0,1081,3148,1381,-1767
2018,6,30,1,1086,3152,1412,-1740
2018,6,30,2,1051,3075,1384,-1691
2018,6,30,3,993,3012,1321,-1691
2018,6,30,4,997,2982,1306,-1676
2018,6,30,5,994,2939,1238,-1701
2018,6,30,6,1160,2757,1232,-1525
2018,6,30,7,910,2534,1131,-1403
2018,6,30,8,808,2354,1080,-1274
2018,6,30,9,762,2188,1012,-1176
2018,6,30,10,727,2121,1012,-1109
2018,6,30,11,710,1999,861,-1138
2018,6,30,12,707,2093,1022,-1071
2018,6,30,13,681,2121,1034,-1087
2018,6,30,14,483,2150,894,-1256
2018,6,30,15,545,2328,971,-1357
2018,6,30,16,714,2608,1108,-1500
2018,6,30,17,734,2751,1107,-1644
2018,6,30,18,831,2814,1057,-1757
2018,6,30,19,836,2838,1028,-1810
2018,6,30,20,820,2829,1070,-1759
2018,6,30,21,842,2814,1044,-1770
2018,6,30,22,834,2773,1086,-1687
2018,6,30,23,816,2756,1060,-1696
2018,7,1,0,826,2768,1036,-1732
2018,7,1,1,848,2792,1013,-1779
2018,7,1,2,788,2786,1074,-1712
2018,7,1,3,745,2742,1048,-1694
2018,7,1,4,714,2722,1141,-1581
2018,7,1,5,694,2737,1175,-1562
2018,7,1,6,707,2622,1205,-1417
2018,7,1,7,593,2450,1168,-1282
2018,7,1,8,675,2286,1067,-1219
2018,7,1,9,752,2182,899,-1283
2018,7,1,10,766,2107,865,-1242
2018,7,1,11,564,2104,851,-1253
2018,7,1,12,602,2108,846,-1262
2018,7,1,13,645,2116,838,-1278
2018,7,1,14,616,2180,869,-1311
2018,7,1,15,819,2232,936,-1296
2018,7,1,16,825,2265,803,-1462
2018,7,1,17,839,2417,830,-1587
2018,7,1,18,807,2574,1067,-1507
2018,7,1,19,860,2528,1028,-1500
2018,7,1,20,828,2517,1003,-1514
2018,7,1,21,924,2503,974,-1529
2018,7,1,22,729,2492,971,-1521
2018,7,1,23,786,2535,1003,-1532
2018,7,2,0,889,2721,1085,-1636
2018,7,2,1,946,2769,1114,-1655
2018,7,2,2,984,2784,1184,-1600
2018,7,2,3,1119,2766,1257,-1509
2018,7,2,4,1116,2810,1342,-1468
2018,7,2,5,1238,2939,1495,-1444
2018,7,2,6,1177,2680,1335,-1345
2018,7,2,7,1111,2440,1328,-1112
2018,7,2,8,1067,2370,1316,-1054
2018,7,2,9,965,2204,1222,-982
2018,7,2,10,838,2149,1224,-925
2018,7,2,11,908,2099,1138,-961
2018,7,2,12,980,2210,1171,-1039
2018,7,2,13,1098,2394,1233,-1161
2018,7,2,14,1075,2592,1253,-1339
2018,7,2,15,1258,2794,1462,-1332
2018,7,2,16,1225,2908,1435,-1473
2018,7,2,17,1224,2960,1484,-1476
2018,7,2,18,1192,3002,1519,-1483
2018,7,2,19,1278,3017,1618,-1399
2018,7,2,20,1288,3053,1599,-1454
2018,7,2,21,1469,3040,1605,-1435
2018,7,2,22,1406,3028,1618,-1410
2018,7,2,23,1419,3001,1682,-1319
2018,7,3,0,1516,3049,1777,-1272
2018,7,3,1,1496,3106,1865,-1241
2018,7,3,2,1469,3027,1737,-1290
2018,7,3,3,1375,2962,1790,-1172
2018,7,3,4,1493,2778,1493,-1285
2018,7,3,5,1403,2895,1809,-1086
2018,7,3,6,1462,2857,1943,-914
2018,7,3,7,1238,2481,1858,-623
2018,7,3,8,1251,2297,1730,-567
2018,7,3,9,1353,2360,1752,-608
2018,7,3,10,1267,2226,1543,-683
2018,7,3,11,1175,2225,1519,-706
2018,7,3,12,1317,2379,1637,-742
2018,7,3,13,1371,2524,1596,-928
2018,7,3,14,1445,2672,1525,-1147
2018,7,3,15,1438,2876,1606,-1270
2018,7,3,16,1725,2961,1837,-1124
2018,7,3,17,1645,2997,1772,-1225
2018,7,3,18,1734,3072,1910,-1162
2018,7,3,19,1794,3088,1903,-1185
2018,7,3,20,1855,3097,1875,-1222
2018,7,3,21,1908,3086,1930,-1156
2018,7,3,22,1933,3128,2040,-1088
2018,7,3,23,2060,3093,1982,-1111
2018,7,4,0,2222,3108,2031,-1077
2018,7,4,1,2267,3182,2063,-1119
2018,7,4,2,2248,3181,2103,-1078
2018,7,4,3,2196,3173,2161,-1012
2018,7,4,4,2133,3101,1965,-1136
2018,7,4,5,2078,3065,2021,-1044
2018,7,4,6,1969,2929,1963,-966
2018,7,4,7,1740,2687,1915,-772
2018,7,4,8,1477,2453,1732,-721
2018,7,4,9,1509,2314,1736,-578
2018,7,4,10,1429,2225,1738,-487
2018,7,4,11,1395,2159,1649,-510
2018,7,4,12,1466,2119,1606,-513
2018,7,4,13,1570,2178,1632,-546
2018,7,4,14,1315,2277,1581,-696
2018,7,4,15,1381,2451,1514,-937
2018,7,4,16,1552,2626,1525,-1101
2018,7,4,17,1706,2795,1643,-1152
2018,7,4,18,1814,2908,1688,-1220
2018,7,4,19,1857,2916,1654,-1262
2018,7,4,20,1883,2957,1640,-1317
2018,7,4,21,1896,2981,1661,-1320
2018,7,4,22,1907,2997,1804,-1193
2018,7,4,23,1928,3021,2047,-974
2018,7,5,0,1977,3075,2081,-994
2018,7,5,1,2017,3067,2073,-994
2018,7,5,2,2006,3010,2073,-937
2018,7,5,3,2009,2935,2166,-769
2018,7,5,4,1990,2869,2069,-800
2018,7,5,5,1953,2846,2069,-777
2018,7,5,6,1950,2763,2149,-614
2018,7,5,7,1875,2497,1999,-498
2018,7,5,8,1675,2487,1985,-502
2018,7,5,9,1643,2368,1896,-472
2018,7,5,10,1647,2255,1841,-414
2018,7,5,11,1661,2111,1722,-389
2018,7,5,12,1711,2227,1841,-386
2018,7,5,13,1695,2325,1857,-468
2018,7,5,14,1636,2510,1689,-821
2018,7,5,15,1578,2716,1819,-897
2018,7,5,16,1813,2894,1978,-916
2018,7,5,17,1816,3038,1975,-1063
2018,7,5,18,1925,3188,1892,-1296
2018,7,5,19,1947,3271,1846,-1425
2018,7,5,20,1988,3323,1928,-1395
2018,7,5,21,2021,3419,2020,-1399
2018,7,5,22,1974,3395,1971,-1424
2018,7,5,23,1965,3504,2222,-1282
2018,7,6,0,2095,3555,2267,-1288
2018,7,6,1,2110,3599,2347,-1252
2018,7,6,2,2054,3607,2447,-1160
2018,7,6,3,1996,3356,2365,-991
2018,7,6,4,1934,3236,2422,-814
2018,7,6,5,2017,3164,2403,-761
2018,7,6,6,2278,2995,2411,-584
2018,7,6,7,1917,2763,2109,-654
2018,7,6,8,1678,2519,1999,-520
2018,7,6,9,1588,2360,1904,-456
2018,7,6,10,1625,2294,1815,-479
2018,7,6,11,1424,2272,1761,-511
2018,7,6,12,1494,2306,1792,-514
2018,7,6,13,1476,2395,1883,-512
2018,7,6,14,1265,2634,1671,-963
2018,7,6,15,1349,2849,1885,-964
2018,7,6,16,1552,3017,1834,-1183
2018,7,6,17,1735,3160,1931,-1229
2018,7,6,18,1882,3257,2027,-1230
2018,7,6,19,1951,3355,2251,-1104
2018,7,6,20,2037,3345,2386,-959
2018,7,6,21,2080,3335,2401,-934
2018,7,6,22,2099,3358,2349,-1009
2018,7,6,23,2217,3346,2401,-945
2018,7,7,0,2334,3391,2414,-977
2018,7,7,1,2332,3411,2250,-1161
2018,7,7,2,2270,3322,2410,-912
2018,7,7,3,2148,3232,2260,-972
2018,7,7,4,2010,3131,2156,-975
2018,7,7,5,1915,3108,2396,-712
2018,7,7,6,2246,2937,2350,-587
2018,7,7,7,2014,2703,2063,-640
2018,7,7,8,1590,2524,1939,-585
2018,7,7,9,1441,2322,1678,-644
2018,7,7,10,1432,2112,1683,-429
2018,7,7,11,1394,1981,1577,-404
2018,7,7,12,1400,2051,1754,-297
2018,7,7,13,1413,2177,1822,-355
2018,7,7,14,1128,2343,1974,-369
2018,7,7,15,1231,2495,1828,-667
2018,7,7,16,1385,2652,1906,-746
2018,7,7,17,1590,2810,1922,-888
2018,7,7,18,1736,2861,1828,-1033
2018,7,7,19,1783,2857,1834,-1023
2018,7,7,20,1798,2896,1921,-975
2018,7,7,21,1821,2879,1930,-949
2018,7,7,22,1811,2904,1964,-940
2018,7,7,23,1875,2925,1931,-994
2018,7,8,0,1919,2984,2018,-966
2018,7,8,1,1950,3060,2102,-958
2018,7,8,2,2007,3072,2113,-959
2018,7,8,3,1998,3043,2142,-901
2018,7,8,4,1957,2958,2104,-854
2018,7,8,5,1951,2932,1955,-977
2018,7,8,6,2145,2702,2134,-568
2018,7,8,7,2135,2500,1994,-506
2018,7,8,8,1497,2365,1793,-572
2018,7,8,9,1260,2266,1651,-615
2018,7,8,10,1343,2088,1530,-558
2018,7,8,11,1478,2164,1739,-425
2018,7,8,12,1606,2174,1795,-379
2018,7,8,13,1499,2208,1889,-319
2018,7,8,14,1533,2365,1999,-366
2018,7,8,15,1530,2469,1912,-557
2018,7,8,16,1713,2692,1972,-720
2018,7,8,17,1891,2859,2045,-814
2018,7,8,18,2001,2969,2048,-921
2018,7,8,19,2061,3035,2057,-978
2018,7,8,20,2094,3081,2052,-1029
2018,7,8,21,2109,3108,2150,-958
2018,7,8,22,2119,3132,2136,-996
2018,7,8,23,2159,3186,2139,-1047
2018,7,9,0,2265,3272,2210,-1062
2018,7,9,1,2344,3368,2316,-1052
2018,7,9,2,2353,3481,2342,-1139
2018,7,9,3,2304,3433,2412,-1021
2018,7,9,4,2343,3405,2440,-965
2018,7,9,5,2328,3373,2413,-960
2018,7,9,6,2216,3196,2249,-947
2018,7,9,7,1857,2837,2104,-733
2018,7,9,8,1322,2566,1718,-848
2018,7,9,9,1379,2517,1663,-854
2018,7,9,10,1316,2456,1709,-747
2018,7,9,11,1290,2439,1700,-739
2018,7,9,12,1559,2503,1657,-846
2018,7,9,13,1497,2554,1573,-981
2018,7,9,14,1574,2803,1857,-946
2018,7,9,15,1786,2955,1663,-1292
2018,7,9,16,1902,3091,1702,-1389
2018,7,9,17,1932,3168,1855,-1313
2018,7,9,18,2012,3350,2055,-1295
2018,7,9,19,1902,3400,2124,-1276
2018,7,9,20,1978,3452,2179,-1273
2018,7,9,21,1999,3473,2304,-1169
2018,7,9,22,2010,3486,2492,-994
2018,7,9,23,2139,3487,2484,-1003
2018,7,10,0,2271,3479,2537,-942
2018,7,10,1,2290,3488,2506,-982
2018,7,10,2,2254,3470,2492,-978
2018,7,10,3,2151,3378,2509,-869
2018,7,10,4,1975,3328,2312,-1016
2018,7,10,5,1896,3287,2330,-957
2018,7,10,6,1777,3086,2327,-759
2018,7,10,7,1611,2794,2157,-637
2018,7,10,8,1575,2537,2092,-445
2018,7,10,9,1597,2426,2053,-373
2018,7,10,10,1440,2360,2075,-285
2018,7,10,11,1444,2247,1846,-401
2018,7,10,12,1506,2320,1780,-540
2018,7,10,13,1550,2618,1727,-891
2018,7,10,14,1575,2762,1752,-1010
2018,7,10,15,1634,3035,2024,-1011
2018,7,10,16,1692,3143,2004,-1139
2018,7,10,17,1678,3237,2033,-1204
2018,7,10,18,1743,3269,2091,-1178
2018,7,10,19,1796,3329,2150,-1179
2018,7,10,20,1838,3299,2259,-1040
2018,7,10,21,1876,3243,2161,-1082
2018,7,10,22,1923,3196,2115,-1081
2018,7,10,23,2085,3200,2277,-923
2018,7,11,0,2255,3230,2484,-746
2018,7,11,1,2333,3280,2578,-702
2018,7,11,2,2370,3305,2671,-634
2018,7,11,3,2351,3271,2641,-630
2018,7,11,4,2343,3214,2594,-620
2018,7,11,5,2333,3182,2504,-678
2018,7,11,6,2455,3034,2485,-549
2018,7,11,7,2049,2767,2314,-453
2018,7,11,8,1932,2478,2054,-424
2018,7,11,9,1769,2325,2002,-323
2018,7,11,10,1828,2231,1965,-266
2018,7,11,11,1876,2187,1931,-256
2018,7,11,12,1879,2249,1934,-315
2018,7,11,13,1903,2380,1891,-489
2018,7,11,14,1902,2588,1833,-755
2018,7,11,15,1917,2779,1856,-923
2018,7,11,16,2043,2930,1909,-1021
2018,7,11,17,2135,3042,2086,-956
2018,7,11,18,2205,3120,2116,-1004
2018,7,11,19,2264,3170,2198,-972
2018,7,11,20,2234,3292,2134,-1158
2018,7,11,21,2242,3335,2250,-1085
2018,7,11,22,2228,3411,2234,-1177
2018,7,11,23,2216,3470,2288,-1182
2018,7,12,0,2235,3523,2300,-1223
2018,7,12,1,2293,3548,2406,-1142
2018,7,12,2,2361,3541,2436,-1105
2018,7,12,3,2336,3493,2337,-1156
2018,7,12,4,2322,3418,2443,-975
2018,7,12,5,2298,3335,2425,-910
2018,7,12,6,2446,3162,2504,-658
2018,7,12,7,2307,2860,2513,-347
2018,7,12,8,1693,2539,1952,-587
2018,7,12,9,1407,2362,1854,-508
2018,7,12,10,1581,2178,1668,-510
2018,7,12,11,1558,2177,1678,-499
2018,7,12,12,1644,2299,1752,-547
2018,7,12,13,1623,2434,1778,-656
2018,7,12,14,1481,2633,1816,-817
2018,7,12,15,1396,2930,1844,-1086
2018,7,12,16,1499,3085,1824,-1261
2018,7,12,17,1620,3221,1902,-1319
2018,7,12,18,1837,3355,1994,-1361
2018,7,12,19,2020,3451,2177,-1274
2018,7,12,20,2093,3521,2327,-1194
2018,7,12,21,2149,3604,2329,-1275
2018,7,12,22,2192,3659,2436,-1223
2018,7,12,23,2242,3737,2520,-1217
2018,7,13,0,2158,3794,2524,-1270
2018,7,13,1,2190,3848,2543,-1305
2018,7,13,2,2261,3759,2470,-1289
2018,7,13,3,2176,3666,2428,-1238
2018,7,13,4,2095,3549,2510,-1039
2018,7,13,5,2054,3464,2536,-928
2018,7,13,6,2143,3262,2447,-815
2018,7,13,7,2145,2930,2457,-473
2018,7,13,8,1919,2638,2189,-449
2018,7,13,9,1894,2488,1953,-535
2018,7,13,10,1819,2308,1877,-431
2018,7,13,11,1739,2259,1842,-417
2018,7,13,12,1814,2318,1858,-460
2018,7,13,13,1890,2421,1900,-521
2018,7,13,14,1630,2645,1911,-734
2018,7,13,15,1571,2922,1924,-998
2018,7,13,16,1708,3084,2038,-1046
2018,7,13,17,1831,3204,2193,-1011
2018,7,13,18,1933,3278,2111,-1167
2018,7,13,19,2078,3344,2180,-1164
2018,7,13,20,2225,3417,2354,-1063
2018,7,13,21,2241,3522,2447,-1075
2018,7,13,22,2249,3564,2501,-1063
2018,7,13,23,2269,3662,2586,-1076
2018,7,14,0,2280,3771,2672,-1099
2018,7,14,1,2298,3799,2758,-1041
2018,7,14,2,2240,3782,2736,-1046
2018,7,14,3,2239,3714,2629,-1085
2018,7,14,4,2107,3600,2504,-1096
2018,7,14,5,2007,3522,2491,-1031
2018,7,14,6,2180,3312,2481,-831
2018,7,14,7,2046,2980,2268,-712
2018,7,14,8,1790,2841,2134,-707
2018,7,14,9,1601,2611,2061,-550
2018,7,14,10,1640,2526,2150,-376
2018,7,14,11,1548,2469,2168,-301
2018,7,14,12,1575,2486,2044,-442
2018,7,14,13,1467,2474,1845,-629
2018,7,14,14,1504,2547,1772,-775
2018,7,14,15,1289,2666,1919,-747
2018,7,14,16,1328,2948,2046,-902
2018,7,14,17,1491,3145,2048,-1097
2018,7,14,18,1657,3223,1953,-1270
2018,7,14,19,1758,3337,2000,-1337
2018,7,14,20,1823,3384,2000,-1384
2018,7,14,21,1964,3464,2146,-1318
2018,7,14,22,2110,3516,2308,-1208
2018,7,14,23,2158,3603,2344,-1259
2018,7,15,0,2210,3653,2395,-1258
2018,7,15,1,2267,3724,2409,-1315
2018,7,15,2,2237,3728,2400,-1328
2018,7,15,3,2184,3675,2392,-1283
2018,7,15,4,2108,3571,2407,-1164
2018,7,15,5,2078,3494,2374,-1120
2018,7,15,6,2139,3373,2483,-890
2018,7,15,7,2097,3129,2403,-726
2018,7,15,8,1853,2807,1874,-933
2018,7,15,9,1772,2692,1958,-734
2018,7,15,10,1742,2556,1932,-624
2018,7,15,11,1683,2486,1935,-551
2018,7,15,12,1734,2458,1915,-543
2018,7,15,13,1721,2451,1881,-570
2018,7,15,14,1357,2459,1480,-979
2018,7,15,15,1361,2648,1516,-1132
2018,7,15,16,1580,2920,1613,-1307
2018,7,15,17,1714,3184,1874,-1310
2018,7,15,18,1854,3355,2047,-1308
2018,7,15,19,1977,3486,2110,-1376
2018,7,15,20,1802,3595,2017,-1578
2018,7,15,21,1833,3671,2083,-1588
2018,7,15,22,1905,3745,2074,-1671
2018,7,15,23,1966,3818,2268,-1550
2018,7,16,0,2141,3860,2360,-1500
2018,7,16,1,2321,3882,2289,-1593
2018,7,16,2,2315,3923,2413,-1510
2018,7,16,3,2239,3859,2394,-1465
2018,7,16,4,2298,3836,2391,-1445
2018,7,16,5,2266,3764,2400,-1364
2018,7,16,6,2236,3518,2377,-1141
2018,7,16,7,2089,3153,2248,-905
2018,7,16,8,1964,2832,1961,-871
2018,7,16,9,1836,2708,1898,-810
2018,7,16,10,1773,2625,1724,-901
2018,7,16,11,1754,2582,1707,-875
2018,7,16,12,1788,2621,1772,-849
2018,7,16,13,1664,2691,1604,-1087
2018,7,16,14,1504,2875,1504,-1371
2018,7,16,15,1537,3125,1520,-1605
2018,7,16,16,1604,3311,1645,-1666
2018,7,16,17,1705,3442,1769,-1673
2018,7,16,18,1832,3630,2124,-1506
2018,7,16,19,1936,3763,2254,-1509
2018,7,16,20,1997,3880,2284,-1596
2018,7,16,21,2091,4009,2673,-1336
2018,7,16,22,2165,4052,2692,-1360
2018,7,16,23,2228,4143,2718,-1425
2018,7,17,0,2266,4175,2720,-1455
2018,7,17,1,2287,4235,2676,-1559
2018,7,17,2,2243,4190,2742,-1448
2018,7,17,3,2136,4126,2797,-1329
2018,7,17,4,2013,3978,2626,-1352
2018,7,17,5,1949,3855,2586,-1269
2018,7,17,6,2398,3594,2739,-855
2018,7,17,7,2273,3170,2351,-819
2018,7,17,8,2232,3008,2431,-577
2018,7,17,9,2071,2849,2306,-543
2018,7,17,10,1989,2747,2382,-365
2018,7,17,11,1956,2711,2187,-524
2018,7,17,12,1942,2749,2078,-671
2018,7,17,13,1987,2853,2024,-829
2018,7,17,14,1624,2979,1748,-1231
2018,7,17,15,1751,3234,1859,-1375
2018,7,17,16,1638,3396,1980,-1416
2018,7,17,17,1807,3524,2066,-1458
2018,7,17,18,1913,3925,2531,-1394
2018,7,17,19,1982,3744,2252,-1492
2018,7,17,20,2148,4215,2753,-1462
2018,7,17,21,2211,3930,2366,-1564
2018,7,17,22,2248,4043,2475,-1568
2018,7,17,23,2302,4125,2573,-1552
2018,7,18,0,2349,4173,2788,-1385
2018,7,18,1,2378,4265,2969,-1296
2018,7,18,2,2395,4225,2847,-1378
2018,7,18,3,2375,4061,2749,-1312
2018,7,18,4,2084,3897,2655,-1242
2018,7,18,5,2249,3731,2564,-1167
2018,7,18,6,2337,3421,2648,-773
2018,7,18,7,2133,3075,2309,-766
2018,7,18,8,2228,2899,2550,-349
2018,7,18,9,2093,2703,2487,-216
2018,7,18,10,2125,2619,2515,-104
2018,7,18,11,2115,2545,2327,-218
2018,7,18,12,2095,2598,2290,-308
2018,7,18,13,2163,2742,2199,-543
2018,7,18,14,2047,2894,1937,-957
2018,7,18,15,1838,3070,2167,-903
2018,7,18,16,1989,3237,2170,-1067
2018,7,18,17,2077,3330,2234,-1096
2018,7,18,18,2046,3385,2203,-1182
2018,7,18,19,2085,3381,2227,-1154
2018,7,18,20,2136,3412,2327,-1085
2018,7,18,21,2191,3464,2646,-818
2018,7,18,22,2358,3495,2684,-811
2018,7,18,23,2476,3569,2685,-884
2018,7,19,0,2530,3659,2805,-854
2018,7,19,1,2595,3691,2742,-949
2018,7,19,2,2590,3715,2839,-876
2018,7,19,3,2534,3658,2920,-738
2018,7,19,4,2467,3531,2811,-720
2018,7,19,5,2330,3501,2718,-783
2018,7,19,6,2215,3257,2713,-544
2018,7,19,7,2100,2988,2573,-415
2018,7,19,8,2297,2767,2500,-267
2018,7,19,9,2080,2648,2547,-101
2018,7,19,10,2017,2541,2459,-82
2018,7,19,11,2090,2585,2380,-205
2018,7,19,12,2081,2641,2344,-297
2018,7,19,13,2112,2672,2188,-484
2018,7,19,14,1832,2859,1994,-865
2018,7,19,15,2033,3007,2135,-872
2018,7,19,16,2108,3133,2137,-996
2018,7,19,17,2151,3184,2186,-998
2018,7,19,18,2175,3271,2361,-910
2018,7,19,19,2184,3276,2336,-940
2018,7,19,20,2203,3303,2481,-822
2018,7,19,21,2215,3340,2433,-907
2018,7,19,22,2252,3333,2525,-808
2018,7,19,23,2382,3323,2658,-665
2018,7,20,0,2371,3304,2631,-673
2018,7,20,1,2447,3321,2492,-829
2018,7,20,2,2524,3320,2443,-877
2018,7,20,3,2539,3312,2586,-726
2018,7,20,4,2470,3292,2561,-731
2018,7,20,5,2316,3264,2487,-777
2018,7,20,6,2185,3096,2468,-628
2018,7,20,7,2147,2807,2102,-705
2018,7,20,8,1968,2650,2147,-503
2018,7,20,9,1867,2520,2092,-428
2018,7,20,10,1915,2478,2129,-349
2018,7,20,11,1923,2458,2185,-273
2018,7,20,12,1964,2485,2178,-307
2018,7,20,13,2078,2561,2065,-496
2018,7,20,14,1944,2707,1779,-928
2018,7,20,15,1752,2925,2095,-830
2018,7,20,16,1882,3097,2337,-760
2018,7,20,17,1983,3173,2310,-863
2018,7,20,18,2023,3200,2298,-902
2018,7,20,19,2062,3300,2293,-1007
2018,7,20,20,2143,3330,2301,-1029
2018,7,20,21,2185,3339,2357,-982
2018,7,20,22,2203,3290,2292,-998
2018,7,20,23,2364,3216,2455,-761
2018,7,21,0,2508,3239,2554,-685
2018,7,21,1,2545,3260,2479,-781
2018,7,21,2,2513,3246,2455,-791
2018,7,21,3,2461,3163,2509,-654
2018,7,21,4,2412,3109,2361,-748
2018,7,21,5,2298,3093,2346,-747
2018,7,21,6,2292,2950,2473,-477
2018,7,21,7,2081,2716,2216,-500
2018,7,21,8,1871,2532,2027,-505
2018,7,21,9,2000,2410,2032,-378
2018,7,21,10,2045,2279,2011,-268
2018,7,21,11,1963,2246,1956,-290
2018,7,21,12,1903,2212,1960,-252
2018,7,21,13,1840,2187,1956,-231
2018,7,21,14,1485,2237,1658,-579
2018,7,21,15,1757,2475,2062,-413
2018,7,21,16,1821,2680,2110,-570
2018,7,21,17,1866,2802,2091,-711
2018,7,21,18,1922,2885,2051,-834
2018,7,21,19,1963,2947,2128,-819
2018,7,21,20,1955,2967,2032,-935
2018,7,21,21,1968,2992,2087,-905
2018,7,21,22,1979,3010,2151,-859
2018,7,21,23,2008,3048,2180,-868
2018,7,22,0,2050,3098,2183,-915
2018,7,22,1,2120,3146,2056,-1090
2018,7,22,2,2120,3137,2103,-1034
2018,7,22,3,2095,3130,2104,-1026
2018,7,22,4,2057,3047,2184,-863
2018,7,22,5,2054,3059,2203,-856
2018,7,22,6,2211,2916,2244,-672
2018,7,22,7,2367,2700,2228,-472
2018,7,22,8,1633,2468,1962,-506
2018,7,22,9,1530,2341,1945,-396
2018,7,22,10,1476,2225,1968,-257
2018,7,22,11,1439,2119,1878,-241
2018,7,22,12,1589,2132,1830,-302
2018,7,22,13,1428,2140,1801,-339
2018,7,22,14,1486,2182,1542,-640
2018,7,22,15,1393,2342,1468,-874
2018,7,22,16,1589,2547,1510,-1037
2018,7,22,17,1714,2780,1738,-1042
2018,7,22,18,1826,2961,1944,-1017
2018,7,22,19,1898,3065,2013,-1052
2018,7,22,20,1927,3142,2095,-1047
2018,7,22,21,1805,3194,2067,-1127
2018,7,22,22,1825,3254,2176,-1078
2018,7,22,23,1874,3343,2187,-1156
2018,7,23,0,1956,3462,2325,-1137
2018,7,23,1,2026,3551,2322,-1229
2018,7,23,2,2048,3588,2383,-1205
2018,7,23,3,2014,3547,2485,-1062
2018,7,23,4,1980,3450,2497,-953
2018,7,23,5,2114,3408,2503,-905
2018,7,23,6,1893,3174,2485,-689
2018,7,23,7,1859,2885,2369,-516
2018,7,23,8,2123,2682,2279,-403
2018,7,23,9,2017,2511,2075,-436
2018,7,23,10,1930,2493,2087,-406
2018,7,23,11,1862,2455,2084,-371
2018,7,23,12,1909,2516,2026,-490
2018,7,23,13,2049,2680,2113,-567
2018,7,23,14,1914,2867,2139,-728
2018,7,23,15,1632,3144,2031,-1113
2018,7,23,16,1899,3319,2188,-1131
2018,7,23,17,1755,3467,2193,-1274
2018,7,23,18,1883,3613,2242,-1371
2018,7,23,19,1950,3743,2319,-1424
2018,7,23,20,2049,3839,2432,-1407
2018,7,23,21,2056,3920,2420,-1500
2018,7,23,22,2098,4000,2447,-1553
2018,7,23,23,2143,4079,2643,-1436
2018,7,24,0,2190,4135,2680,-1455
2018,7,24,1,2214,4185,2691,-1494
2018,7,24,2,2176,4156,2700,-1456
2018,7,24,3,2075,4072,2685,-1387
2018,7,24,4,2051,3919,2699,-1220
2018,7,24,5,1974,3811,2612,-1199
2018,7,24,6,2359,3495,2618,-877
2018,7,24,7,2298,3148,2470,-678
2018,7,24,8,2025,2840,2138,-702
2018,7,24,9,1889,2661,2095,-566
2018,7,24,10,1860,2586,2098,-488
2018,7,24,11,1818,2529,2020,-509
2018,7,24,12,1791,2530,1947,-583
2018,7,24,13,1882,2636,1959,-677
2018,7,24,14,1722,2821,1886,-935
2018,7,24,15,1841,3028,1783,-1245
2018,7,24,16,1858,3166,2032,-1134
2018,7,24,17,1835,3293,2035,-1258
2018,7,24,18,1917,3479,2190,-1289
2018,7,24,19,1981,3698,2370,-1328
2018,7,24,20,2065,3816,2459,-1357
2018,7,24,21,2099,3873,2539,-1334
2018,7,24,22,2217,3961,2587,-1374
2018,7,24,23,2217,4022,2614,-1408
2018,7,25,0,2261,4118,2617,-1501
2018,7,25,1,2321,4181,2520,-1661
2018,7,25,2,2280,4149,2456,-1693
2018,7,25,3,2224,4069,2471,-1598
2018,7,25,4,2221,3952,2553,-1399
2018,7,25,5,2223,3835,2504,-1331
2018,7,25,6,2530,3551,2537,-1014
2018,7,25,7,2223,3252,2442,-810
2018,7,25,8,2167,2972,2395,-577
2018,7,25,9,1944,2847,2430,-417
2018,7,25,10,1912,2695,2313,-382
2018,7,25,11,1878,2599,2236,-363
2018,7,25,12,1894,2655,2274,-381
2018,7,25,13,2065,2777,2278,-499
2018,7,25,14,2013,3012,2130,-882
2018,7,25,15,2045,3268,2251,-1017
2018,7,25,16,2173,3392,2145,-1247
2018,7,25,17,2090,3601,2241,-1360
2018,7,25,18,2198,3738,2324,-1414
2018,7,25,19,2247,3775,2357,-1418
2018,7,25,20,2278,3855,2311,-1544
2018,7,25,21,2372,3952,2287,-1665
2018,7,25,22,2383,4004,2660,-1344
2018,7,25,23,2432,4032,2667,-1365
2018,7,26,0,2492,4051,2764,-1287
2018,7,26,1,2504,4228,2908,-1320
2018,7,26,2,2439,4208,2929,-1279
2018,7,26,3,2441,4118,2823,-1295
2018,7,26,4,2474,3999,2782,-1217
2018,7,26,5,2410,3912,2780,-1132
2018,7,26,6,2508,3649,2840,-809
2018,7,26,7,2496,3283,2666,-617
2018,7,26,8,2265,3054,2387,-667
2018,7,26,9,2099,2889,2280,-609
2018,7,26,10,2007,2785,2224,-561
2018,7,26,11,1950,2729,2198,-531
2018,7,26,12,1934,2761,2110,-651
2018,7,26,13,2082,2880,2365,-515
2018,7,26,14,2031,3048,2225,-823
2018,7,26,15,2012,3197,2247,-950
2018,7,26,16,1992,3384,2236,-1148
2018,7,26,17,1953,3509,2211,-1298
2018,7,26,18,2072,3655,2355,-1300
2018,7,26,19,2168,3804,2471,-1333
2018,7,26,20,2174,3920,2498,-1422
2018,7,26,21,2230,4008,2499,-1509
2018,7,26,22,2355,3990,2580,-1410
2018,7,26,23,2375,4066,2585,-1481
2018,7,27,0,2401,4056,2641,-1415
2018,7,27,1,2401,3988,2597,-1391
2018,7,27,2,2401,3930,2584,-1346
2018,7,27,3,2403,3959,2683,-1276
2018,7,27,4,2436,3821,2729,-1092
2018,7,27,5,2472,3710,2700,-1010
2018,7,27,6,2518,3430,2624,-806
2018,7,27,7,2522,3120,2301,-819
2018,7,27,8,2084,2787,2115,-672
2018,7,27,9,2035,2610,2004,-606
2018,7,27,10,1972,2461,1946,-515
2018,7,27,11,1911,2423,1879,-544
2018,7,27,12,1952,2524,1925,-599
2018,7,27,13,2019,2600,1947,-653
2018,7,27,14,1792,2739,1812,-927
2018,7,27,15,1986,2950,1913,-1037
2018,7,27,16,1862,3146,2135,-1011
2018,7,27,17,1989,3325,2194,-1131
2018,7,27,18,2045,3449,2308,-1141
2018,7,27,19,2144,3549,2362,-1187
2018,7,27,20,2081,3634,2388,-1246
2018,7,27,21,2133,3703,2423,-1280
2018,7,27,22,2181,3783,2427,-1356
2018,7,27,23,2250,3829,2527,-1302
2018,7,28,0,2288,3858,2531,-1327
2018,7,28,1,2297,3879,2519,-1360
2018,7,28,2,2224,3822,2506,-1316
2018,7,28,3,2115,3723,2534,-1189
2018,7,28,4,2171,3617,2480,-1137
2018,7,28,5,2103,3538,2436,-1102
2018,7,28,6,2256,3303,2445,-858
2018,7,28,7,2255,3008,2402,-606
2018,7,28,8,2068,2711,2159,-552
2018,7,28,9,2071,2536,2078,-458
2018,7,28,10,1996,2407,1961,-446
2018,7,28,11,1982,2355,1840,-515
2018,7,28,12,1920,2336,1786,-550
2018,7,28,13,1711,2367,1926,-441
2018,7,28,14,1768,2368,1773,-595
2018,7,28,15,1700,2541,1937,-604
2018,7,28,16,1606,2722,1972,-750
2018,7,28,17,1763,2886,1985,-901
2018,7,28,18,1858,3048,2003,-1045
2018,7,28,19,1956,3079,2018,-1061
2018,7,28,20,1938,3160,2126,-1034
2018,7,28,21,1959,3264,2180,-1084
2018,7,28,22,1959,3298,2213,-1085
2018,7,28,23,2011,3465,2367,-1098
2018,7,29,0,2071,3562,2463,-1099
2018,7,29,1,2124,3613,2518,-1095
2018,7,29,2,2098,3596,2611,-985
2018,7,29,3,2026,3543,2555,-988
2018,7,29,4,2115,3455,2488,-967
2018,7,29,5,2083,3406,2549,-857
2018,7,29,6,2186,3221,2663,-558
2018,7,29,7,2221,2901,2500,-401
2018,7,29,8,1991,2674,2246,-428
2018,7,29,9,1880,2515,2120,-395
2018,7,29,10,1896,2288,1955,-333
2018,7,29,11,1838,2322,1984,-338
2018,7,29,12,1795,2308,1992,-316
2018,7,29,13,1716,2260,1840,-420
2018,7,29,14,1582,2380,1894,-486
2018,7,29,15,1708,2566,1917,-649
2018,7,29,16,1634,2806,1935,-871
2018,7,29,17,1697,3007,2152,-855
2018,7,29,18,1770,3192,2171,-1021
2018,7,29,19,1868,3334,2166,-1168
2018,7,29,20,1733,3460,2249,-1211
2018,7,29,21,1786,3584,2301,-1283
2018,7,29,22,1838,3674,2355,-1319
2018,7,29,23,1918,3776,2350,-1426
2018,7,30,0,2008,3862,2388,-1474
2018,7,30,1,2044,3925,2417,-1508
2018,7,30,2,2048,3907,2497,-1410
2018,7,30,3,2043,3848,2503,-1345
2018,7,30,4,2180,3752,2581,-1171
2018,7,30,5,2137,3691,2580,-1111
2018,7,30,6,2381,3364,2510,-854
2018,7,30,7,2095,3012,2257,-755
2018,7,30,8,2114,2709,1970,-739
2018,7,30,9,2085,2560,1981,-579
2018,7,30,10,1988,2460,1916,-544
2018,7,30,11,1956,2435,1890,-545
2018,7,30,12,1990,2478,1940,-538
2018,7,30,13,2124,2604,2003,-601
2018,7,30,14,1934,2859,1971,-888
2018,7,30,15,1705,3109,2112,-997
2018,7,30,16,1538,3251,2112,-1139
2018,7,30,17,1669,3446,2035,-1411
2018,7,30,18,1715,3606,2015,-1591
2018,7,30,19,1818,3699,1981,-1718
2018,7,30,20,1910,3829,2187,-1642
2018,7,30,21,1990,3921,2231,-1690
2018,7,30,22,2061,3993,2268,-1725
2018,7,30,23,2134,4057,2473,-1584
2018,7,31,0,2199,4113,2542,-1571
2018,7,31,1,2236,4139,2563,-1576
2018,7,31,2,2164,4066,2525,-1541
2018,7,31,3,2061,3959,2500,-1459
2018,7,31,4,2020,3853,2509,-1344
2018,7,31,5,1908,3730,2453,-1277
2018,7,31,6,2109,3340,2343,-997
2018,7,31,7,2178,3002,2337,-665
2018,7,31,8,2036,2705,2026,-679
2018,7,31,9,1904,2553,1991,-562
2018,7,31,10,1891,2366,1879,-487
2018,7,31,11,1902,2383,1785,-598
2018,7,31,12,1868,2456,1854,-602
2018,7,31,13,1866,2597,1923,-674
2018,7,31,14,1777,2696,1717,-979
2018,7,31,15,1824,3006,2018,-988
2018,7,31,16,1876,3123,2047,-1076
2018,7,31,17,1937,3172,2071,-1101
2018,7,31,18,2020,3285,2144,-1141
2018,7,31,19,2096,3346,2211,-1135
2018,7,31,20,2106,3399,2371,-1028
2018,7,31,21,2161,3529,2505,-1024
2018,7,31,22,2209,3598,2506,-1092
2018,7,31,23,2252,3659,2561,-1098
2018,8,1,0,2297,3729,2638,-1091
2018,8,1,1,2317,3773,2643,-1130
2018,8,1,2,2251,3727,2664,-1063
2018,8,1,3,2269,3646,2660,-986
2018,8,1,4,2223,3545,2586,-959
2018,8,1,5,2049,3466,2509,-957
2018,8,1,6,2263,3117,2442,-675
2018,8,1,7,2023,2804,2289,-515
2018,8,1,8,1891,2597,2297,-300
2018,8,1,9,1929,2403,2195,-208
2018,8,1,10,1975,2318,2160,-158
2018,8,1,11,2027,2381,2292,-89
2018,8,1,12,2088,2513,2274,-239
2018,8,1,13,2140,2685,2271,-414
2018,8,1,14,1832,2837,2159,-678
2018,8,1,15,1937,2991,2211,-780
2018,8,1,16,2082,3051,2158,-893
2018,8,1,17,2046,3118,2171,-947
2018,8,1,18,2132,3161,2151,-1010
2018,8,1,19,2202,3172,2255,-917
2018,8,1,20,2271,3195,2376,-819
2018,8,1,21,2326,3299,2666,-633
2018,8,1,22,2379,3353,2878,-475
2018,8,1,23,2424,3420,2774,-646
2018,8,2,0,2468,3493,2873,-620
2018,8,2,1,2473,3561,2853,-708
2018,8,2,2,2453,3589,2895,-694
2018,8,2,3,2388,3537,2910,-627
2018,8,2,4,2345,3403,2770,-633
2018,8,2,5,2268,3356,2707,-649
2018,8,2,6,2444,3083,2679,-404
2018,8,2,7,2321,2796,2661,-135
2018,8,2,8,2199,2618,2448,-170
2018,8,2,9,2012,2496,2260,-236
2018,8,2,10,2057,2363,2267,-96
2018,8,2,11,2122,2399,2332,-67
2018,8,2,12,2069,2519,2376,-143
2018,8,2,13,2293,2679,2357,-322
2018,8,2,14,1993,2862,2323,-539
2018,8,2,15,2031,2964,2218,-746
2018,8,2,16,2126,3080,2323,-757
2018,8,2,17,2194,3195,2446,-749
2018,8,2,18,2239,3244,2463,-781
2018,8,2,19,2297,3243,2422,-821
2018,8,2,20,2326,3236,2443,-793
2018,8,2,21,2559,3250,2645,-605
2018,8,2,22,2667,3215,2701,-514
2018,8,2,23,2688,3195,2613,-582
2018,8,3,0,2706,3170,2659,-511
2018,8,3,1,2737,3147,2753,-394
2018,8,3,2,2705,3202,2777,-425
2018,8,3,3,2563,3098,2702,-396
2018,8,3,4,2536,3114,2674,-440
2018,8,3,5,2332,3083,2766,-317
2018,8,3,6,2425,2920,2762,-158
2018,8,3,7,2200,2707,2545,-162
2018,8,3,8,1850,2501,2302,-199
2018,8,3,9,1721,2372,2261,-111
2018,8,3,10,1810,2317,2249,-68
2018,8,3,11,1794,2210,2180,-30
2018,8,3,12,1715,2371,2229,-142
2018,8,3,13,1967,2585,2294,-291
2018,8,3,14,1951,2794,2199,-595
2018,8,3,15,2180,3023,2277,-746
2018,8,3,16,2108,3146,2231,-915
2018,8,3,17,2014,3249,2260,-989
2018,8,3,18,2040,3263,2252,-1011
2018,8,3,19,2088,3287,2276,-1011
2018,8,3,20,2129,3288,2272,-1016
2018,8,3,21,2283,3347,2423,-924
2018,8,3,22,2423,3375,2629,-746
2018,8,3,23,2460,3378,2772,-606
2018,8,4,0,2513,3393,2791,-602
2018,8,4,1,2540,3424,2848,-576
2018,8,4,2,2549,3347,2872,-475
2018,8,4,3,2453,3216,2836,-380
2018,8,4,4,2435,3139,2678,-461
2018,8,4,5,2402,3124,2596,-528
2018,8,4,6,2243,2917,2409,-508
2018,8,4,7,2252,2720,2383,-337
2018,8,4,8,1797,2460,2236,-224
2018,8,4,9,1621,2310,2175,-135
2018,8,4,10,1666,2171,2225,0
2018,8,4,11,1455,2151,2167,0
2018,8,4,12,1736,2295,2194,-101
2018,8,4,13,1783,2380,2294,-86
2018,8,4,14,1580,2461,2057,-404
2018,8,4,15,1661,2602,2345,-257
2018,8,4,16,1700,2792,2341,-451
2018,8,4,17,1883,2955,2274,-681
2018,8,4,18,1984,3072,2278,-794
2018,8,4,19,1983,3151,2300,-851
2018,8,4,20,2037,3223,2419,-804
2018,8,4,21,2091,3218,2359,-859
2018,8,4,22,2208,3281,2436,-845
2018,8,4,23,2230,3262,2401,-861
2018,8,5,0,2264,3345,2519,-826
2018,8,5,1,2266,3430,2786,-644
2018,8,5,2,2253,3414,2791,-623
2018,8,5,3,2203,3272,2686,-586
2018,8,5,4,2199,3169,2658,-511
2018,8,5,5,2177,3138,2550,-588
2018,8,5,6,1942,2961,2546,-415
2018,8,5,7,2197,2730,2488,-242
2018,8,5,8,2011,2534,2381,-153
2018,8,5,9,1902,2424,2231,-193
2018,8,5,10,1840,2355,2237,-118
2018,8,5,11,1887,2319,2200,-119
2018,8,5,12,1853,2394,2276,-118
2018,8,5,13,1816,2421,2216,-205
2018,8,5,14,1715,2427,2107,-320
2018,8,5,15,1807,2492,2031,-461
2018,8,5,16,1891,2716,1907,-809
2018,8,5,17,2087,2903,2240,-663
2018,8,5,18,2199,3030,2313,-717
2018,8,5,19,2291,3122,2312,-810
2018,8,5,20,2333,3261,2428,-833
2018,8,5,21,2353,3332,2312,-1020
2018,8,5,22,2326,3435,2345,-1090
2018,8,5,23,2385,3521,2409,-1112
2018,8,6,0,2431,3635,2550,-1085
2018,8,6,1,2546,3644,2601,-1043
2018,8,6,2,2560,3622,2607,-1015
2018,8,6,3,2636,3598,2730,-868
2018,8,6,4,2334,3475,2711,-764
2018,8,6,5,2393,3387,2604,-783
2018,8,6,6,2395,3165,2675,-490
2018,8,6,7,2116,2841,2549,-292
2018,8,6,8,1998,2552,2420,-132
2018,8,6,9,1883,2391,2380,-11
2018,8,6,10,1773,2316,2184,-132
2018,8,6,11,1740,2453,2254,-199
2018,8,6,12,1838,2609,2352,-257
2018,8,6,13,1972,2830,2502,-328
2018,8,6,14,1815,2989,2121,-868
2018,8,6,15,2053,3216,2260,-956
2018,8,6,16,2048,3286,2253,-1033
2018,8,6,17,2035,3410,2214,-1196
2018,8,6,18,2152,3642,2412,-1230
2018,8,6,19,2252,3768,2492,-1276
2018,8,6,20,2287,3884,2508,-1376
2018,8,6,21,2359,3950,2441,-1509
2018,8,6,22,2412,4044,2700,-1344
2018,8,6,23,2465,4124,2854,-1270
2018,8,7,0,2524,4214,2972,-1242
2018,8,7,1,2565,4172,2970,-1202
2018,8,7,2,2509,4007,2827,-1180
2018,8,7,3,2410,3858,2857,-1001
2018,8,7,4,2403,3764,2752,-1012
2018,8,7,5,2305,3640,2791,-849
2018,8,7,6,2224,3319,2719,-600
2018,8,7,7,2201,3031,2866,-165
2018,8,7,8,2080,2786,2654,-132
2018,8,7,9,1878,2605,2464,-141
2018,8,7,10,1786,2554,2198,-356
2018,8,7,11,1818,2570,2122,-448
2018,8,7,12,1840,2669,2236,-433
2018,8,7,13,1933,2848,2212,-636
2018,8,7,14,1592,2995,2133,-862
2018,8,7,15,1689,3107,2053,-1054
2018,8,7,16,1488,3279,1971,-1308
2018,8,7,17,1578,3421,1950,-1471
2018,8,7,18,1596,3530,1946,-1584
2018,8,7,19,1695,3553,2047,-1506
2018,8,7,20,1716,3735,2322,-1413
2018,8,7,21,1823,3876,2488,-1388
2018,8,7,22,1850,3993,2504,-1489
2018,8,7,23,1918,4080,2527,-1553
2018,8,8,0,1994,4141,2552,-1589
2018,8,8,1,2022,4099,2481,-1618
2018,8,8,2,2012,3896,2382,-1514
2018,8,8,3,1917,3786,2355,-1431
2018,8,8,4,1963,3750,2413,-1337
2018,8,8,5,1880,3585,2253,-1332
2018,8,8,6,2492,3268,2367,-901
2018,8,8,7,2220,2955,2363,-592
2018,8,8,8,2025,2807,2274,-533
2018,8,8,9,1798,2671,2192,-479
2018,8,8,10,1785,2547,2191,-356
2018,8,8,11,1735,2581,2228,-353
2018,8,8,12,1756,2652,2265,-387
2018,8,8,13,1966,2756,2208,-548
2018,8,8,14,1859,2911,1968,-943
2018,8,8,15,1911,3135,2082,-1053
2018,8,8,16,1646,3300,2076,-1224
2018,8,8,17,1738,3448,2128,-1320
2018,8,8,18,1854,3584,2226,-1358
2018,8,8,19,1954,3689,2297,-1392
2018,8,8,20,2030,3814,2333,-1481
2018,8,8,21,2114,3925,2263,-1662
2018,8,8,22,2216,3954,2229,-1725
2018,8,8,23,2238,4053,2311,-1742
2018,8,9,0,2302,4149,2325,-1824
2018,8,9,1,2322,4183,2462,-1721
2018,8,9,2,2262,4121,2496,-1625
2018,8,9,3,2159,4017,2576,-1441
2018,8,9,4,2142,3923,2498,-1425
2018,8,9,5,2032,3814,2485,-1329
2018,8,9,6,2509,3493,2573,-920
2018,8,9,7,2382,3164,2518,-646
2018,8,9,8,2239,2921,2297,-624
2018,8,9,9,2110,2761,2234,-527
2018,8,9,10,2017,2634,2096,-538
2018,8,9,11,1972,2490,1929,-561
2018,8,9,12,2008,2581,2146,-435
2018,8,9,13,2195,2748,2334,-414
2018,8,9,14,1881,2985,2141,-844
2018,8,9,15,1849,3118,2146,-972
2018,8,9,16,1755,3269,2189,-1080
2018,8,9,17,1875,3437,2258,-1179
2018,8,9,18,1991,3609,2389,-1220
2018,8,9,19,2100,3775,2520,-1255
2018,8,9,20,1968,3903,2553,-1350
2018,8,9,21,2073,3996,2563,-1433
2018,8,9,22,2157,4099,2629,-1470
2018,8,9,23,2232,4186,2675,-1511
2018,8,10,0,2200,4257,2720,-1537
2018,8,10,1,2261,4191,2644,-1547
2018,8,10,2,2253,4087,2664,-1423
2018,8,10,3,2259,3961,2558,-1403
2018,8,10,4,2397,3868,2576,-1292
2018,8,10,5,2296,3763,2597,-1166
2018,8,10,6,2467,3453,2620,-833
2018,8,10,7,2463,3130,2573,-557
2018,8,10,8,2300,2890,2524,-366
2018,8,10,9,2245,2738,2612,-126
2018,8,10,10,2289,2570,2449,-121
2018,8,10,11,2268,2654,2278,-376
2018,8,10,12,2357,2742,2355,-387
2018,8,10,13,2247,2751,2477,-274
2018,8,10,14,2013,2889,2259,-630
2018,8,10,15,1986,3100,2224,-876
2018,8,10,16,2133,3301,2296,-1005
2018,8,10,17,2246,3425,2595,-830
2018,8,10,18,2325,3602,2645,-957
2018,8,10,19,2373,3609,2671,-938
2018,8,10,20,2519,3694,2735,-959
2018,8,10,21,2619,3748,2734,-1014
2018,8,10,22,2638,3814,2784,-1030
2018,8,10,23,2637,3866,2807,-1059
2018,8,11,0,2610,3957,2881,-1076
2018,8,11,1,2582,3882,2706,-1176
2018,8,11,2,2474,3736,2692,-1044
2018,8,11,3,2330,3596,2743,-853
2018,8,11,4,2260,3497,2740,-757
2018,8,11,5,2174,3390,2651,-739
2018,8,11,6,2369,3116,2681,-435
2018,8,11,7,2063,2807,2359,-448
2018,8,11,8,1709,2583,1931,-652
2018,8,11,9,1640,2497,1887,-610
2018,8,11,10,1532,2395,1782,-613
2018,8,11,11,1488,2449,1886,-563
2018,8,11,12,1500,2388,1748,-640
2018,8,11,13,1527,2427,1685,-742
2018,8,11,14,1417,2485,1620,-865
2018,8,11,15,1419,2664,1733,-931
2018,8,11,16,1484,2837,1844,-993
2018,8,11,17,1613,3037,1972,-1065
2018,8,11,18,1630,3117,2038,-1079
2018,8,11,19,1756,3110,2077,-1033
2018,8,11,20,1850,3096,2061,-1035
2018,8,11,21,1855,3023,2200,-823
2018,8,11,22,1929,3027,2280,-747
2018,8,11,23,1912,3020,2298,-722
2018,8,12,0,1925,3016,2369,-647
2018,8,12,1,1958,3042,2462,-580
2018,8,12,2,1939,2960,2421,-539
2018,8,12,3,1907,2975,2331,-644
2018,8,12,4,1938,2994,2392,-602
2018,8,12,5,1936,2992,2382,-610
2018,8,12,6,2011,2854,2457,-397
2018,8,12,7,1760,2641,2287,-354
2018,8,12,8,1864,2483,2264,-219
2018,8,12,9,1714,2258,1991,-267
2018,8,12,10,1587,2250,1984,-266
2018,8,12,11,1565,2223,2096,-127
2018,8,12,12,1577,2176,1975,-201
2018,8,12,13,1597,2198,1895,-303
2018,8,12,14,1587,2231,1808,-423
2018,8,12,15,1620,2374,1791,-583
2018,8,12,16,1698,2536,1753,-783
2018,8,12,17,1820,2694,1791,-903
2018,8,12,18,1956,2814,1820,-994
2018,8,12,19,2123,2891,2148,-743
2018,8,12,20,2046,2896,2099,-797
2018,8,12,21,1986,2920,2059,-861
2018,8,12,22,1985,2924,2065,-859
2018,8,12,23,2032,2961,2155,-806
2018,8,13,0,2217,3059,2260,-799
2018,8,13,1,2335,3144,2426,-718
2018,8,13,2,2344,3170,2520,-650
2018,8,13,3,2320,3138,2523,-615
2018,8,13,4,2419,3153,2604,-549
2018,8,13,5,2434,3104,2377,-727
2018,8,13,6,2267,2742,2287,-455
2018,8,13,7,2074,2508,2201,-307
2018,8,13,8,1788,2326,2148,-178
2018,8,13,9,1631,2232,2054,-178
2018,8,13,10,1667,2144,1909,-235
2018,8,13,11,1662,2153,1879,-274
2018,8,13,12,1710,2292,1975,-317
2018,8,13,13,1885,2472,2167,-305
2018,8,13,14,1795,2633,2145,-488
2018,8,13,15,1680,2818,2057,-761
2018,8,13,16,1778,2958,2035,-923
2018,8,13,17,1874,3070,2101,-969
2018,8,13,18,1979,3142,2155,-987
2018,8,13,19,2133,3230,2196,-1034
2018,8,13,20,2047,3227,2233,-994
2018,8,13,21,2055,3254,2328,-926
2018,8,13,22,2096,3317,2263,-1054
2018,8,13,23,2143,3378,2290,-1088
2018,8,14,0,2186,3421,2281,-1140
2018,8,14,1,2155,3434,2235,-1199
2018,8,14,2,2128,3388,2226,-1162
2018,8,14,3,2063,3314,2264,-1050
2018,8,14,4,2216,3293,2314,-979
2018,8,14,5,2191,3180,2321,-859
2018,8,14,6,2333,2927,2333,-594
2018,8,14,7,2136,2656,2232,-424
2018,8,14,8,1933,2439,2083,-356
2018,8,14,9,1911,2319,1987,-332
2018,8,14,10,1794,2199,1906,-293
2018,8,14,11,1765,2281,1952,-329
2018,8,14,12,1809,2355,1924,-431
2018,8,14,13,2076,2557,2034,-523
2018,8,14,14,1838,2774,2022,-752
2018,8,14,15,2055,2982,2098,-884
2018,8,14,16,1955,3127,2091,-1036
2018,8,14,17,1864,3253,2153,-1100
2018,8,14,18,1943,3321,2130,-1191
2018,8,14,19,2057,3420,2151,-1269
2018,8,14,20,1929,3514,2141,-1373
2018,8,14,21,1900,3604,2204,-1400
2018,8,14,22,1949,3683,2212,-1471
2018,8,14,23,1936,3774,2433,-1341
2018,8,15,0,2037,3898,2494,-1404
2018,8,15,1,1806,3710,2170,-1540
2018,8,15,2,1818,3576,2147,-1429
2018,8,15,3,1911,3543,2314,-1229
2018,8,15,4,2045,3547,2308,-1239
2018,8,15,5,1977,3384,2157,-1227
2018,8,15,6,1884,3088,2202,-886
2018,8,15,7,2016,2826,2305,-521
2018,8,15,8,1869,2636,2037,-599
2018,8,15,9,1852,2484,2093,-391
2018,8,15,10,1769,2405,1955,-450
2018,8,15,11,1903,2478,2016,-462
2018,8,15,12,1918,2639,2095,-544
2018,8,15,13,1998,2722,2088,-634
2018,8,15,14,1901,2854,1979,-875
2018,8,15,15,2003,3021,2141,-880
2018,8,15,16,1887,3153,2149,-1004
2018,8,15,17,1880,3264,2198,-1066
2018,8,15,18,1959,3361,2236,-1125
2018,8,15,19,2049,3526,2210,-1316
2018,8,15,20,2045,3582,2233,-1349
2018,8,15,21,2170,3722,2315,-1407
2018,8,15,22,2155,3804,2316,-1488
2018,8,15,23,2214,3867,2506,-1361
2018,8,16,0,2116,3979,2483,-1496
2018,8,16,1,2094,3889,2402,-1487
2018,8,16,2,2022,3728,2316,-1412
2018,8,16,3,1971,3619,2327,-1292
2018,8,16,4,2127,3562,2398,-1164
2018,8,16,5,2090,3439,2447,-992
2018,8,16,6,2255,3171,2475,-696
2018,8,16,7,2377,2924,2373,-551
2018,8,16,8,2051,2721,2251,-470
2018,8,16,9,2090,2616,2087,-529
2018,8,16,10,2028,2541,2096,-445
2018,8,16,11,2014,2507,1976,-531
2018,8,16,12,2106,2689,2179,-510
2018,8,16,13,2363,2883,2295,-588
2018,8,16,14,2050,3072,2193,-879
2018,8,16,15,2047,3213,2287,-926
2018,8,16,16,2147,3262,2191,-1071
2018,8,16,17,2257,3356,2293,-1063
2018,8,16,18,2345,3439,2323,-1116
2018,8,16,19,2351,3454,2367,-1087
2018,8,16,20,2387,3507,2548,-959
2018,8,16,21,2388,3551,2620,-931
2018,8,16,22,2231,3620,2605,-1015
2018,8,16,23,2275,3609,2686,-923
2018,8,17,0,2213,3720,2590,-1130
2018,8,17,1,2018,3624,2409,-1215
2018,8,17,2,1970,3479,2443,-1036
2018,8,17,3,2024,3388,2464,-924
2018,8,17,4,2280,3394,2556,-838
2018,8,17,5,2329,3278,2525,-753
2018,8,17,6,2372,2999,2355,-644
2018,8,17,7,1980,2815,2465,-350
2018,8,17,8,2107,2568,2289,-279
2018,8,17,9,1958,2472,2217,-255
2018,8,17,10,1861,2310,1955,-355
2018,8,17,11,2075,2413,2115,-298
2018,8,17,12,2006,2602,2126,-476
2018,8,17,13,2088,2768,2185,-583
2018,8,17,14,2166,2917,2279,-638
2018,8,17,15,2090,3100,2322,-778
2018,8,17,16,1962,3180,2303,-877
2018,8,17,17,2098,3265,2296,-969
2018,8,17,18,2314,3351,2249,-1102
2018,8,17,19,2389,3395,2366,-1029
2018,8,17,20,2230,3450,2352,-1098
2018,8,17,21,2253,3458,2464,-994
2018,8,17,22,2264,3477,2524,-953
2018,8,17,23,2288,3500,2502,-998
2018,8,18,0,2318,3548,2570,-978
2018,8,18,1,2391,3494,2654,-840
2018,8,18,2,2264,3397,2710,-687
2018,8,18,3,2245,3236,2601,-635
2018,8,18,4,2306,3180,2458,-722
2018,8,18,5,2164,3114,2390,-724
2018,8,18,6,2206,2908,2315,-593
2018,8,18,7,1852,2625,2187,-438
2018,8,18,8,1981,2479,2016,-463
2018,8,18,9,1933,2322,1885,-437
2018,8,18,10,1975,2283,1831,-452
2018,8,18,11,1897,2260,1814,-446
2018,8,18,12,1926,2264,2008,-256
2018,8,18,13,2051,2302,1941,-361
2018,8,18,14,1758,2355,1901,-454
2018,8,18,15,1919,2509,1903,-606
2018,8,18,16,1883,2703,1901,-802
2018,8,18,17,1838,2840,1859,-981
2018,8,18,18,1956,2936,1945,-991
2018,8,18,19,2075,2966,2067,-899
2018,8,18,20,2057,2995,2187,-808
2018,8,18,21,2053,3039,2230,-809
2018,8,18,22,2067,3072,2214,-858
2018,8,18,23,2099,3118,2186,-932
2018,8,19,0,2098,3189,2286,-903
2018,8,19,1,2147,3248,2330,-918
2018,8,19,2,2101,3232,2390,-842
2018,8,19,3,2063,3186,2339,-847
2018,8,19,4,2120,3124,2339,-785
2018,8,19,5,2051,3058,2281,-777
2018,8,19,6,2047,2901,2358,-543
2018,8,19,7,1984,2616,2169,-447
2018,8,19,8,1957,2415,1896,-519
2018,8,19,9,1969,2272,1856,-416
2018,8,19,10,1960,2150,1804,-346
2018,8,19,11,1977,2182,1881,-301
2018,8,19,12,2096,2262,2077,-185
2018,8,19,13,2054,2301,2166,-135
2018,8,19,14,1806,2335,2069,-266
2018,8,19,15,1801,2440,1955,-485
2018,8,19,16,1794,2623,1838,-785
2018,8,19,17,1806,2788,1885,-903
2018,8,19,18,1918,2841,1920,-921
2018,8,19,19,2009,2929,1931,-998
2018,8,19,20,1958,2981,2031,-950
2018,8,19,21,1995,3018,2058,-960
2018,8,19,22,2020,3061,2134,-927
2018,8,19,23,2081,3119,2100,-1019
2018,8,20,0,2109,3197,2216,-981
2018,8,20,1,2184,3252,2291,-961
2018,8,20,2,2180,3287,2411,-876
2018,8,20,3,2151,3257,2397,-860
2018,8,20,4,2160,3319,2378,-941
2018,8,20,5,2061,3194,2259,-935
2018,8,20,6,2213,2930,2264,-666
2018,8,20,7,2205,2663,2111,-552
2018,8,20,8,1979,2539,1992,-547
2018,8,20,9,2064,2401,1955,-446
2018,8,20,10,1933,2381,2004,-377
2018,8,20,11,1984,2379,2059,-320
2018,8,20,12,1973,2429,2158,-271
2018,8,20,13,1941,2583,2262,-321
2018,8,20,14,1903,2790,2107,-683
2018,8,20,15,2053,2944,2146,-798
2018,8,20,16,1962,3076,2153,-923
2018,8,20,17,2095,3151,2107,-1044
2018,8,20,18,2219,3240,2183,-1057
2018,8,20,19,2215,3327,2312,-1015
2018,8,20,20,2164,3432,2484,-948
2018,8,20,21,2221,3490,2430,-1060
2018,8,20,22,2233,3546,2386,-1160
2018,8,20,23,2265,3592,2439,-1153
2018,8,21,0,2179,3642,2430,-1212
2018,8,21,1,2140,3615,2495,-1120
2018,8,21,2,2087,3585,2508,-1077
2018,8,21,3,2127,3508,2540,-968
2018,8,21,4,2234,3429,2418,-1011
2018,8,21,5,2136,3273,2351,-922
2018,8,21,6,2277,3001,2363,-638
2018,8,21,7,2169,2679,1982,-697
2018,8,21,8,1985,2588,2060,-528
2018,8,21,9,1581,2509,2063,-446
2018,8,21,10,1868,2454,2085,-369
2018,8,21,11,1961,2477,2041,-436
2018,8,21,12,2009,2627,2269,-358
2018,8,21,13,2157,2826,2333,-493
2018,8,21,14,2090,2986,2152,-834
2018,8,21,15,2009,3213,2227,-986
2018,8,21,16,2069,3336,2236,-1100
2018,8,21,17,2125,3490,2310,-1180
2018,8,21,18,2248,3636,2376,-1260
2018,8,21,19,2341,3732,2422,-1310
2018,8,21,20,2247,3886,2501,-1385
2018,8,21,21,2320,3967,2523,-1444
2018,8,21,22,2396,4055,2518,-1537
2018,8,21,23,2422,4130,2617,-1513
2018,8,22,0,2441,4163,2613,-1550
2018,8,22,1,2172,4105,2540,-1565
2018,8,22,2,2117,3940,2418,-1522
2018,8,22,3,2140,3795,2377,-1418
2018,8,22,4,2273,3756,2397,-1359
2018,8,22,5,2248,3562,2427,-1135
2018,8,22,6,2034,3250,2416,-834
2018,8,22,7,2187,2979,2281,-698
2018,8,22,8,1972,2768,2234,-534
2018,8,22,9,1888,2593,1939,-654
2018,8,22,10,1809,2504,1885,-619
2018,8,22,11,1821,2624,2010,-614
2018,8,22,12,1938,2781,2159,-622
2018,8,22,13,2084,2908,2298,-610
2018,8,22,14,1987,3075,2132,-943
2018,8,22,15,2000,3283,2138,-1145
2018,8,22,16,2152,3384,2286,-1098
2018,8,22,17,2177,3520,2382,-1138
2018,8,22,18,2290,3632,2410,-1222
2018,8,22,19,2301,3735,2473,-1262
2018,8,22,20,2341,3834,2454,-1380
2018,8,22,21,2370,3884,2497,-1387
2018,8,22,22,2476,4003,2469,-1534
2018,8,22,23,2470,4070,2614,-1456
2018,8,23,0,2430,4128,2490,-1638
2018,8,23,1,2249,4047,2381,-1666
2018,8,23,2,2155,3809,2338,-1471
2018,8,23,3,2098,3669,2413,-1256
2018,8,23,4,2273,3648,2450,-1198
2018,8,23,5,2234,3418,2349,-1069
2018,8,23,6,2343,3144,2441,-703
2018,8,23,7,2085,2852,2120,-732
2018,8,23,8,1951,2637,2184,-453
2018,8,23,9,1956,2571,2180,-391
2018,8,23,10,1862,2514,2153,-361
2018,8,23,11,1773,2579,2220,-359
2018,8,23,12,1786,2774,2345,-429
2018,8,23,13,1812,2944,2381,-563
2018,8,23,14,1743,3089,2136,-953
2018,8,23,15,1927,3263,2224,-1039
2018,8,23,16,2037,3373,2292,-1081
2018,8,23,17,2085,3436,2268,-1168
2018,8,23,18,2096,3484,2338,-1146
2018,8,23,19,2117,3522,2398,-1124
2018,8,23,20,2155,3538,2480,-1058
2018,8,23,21,2132,3568,2485,-1083
2018,8,23,22,2193,3588,2500,-1088
2018,8,23,23,2205,3592,2476,-1116
2018,8,24,0,2260,3619,2456,-1163
2018,8,24,1,2242,3505,2435,-1070
2018,8,24,2,2221,3329,2311,-1018
2018,8,24,3,2165,3269,2337,-932
2018,8,24,4,2160,3265,2295,-970
2018,8,24,5,2064,3195,2405,-790
2018,8,24,6,2073,2950,2422,-528
2018,8,24,7,2054,2614,2026,-588
2018,8,24,8,1333,2361,1779,-582
2018,8,24,9,1301,2377,1854,-523
2018,8,24,10,1233,2310,1843,-467
2018,8,24,11,1354,2392,1892,-500
2018,8,24,12,1398,2645,1880,-765
2018,8,24,13,1390,2817,1955,-862
2018,8,24,14,1349,3024,1756,-1268
2018,8,24,15,1307,3220,2006,-1214
2018,8,24,16,1274,3264,1753,-1511
2018,8,24,17,1246,3408,1980,-1428
2018,8,24,18,1267,3445,1985,-1460
2018,8,24,19,1294,3450,1970,-1480
2018,8,24,20,1563,3443,2037,-1406
2018,8,24,21,1578,3489,2078,-1411
2018,8,24,22,1596,3463,2080,-1383
2018,8,24,23,1627,3462,2121,-1341
2018,8,25,0,1765,3457,2222,-1235
2018,8,25,1,1832,3368,2243,-1125
2018,8,25,2,1808,3189,2163,-1026
2018,8,25,3,1781,3098,2088,-1010
2018,8,25,4,1755,3133,2024,-1109
2018,8,25,5,1636,3036,1885,-1151
2018,8,25,6,1622,2854,1863,-991
2018,8,25,7,1672,2592,1694,-898
2018,8,25,8,1493,2439,1661,-778
2018,8,25,9,1392,2364,1649,-715
2018,8,25,10,1343,2311,1639,-672
2018,8,25,11,1419,2337,1692,-645
2018,8,25,12,1465,2408,1747,-661
2018,8,25,13,1515,2479,1746,-733
2018,8,25,14,1320,2540,1498,-1042
2018,8,25,15,1110,2696,1693,-1003
2018,8,25,16,1262,2880,1722,-1158
2018,8,25,17,1328,3020,1721,-1299
2018,8,25,18,1370,3083,1735,-1348
2018,8,25,19,1385,3077,1819,-1258
2018,8,25,20,1359,3076,1854,-1222
2018,8,25,21,1303,3039,1850,-1189
2018,8,25,22,1265,3030,1856,-1174
2018,8,25,23,1254,2999,1904,-1095
2018,8,26,0,1252,3015,1869,-1146
2018,8,26,1,1271,2986,1984,-1002
2018,8,26,2,1293,2934,1948,-986
2018,8,26,3,1303,2962,1907,-1055
2018,8,26,4,1367,2963,1841,-1122
2018,8,26,5,1286,2873,1699,-1174
2018,8,26,6,1484,2730,1733,-997
2018,8,26,7,1481,2586,1654,-932
2018,8,26,8,1373,2380,1505,-875
2018,8,26,9,1313,2212,1458,-754
2018,8,26,10,1320,2087,1368,-719
2018,8,26,11,1333,2116,1380,-736
2018,8,26,12,1340,2257,1551,-706
2018,8,26,13,1417,2327,1607,-720
2018,8,26,14,1205,2405,1557,-848
2018,8,26,15,1152,2521,1503,-1018
2018,8,26,16,1290,2708,1465,-1243
2018,8,26,17,1415,2854,1425,-1429
2018,8,26,18,1484,2857,1495,-1362
2018,8,26,19,1603,2967,1612,-1355
2018,8,26,20,1589,2993,1673,-1320
2018,8,26,21,1600,2968,1757,-1211
2018,8,26,22,1608,2995,1708,-1287
2018,8,26,23,1622,3074,1986,-1088
2018,8,27,0,1680,3116,2034,-1082
2018,8,27,1,1696,3127,2103,-1024
2018,8,27,2,1619,3076,2034,-1042
2018,8,27,3,1638,3087,1949,-1138
2018,8,27,4,1703,3093,1860,-1233
2018,8,27,5,1621,2899,1720,-1179
2018,8,27,6,1655,2687,1647,-1040
2018,8,27,7,1666,2508,1612,-896
2018,8,27,8,1481,2328,1380,-948
2018,8,27,9,1541,2312,1411,-901
2018,8,27,10,1537,2327,1449,-878
2018,8,27,11,1645,2398,1512,-886
2018,8,27,12,1697,2537,1619,-918
2018,8,27,13,1552,2731,1709,-1022
2018,8,27,14,1507,3034,1773,-1261
2018,8,27,15,1740,3219,1789,-1430
2018,8,27,16,1839,3363,1939,-1424
2018,8,27,17,1897,3401,1943,-1458
2018,8,27,18,1959,3435,1949,-1486
2018,8,27,19,1978,3473,2248,-1225
2018,8,27,20,1928,3513,2316,-1197
2018,8,27,21,1950,3449,2314,-1135
2018,8,27,22,1971,3470,2323,-1147
2018,8,27,23,1996,3558,2382,-1176
2018,8,28,0,2028,3596,2381,-1215
2018,8,28,1,2028,3553,2380,-1173
2018,8,28,2,2015,3413,2258,-1155
2018,8,28,3,2016,3348,2261,-1087
2018,8,28,4,2112,3365,2257,-1108
2018,8,28,5,1946,3200,2174,-1026
2018,8,28,6,1941,2947,2156,-791
2018,8,28,7,1896,2708,2082,-626
2018,8,28,8,1809,2535,2073,-462
2018,8,28,9,1744,2441,1951,-490
2018,8,28,10,1800,2457,2033,-424
2018,8,28,11,1842,2524,2126,-398
2018,8,28,12,1866,2673,2216,-457
2018,8,28,13,1978,2848,2216,-632
2018,8,28,14,1912,3053,2185,-868
2018,8,28,15,1874,3156,2154,-1002
2018,8,28,16,1971,3299,2116,-1183
2018,8,28,17,2038,3338,2181,-1157
2018,8,28,18,2095,3372,2163,-1209
2018,8,28,19,2144,3429,2151,-1278
2018,8,28,20,2188,3481,2196,-1285
2018,8,28,21,2106,3499,2173,-1326
2018,8,28,22,2132,3528,2187,-1341
2018,8,28,23,2272,3583,2284,-1299
2018,8,29,0,2293,3622,2213,-1409
2018,8,29,1,2319,3703,2358,-1345
2018,8,29,2,2226,3557,2273,-1284
2018,8,29,3,2234,3474,2330,-1144
2018,8,29,4,2300,3476,2217,-1259
2018,8,29,5,2221,3298,2212,-1086
2018,8,29,6,2140,3017,2283,-734
2018,8,29,7,2147,2759,2126,-633
2018,8,29,8,1839,2592,2034,-558
2018,8,29,9,1853,2482,1994,-488
2018,8,29,10,1794,2468,1973,-495
2018,8,29,11,1811,2548,2019,-529
2018,8,29,12,1852,2665,2059,-606
2018,8,29,13,2074,2852,2191,-661
2018,8,29,14,2056,3036,2210,-826
2018,8,29,15,2221,3166,2167,-999
2018,8,29,16,2290,3204,2123,-1081
2018,8,29,17,2316,3289,2190,-1099
2018,8,29,18,2322,3343,2246,-1097
2018,8,29,19,2300,3412,2222,-1190
2018,8,29,20,2254,3450,2369,-1081
2018,8,29,21,2198,3511,2265,-1246
2018,8,29,22,2159,3547,2332,-1215
2018,8,29,23,2253,3507,2368,-1139
2018,8,30,0,2306,3552,2463,-1089
2018,8,30,1,2324,3462,2365,-1097
2018,8,30,2,2290,3308,2352,-956
2018,8,30,3,2260,3342,2471,-871
2018,8,30,4,2317,3368,2415,-953
2018,8,30,5,2144,3214,2371,-843
2018,8,30,6,2105,2971,2434,-537
2018,8,30,7,1954,2665,2130,-535
2018,8,30,8,1849,2512,2057,-455
2018,8,30,9,1863,2455,1998,-457
2018,8,30,10,1826,2405,2036,-369
2018,8,30,11,1805,2402,2038,-364
2018,8,30,12,1923,2507,2054,-453
2018,8,30,13,2113,2740,2085,-655
2018,8,30,14,2019,2959,2079,-880
2018,8,30,15,2018,3130,2040,-1090
2018,8,30,16,2011,3180,2001,-1179
2018,8,30,17,2059,3236,2115,-1121
2018,8,30,18,2099,3357,2253,-1104
2018,8,30,19,2112,3396,2345,-1051
2018,8,30,20,2208,3424,2445,-979
2018,8,30,21,2214,3436,2505,-931
2018,8,30,22,2226,3456,2528,-928
2018,8,30,23,2196,3477,2508,-969
2018,8,31,0,2196,3531,2404,-1127
2018,8,31,1,2190,3408,2339,-1069
2018,8,31,2,2153,3328,2276,-1052
2018,8,31,3,2121,3315,2507,-808
2018,8,31,4,2139,3347,2471,-876
2018,8,31,5,2000,3188,2336,-852
2018,8,31,6,2196,2976,2367,-609
2018,8,31,7,2111,2726,2295,-431
2018,8,31,8,1850,2502,2047,-455
2018,8,31,9,1722,2409,1908,-501
2018,8,31,10,1697,2353,1871,-482
2018,8,31,11,1746,2427,1935,-492
2018,8,31,12,1798,2576,2036,-540
2018,8,31,13,1955,2738,2068,-670
2018,8,31,14,1868,2931,2070,-861
2018,8,31,15,1809,3085,2044,-1041
2018,8,31,16,1928,3185,1980,-1205
2018,8,31,17,1980,3295,2160,-1135
2018,8,31,18,2046,3326,2268,-1058
2018,8,31,19,2109,3351,2287,-1064
2018,8,31,20,2197,3380,2436,-944
2018,8,31,21,2244,3380,2466,-914
2018,8,31,22,2225,3321,2433,-888
2018,8,31,23,2265,3365,2542,-823
2018,9,1,0,2334,3261,2611,-650
2018,9,1,1,2363,3190,2601,-589
2018,9,1,2,2317,3134,2663,-471
2018,9,1,3,2265,3126,2652,-474
2018,9,1,4,2269,3145,2554,-591
2018,9,1,5,2105,3037,2424,-613
2018,9,1,6,2332,2853,2437,-416
2018,9,1,7,2065,2598,2148,-450
2018,9,1,8,1753,2338,1927,-411
2018,9,1,9,1593,2197,1820,-377
2018,9,1,10,1588,2119,1694,-425
2018,9,1,11,1676,2187,1789,-398
2018,9,1,12,1760,2300,1874,-426
2018,9,1,13,1828,2460,1924,-536
2018,9,1,14,1791,2566,1739,-827
2018,9,1,15,1784,2684,1733,-951
2018,9,1,16,1752,2855,1691,-1164
2018,9,1,17,1725,3003,1878,-1125
2018,9,1,18,1742,3077,1933,-1144
2018,9,1,19,1797,3084,1982,-1102
2018,9,1,20,1829,3131,2137,-994
2018,9,1,21,1893,3116,2156,-960
2018,9,1,22,2026,3097,2162,-935
2018,9,1,23,2055,3169,2306,-863
2018,9,2,0,2110,3098,2240,-858
2018,9,2,1,2192,3041,2306,-735
2018,9,2,2,2077,2993,2414,-579
2018,9,2,3,2081,2984,2455,-529
2018,9,2,4,2143,3036,2478,-558
2018,9,2,5,2030,2939,2397,-542
2018,9,2,6,2213,2775,2304,-471
2018,9,2,7,2043,2590,2166,-424
2018,9,2,8,1809,2301,1976,-325
2018,9,2,9,1760,2202,1872,-330
2018,9,2,10,1689,2152,1817,-335
2018,9,2,11,1657,2226,1816,-410
2018,9,2,12,1689,2305,1937,-368
2018,9,2,13,1612,2394,1934,-460
2018,9,2,14,1566,2456,1859,-597
2018,9,2,15,1563,2659,1855,-804
2018,9,2,16,1591,2832,1834,-998
2018,9,2,17,1708,2978,1853,-1125
2018,9,2,18,1759,3033,1835,-1198
2018,9,2,19,1788,3097,1919,-1178
2018,9,2,20,1830,3067,2101,-966
2018,9,2,21,1849,3054,2132,-922
2018,9,2,22,1970,3072,2179,-893
2018,9,2,23,1974,3105,2334,-771
2018,9,3,0,2024,3151,2423,-728
2018,9,3,1,2120,3106,2500,-606
2018,9,3,2,2133,2997,2380,-617
2018,9,3,3,2154,2941,2324,-617
2018,9,3,4,2201,2927,2346,-581
2018,9,3,5,2025,2839,2265,-574
2018,9,3,6,1982,2678,2224,-454
2018,9,3,7,1986,2470,1954,-516
2018,9,3,8,1821,2289,1786,-503
2018,9,3,9,1714,2186,1833,-353
2018,9,3,10,1700,2115,1830,-285
2018,9,3,11,1685,2152,1867,-285
2018,9,3,12,1588,2231,1930,-301
2018,9,3,13,1594,2305,1915,-390
2018,9,3,14,1531,2387,1911,-476
2018,9,3,15,1639,2482,1831,-651
2018,9,3,16,1669,2660,1849,-811
2018,9,3,17,1809,2842,1856,-986
2018,9,3,18,1971,2980,1978,-1002
2018,9,3,19,2084,3005,1970,-1035
2018,9,3,20,1919,3104,2139,-965
2018,9,3,21,1939,3118,2143,-975
2018,9,3,22,2006,3181,2225,-956
2018,9,3,23,2018,3204,2206,-998
2018,9,4,0,2072,3261,2158,-1103
2018,9,4,1,2153,3269,2128,-1141
2018,9,4,2,2070,3193,2088,-1105
2018,9,4,3,2099,3163,2023,-1140
2018,9,4,4,2283,3200,1949,-1251
2018,9,4,5,2088,3004,1926,-1078
2018,9,4,6,2028,2736,1894,-842
2018,9,4,7,1837,2490,1844,-646
2018,9,4,8,1590,2382,1792,-590
2018,9,4,9,1598,2246,1810,-436
2018,9,4,10,1602,2174,1821,-353
2018,9,4,11,1631,2226,1865,-361
2018,9,4,12,1708,2341,2024,-317
2018,9,4,13,1805,2572,2110,-462
2018,9,4,14,1747,2809,2061,-748
2018,9,4,15,1921,3024,2093,-931
2018,9,4,16,1957,3103,2136,-967
2018,9,4,17,1981,3150,2136,-1014
2018,9,4,18,1993,3220,2053,-1167
2018,9,4,19,2001,3283,2108,-1175
2018,9,4,20,2026,3333,2096,-1237
2018,9,4,21,2034,3336,2182,-1154
2018,9,4,22,2048,3347,2287,-1060
2018,9,4,23,2098,3373,2419,-954
2018,9,5,0,2250,3368,2552,-816
2018,9,5,1,2259,3382,2596,-786
2018,9,5,2,2228,3264,2539,-725
2018,9,5,3,2256,3255,2490,-765
2018,9,5,4,2295,3287,2233,-1054
2018,9,5,5,2095,3123,2134,-989
2018,9,5,6,2077,2839,2076,-763
2018,9,5,7,1769,2537,1871,-666
2018,9,5,8,1904,2345,1927,-418
2018,9,5,9,1790,2241,1818,-423
2018,9,5,10,1816,2215,1826,-389
2018,9,5,11,1931,2288,1839,-449
2018,9,5,12,1884,2423,1938,-485
2018,9,5,13,2011,2649,2082,-567
2018,9,5,14,2040,2956,2103,-853
2018,9,5,15,2093,3148,2104,-1044
2018,9,5,16,2138,3228,2130,-1098
2018,9,5,17,2163,3295,2167,-1128
2018,9,5,18,2211,3348,2208,-1140
2018,9,5,19,2261,3403,2168,-1235
2018,9,5,20,2296,3449,2192,-1257
2018,9,5,21,2310,3480,2187,-1293
2018,9,5,22,2318,3525,2398,-1127
2018,9,5,23,2382,3502,2415,-1087
2018,9,6,0,2430,3541,2526,-1015
2018,9,6,1,2422,3530,2501,-1029
2018,9,6,2,2390,3452,2338,-1114
2018,9,6,3,2413,3428,2227,-1201
2018,9,6,4,2407,3436,2165,-1271
2018,9,6,5,2226,3202,2044,-1158
2018,9,6,6,2333,2913,2076,-837
2018,9,6,7,2258,2645,1915,-730
2018,9,6,8,1995,2479,1935,-544
2018,9,6,9,1933,2384,1943,-441
2018,9,6,10,1927,2361,1907,-454
2018,9,6,11,1833,2407,1903,-504
2018,9,6,12,1895,2554,2048,-506
2018,9,6,13,2049,2777,2173,-604
2018,9,6,14,1832,3062,2147,-915
2018,9,6,15,1945,3221,2046,-1175
2018,9,6,16,2016,3286,2029,-1257
2018,9,6,17,2066,3312,2019,-1293
2018,9,6,18,2136,3417,2026,-1391
2018,9,6,19,2110,3460,2006,-1454
2018,9,6,20,2114,3526,2072,-1454
2018,9,6,21,2271,3568,2075,-1493
2018,9,6,22,2295,3612,2399,-1213
2018,9,6,23,2285,3675,2549,-1126
2018,9,7,0,2280,3714,2601,-1113
2018,9,7,1,2261,3656,2485,-1171
2018,9,7,2,2217,3507,2389,-1118
2018,9,7,3,2225,3324,2196,-1128
2018,9,7,4,2231,3327,2290,-1037
2018,9,7,5,2007,3097,2242,-855
2018,9,7,6,2307,2811,2275,-536
2018,9,7,7,2008,2568,2048,-520
2018,9,7,8,1923,2482,1967,-515
2018,9,7,9,1950,2417,1966,-451
2018,9,7,10,2052,2403,2005,-398
2018,9,7,11,1978,2449,1897,-552
2018,9,7,12,1965,2532,2030,-502
2018,9,7,13,2036,2773,2106,-667
2018,9,7,14,1685,2978,2006,-972
2018,9,7,15,1871,3146,2118,-1028
2018,9,7,16,1982,3246,2125,-1121
2018,9,7,17,2056,3336,2269,-1067
2018,9,7,18,2085,3433,2363,-1070
2018,9,7,19,2148,3459,2380,-1079
2018,9,7,20,2206,3499,2327,-1172
2018,9,7,21,2266,3532,2448,-1084
2018,9,7,22,2305,3520,2486,-1034
2018,9,7,23,2367,3499,2531,-968
2018,9,8,0,2090,3465,2606,-859
2018,9,8,1,2078,3333,2508,-825
2018,9,8,2,2317,3129,2356,-773
2018,9,8,3,2350,3223,2441,-782
2018,9,8,4,2331,3159,2501,-658
2018,9,8,5,2219,3084,2576,-508
2018,9,8,6,2705,2903,2576,-327
2018,9,8,7,2447,2593,2125,-468
2018,9,8,8,1903,2420,1951,-469
2018,9,8,9,1780,2332,1982,-350
2018,9,8,10,1767,2254,1913,-341
2018,9,8,11,1866,2241,1938,-303
2018,9,8,12,1726,2257,1937,-320
2018,9,8,13,1783,2314,1907,-407
2018,9,8,14,1659,2419,1754,-665
2018,9,8,15,1754,2544,1738,-806
2018,9,8,16,1826,2719,1681,-1038
2018,9,8,17,1918,2888,1944,-944
2018,9,8,18,2027,2995,2069,-926
2018,9,8,19,2065,3011,2026,-985
2018,9,8,20,2071,3013,2106,-907
2018,9,8,21,2049,2980,2207,-773
2018,9,8,22,2028,2945,2219,-726
2018,9,8,23,2042,2939,2227,-712
2018,9,9,0,2065,2980,2226,-754
2018,9,9,1,2093,2989,2338,-651
2018,9,9,2,2119,3004,2428,-576
2018,9,9,3,2147,3041,2417,-624
2018,9,9,4,2174,3040,2407,-633
2018,9,9,5,2084,2962,2335,-627
2018,9,9,6,2022,2798,2362,-436
2018,9,9,7,1931,2600,2258,-342
2018,9,9,8,1599,2449,2073,-376
2018,9,9,9,1528,2326,2005,-321
2018,9,9,10,1505,2280,1942,-338
2018,9,9,11,1501,2256,1931,-325
2018,9,9,12,1496,2260,1947,-313
2018,9,9,13,1570,2299,1928,-371
2018,9,9,14,1424,2392,1860,-532
2018,9,9,15,1465,2501,1809,-692
2018,9,9,16,1457,2681,1636,-1045
2018,9,9,17,1550,2961,1794,-1167
2018,9,9,18,1619,3047,1883,-1164
2018,9,9,19,1645,3106,2027,-1079
2018,9,9,20,1679,3122,2102,-1020
2018,9,9,21,1695,3132,2066,-1066
2018,9,9,22,1830,3139,2103,-1036
2018,9,9,23,1975,3159,2245,-914
2018,9,10,0,2010,3199,2245,-954
2018,9,10,1,2061,3250,2315,-935
2018,9,10,2,2074,3265,2307,-958
2018,9,10,3,2107,3308,2199,-1109
2018,9,10,4,2106,3266,2203,-1063
2018,9,10,5,2002,3065,2155,-910
2018,9,10,6,2137,2807,2235,-572
2018,9,10,7,2015,2568,2168,-400
2018,9,10,8,1784,2372,2059,-313
2018,9,10,9,1767,2287,1968,-319
2018,9,10,10,1764,2257,1938,-319
2018,9,10,11,1550,2311,1932,-379
2018,9,10,12,1597,2454,2006,-448
2018,9,10,13,1810,2668,2163,-505
2018,9,10,14,1761,2947,2158,-789
2018,9,10,15,1929,3111,2247,-864
2018,9,10,16,1962,3134,2159,-975
2018,9,10,17,1956,3198,2250,-948
2018,9,10,18,1978,3235,2225,-1010
2018,9,10,19,1984,3245,2282,-963
2018,9,10,20,2019,3285,2370,-915
2018,9,10,21,2115,3277,2356,-921
2018,9,10,22,2211,3252,2363,-889
2018,9,10,23,2244,3261,2426,-835
2018,9,11,0,2304,3274,2498,-776
2018,9,11,1,2399,3386,2644,-742
2018,9,11,2,2429,3313,2592,-721
2018,9,11,3,2510,3342,2659,-683
2018,9,11,4,2553,3353,2675,-678
2018,9,11,5,2372,3134,2550,-584
2018,9,11,6,2371,2902,2428,-474
2018,9,11,7,2186,2727,2336,-391
2018,9,11,8,1881,2538,2181,-357
2018,9,11,9,1764,2554,2257,-297
2018,9,11,10,1600,2520,2144,-376
2018,9,11,11,1691,2518,2164,-354
2018,9,11,12,1918,2591,2217,-374
2018,9,11,13,2168,2758,2200,-558
2018,9,11,14,1970,3032,2199,-833
2018,9,11,15,1951,3057,1940,-1117
2018,9,11,16,1938,3117,1866,-1251
2018,9,11,17,1980,3137,1879,-1258
2018,9,11,18,1974,3169,1799,-1370
2018,9,11,19,1989,3183,1902,-1281
2018,9,11,20,2014,3191,2101,-1090
2018,9,11,21,2017,3188,2034,-1154
2018,9,11,22,2018,3176,2044,-1132
2018,9,11,23,2039,3221,2157,-1064
2018,9,12,0,2076,3259,2221,-1038
2018,9,12,1,2143,3277,2290,-987
2018,9,12,2,2202,3280,2424,-856
2018,9,12,3,2315,3337,2462,-875
2018,9,12,4,2416,3341,2401,-940
2018,9,12,5,2204,3158,2310,-848
2018,9,12,6,2291,2902,2328,-574
2018,9,12,7,2008,2676,2296,-380
2018,9,12,8,1610,2567,2131,-436
2018,9,12,9,1454,2494,1980,-514
2018,9,12,10,1458,2453,1952,-501
2018,9,12,11,1461,2442,1942,-500
2018,9,12,12,1587,2480,1946,-534
2018,9,12,13,1770,2716,2084,-632
2018,9,12,14,1607,3005,2029,-976
2018,9,12,15,1677,3167,1941,-1226
2018,9,12,16,1730,3189,1901,-1288
2018,9,12,17,1738,3205,1783,-1422
2018,9,12,18,1739,3244,1875,-1369
2018,9,12,19,1856,3231,1881,-1350
2018,9,12,20,2002,3295,2045,-1250
2018,9,12,21,2045,3281,2021,-1260
2018,9,12,22,2043,3288,2060,-1228
2018,9,12,23,2046,3286,2156,-1130
2018,9,13,0,2085,3299,2263,-1036
2018,9,13,1,2118,3355,2349,-1006
2018,9,13,2,2168,3337,2460,-877
2018,9,13,3,2261,3342,2406,-936
2018,9,13,4,2356,3357,2435,-922
2018,9,13,5,2180,3185,2362,-823
2018,9,13,6,2380,2921,2374,-547
2018,9,13,7,2198,2700,2338,-362
2018,9,13,8,1953,2479,2056,-423
2018,9,13,9,1949,2312,1900,-412
2018,9,13,10,1842,2313,1991,-322
2018,9,13,11,1711,2407,2050,-357
2018,9,13,12,1883,2499,2078,-421
2018,9,13,13,2040,2672,2091,-581
2018,9,13,14,2020,3014,2104,-910
2018,9,13,15,1913,3175,2084,-1091
2018,9,13,16,1925,3185,2066,-1119
2018,9,13,17,1903,3177,1967,-1210
2018,9,13,18,1851,3192,1930,-1262
2018,9,13,19,1921,3176,2031,-1145
2018,9,13,20,2018,3171,2036,-1135
2018,9,13,21,2028,3181,2084,-1097
2018,9,13,22,2051,3160,2075,-1085
2018,9,13,23,2059,3233,2151,-1082
2018,9,14,0,2117,3288,2306,-982
2018,9,14,1,2171,3342,2329,-1013
2018,9,14,2,2224,3368,2500,-868
2018,9,14,3,2340,3371,2383,-988
2018,9,14,4,2448,3421,2484,-937
2018,9,14,5,2320,3183,2416,-767
2018,9,14,6,2307,2912,2372,-540
2018,9,14,7,2241,2733,2310,-423
2018,9,14,8,1855,2587,1973,-614
2018,9,14,9,1815,2494,1937,-557
2018,9,14,10,1862,2456,1909,-547
2018,9,14,11,1833,2467,1931,-536
2018,9,14,12,1911,2541,1934,-607
2018,9,14,13,2115,2742,1917,-825
2018,9,14,14,1836,3054,1971,-1083
2018,9,14,15,2070,3262,2102,-1160
2018,9,14,16,2077,3289,2041,-1248
2018,9,14,17,2092,3294,2037,-1257
2018,9,14,18,2099,3318,2116,-1202
2018,9,14,19,2201,3313,2106,-1207
2018,9,14,20,2276,3312,2209,-1103
2018,9,14,21,2307,3334,2251,-1083
2018,9,14,22,2279,3333,2234,-1099
2018,9,14,23,2282,3320,2272,-1048
2018,9,15,0,2273,3333,2372,-961
2018,9,15,1,2265,3347,2364,-983
2018,9,15,2,2230,3325,2334,-991
2018,9,15,3,2263,3314,2274,-1040
2018,9,15,4,2361,3287,2316,-971
2018,9,15,5,2179,3131,2260,-871
2018,9,15,6,2365,2886,2276,-610
2018,9,15,7,2316,2682,2282,-400
2018,9,15,8,1846,2555,2111,-444
2018,9,15,9,1769,2479,2039,-440
2018,9,15,10,1806,2382,1962,-420
2018,9,15,11,1762,2361,1942,-419
2018,9,15,12,1757,2371,1870,-501
2018,9,15,13,1753,2476,1930,-546
2018,9,15,14,1750,2613,1869,-744
2018,9,15,15,1630,2745,1850,-895
2018,9,15,16,1830,2938,1858,-1080
2018,9,15,17,1904,3048,1824,-1224
2018,9,15,18,1949,3112,1899,-1213
2018,9,15,19,2069,3134,1910,-1224
2018,9,15,20,2134,3109,2153,-956
2018,9,15,21,2095,3060,2139,-921
2018,9,15,22,2056,3023,2090,-933
2018,9,15,23,2047,3001,2093,-908
2018,9,16,0,2039,3083,2076,-1007
2018,9,16,1,2061,3092,1910,-1182
2018,9,16,2,2073,3114,1996,-1118
2018,9,16,3,2140,3165,2080,-1085
2018,9,16,4,2141,3141,2118,-1023
2018,9,16,5,1993,3056,2138,-918
2018,9,16,6,2299,2919,2283,-636
2018,9,16,7,2079,2630,2155,-475
2018,9,16,8,1627,2484,1947,-537
2018,9,16,9,1507,2407,1909,-498
2018,9,16,10,1516,2336,1859,-477
2018,9,16,11,1537,2321,1881,-440
2018,9,16,12,1383,2270,1852,-418
2018,9,16,13,1413,2371,1864,-507
2018,9,16,14,1474,2490,1901,-589
2018,9,16,15,1626,2670,2014,-656
2018,9,16,16,1738,2795,2022,-773
2018,9,16,17,1865,3037,2167,-870
2018,9,16,18,1919,3011,2149,-862
2018,9,16,19,1912,2993,2137,-856
2018,9,16,20,1899,2984,2186,-798
2018,9,16,21,1914,2962,2061,-901
2018,9,16,22,1929,2988,2255,-733
2018,9,16,23,1946,3050,2365,-685
2018,9,17,0,1970,3078,2343,-735
2018,9,17,1,2029,3155,2375,-780
2018,9,17,2,2204,3109,2091,-1018
2018,9,17,3,2270,3210,2291,-919
2018,9,17,4,2412,3192,2520,-672
2018,9,17,5,2272,3002,2506,-496
2018,9,17,6,2279,2779,2474,-305
2018,9,17,7,1995,2539,2278,-261
2018,9,17,8,1814,2392,2155,-237
2018,9,17,9,1854,2330,2001,-329
2018,9,17,10,1784,2309,1857,-452
2018,9,17,11,1938,2317,1873,-444
2018,9,17,12,1907,2443,2084,-359
2018,9,17,13,1982,2659,1974,-685
2018,9,17,14,1936,2985,1884,-1101
2018,9,17,15,2023,3175,1996,-1179
2018,9,17,16,2071,3207,2017,-1190
2018,9,17,17,2059,3224,2026,-1198
2018,9,17,18,2048,3236,2086,-1150
2018,9,17,19,2028,3215,2091,-1124
2018,9,17,20,2090,3187,2176,-1011
2018,9,17,21,2149,3165,2162,-1003
2018,9,17,22,2206,3137,2108,-1029
2018,9,17,23,2203,3153,2147,-1006
2018,9,18,0,2228,3190,2283,-907
2018,9,18,1,2294,3256,2394,-862
2018,9,18,2,2313,3257,2417,-840
2018,9,18,3,2389,3299,2382,-917
2018,9,18,4,2332,3261,2337,-924
2018,9,18,5,2123,3065,2289,-776
2018,9,18,6,2402,2854,2368,-486
2018,9,18,7,2190,2560,2163,-397
2018,9,18,8,1679,2389,1794,-595
2018,9,18,9,1640,2403,1775,-628
2018,9,18,10,1631,2396,1790,-606
2018,9,18,11,1659,2421,1777,-644
2018,9,18,12,1696,2599,1882,-717
2018,9,18,13,1913,2848,2028,-820
2018,9,18,14,1813,3209,2030,-1179
2018,9,18,15,2030,3340,2077,-1263
2018,9,18,16,2036,3277,1947,-1330
2018,9,18,17,1996,3225,1834,-1391
2018,9,18,18,1964,3199,1885,-1314
2018,9,18,19,2002,3139,1844,-1295
2018,9,18,20,2062,3140,1895,-1245
2018,9,18,21,2037,3118,1943,-1175
2018,9,18,22,2017,3179,2037,-1142
2018,9,18,23,2008,3187,2012,-1175
2018,9,19,0,2051,3221,2012,-1209
2018,9,19,1,2079,3266,2134,-1132
2018,9,19,2,2102,3263,2198,-1065
2018,9,19,3,2203,3384,2332,-1052
2018,9,19,4,2183,3350,2233,-1117
2018,9,19,5,1972,3163,2298,-865
2018,9,19,6,2181,2870,2282,-588
2018,9,19,7,1964,2643,2175,-468
2018,9,19,8,1678,2493,1945,-548
2018,9,19,9,1651,2426,1853,-573
2018,9,19,10,1789,2372,1825,-547
2018,9,19,11,1803,2411,1810,-601
2018,9,19,12,1800,2521,1873,-648
2018,9,19,13,1980,2776,2093,-683
2018,9,19,14,1961,3173,2189,-984
2018,9,19,15,2110,3383,2270,-1113
2018,9,19,16,2129,3360,2250,-1110
2018,9,19,17,2077,3377,2184,-1193
2018,9,19,18,2054,3293,2024,-1269
2018,9,19,19,2110,3324,2080,-1244
2018,9,19,20,2175,3315,2094,-1221
2018,9,19,21,2170,3307,2103,-1204
2018,9,19,22,2133,3303,2068,-1235
2018,9,19,23,2170,3353,2114,-1239
2018,9,20,0,2161,3397,2132,-1265
2018,9,20,1,2180,3436,2154,-1282
2018,9,20,2,2182,3470,2180,-1290
2018,9,20,3,2264,3528,2107,-1421
2018,9,20,4,2215,3458,2201,-1257
2018,9,20,5,1983,3254,2199,-1055
2018,9,20,6,2066,3006,2208,-798
2018,9,20,7,2000,2768,2073,-695
2018,9,20,8,1943,2613,1895,-718
2018,9,20,9,1902,2537,1823,-714
2018,9,20,10,1741,2498,1879,-619
2018,9,20,11,1811,2499,1856,-643
2018,9,20,12,1817,2587,1905,-682
2018,9,20,13,1700,2814,1933,-881
2018,9,20,14,1749,3148,1962,-1186
2018,9,20,15,1928,3341,2020,-1321
2018,9,20,16,1910,3342,1943,-1399
2018,9,20,17,1945,3357,1923,-1434
2018,9,20,18,1952,3366,1953,-1413
2018,9,20,19,2005,3365,1970,-1395
2018,9,20,20,2043,3360,2162,-1198
2018,9,20,21,2179,3357,2237,-1120
2018,9,20,22,2196,3347,2247,-1100
2018,9,20,23,2243,3325,2252,-1073
2018,9,21,0,2302,3351,2272,-1079
2018,9,21,1,2368,3405,2445,-960
2018,9,21,2,2518,3480,2569,-911
2018,9,21,3,2628,3541,2502,-1039
2018,9,21,4,2627,3466,2482,-984
2018,9,21,5,2439,3254,2385,-869
2018,9,21,6,2495,2988,2353,-635
2018,9,21,7,2437,2779,2300,-479
2018,9,21,8,1877,2600,2045,-555
2018,9,21,9,1859,2519,2032,-487
2018,9,21,10,1851,2487,2088,-399
2018,9,21,11,1851,2522,2110,-412
2018,9,21,12,1851,2606,2107,-499
2018,9,21,13,2190,2832,2168,-664
2018,9,21,14,2021,3155,2216,-939
2018,9,21,15,2207,3312,2342,-970
2018,9,21,16,2208,3335,2262,-1073
2018,9,21,17,2292,3376,2183,-1193
2018,9,21,18,2234,3393,2241,-1152
2018,9,21,19,2308,3400,2308,-1092
2018,9,21,20,2252,3425,2347,-1078
2018,9,21,21,2363,3412,2381,-1031
2018,9,21,22,2273,3400,2423,-977
2018,9,21,23,2371,3402,2440,-962
2018,9,22,0,2447,3420,2541,-879
2018,9,22,1,2320,3481,2623,-858
2018,9,22,2,2339,3449,2529,-920
2018,9,22,3,2340,3456,2496,-960
2018,9,22,4,2330,3350,2422,-928
2018,9,22,5,2227,3161,2292,-869
2018,9,22,6,2460,2990,2379,-611
2018,9,22,7,2268,2790,2347,-443
2018,9,22,8,1729,2593,2007,-586
2018,9,22,9,1679,2518,1951,-567
2018,9,22,10,1539,2449,1934,-515
2018,9,22,11,1588,2431,1975,-456
2018,9,22,12,1567,2476,1942,-534
2018,9,22,13,1606,2538,1951,-587
2018,9,22,14,1552,2682,2023,-659
2018,9,22,15,1525,2866,2009,-857
2018,9,22,16,1690,3043,1890,-1153
2018,9,22,17,1852,3169,1807,-1362
2018,9,22,18,1922,3227,1893,-1334
2018,9,22,19,1896,3212,1928,-1284
2018,9,22,20,1899,3224,2081,-1143
2018,9,22,21,1884,3187,2171,-1016
2018,9,22,22,1985,3132,2222,-910
2018,9,22,23,2038,3121,2227,-894
2018,9,23,0,2002,3118,2179,-939
2018,9,23,1,2015,3155,2172,-983
2018,9,23,2,2107,3128,2182,-946
2018,9,23,3,2232,3220,2215,-1005
2018,9,23,4,2263,3209,2135,-1074
2018,9,23,5,2094,3090,2029,-1061
2018,9,23,6,2258,2930,2014,-916
2018,9,23,7,2058,2719,1822,-897
2018,9,23,8,1703,2591,1755,-836
2018,9,23,9,1647,2482,1708,-774
2018,9,23,10,1614,2433,1712,-721
2018,9,23,11,1562,2435,1706,-729
2018,9,23,12,1591,2453,1710,-743
2018,9,23,13,1643,2518,1737,-781
2018,9,23,14,1611,2660,1769,-891
2018,9,23,15,1739,2797,1826,-971
2018,9,23,16,1880,3003,1828,-1175
2018,9,23,17,1905,3135,1804,-1331
2018,9,23,18,1970,3179,1771,-1408
2018,9,23,19,2017,3187,1799,-1388
2018,9,23,20,1730,3098,1843,-1255
2018,9,23,21,1728,3036,1864,-1172
2018,9,23,22,1726,3002,1887,-1115
2018,9,23,23,1802,3087,2108,-979
2018,9,24,0,1987,3166,2158,-1008
2018,9,24,1,2066,3276,2338,-938
2018,9,24,2,2139,3282,2442,-840
2018,9,24,3,2266,3386,2411,-975
2018,9,24,4,2537,3417,2522,-895
2018,9,24,5,2272,3217,2431,-786
2018,9,24,6,2246,3031,2482,-549
2018,9,24,7,2163,2860,2312,-548
2018,9,24,8,1957,2656,2053,-603
2018,9,24,9,1810,2553,1892,-661
2018,9,24,10,1789,2564,1905,-659
2018,9,24,11,1829,2560,1886,-674
2018,9,24,12,1849,2708,2053,-655
2018,9,24,13,1860,2939,2035,-904
2018,9,24,14,1710,3352,2108,-1244
2018,9,24,15,1878,3496,2082,-1414
2018,9,24,16,1897,3511,2123,-1388
2018,9,24,17,1879,3466,2158,-1308
2018,9,24,18,1873,3445,2242,-1203
2018,9,24,19,1867,3448,2271,-1177
2018,9,24,20,1881,3431,2322,-1109
2018,9,24,21,1884,3425,2310,-1115
2018,9,24,22,1954,3389,2314,-1075
2018,9,24,23,2089,3388,2322,-1066
2018,9,25,0,2136,3427,2424,-1003
2018,9,25,1,2185,3485,2440,-1045
2018,9,25,2,2214,3454,2435,-1019
2018,9,25,3,2329,3589,2493,-1096
2018,9,25,4,2267,3437,2327,-1110
2018,9,25,5,2047,3241,2308,-933
2018,9,25,6,2364,2983,2293,-690
2018,9,25,7,2301,2767,2360,-407
2018,9,25,8,1954,2675,2141,-534
2018,9,25,9,1908,2616,2133,-483
2018,9,25,10,1898,2547,2094,-453
2018,9,25,11,1938,2579,2017,-562
2018,9,25,12,1994,2705,2056,-649
2018,9,25,13,2365,2973,2123,-850
2018,9,25,14,2068,3349,2142,-1207
2018,9,25,15,2286,3531,2188,-1343
2018,9,25,16,2285,3379,1940,-1439
2018,9,25,17,2166,3316,1923,-1393
2018,9,25,18,2122,3307,1920,-1387
2018,9,25,19,2091,3374,2031,-1343
2018,9,25,20,2072,3357,2104,-1253
2018,9,25,21,2057,3357,2148,-1209
2018,9,25,22,2043,3336,2147,-1189
2018,9,25,23,2040,3380,2202,-1178
2018,9,26,0,2189,3411,2292,-1119
2018,9,26,1,2345,3456,2376,-1080
2018,9,26,2,2365,3446,2303,-1143
2018,9,26,3,2486,3496,2330,-1166
2018,9,26,4,2425,3432,2352,-1080
2018,9,26,5,2298,3293,2428,-865
2018,9,26,6,2570,3114,2548,-566
2018,9,26,7,2388,2814,2301,-513
2018,9,26,8,1946,2679,2226,-453
2018,9,26,9,1904,2591,2171,-420
2018,9,26,10,1940,2557,2102,-455
2018,9,26,11,1968,2561,2041,-520
2018,9,26,12,1982,2680,2074,-606
2018,9,26,13,2156,3001,2322,-679
2018,9,26,14,2250,3337,2300,-1037
2018,9,26,15,2005,3485,2097,-1388
2018,9,26,16,2076,3472,2095,-1377
2018,9,26,17,2038,3421,2021,-1400
2018,9,26,18,1961,3409,2043,-1366
2018,9,26,19,2101,3455,2276,-1179
2018,9,26,20,2181,3448,2318,-1130
2018,9,26,21,2222,3436,2349,-1087
2018,9,26,22,2154,3362,2316,-1046
2018,9,26,23,2207,3447,2399,-1048
2018,9,27,0,2325,3426,2406,-1020
2018,9,27,1,2285,3466,2407,-1059
2018,9,27,2,2226,3453,2420,-1033
2018,9,27,3,2331,3535,2427,-1108
2018,9,27,4,2294,3514,2436,-1078
2018,9,27,5,2324,3272,2357,-915
2018,9,27,6,2291,3067,2399,-668
2018,9,27,7,2279,2817,2214,-603
2018,9,27,8,1930,2701,1986,-715
2018,9,27,9,1860,2624,2002,-622
2018,9,27,10,1767,2560,2005,-555
2018,9,27,11,1762,2587,2010,-577
2018,9,27,12,1842,2661,2000,-661
2018,9,27,13,2015,2893,2011,-882
2018,9,27,14,1903,3257,2035,-1222
2018,9,27,15,2032,3454,2216,-1238
2018,9,27,16,2098,3441,2319,-1122
2018,9,27,17,2098,3397,2336,-1061
2018,9,27,18,2105,3380,2304,-1076
2018,9,27,19,2107,3353,2285,-1068
2018,9,27,20,2227,3349,2292,-1057
2018,9,27,21,2199,3361,2355,-1006
2018,9,27,22,2253,3357,2224,-1133
2018,9,27,23,2219,3376,2217,-1159
2018,9,28,0,2203,3440,2264,-1176
2018,9,28,1,2220,3475,2345,-1130
2018,9,28,2,2320,3488,2282,-1206
2018,9,28,3,2424,3551,2241,-1310
2018,9,28,4,2363,3490,2248,-1242
2018,9,28,5,2142,3292,2247,-1045
2018,9,28,6,2389,3072,2295,-777
2018,9,28,7,2339,2845,2324,-521
2018,9,28,8,2082,2719,2326,-393
2018,9,28,9,1897,2640,2312,-328
2018,9,28,10,1992,2517,2286,-231
2018,9,28,11,2002,2516,2300,-216
2018,9,28,12,1896,2599,2297,-302
2018,9,28,13,2066,2864,2374,-490
2018,9,28,14,1920,3189,2380,-809
2018,9,28,15,2146,3331,2431,-900
2018,9,28,16,2052,3394,2351,-1043
2018,9,28,17,2062,3389,2232,-1157
2018,9,28,18,2067,3406,2219,-1187
2018,9,28,19,2073,3420,2283,-1137
2018,9,28,20,2086,3424,2260,-1164
2018,9,28,21,2109,3432,2322,-1110
2018,9,28,22,2225,3428,2317,-1111
2018,9,28,23,2287,3496,2466,-1030
2018,9,29,0,2305,3510,2409,-1101
2018,9,29,1,2301,3483,2473,-1010
2018,9,29,2,2284,3477,2525,-952
2018,9,29,3,2334,3477,2432,-1045
2018,9,29,4,2298,3395,2434,-961
2018,9,29,5,2124,3226,2367,-859
2018,9,29,6,2277,3082,2475,-607
2018,9,29,7,2146,2869,2431,-438
2018,9,29,8,2123,2666,2237,-429
2018,9,29,9,1997,2577,2084,-493
2018,9,29,10,1891,2538,2078,-460
2018,9,29,11,1908,2465,2035,-430
2018,9,29,12,1965,2518,2127,-391
2018,9,29,13,2023,2609,2214,-395
2018,9,29,14,1973,2758,2203,-555
2018,9,29,15,1968,2882,2197,-685
2018,9,29,16,2151,3053,2176,-877
2018,9,29,17,2262,3158,2171,-987
2018,9,29,18,2287,3182,2226,-956
2018,9,29,19,2330,3210,2373,-837
2018,9,29,20,2232,3204,2470,-734
2018,9,29,21,2209,3176,2481,-695
2018,9,29,22,2177,3135,2476,-659
2018,9,29,23,2177,3151,2459,-692
2018,9,30,0,2241,3186,2525,-661
2018,9,30,1,2265,3197,2533,-664
2018,9,30,2,2282,3279,2551,-728
2018,9,30,3,2349,3335,2583,-752
2018,9,30,4,2359,3244,2585,-659
2018,9,30,5,2258,3123,2482,-641
2018,9,30,6,2240,2991,2574,-417
2018,9,30,7,2196,2795,2370,-425
2018,9,30,8,1965,2642,2266,-376
2018,9,30,9,1855,2534,2192,-342
2018,9,30,10,1871,2480,2170,-310
2018,9,30,11,1922,2484,2175,-309
2018,9,30,12,1905,2524,2188,-336
2018,9,30,13,1866,2610,2190,-420
2018,9,30,14,1861,2693,2211,-482
2018,9,30,15,1977,2772,2081,-691
2018,9,30,16,2133,2991,2086,-905
2018,9,30,17,1896,3130,2149,-981
2018,9,30,18,1944,3199,2115,-1084
2018,9,30,19,2054,3260,2141,-1119
2018,9,30,20,1995,3280,2300,-980
2018,9,30,21,1988,3263,2290,-973
2018,9,30,22,1986,3233,2267,-966
2018,9,30,23,2041,3212,2223,-989
2018,10,1,0,2084,3233,2245,-988
2018,10,1,1,2176,3326,2279,-1047
2018,10,1,2,2177,3406,2304,-1102
2018,10,1,3,2282,3560,2509,-1051
2018,10,1,4,2289,3469,2464,-1005
2018,10,1,5,2096,3274,2466,-808
2018,10,1,6,2301,3033,2524,-509
2018,10,1,7,2097,2784,2351,-433
2018,10,1,8,2031,2541,2064,-477
2018,10,1,9,1798,2456,1956,-500
2018,10,1,10,1873,2431,1957,-474
2018,10,1,11,1890,2443,1985,-458
2018,10,1,12,1933,2535,2042,-493
2018,10,1,13,2176,2785,2218,-567
2018,10,1,14,2042,3066,2194,-872
2018,10,1,15,2245,3299,2296,-1003
2018,10,1,16,2246,3345,2322,-1023
2018,10,1,17,2232,3336,2328,-1008
2018,10,1,18,2226,3354,2279,-1075
2018,10,1,19,2223,3427,2371,-1056
2018,10,1,20,2292,3421,2432,-989
2018,10,1,21,2270,3417,2498,-919
2018,10,1,22,2255,3394,2484,-910
2018,10,1,23,2260,3447,2583,-864
2018,10,2,0,2273,3479,2543,-936
2018,10,2,1,2343,3554,2619,-935
2018,10,2,2,2423,3632,2698,-934
2018,10,2,3,2529,3683,2750,-933
2018,10,2,4,2339,3545,2588,-957
2018,10,2,5,2221,3338,2588,-750
2018,10,2,6,2300,3061,2559,-502
2018,10,2,7,2056,2793,2278,-515
2018,10,2,8,1981,2645,2291,-354
2018,10,2,9,2109,2568,2247,-321
2018,10,2,10,2033,2518,2226,-292
2018,10,2,11,2146,2515,2384,-131
2018,10,2,12,2181,2617,2419,-198
2018,10,2,13,2272,2866,2568,-298
2018,10,2,14,2251,3228,2578,-650
2018,10,2,15,2414,3368,2494,-874
2018,10,2,16,2354,3416,2419,-997
2018,10,2,17,2275,3382,2484,-898
2018,10,2,18,2173,3129,2254,-875
2018,10,2,19,2136,3180,2347,-833
2018,10,2,20,2108,3127,2056,-1071
2018,10,2,21,2063,3170,2239,-931
2018,10,2,22,2033,3125,2297,-828
2018,10,2,23,2046,3033,2293,-740
2018,10,3,0,2062,3086,2330,-756
2018,10,3,1,2127,3181,2353,-828
2018,10,3,2,2210,3224,2356,-868
2018,10,3,3,2355,3369,2406,-963
2018,10,3,4,2312,3334,2383,-951
2018,10,3,5,2161,3180,2415,-765
2018,10,3,6,2264,2941,2415,-526
2018,10,3,7,2154,2704,2299,-405
2018,10,3,8,1976,2527,2050,-477
2018,10,3,9,1866,2484,1867,-617
2018,10,3,10,1879,2469,1875,-594
2018,10,3,11,2094,2539,1917,-622
2018,10,3,12,2149,2691,1885,-806
2018,10,3,13,2161,3019,2083,-936
2018,10,3,14,2306,3446,2141,-1305
2018,10,3,15,2316,3654,2238,-1416
2018,10,3,16,2316,3632,2182,-1450
2018,10,3,17,2288,3548,2178,-1370
2018,10,3,18,2084,3461,2061,-1400
2018,10,3,19,2051,3371,2133,-1238
2018,10,3,20,2082,3349,2085,-1264
2018,10,3,21,2014,3309,2025,-1284
2018,10,3,22,2024,3285,2206,-1079
2018,10,3,23,2014,3290,2223,-1067
2018,10,4,0,2126,3335,2284,-1051
2018,10,4,1,2202,3434,2235,-1199
2018,10,4,2,2157,3571,2255,-1316
2018,10,4,3,2198,3660,2298,-1362
2018,10,4,4,2244,3563,2244,-1319
2018,10,4,5,2213,3337,2135,-1202
2018,10,4,6,2209,3043,2150,-893
2018,10,4,7,2269,2815,2171,-644
2018,10,4,8,1884,2647,1897,-750
2018,10,4,9,1772,2570,1894,-676
2018,10,4,10,1776,2540,1856,-684
2018,10,4,11,1778,2587,1871,-716
2018,10,4,12,1879,2702,1861,-841
2018,10,4,13,1871,3008,1922,-1086
2018,10,4,14,2017,3424,2027,-1397
2018,10,4,15,2091,3642,2265,-1377
2018,10,4,16,2072,3606,2232,-1374
2018,10,4,17,1955,3557,2224,-1333
2018,10,4,18,2060,3513,2255,-1258
2018,10,4,19,1967,3368,2145,-1223
2018,10,4,20,1851,3304,2139,-1165
2018,10,4,21,1806,3193,1969,-1224
2018,10,4,22,1759,3140,1978,-1162
2018,10,4,23,1770,3131,1955,-1176
2018,10,5,0,1773,3244,2123,-1121
2018,10,5,1,1829,3351,2256,-1095
2018,10,5,2,1966,3455,2305,-1150
2018,10,5,3,2071,3507,2143,-1364
2018,10,5,4,2028,3441,2210,-1231
2018,10,5,5,1823,3267,2155,-1112
2018,10,5,6,1986,3006,2112,-894
2018,10,5,7,1804,2755,2020,-735
2018,10,5,8,1853,2652,1989,-663
2018,10,5,9,1815,2593,1899,-694
2018,10,5,10,1808,2576,1859,-717
2018,10,5,11,1832,2598,1800,-798
2018,10,5,12,1872,2708,1809,-899
2018,10,5,13,2207,2973,1870,-1103
2018,10,5,14,2089,3337,1935,-1402
2018,10,5,15,2303,3616,2107,-1509
2018,10,5,16,2295,3612,2085,-1527
2018,10,5,17,2240,3598,2062,-1536
2018,10,5,18,2193,3559,2038,-1521
2018,10,5,19,2108,3528,2078,-1450
2018,10,5,20,2086,3488,2170,-1318
2018,10,5,21,1987,3458,2159,-1299
2018,10,5,22,1960,3562,2238,-1324
2018,10,5,23,2080,3577,2246,-1331
2018,10,6,0,2056,3642,2308,-1334
2018,10,6,1,2131,3756,2384,-1372
2018,10,6,2,2281,3891,2320,-1571
2018,10,6,3,2366,3858,2339,-1519
2018,10,6,4,2189,3688,2280,-1408
2018,10,6,5,2130,3557,2257,-1300
2018,10,6,6,2353,3282,2203,-1079
2018,10,6,7,2117,3056,2129,-927
2018,10,6,8,1966,2857,2099,-758
2018,10,6,9,1890,2748,2010,-738
2018,10,6,10,1935,2714,2053,-661
2018,10,6,11,1919,2704,2036,-668
2018,10,6,12,1948,2719,1967,-752
2018,10,6,13,1997,2830,1961,-869
2018,10,6,14,1927,3012,1941,-1071
2018,10,6,15,1911,3268,2108,-1160
2018,10,6,16,2040,3454,2295,-1159
2018,10,6,17,2242,3501,2224,-1277
2018,10,6,18,2233,3496,2255,-1241
2018,10,6,19,2110,3397,2167,-1230
2018,10,6,20,2030,3323,2178,-1145
2018,10,6,21,1975,3260,2156,-1104
2018,10,6,22,1881,3182,2028,-1154
2018,10,6,23,1854,3143,1920,-1223
2018,10,7,0,1888,3181,2016,-1165
2018,10,7,1,1938,3253,2016,-1237
2018,10,7,2,2025,3354,2105,-1249
2018,10,7,3,2142,3519,2288,-1231
2018,10,7,4,2035,3482,2367,-1115
2018,10,7,5,1912,3299,2233,-1066
2018,10,7,6,2246,3176,2321,-855
2018,10,7,7,2081,2971,2172,-799
2018,10,7,8,1978,2787,2003,-784
2018,10,7,9,1990,2702,1920,-782
2018,10,7,10,1942,2658,1879,-779
2018,10,7,11,1930,2645,1856,-789
2018,10,7,12,1960,2673,1839,-834
2018,10,7,13,1928,2774,1869,-905
2018,10,7,14,1941,2930,1855,-1075
2018,10,7,15,2126,3109,1970,-1139
2018,10,7,16,2301,3308,2145,-1163
2018,10,7,17,2388,3421,2063,-1358
2018,10,7,18,2321,3461,2082,-1379
2018,10,7,19,2398,3459,2158,-1301
2018,10,7,20,2272,3442,2107,-1335
2018,10,7,21,2225,3393,2121,-1272
2018,10,7,22,2154,3401,2287,-1114
2018,10,7,23,2134,3372,2221,-1151
2018,10,8,0,2153,3375,2246,-1129
2018,10,8,1,2343,3486,2269,-1217
2018,10,8,2,2408,3580,2277,-1303
2018,10,8,3,2583,3640,2264,-1376
2018,10,8,4,2483,3508,2192,-1316
2018,10,8,5,2245,3296,2177,-1119
2018,10,8,6,2338,3038,2272,-766
2018,10,8,7,2001,2819,2116,-703
2018,10,8,8,1966,2723,2056,-667
2018,10,8,9,1904,2663,2012,-651
2018,10,8,10,1882,2626,1970,-656
2018,10,8,11,1918,2563,1953,-610
2018,10,8,12,1980,2703,2056,-647
2018,10,8,13,2077,3004,2218,-786
2018,10,8,14,2197,3384,2294,-1090
2018,10,8,15,2339,3559,2404,-1155
2018,10,8,16,2353,3583,2444,-1139
2018,10,8,17,2244,3572,2400,-1172
2018,10,8,18,2237,3544,2397,-1147
2018,10,8,19,2307,3554,2410,-1144
2018,10,8,20,2296,3532,2387,-1145
2018,10,8,21,2252,3511,2366,-1145
2018,10,8,22,2214,3509,2420,-1089
2018,10,8,23,2214,3559,2509,-1050
2018,10,9,0,2321,3622,2554,-1068
2018,10,9,1,2314,3737,2498,-1239
2018,10,9,2,2346,3761,2394,-1367
2018,10,9,3,2380,3776,2415,-1361
2018,10,9,4,2405,3658,2445,-1213
2018,10,9,5,2239,3428,2330,-1098
2018,10,9,6,2109,3141,2371,-770
2018,10,9,7,2068,2877,2152,-725
2018,10,9,8,1965,2696,2005,-691
2018,10,9,9,1941,2602,1927,-675
2018,10,9,10,1865,2550,1884,-666
2018,10,9,11,1889,2561,1844,-717
2018,10,9,12,1886,2751,1925,-826
2018,10,9,13,2117,2991,2150,-841
2018,10,9,14,2049,3339,2145,-1194
2018,10,9,15,2193,3548,2197,-1351
2018,10,9,16,2171,3544,2267,-1277
2018,10,9,17,2130,3532,2338,-1194
2018,10,9,18,2104,3533,2311,-1222
2018,10,9,19,2087,3465,2264,-1201
2018,10,9,20,2071,3440,2143,-1297
2018,10,9,21,2057,3403,2115,-1288
2018,10,9,22,2035,3368,2087,-1281
2018,10,9,23,2037,3348,2083,-1265
2018,10,10,0,2067,3359,2055,-1304
2018,10,10,1,2097,3455,2138,-1317
2018,10,10,2,2215,3603,2265,-1338
2018,10,10,3,2302,3705,2305,-1400
2018,10,10,4,2221,3608,2293,-1315
2018,10,10,5,2025,3423,2231,-1192
2018,10,10,6,2322,3195,2209,-986
2018,10,10,7,2072,2895,1845,-1050
2018,10,10,8,1547,2728,1502,-1226
2018,10,10,9,1332,2636,1474,-1162
2018,10,10,10,1396,2616,1304,-1312
2018,10,10,11,1354,2632,1298,-1334
2018,10,10,12,1427,2760,1335,-1425
2018,10,10,13,1444,3021,1392,-1629
2018,10,10,14,1371,3421,1226,-2195
2018,10,10,15,1478,3628,1223,-2405
2018,10,10,16,1418,3618,1256,-2362
2018,10,10,17,1839,3592,1369,-2223
2018,10,10,18,1781,3561,1280,-2281
2018,10,10,19,1778,3501,1287,-2214
2018,10,10,20,1972,3449,1262,-2187
2018,10,10,21,1941,3397,1308,-2089
2018,10,10,22,1921,3367,1399,-1968
2018,10,10,23,1916,3360,1449,-1911
2018,10,11,0,1954,3397,1466,-1931
2018,10,11,1,2032,3403,1409,-1994
2018,10,11,2,2144,3594,1475,-2119
2018,10,11,3,2212,3684,1513,-2171
2018,10,11,4,2139,3601,1529,-2072
2018,10,11,5,1975,3421,1525,-1896
2018,10,11,6,2304,3164,1512,-1652
2018,10,11,7,2071,2919,1402,-1517
2018,10,11,8,952,2664,1002,-1662
2018,10,11,9,831,2549,947,-1602
2018,10,11,10,935,2503,913,-1590
2018,10,11,11,986,2565,888,-1677
2018,10,11,12,990,2733,857,-1876
2018,10,11,13,1071,3032,944,-2088
2018,10,11,14,1003,3513,999,-2514
2018,10,11,15,1038,3746,1139,-2607
2018,10,11,16,1289,3747,1129,-2618
2018,10,11,17,1118,3687,1102,-2585
2018,10,11,18,1046,3616,1064,-2552
2018,10,11,19,1114,3507,914,-2593
2018,10,11,20,968,3495,960,-2535
2018,10,11,21,1001,3443,1117,-2326
2018,10,11,22,965,3416,1184,-2232
2018,10,11,23,961,3439,1244,-2195
2018,10,12,0,847,3435,1209,-2226
2018,10,12,1,960,3529,1241,-2288
2018,10,12,2,1081,3675,1257,-2418
2018,10,12,3,1102,3758,1328,-2430
2018,10,12,4,1028,3677,1353,-2324
2018,10,12,5,1008,3509,1411,-2098
2018,10,12,6,1117,3284,1433,-1851
2018,10,12,7,1042,3053,1269,-1784
2018,10,12,8,1058,2869,1285,-1584
2018,10,12,9,1017,2780,1187,-1593
2018,10,12,10,1091,2720,1173,-1547
2018,10,12,11,1070,2748,1157,-1591
2018,10,12,12,1157,2853,1158,-1695
2018,10,12,13,1127,3134,1286,-1848
2018,10,12,14,1101,3496,1354,-2142
2018,10,12,15,1221,3731,1403,-2328
2018,10,12,16,1195,3793,1453,-2340
2018,10,12,17,1430,3716,1341,-2375
2018,10,12,18,1430,3657,1372,-2285
2018,10,12,19,1280,3550,1393,-2157
2018,10,12,20,1081,3521,1510,-2011
2018,10,12,21,1087,3502,1595,-1907
2018,10,12,22,1091,3424,1575,-1849
2018,10,12,23,1098,3423,1628,-1795
2018,10,13,0,1087,3451,1647,-1804
2018,10,13,1,1169,3495,1685,-1810
2018,10,13,2,1264,3575,1670,-1905
2018,10,13,3,1288,3597,1625,-1972
2018,10,13,4,1233,3537,1655,-1882
2018,10,13,5,1143,3366,1444,-1922
2018,10,13,6,1222,3189,1339,-1850
2018,10,13,7,1018,2971,1142,-1829
2018,10,13,8,979,2789,1078,-1711
2018,10,13,9,978,2704,1048,-1656
2018,10,13,10,945,2673,928,-1745
2018,10,13,11,950,2658,917,-1741
2018,10,13,12,932,2704,914,-1790
2018,10,13,13,1026,2851,982,-1869
2018,10,13,14,995,3055,1179,-1876
2018,10,13,15,1091,3339,1290,-2049
2018,10,13,16,1230,3494,1389,-2105
2018,10,13,17,1401,3549,1394,-2155
2018,10,13,18,1300,3562,1350,-2212
2018,10,13,19,1230,3456,1336,-2120
2018,10,13,20,1149,3309,1280,-2029
2018,10,13,21,1260,3211,1213,-1998
2018,10,13,22,1209,3168,1165,-2003
2018,10,13,23,1183,3137,1221,-1916
2018,10,14,0,1223,3168,1206,-1962
2018,10,14,1,1286,3209,1302,-1907
2018,10,14,2,1234,3309,1438,-1871
2018,10,14,3,1281,3383,1454,-1929
2018,10,14,4,1231,3310,1504,-1806
2018,10,14,5,1176,3197,1477,-1720
2018,10,14,6,1185,3003,1442,-1561
2018,10,14,7,1189,2766,1323,-1443
2018,10,14,8,1387,2634,1372,-1262
2018,10,14,9,1369,2570,1323,-1247
2018,10,14,10,1228,2543,1381,-1162
2018,10,14,11,1275,2556,1412,-1144
2018,10,14,12,1533,2613,1514,-1099
2018,10,14,13,1429,2742,1513,-1229
2018,10,14,14,1380,2949,1500,-1449
2018,10,14,15,1678,3252,1717,-1535
2018,10,14,16,1789,3444,1651,-1793
2018,10,14,17,1607,3527,1712,-1815
2018,10,14,18,1701,3420,1672,-1748
2018,10,14,19,1453,3317,1684,-1633
2018,10,14,20,1387,3254,1603,-1651
2018,10,14,21,1335,3117,1468,-1649
2018,10,14,22,1456,3069,1458,-1611
2018,10,14,23,1281,3048,1613,-1435
2018,10,15,0,1328,3151,1640,-1511
2018,10,15,1,1448,3266,1771,-1495
2018,10,15,2,1603,3416,1770,-1646
2018,10,15,3,1652,3466,1716,-1750
2018,10,15,4,1817,3383,1847,-1536
2018,10,15,5,1634,3194,1741,-1453
2018,10,15,6,1557,2980,1609,-1371
2018,10,15,7,1376,2753,1473,-1280
2018,10,15,8,1484,2633,1397,-1236
2018,10,15,9,1483,2594,1418,-1176
2018,10,15,10,1480,2595,1403,-1192
2018,10,15,11,1510,2651,1414,-1237
2018,10,15,12,1635,2822,1512,-1310
2018,10,15,13,1840,3144,1502,-1642
2018,10,15,14,1814,3631,1825,-1806
2018,10,15,15,1836,3896,1895,-2001
2018,10,15,16,1905,3877,1781,-2096
2018,10,15,17,1738,3623,1449,-2174
2018,10,15,18,1813,3520,1525,-1995
2018,10,15,19,1741,3505,1770,-1735
2018,10,15,20,1776,3431,1760,-1671
2018,10,15,21,1694,3372,1710,-1662
2018,10,15,22,1658,3331,1730,-1601
2018,10,15,23,1660,3313,1642,-1671
2018,10,16,0,1719,3343,1619,-1724
2018,10,16,1,1807,3442,1716,-1726
2018,10,16,2,1942,3612,1754,-1858
2018,10,16,3,1967,3667,1804,-1863
2018,10,16,4,1890,3573,1791,-1782
2018,10,16,5,1697,3303,1683,-1620
2018,10,16,6,1802,3045,1670,-1375
2018,10,16,7,1572,2776,1489,-1287
2018,10,16,8,1287,2626,1357,-1269
2018,10,16,9,1208,2570,1434,-1136
2018,10,16,10,1324,2549,1412,-1137
2018,10,16,11,1321,2625,1530,-1095
2018,10,16,12,1462,2755,1442,-1313
2018,10,16,13,1434,3095,1545,-1550
2018,10,16,14,1436,3529,1608,-1921
2018,10,16,15,1773,3776,1637,-2139
2018,10,16,16,1670,3672,1525,-2147
2018,10,16,17,1676,3579,1606,-1973
2018,10,16,18,1438,3489,1653,-1836
2018,10,16,19,1367,3414,1579,-1835
2018,10,16,20,1449,3345,1566,-1779
2018,10,16,21,1440,3334,1616,-1718
2018,10,16,22,1362,3262,1521,-1741
2018,10,16,23,1361,3296,1546,-1750
2018,10,17,0,1394,3350,1601,-1749
2018,10,17,1,1459,3498,1704,-1794
2018,10,17,2,1567,3557,1783,-1774
2018,10,17,3,1598,3691,1934,-1757
2018,10,17,4,1496,3574,1830,-1744
2018,10,17,5,1320,3380,1598,-1782
2018,10,17,6,1466,3133,1723,-1410
2018,10,17,7,1340,2919,1666,-1253
2018,10,17,8,1601,2765,1719,-1046
2018,10,17,9,1544,2695,1686,-1009
2018,10,17,10,1614,2693,1707,-986
2018,10,17,11,1578,2671,1652,-1019
2018,10,17,12,1681,2872,1694,-1178
2018,10,17,13,1950,3210,2011,-1199
2018,10,17,14,1842,3618,2023,-1595
2018,10,17,15,2071,3861,1979,-1882
2018,10,17,16,1925,3852,2093,-1759
2018,10,17,17,2004,3728,2119,-1609
2018,10,17,18,1755,3629,1998,-1631
2018,10,17,19,1670,3514,1887,-1627
2018,10,17,20,1629,3470,1750,-1720
2018,10,17,21,1761,3410,1721,-1689
2018,10,17,22,1758,3396,1723,-1673
2018,10,17,23,1781,3385,1666,-1719
2018,10,18,0,1821,3462,1747,-1715
2018,10,18,1,1734,3529,1826,-1703
2018,10,18,2,1846,3707,2000,-1707
2018,10,18,3,2018,3717,1969,-1748
2018,10,18,4,1774,3602,1957,-1645
2018,10,18,5,1624,3388,1799,-1589
2018,10,18,6,1988,3141,1882,-1259
2018,10,18,7,1818,2917,1677,-1240
2018,10,18,8,1573,2742,1591,-1151
2018,10,18,9,1614,2678,1614,-1064
2018,10,18,10,1457,2659,1635,-1024
2018,10,18,11,1490,2699,1628,-1071
2018,10,18,12,1703,2875,1755,-1120
2018,10,18,13,1620,3203,1830,-1373
2018,10,18,14,1686,3673,1971,-1702
2018,10,18,15,1915,3853,1942,-1911
2018,10,18,16,1892,3807,1725,-2082
2018,10,18,17,1804,3763,1930,-1833
2018,10,18,18,1713,3660,1931,-1729
2018,10,18,19,1619,3586,1773,-1813
2018,10,18,20,1570,3478,1615,-1863
2018,10,18,21,1548,3461,1720,-1741
2018,10,18,22,1539,3366,1690,-1676
2018,10,18,23,1556,3363,1674,-1689
2018,10,19,0,1589,3393,1824,-1569
2018,10,19,1,1607,3457,1898,-1559
2018,10,19,2,1709,3630,2098,-1532
2018,10,19,3,1728,3732,2073,-1659
2018,10,19,4,1628,3659,2058,-1601
2018,10,19,5,1481,3440,1959,-1481
2018,10,19,6,1851,3230,1968,-1262
2018,10,19,7,1624,2983,1843,-1140
2018,10,19,8,1582,2832,1522,-1310
2018,10,19,9,1446,2719,1397,-1322
2018,10,19,10,1462,2695,1362,-1333
2018,10,19,11,1494,2725,1352,-1373
2018,10,19,12,1535,2866,1359,-1507
2018,10,19,13,1921,3153,1531,-1622
2018,10,19,14,1691,3570,1644,-1926
2018,10,19,15,2093,3830,1745,-2085
2018,10,19,16,2091,3852,1724,-2128
2018,10,19,17,2024,3836,1825,-2011
2018,10,19,18,1777,3754,1767,-1987
2018,10,19,19,1848,3676,1766,-1910
2018,10,19,20,1786,3608,1761,-1847
2018,10,19,21,1735,3561,1925,-1636
2018,10,19,22,1697,3479,1745,-1734
2018,10,19,23,1703,3439,1601,-1838
2018,10,20,0,1721,3465,1679,-1786
2018,10,20,1,1710,3539,1739,-1800
2018,10,20,2,1876,3687,1909,-1778
2018,10,20,3,1839,3610,1749,-1861
2018,10,20,4,1777,3534,1695,-1839
2018,10,20,5,1669,3353,1565,-1788
2018,10,20,6,1969,3167,1655,-1512
2018,10,20,7,1785,2986,1520,-1466
2018,10,20,8,1573,2852,1456,-1396
2018,10,20,9,1581,2764,1369,-1395
2018,10,20,10,1523,2712,1337,-1375
2018,10,20,11,1407,2603,1218,-1385
2018,10,20,12,1411,2636,1209,-1427
2018,10,20,13,1386,2756,1323,-1433
2018,10,20,14,1303,2953,1235,-1718
2018,10,20,15,1618,3182,1420,-1762
2018,10,20,16,1683,3442,1700,-1742
2018,10,20,17,1769,3576,1859,-1717
2018,10,20,18,1759,3538,1763,-1775
2018,10,20,19,1605,3484,1682,-1802
2018,10,20,20,1537,3369,1411,-1958
2018,10,20,21,1424,3273,1391,-1882
2018,10,20,22,1363,3175,1323,-1852
2018,10,20,23,1345,3139,1373,-1766
2018,10,21,0,1542,3159,1378,-1781
2018,10,21,1,1460,3338,1554,-1784
2018,10,21,2,1593,3526,1688,-1838
2018,10,21,3,1629,3563,1604,-1959
2018,10,21,4,1553,3545,1656,-1889
2018,10,21,5,1492,3473,1779,-1694
2018,10,21,6,1750,3302,1817,-1485
2018,10,21,7,1669,3056,1492,-1564
2018,10,21,8,1298,2928,1310,-1618
2018,10,21,9,1101,2857,1276,-1581
2018,10,21,10,1312,2818,1285,-1533
2018,10,21,11,1159,2730,1176,-1554
2018,10,21,12,1269,2803,1278,-1525
2018,10,21,13,1212,2956,1423,-1533
2018,10,21,14,1015,3128,1430,-1698
2018,10,21,15,1214,3338,1567,-1771
2018,10,21,16,1298,3510,1544,-1966
2018,10,21,17,1429,3613,1604,-2009
2018,10,21,18,1486,3587,1578,-2009
2018,10,21,19,1323,3550,1545,-2005
2018,10,21,20,1250,3525,1600,-1925
2018,10,21,21,1169,3446,1468,-1978
2018,10,21,22,1076,3367,1460,-1907
2018,10,21,23,1069,3279,1286,-1993
2018,10,22,0,1262,3345,1368,-1977
2018,10,22,1,1241,3533,1596,-1937
2018,10,22,2,1413,3781,1659,-2122
2018,10,22,3,1570,3828,1687,-2141
2018,10,22,4,1388,3752,1679,-2073
2018,10,22,5,1213,3540,1487,-2053
2018,10,22,6,1445,3293,1499,-1794
2018,10,22,7,1231,3084,1445,-1639
2018,10,22,8,1194,2941,1341,-1600
2018,10,22,9,1071,2791,1161,-1630
2018,10,22,10,1209,2785,1137,-1648
2018,10,22,11,1243,2853,1199,-1654
2018,10,22,12,1264,3044,1453,-1591
2018,10,22,13,1335,3368,1620,-1748
2018,10,22,14,1431,3806,1724,-2082
2018,10,22,15,1477,4063,1744,-2319
2018,10,22,16,1462,4026,1750,-2276
2018,10,22,17,1485,3969,1762,-2207
2018,10,22,18,1476,3887,1641,-2246
2018,10,22,19,1388,3792,1496,-2296
2018,10,22,20,1314,3751,1544,-2207
2018,10,22,21,1227,3629,1461,-2168
2018,10,22,22,1184,3502,1264,-2238
2018,10,22,23,1173,3506,1295,-2211
2018,10,23,0,1221,3586,1376,-2210
2018,10,23,1,1354,3743,1494,-2249
2018,10,23,2,1490,3973,1662,-2311
2018,10,23,3,1534,3985,1547,-2438
2018,10,23,4,1445,3875,1617,-2258
2018,10,23,5,1325,3694,1691,-2003
2018,10,23,6,1537,3415,1702,-1713
2018,10,23,7,1385,3109,1356,-1753
2018,10,23,8,1194,2933,1227,-1706
2018,10,23,9,1115,2859,1180,-1679
2018,10,23,10,1234,2811,1151,-1660
2018,10,23,11,1274,3092,1400,-1692
2018,10,23,12,1308,3029,1367,-1662
2018,10,23,13,1312,3346,1568,-1778
2018,10,23,14,1389,3735,1616,-2119
2018,10,23,15,1622,3927,1661,-2266
2018,10,23,16,1631,3908,1622,-2286
2018,10,23,17,1546,3848,1634,-2214
2018,10,23,18,1474,3810,1597,-2213
2018,10,23,19,1392,3737,1528,-2209
2018,10,23,20,1311,3645,1308,-2337
2018,10,23,21,1236,3620,1349,-2271
2018,10,23,22,1176,3613,1286,-2327
2018,10,23,23,1152,3585,1258,-2327
2018,10,24,0,1185,3609,1234,-2375
2018,10,24,1,1298,3800,1507,-2293
2018,10,24,2,1426,3945,1691,-2254
2018,10,24,3,1450,3910,1590,-2320
2018,10,24,4,1407,3795,1671,-2124
2018,10,24,5,1198,3556,1439,-2117
2018,10,24,6,1467,3261,1492,-1769
2018,10,24,7,1188,3007,1287,-1720
2018,10,24,8,1224,2865,1430,-1435
2018,10,24,9,1213,2778,1447,-1331
2018,10,24,10,1138,2725,1439,-1286
2018,10,24,11,1199,2720,1473,-1247
2018,10,24,12,1306,2830,1579,-1251
2018,10,24,13,1445,3088,1815,-1273
2018,10,24,14,1400,3494,1783,-1711
2018,10,24,15,1301,3741,1688,-2053
2018,10,24,16,1353,3694,1571,-2123
2018,10,24,17,1324,3638,1499,-2139
2018,10,24,18,1278,3592,1384,-2208
2018,10,24,19,1207,3526,1325,-2201
2018,10,24,20,1144,3450,1252,-2198
2018,10,24,21,1092,3382,1149,-2233
2018,10,24,22,1054,3313,1140,-2173
2018,10,24,23,1058,3306,1141,-2165
2018,10,25,0,1112,3374,1168,-2206
2018,10,25,1,1228,3589,1428,-2161
2018,10,25,2,1367,3815,1562,-2253
2018,10,25,3,1372,3769,1484,-2285
2018,10,25,4,1261,3705,1549,-2156
2018,10,25,5,1123,3512,1461,-2051
2018,10,25,6,1543,3241,1472,-1769
2018,10,25,7,1293,3035,1557,-1478
2018,10,25,8,923,2862,1207,-1655
2018,10,25,9,955,2770,1176,-1594
2018,10,25,10,886,2681,1107,-1574
2018,10,25,11,881,2640,1094,-1546
2018,10,25,12,931,2705,1026,-1679
2018,10,25,13,893,2998,1029,-1969
2018,10,25,14,893,3339,1001,-2338
2018,10,25,15,998,3588,1125,-2463
2018,10,25,16,1015,3544,1091,-2453
2018,10,25,17,1002,3546,1129,-2417
2018,10,25,18,992,3604,1235,-2369
2018,10,25,19,972,3528,1244,-2284
2018,10,25,20,960,3486,1199,-2287
2018,10,25,21,891,3464,1070,-2394
2018,10,25,22,867,3445,1056,-2389
2018,10,25,23,866,3454,1001,-2453
2018,10,26,0,900,3541,1012,-2529
2018,10,26,1,1003,3772,1229,-2543
2018,10,26,2,1128,3942,1431,-2511
2018,10,26,3,1127,3851,1391,-2460
2018,10,26,4,1028,3721,1386,-2335
2018,10,26,5,958,3514,1392,-2122
2018,10,26,6,1184,3290,1468,-1822
2018,10,26,7,952,3054,1416,-1638
2018,10,26,8,1147,2900,1339,-1561
2018,10,26,9,1122,2807,1308,-1499
2018,10,26,10,1147,2759,1292,-1467
2018,10,26,11,934,2721,1095,-1626
2018,10,26,12,1062,2806,1082,-1724
2018,10,26,13,1168,3034,1087,-1947
2018,10,26,14,1251,3344,1116,-2228
2018,10,26,15,1357,3608,1324,-2284
2018,10,26,16,1294,3628,1233,-2395
2018,10,26,17,1203,3609,1341,-2268
2018,10,26,18,1148,3603,1229,-2374
2018,10,26,19,1098,3638,1321,-2317
2018,10,26,20,1065,3484,1274,-2210
2018,10,26,21,1049,3442,1307,-2135
2018,10,26,22,1024,3402,1463,-1939
2018,10,26,23,1155,3361,1483,-1878
2018,10,27,0,1077,3479,1590,-1889
2018,10,27,1,1334,3614,1678,-1936
2018,10,27,2,1281,3695,1681,-2014
2018,10,27,3,1386,3607,1646,-1961
2018,10,27,4,1224,3539,1649,-1890
2018,10,27,5,1147,3391,1553,-1838
2018,10,27,6,1152,3222,1568,-1654
2018,10,27,7,1074,3038,1548,-1490
2018,10,27,8,1199,2813,1384,-1429
2018,10,27,9,1172,2755,1363,-1392
2018,10,27,10,1225,2709,1182,-1527
2018,10,27,11,963,2764,1080,-1684
2018,10,27,12,944,2845,1127,-1718
2018,10,27,13,884,2976,1230,-1746
2018,10,27,14,866,3115,1078,-2037
2018,10,27,15,926,3451,1283,-2168
2018,10,27,16,1103,3602,1434,-2168
2018,10,27,17,1233,3677,1399,-2278
2018,10,27,18,1251,3678,1409,-2269
2018,10,27,19,1226,3615,1274,-2341
2018,10,27,20,1148,3423,1146,-2277
2018,10,27,21,1078,3372,1060,-2312
2018,10,27,22,998,3376,1062,-2314
2018,10,27,23,912,3408,1111,-2297
2018,10,28,0,987,3491,1153,-2338
2018,10,28,1,1167,3650,1293,-2357
2018,10,28,2,1258,3632,1246,-2386
2018,10,28,3,1237,3605,1326,-2279
2018,10,28,4,1131,3503,1292,-2211
2018,10,28,5,980,3355,1285,-2070
2018,10,28,6,1341,3177,1339,-1838
2018,10,28,7,1217,2982,1304,-1678
2018,10,28,8,1063,2804,1063,-1741
2018,10,28,9,1025,2707,1067,-1640
2018,10,28,10,976,2642,1080,-1562
2018,10,28,11,996,2632,1098,-1534
2018,10,28,12,1181,2646,1068,-1578
2018,10,28,13,1205,2718,1034,-1684
2018,10,28,14,988,2841,1042,-1799
2018,10,28,15,1083,3031,1026,-2005
2018,10,28,16,1129,3213,1093,-2120
2018,10,28,17,939,3358,1176,-2182
2018,10,28,18,938,3408,1113,-2295
2018,10,28,19,1080,3483,1213,-2270
2018,10,28,20,1081,3466,1231,-2235
2018,10,28,21,1053,3465,1231,-2234
2018,10,28,22,935,3426,1274,-2152
2018,10,28,23,952,3487,1340,-2147
2018,10,29,0,943,3513,1259,-2254
2018,10,29,1,1087,3680,1238,-2442
2018,10,29,2,1287,3852,1409,-2443
2018,10,29,3,1278,3770,1425,-2345
2018,10,29,4,1162,3637,1317,-2320
2018,10,29,5,1017,3442,1297,-2145
2018,10,29,6,1015,3174,1282,-1892
2018,10,29,7,911,2948,1161,-1787
2018,10,29,8,954,2820,1109,-1711
2018,10,29,9,927,2749,1128,-1621
2018,10,29,10,974,2734,1207,-1527
2018,10,29,11,1024,2783,1157,-1626
2018,10,29,12,1139,2891,1176,-1715
2018,10,29,13,1206,3203,1342,-1861
2018,10,29,14,1256,3635,1487,-2148
2018,10,29,15,1279,3963,1678,-2285
2018,10,29,16,1418,3947,1668,-2279
2018,10,29,17,1348,3857,1702,-2155
2018,10,29,18,1294,3761,1748,-2013
2018,10,29,19,1140,3741,1744,-1997
2018,10,29,20,1145,3651,1504,-2147
2018,10,29,21,1155,3610,1373,-2237
2018,10,29,22,1153,3561,1342,-2219
2018,10,29,23,1160,3582,1363,-2219
2018,10,30,0,1168,3631,1317,-2314
2018,10,30,1,1324,3874,1505,-2369
2018,10,30,2,1473,3970,1589,-2381
2018,10,30,3,1446,3972,1652,-2320
2018,10,30,4,1308,3883,1739,-2144
2018,10,30,5,1091,3661,1580,-2081
2018,10,30,6,1109,3376,1549,-1827
2018,10,30,7,1081,3151,1609,-1542
2018,10,30,8,1356,3005,1644,-1361
2018,10,30,9,1328,2924,1625,-1299
2018,10,30,10,1282,2907,1621,-1286
2018,10,30,11,1253,2926,1594,-1332
2018,10,30,12,1250,3045,1575,-1470
2018,10,30,13,1250,3317,1555,-1762
2018,10,30,14,1122,3710,1589,-2121
2018,10,30,15,1370,3963,1664,-2299
2018,10,30,16,1363,3933,1678,-2255
2018,10,30,17,1311,3892,1667,-2225
2018,10,30,18,1276,3821,1512,-2309
2018,10,30,19,1233,3671,1366,-2305
2018,10,30,20,1205,3611,1446,-2165
2018,10,30,21,1170,3536,1408,-2128
2018,10,30,22,1160,3508,1403,-2105
2018,10,30,23,1187,3505,1336,-2169
2018,10,31,0,1247,3598,1267,-2331
2018,10,31,1,1400,3814,1476,-2338
2018,10,31,2,1439,3954,1498,-2456
2018,10,31,3,1444,3909,1462,-2447
2018,10,31,4,1446,3854,1574,-2280
2018,10,31,5,1341,3626,1581,-2045
2018,10,31,6,1411,3347,1552,-1795
2018,10,31,7,1354,3080,1549,-1531
2018,10,31,8,1291,2870,1369,-1501
2018,10,31,9,1237,2787,1248,-1539
2018,10,31,10,1168,2700,1188,-1512
2018,10,31,11,1184,2714,1153,-1561
2018,10,31,12,1157,2875,1195,-1680
2018,10,31,13,1230,3162,1298,-1864
2018,10,31,14,1274,3550,1472,-2078
2018,10,31,15,1449,3764,1502,-2262
2018,10,31,16,1450,3706,1453,-2253
2018,10,31,17,1457,3538,1322,-2216
2018,10,31,18,1331,3473,1239,-2234
2018,10,31,19,1285,3483,1236,-2247
2018,10,31,20,1293,3455,1295,-2160
2018,10,31,21,1303,3481,1299,-2182
2018,10,31,22,1313,3542,1492,-2050
2018,10,31,23,1199,3642,1652,-1990
2018,11,1,0,1210,3724,1708,-2016
2018,11,1,1,1302,3818,1688,-2130
2018,11,1,2,1401,3811,1632,-2179
2018,11,1,3,1377,3692,1633,-2059
2018,11,1,4,1251,3648,1617,-2031
2018,11,1,5,1230,3502,1660,-1842
2018,11,1,6,1233,3271,1696,-1575
2018,11,1,7,1234,3030,1673,-1357
2018,11,1,8,1462,2843,1670,-1173
2018,11,1,9,1454,2766,1668,-1098
2018,11,1,10,1384,2657,1548,-1109
2018,11,1,11,1309,2649,1493,-1156
2018,11,1,12,1264,2756,1495,-1261
2018,11,1,13,1353,3058,1627,-1431
2018,11,1,14,1232,3383,1505,-1878
2018,11,1,15,1428,3640,1483,-2157
2018,11,1,16,1423,3649,1465,-2184
2018,11,1,17,1400,3652,1484,-2168
2018,11,1,18,1384,3662,1564,-2098
2018,11,1,19,1359,3669,1633,-2036
2018,11,1,20,1332,3670,1709,-1961
2018,11,1,21,1305,3605,1701,-1904
2018,11,1,22,1280,3554,1625,-1929
2018,11,1,23,1294,3538,1548,-1990
2018,11,2,0,1356,3594,1556,-2038
2018,11,2,1,1479,3689,1629,-2060
2018,11,2,2,1578,3812,1773,-2039
2018,11,2,3,1516,3782,1689,-2093
2018,11,2,4,1381,3648,1639,-2009
2018,11,2,5,1263,3432,1613,-1819
2018,11,2,6,1608,3150,1647,-1503
2018,11,2,7,1362,2923,1660,-1263
2018,11,2,8,1513,2712,1705,-1007
2018,11,2,9,1429,2633,1747,-886
2018,11,2,10,1443,2640,1779,-861
2018,11,2,11,1436,2640,1521,-1119
2018,11,2,12,1479,2722,1513,-1209
2018,11,2,13,1304,2947,1553,-1394
2018,11,2,14,1314,3272,1550,-1722
2018,11,2,15,1605,3500,1529,-1971
2018,11,2,16,1456,3626,1731,-1895
2018,11,2,17,1593,3606,1695,-1911
2018,11,2,18,1424,3587,1722,-1865
2018,11,2,19,1498,3581,1759,-1822
2018,11,2,20,1547,3572,1777,-1795
2018,11,2,21,1529,3504,1744,-1760
2018,11,2,22,1374,3505,1823,-1682
2018,11,2,23,1517,3486,1827,-1659
2018,11,3,0,1471,3502,1770,-1732
2018,11,3,1,1522,3628,1830,-1798
2018,11,3,2,1624,3730,1791,-1939
2018,11,3,3,1577,3646,1784,-1862
2018,11,3,4,1458,3540,1757,-1783
2018,11,3,5,1332,3393,1805,-1588
2018,11,3,6,1747,3211,1827,-1384
2018,11,3,7,1578,3017,1825,-1192
2018,11,3,8,1515,2859,1862,-997
2018,11,3,9,1327,2779,1550,-1229
2018,11,3,10,1307,2708,1557,-1151
2018,11,3,11,1316,2613,1485,-1128
2018,11,3,12,1310,2654,1519,-1135
2018,11,3,13,1409,2771,1590,-1181
2018,11,3,14,1307,2918,1482,-1436
2018,11,3,15,1306,3232,1650,-1582
2018,11,3,16,1343,3409,1645,-1764
2018,11,3,17,1468,3497,1719,-1778
2018,11,3,18,1523,3585,1736,-1849
2018,11,3,19,1527,3616,1771,-1845
2018,11,3,20,1469,3579,1716,-1863
2018,11,3,21,1401,3548,1726,-1822
2018,11,3,22,1370,3555,1846,-1709
2018,11,3,23,1426,3570,1839,-1731
2018,11,4,0,1516,3596,1777,-1819
2018,11,4,1,1515,3675,1808,-1867
2018,11,4,2,1517,3706,1742,-1964
2018,11,4,3,1542,3637,1591,-2046
2018,11,4,4,1504,3525,1580,-1945
2018,11,4,5,1298,3379,1585,-1794
2018,11,4,6,1380,3220,1563,-1657
2018,11,4,7,1365,3028,1634,-1394
2018,11,4,8,1478,2861,1496,-1365
2018,11,4,9,1303,2757,1538,-1219
2018,11,4,10,1280,2712,1576,-1136
2018,11,4,11,1298,2672,1628,-1044
2018,11,4,12,1328,2690,1591,-1099
2018,11,4,13,1360,2787,1780,-1007
2018,11,4,14,1437,2913,1847,-1066
2018,11,4,15,1295,3101,1791,-1310
2018,11,4,16,1283,3297,1823,-1474
2018,11,4,17,1277,3462,1839,-1623
2018,11,4,18,1381,3579,1812,-1767
2018,11,4,19,1302,3559,1723,-1836
2018,11,4,20,1282,3533,1709,-1824
2018,11,4,21,1271,3508,1775,-1733
2018,11,4,22,1277,3424,1724,-1700
2018,11,4,23,1286,3413,1764,-1649
2018,11,5,0,1331,3424,1809,-1615
2018,11,5,1,1441,3617,1850,-1767
2018,11,5,2,1488,3841,1872,-1969
2018,11,5,3,1598,3823,1862,-1961
2018,11,5,4,1615,3696,1784,-1912
2018,11,5,5,1637,3570,1821,-1749
2018,11,5,6,1389,3341,1725,-1616
2018,11,5,7,1342,3095,1718,-1377
2018,11,5,8,1277,2900,1662,-1238
2018,11,5,9,1353,2752,1610,-1142
2018,11,5,10,1401,2697,1634,-1063
2018,11,5,11,1375,2708,1629,-1079
2018,11,5,12,1296,2758,1559,-1199
2018,11,5,13,1441,2863,1495,-1368
2018,11,5,14,1245,3251,1445,-1806
2018,11,5,15,1244,3637,1544,-2093
2018,11,5,16,1332,3777,1596,-2181
2018,11,5,17,1296,3723,1469,-2254
2018,11,5,18,1270,3741,1583,-2158
2018,11,5,19,1281,3752,1681,-2071
2018,11,5,20,1291,3715,1735,-1980
2018,11,5,21,1299,3682,1781,-1901
2018,11,5,22,1304,3656,1739,-1917
2018,11,5,23,1305,3643,1711,-1932
2018,11,6,0,1304,3701,1809,-1892
2018,11,6,1,1443,3850,1810,-2040
2018,11,6,2,1661,4071,1858,-2213
2018,11,6,3,1646,4023,1812,-2211
2018,11,6,4,1542,3917,1789,-2128
2018,11,6,5,1399,3765,1675,-2090
2018,11,6,6,1288,3543,1658,-1885
2018,11,6,7,1756,3299,1734,-1565
2018,11,6,8,1555,3061,1712,-1349
2018,11,6,9,1414,2905,1637,-1268
2018,11,6,10,1365,2812,1645,-1167
2018,11,6,11,1443,2777,1607,-1170
2018,11,6,12,1411,2830,1600,-1230
2018,11,6,13,1483,3025,1637,-1388
2018,11,6,14,1512,3308,1578,-1730
2018,11,6,15,1515,3708,1554,-2154
2018,11,6,16,1548,3934,1661,-2273
2018,11,6,17,1505,3890,1747,-2143
2018,11,6,18,1285,3816,1810,-2006
2018,11,6,19,1227,3775,1782,-1993
2018,11,6,20,1346,3693,1840,-1853
2018,11,6,21,1351,3654,1855,-1799
2018,11,6,22,1452,3619,1835,-1784
2018,11,6,23,1514,3580,1932,-1648
2018,11,7,0,1310,3589,1876,-1713
2018,11,7,1,1489,3811,1912,-1899
2018,11,7,2,1614,4081,1901,-2180
2018,11,7,3,1660,4117,1937,-2180
2018,11,7,4,1585,3978,1728,-2250
2018,11,7,5,1421,3910,1605,-2305
2018,11,7,6,1191,3590,1417,-2173
2018,11,7,7,1441,3397,1495,-1902
2018,11,7,8,1393,3117,1551,-1566
2018,11,7,9,1113,2897,1246,-1651
2018,11,7,10,1116,2835,1211,-1624
2018,11,7,11,1097,2783,1196,-1587
2018,11,7,12,1226,2853,1381,-1472
2018,11,7,13,1287,3042,1455,-1587
2018,11,7,14,1350,3434,1527,-1907
2018,11,7,15,1349,3782,1463,-2319
2018,11,7,16,1255,4048,1529,-2519
2018,11,7,17,1242,4006,1520,-2486
2018,11,7,18,1203,3918,1480,-2438
2018,11,7,19,1035,3874,1488,-2386
2018,11,7,20,1035,3803,1488,-2315
2018,11,7,21,1035,3742,1478,-2264
2018,11,7,22,1035,3683,1491,-2192
2018,11,7,23,1035,3665,1524,-2141
2018,11,8,0,1035,3711,1492,-2219
2018,11,8,1,1246,3917,1575,-2342
2018,11,8,2,1450,4222,1631,-2591
2018,11,8,3,1377,4250,1589,-2661
2018,11,8,4,1362,4231,1563,-2668
2018,11,8,5,1345,4094,1472,-2622
2018,11,8,6,1201,3848,1413,-2435
2018,11,8,7,1316,3586,1430,-2156
2018,11,8,8,1266,3362,1445,-1917
2018,11,8,9,1156,3148,1189,-1959
2018,11,8,10,1125,3094,1232,-1862
2018,11,8,11,1165,3126,1305,-1821
2018,11,8,12,1259,3183,1273,-1910
2018,11,8,13,1374,3489,1450,-2039
2018,11,8,14,1419,3770,1486,-2284
2018,11,8,15,1416,4212,1494,-2718
2018,11,8,16,1357,4391,1469,-2922
2018,11,8,17,1454,4308,1356,-2952
2018,11,8,18,1260,4205,1438,-2767
2018,11,8,19,1146,4120,1480,-2640
2018,11,8,20,1046,3987,1253,-2734
2018,11,8,21,1149,3895,1404,-2491
2018,11,8,22,936,3821,1419,-2402
2018,11,8,23,936,3790,1422,-2368
2018,11,9,0,1016,3856,1366,-2490
2018,11,9,1,1220,4087,1533,-2554
2018,11,9,2,1466,4384,1548,-2836
2018,11,9,3,1483,4408,1527,-2881
2018,11,9,4,1445,4355,1539,-2816
2018,11,9,5,1337,4251,1502,-2749
2018,11,9,6,1119,4041,1499,-2542
2018,11,9,7,1379,3778,1509,-2269
2018,11,9,8,1288,3558,1527,-2031
2018,11,9,9,1275,3412,1417,-1995
2018,11,9,10,1204,3386,1441,-1945
2018,11,9,11,1215,3362,1395,-1967
2018,11,9,12,1250,3439,1426,-2013
2018,11,9,13,1328,3611,1420,-2191
2018,11,9,14,1331,3858,1307,-2551
2018,11,9,15,1203,4287,1331,-2956
2018,11,9,16,1411,4475,1407,-3068
2018,11,9,17,1432,4475,1578,-2897
2018,11,9,18,1312,4433,1636,-2797
2018,11,9,19,1298,4391,1608,-2783
2018,11,9,20,1355,4309,1491,-2818
2018,11,9,21,1289,4270,1525,-2745
2018,11,9,22,1113,4167,1518,-2649
2018,11,9,23,1121,4114,1539,-2575
2018,11,10,0,1123,4179,1579,-2600
2018,11,10,1,1196,4295,1517,-2778
2018,11,10,2,1357,4423,1423,-3000
2018,11,10,3,1315,4351,1179,-3172
2018,11,10,4,1226,4261,1204,-3057
2018,11,10,5,1115,4089,1139,-2950
2018,11,10,6,997,3917,1229,-2688
2018,11,10,7,1328,3704,1367,-2337
2018,11,10,8,1309,3341,1213,-2128
2018,11,10,9,1189,3079,1083,-1996
2018,11,10,10,1191,3016,1139,-1877
2018,11,10,11,1118,2974,1085,-1889
2018,11,10,12,1122,3044,1151,-1893
2018,11,10,13,1190,3213,1276,-1937
2018,11,10,14,1230,3289,1261,-2028
2018,11,10,15,1010,3483,1195,-2288
2018,11,10,16,1144,3816,1305,-2511
2018,11,10,17,1248,3981,1344,-2637
2018,11,10,18,1323,4057,1376,-2681
2018,11,10,19,1323,4013,1273,-2740
2018,11,10,20,1257,3895,1273,-2622
2018,11,10,21,1163,3806,1283,-2523
2018,11,10,22,1088,3715,1286,-2429
2018,11,10,23,1068,3673,1370,-2303
2018,11,11,0,1141,3708,1382,-2326
2018,11,11,1,1265,3890,1383,-2507
2018,11,11,2,1456,4132,1420,-2712
2018,11,11,3,1457,4130,1415,-2715
2018,11,11,4,1383,4083,1449,-2634
2018,11,11,5,1275,3938,1332,-2606
2018,11,11,6,1139,3713,1260,-2453
2018,11,11,7,1190,3539,1279,-2260
2018,11,11,8,1205,3356,1265,-2091
2018,11,11,9,1013,3109,1042,-2067
2018,11,11,10,1027,2999,961,-2038
2018,11,11,11,990,2995,1020,-1975
2018,11,11,12,1041,3162,1157,-2005
2018,11,11,13,1186,3338,1224,-2114
2018,11,11,14,1181,3507,1242,-2265
2018,11,11,15,936,3723,1319,-2404
2018,11,11,16,1304,3958,1424,-2534
2018,11,11,17,1337,4120,1407,-2713
2018,11,11,18,1342,4158,1423,-2735
2018,11,11,19,1331,4068,1408,-2660
2018,11,11,20,1189,3963,1432,-2531
2018,11,11,21,1125,3881,1425,-2456
2018,11,11,22,1052,3809,1361,-2448
2018,11,11,23,980,3784,1367,-2417
2018,11,12,0,1041,3853,1404,-2449
2018,11,12,1,1343,4012,1504,-2508
2018,11,12,2,1499,4286,1512,-2774
2018,11,12,3,1521,4256,1484,-2772
2018,11,12,4,1446,4070,1397,-2673
2018,11,12,5,1316,3933,1342,-2591
2018,11,12,6,1128,3749,1283,-2466
2018,11,12,7,1165,3521,1299,-2222
2018,11,12,8,1097,3368,1362,-2006
2018,11,12,9,1290,3241,1270,-1971
2018,11,12,10,1309,3209,1281,-1928
2018,11,12,11,1264,3225,1336,-1889
2018,11,12,12,1295,3287,1400,-1887
2018,11,12,13,1289,3445,1297,-2148
2018,11,12,14,1087,3737,1272,-2465
2018,11,12,15,1279,4036,1235,-2801
2018,11,12,16,1340,4220,1267,-2953
2018,11,12,17,1454,4248,1150,-3098
2018,11,12,18,1482,4204,1252,-2952
2018,11,12,19,1352,4081,1244,-2837
2018,11,12,20,1222,3959,1268,-2691
2018,11,12,21,1133,3844,1270,-2574
2018,11,12,22,1040,3738,1266,-2472
2018,11,12,23,1176,3694,1199,-2495
2018,11,13,0,1057,3709,1246,-2463
2018,11,13,1,1308,3973,1331,-2642
2018,11,13,2,1605,4251,1353,-2898
2018,11,13,3,1605,4249,1339,-2910
2018,11,13,4,1565,4148,1288,-2860
2018,11,13,5,1407,4031,1287,-2744
2018,11,13,6,1205,3785,1229,-2556
2018,11,13,7,1477,3501,1238,-2263
2018,11,13,8,1344,3228,1172,-2056
2018,11,13,9,1061,3081,1030,-2051
2018,11,13,10,1076,3026,1065,-1961
2018,11,13,11,1015,3025,1044,-1981
2018,11,13,12,1056,3100,1061,-2039
2018,11,13,13,1133,3268,1162,-2106
2018,11,13,14,1136,3618,1194,-2424
2018,11,13,15,1462,4037,1151,-2886
2018,11,13,16,1355,4279,1198,-3081
2018,11,13,17,1089,4243,1128,-3115
2018,11,13,18,1093,4078,1113,-2965
2018,11,13,19,983,3968,1118,-2850
2018,11,13,20,1105,3896,1181,-2715
2018,11,13,21,1055,3847,1144,-2703
2018,11,13,22,1003,3755,1218,-2537
2018,11,13,23,933,3815,1315,-2500
2018,11,14,0,1015,3728,1261,-2467
2018,11,14,1,1229,3990,1290,-2700
2018,11,14,2,1393,4206,1260,-2946
2018,11,14,3,1406,4221,1267,-2954
2018,11,14,4,1365,4122,1297,-2825
2018,11,14,5,1213,4033,1325,-2708
2018,11,14,6,980,3782,1258,-2524
2018,11,14,7,1075,3484,1336,-2148
2018,11,14,8,925,3150,1160,-1990
2018,11,14,9,1014,2978,1097,-1881
2018,11,14,10,995,2898,1074,-1824
2018,11,14,11,940,2914,1147,-1767
2018,11,14,12,944,2957,1145,-1812
2018,11,14,13,1096,3126,1291,-1835
2018,11,14,14,1097,3433,1311,-2122
2018,11,14,15,1193,3780,1341,-2439
2018,11,14,16,1196,3983,1363,-2620
2018,11,14,17,1172,3943,1222,-2721
2018,11,14,18,1092,3883,1222,-2661
2018,11,14,19,1109,3846,1193,-2653
2018,11,14,20,1180,3749,1195,-2554
2018,11,14,21,1096,3713,1249,-2464
2018,11,14,22,1096,3662,1350,-2312
2018,11,14,23,926,3638,1374,-2264
2018,11,15,0,937,3652,1384,-2268
2018,11,15,1,1121,3852,1394,-2458
2018,11,15,2,1339,4031,1342,-2689
2018,11,15,3,1327,4041,1327,-2714
2018,11,15,4,1223,3955,1289,-2666
2018,11,15,5,1194,3833,1352,-2481
2018,11,15,6,1076,3657,1377,-2280
2018,11,15,7,1118,3456,1555,-1901
2018,11,15,8,1026,3230,1633,-1597
2018,11,15,9,1188,3083,1616,-1467
2018,11,15,10,1230,3006,1561,-1445
2018,11,15,11,1308,2978,1542,-1436
2018,11,15,12,1268,3012,1519,-1493
2018,11,15,13,1084,3097,1432,-1665
2018,11,15,14,1137,3422,1523,-1899
2018,11,15,15,1093,3791,1470,-2321
2018,11,15,16,1253,3934,1431,-2503
2018,11,15,17,1246,3918,1455,-2463
2018,11,15,18,1206,3850,1375,-2475
2018,11,15,19,1175,3791,1346,-2445
2018,11,15,20,1135,3725,1408,-2317
2018,11,15,21,1117,3660,1344,-2316
2018,11,15,22,1090,3642,1399,-2243
2018,11,15,23,1067,3629,1378,-2251
2018,11,16,0,1138,3702,1462,-2240
2018,11,16,1,1317,3884,1553,-2331
2018,11,16,2,1411,4091,1671,-2420
2018,11,16,3,1434,4041,1628,-2413
2018,11,16,4,1413,3961,1651,-2310
2018,11,16,5,1414,3862,1706,-2156
2018,11,16,6,1199,3629,1625,-2004
2018,11,16,7,1337,3422,1745,-1677
2018,11,16,8,1100,3154,1655,-1499
2018,11,16,9,1372,2958,1578,-1380
2018,11,16,10,1190,2867,1533,-1334
2018,11,16,11,1214,2831,1444,-1387
2018,11,16,12,1098,2845,1251,-1594
2018,11,16,13,1163,2969,1134,-1835
2018,11,16,14,1243,3268,1332,-1936
2018,11,16,15,1007,3630,1370,-2260
2018,11,16,16,1031,3845,1455,-2390
2018,11,16,17,1046,3862,1479,-2383
2018,11,16,18,1148,3819,1315,-2504
2018,11,16,19,1041,3795,1379,-2416
2018,11,16,20,1065,3733,1359,-2374
2018,11,16,21,1072,3684,1264,-2420
2018,11,16,22,1063,3655,1233,-2422
2018,11,16,23,1042,3605,1263,-2342
2018,11,17,0,1082,3659,1312,-2347
2018,11,17,1,1200,3854,1339,-2515
2018,11,17,2,1381,4055,1530,-2525
2018,11,17,3,1336,3990,1522,-2468
2018,11,17,4,1213,3913,1474,-2439
2018,11,17,5,1111,3840,1554,-2286
2018,11,17,6,1011,3710,1553,-2157
2018,11,17,7,1347,3520,1614,-1906
2018,11,17,8,1338,3329,1552,-1777
2018,11,17,9,1190,3184,1475,-1709
2018,11,17,10,1143,3106,1470,-1636
2018,11,17,11,1129,3089,1476,-1613
2018,11,17,12,1147,3113,1433,-1680
2018,11,17,13,1167,3195,1441,-1754
2018,11,17,14,1178,3326,1390,-1936
2018,11,17,15,1146,3548,1351,-2197
2018,11,17,16,1167,3828,1430,-2398
2018,11,17,17,1129,4003,1456,-2547
2018,11,17,18,1224,3993,1435,-2558
2018,11,17,19,1230,3924,1430,-2494
2018,11,17,20,1176,3823,1408,-2415
2018,11,17,21,1219,3716,1387,-2329
2018,11,17,22,1098,3587,1320,-2267
2018,11,17,23,1064,3535,1296,-2239
2018,11,18,0,1108,3585,1322,-2263
2018,11,18,1,1218,3787,1308,-2479
2018,11,18,2,1355,4018,1317,-2701
2018,11,18,3,1353,4007,1280,-2727
2018,11,18,4,1281,3980,1317,-2663
2018,11,18,5,1226,3922,1297,-2625
2018,11,18,6,1221,3813,1253,-2560
2018,11,18,7,1191,3685,1389,-2296
2018,11,18,8,1225,3501,1320,-2181
2018,11,18,9,995,3335,1156,-2179
2018,11,18,10,1074,3297,1171,-2126
2018,11,18,11,1056,3307,1190,-2117
2018,11,18,12,1081,3341,1194,-2147
2018,11,18,13,1142,3379,1218,-2161
2018,11,18,14,1215,3558,1356,-2202
2018,11,18,15,893,3787,1373,-2414
2018,11,18,16,1210,4052,1413,-2639
2018,11,18,17,1275,4198,1443,-2755
2018,11,18,18,1338,4131,1385,-2746
2018,11,18,19,1315,4006,1310,-2696
2018,11,18,20,1236,3885,1213,-2672
2018,11,18,21,1210,3762,1163,-2599
2018,11,18,22,1108,3571,1040,-2531
2018,11,18,23,992,3494,1046,-2448
2018,11,19,0,1153,3605,1173,-2432
2018,11,19,1,1159,3930,1256,-2674
2018,11,19,2,1409,4238,1416,-2822
2018,11,19,3,1411,4269,1388,-2881
2018,11,19,4,1376,4233,1402,-2831
2018,11,19,5,1260,4149,1394,-2755
2018,11,19,6,1057,3960,1298,-2662
2018,11,19,7,1185,3698,1300,-2398
2018,11,19,8,1194,3480,1298,-2182
2018,11,19,9,1002,3330,1212,-2118
2018,11,19,10,978,3285,1186,-2099
2018,11,19,11,979,3304,1188,-2116
2018,11,19,12,1078,3392,1240,-2152
2018,11,19,13,1071,3626,1267,-2359
2018,11,19,14,1250,3989,1348,-2641
2018,11,19,15,1148,4408,1328,-3080
2018,11,19,16,1244,4645,1372,-3273
2018,11,19,17,1245,4556,1388,-3168
2018,11,19,18,1088,4453,1420,-3033
2018,11,19,19,963,4269,1250,-3019
2018,11,19,20,986,4116,1187,-2929
2018,11,19,21,967,4012,1210,-2802
2018,11,19,22,912,3914,1280,-2634
2018,11,19,23,860,3853,1272,-2581
2018,11,20,0,933,3918,1295,-2623
2018,11,20,1,1144,4148,1284,-2864
2018,11,20,2,1295,4435,1382,-3053
2018,11,20,3,1270,4427,1385,-3042
2018,11,20,4,1288,4336,1276,-3060
2018,11,20,5,1148,4247,1283,-2964
2018,11,20,6,1043,4014,1178,-2836
2018,11,20,7,1118,3730,1233,-2497
2018,11,20,8,1093,3426,1154,-2272
2018,11,20,9,1068,3298,1123,-2175
2018,11,20,10,1103,3251,1108,-2143
2018,11,20,11,1103,3266,1110,-2156
2018,11,20,12,1057,3328,1095,-2233
2018,11,20,13,1033,3561,1138,-2423
2018,11,20,14,1199,3905,1222,-2683
2018,11,20,15,1307,4373,1263,-3110
2018,11,20,16,1394,4559,1328,-3231
2018,11,20,17,1389,4521,1314,-3207
2018,11,20,18,1279,4374,1300,-3074
2018,11,20,19,1142,4217,1249,-2968
2018,11,20,20,1144,4065,1209,-2856
2018,11,20,21,966,3945,1227,-2718
2018,11,20,22,1061,3868,1245,-2623
2018,11,20,23,1003,3893,1330,-2563
2018,11,21,0,1090,3961,1331,-2630
2018,11,21,1,1141,4223,1360,-2863
2018,11,21,2,1368,4483,1492,-2991
2018,11,21,3,1395,4484,1473,-3011
2018,11,21,4,1350,4403,1450,-2953
2018,11,21,5,1225,4279,1356,-2923
2018,11,21,6,992,4058,1300,-2758
2018,11,21,7,1337,3784,1394,-2390
2018,11,21,8,1183,3531,1256,-2275
2018,11,21,9,1066,3289,1229,-2060
2018,11,21,10,1026,3172,1180,-1992
2018,11,21,11,1022,3107,1151,-1956
2018,11,21,12,1031,3132,1199,-1933
2018,11,21,13,1047,3220,1130,-2090
2018,11,21,14,1149,3541,1120,-2421
2018,11,21,15,1130,3880,1010,-2870
2018,11,21,16,1258,4136,1301,-2835
2018,11,21,17,1113,4160,1351,-2809
2018,11,21,18,1023,4170,1288,-2882
2018,11,21,19,1128,4176,1299,-2877
2018,11,21,20,952,4150,1281,-2869
2018,11,21,21,941,4105,1323,-2782
2018,11,21,22,946,4102,1369,-2733
2018,11,21,23,978,4066,1346,-2720
2018,11,22,0,1021,4086,1325,-2761
2018,11,22,1,1159,4238,1317,-2921
2018,11,22,2,1295,4347,1400,-2947
2018,11,22,3,1295,4239,1357,-2882
2018,11,22,4,1263,4120,1326,-2794
2018,11,22,5,1163,4018,1272,-2746
2018,11,22,6,856,3814,1148,-2666
2018,11,22,7,1191,3604,1242,-2362
2018,11,22,8,1048,3388,1206,-2182
2018,11,22,9,1104,3210,1268,-1942
2018,11,22,10,1092,3042,1197,-1845
2018,11,22,11,1042,2977,1211,-1766
2018,11,22,12,1031,2953,1187,-1766
2018,11,22,13,1024,3019,1177,-1842
2018,11,22,14,1093,3160,1212,-1948
2018,11,22,15,1003,3340,1238,-2102
2018,11,22,16,1161,3544,1359,-2185
2018,11,22,17,1137,3797,1395,-2402
2018,11,22,18,1161,3959,1372,-2587
2018,11,22,19,1230,4018,1274,-2744
2018,11,22,20,1164,4080,1290,-2790
2018,11,22,21,1104,4028,1196,-2832
2018,11,22,22,1094,3936,1131,-2805
2018,11,22,23,1034,3870,1147,-2723
2018,11,23,0,1125,3846,1244,-2602
2018,11,23,1,1140,3840,1260,-2580
2018,11,23,2,1108,3748,1183,-2565
2018,11,23,3,1198,3633,1140,-2493
2018,11,23,4,1122,3623,1337,-2286
2018,11,23,5,984,3577,1432,-2145
2018,11,23,6,945,3558,1496,-2062
2018,11,23,7,969,3385,1341,-2044
2018,11,23,8,982,3215,1326,-1889
2018,11,23,9,1138,3123,1444,-1679
2018,11,23,10,1223,3023,1430,-1593
2018,11,23,11,1177,2970,1370,-1600
2018,11,23,12,1222,2968,1342,-1626
2018,11,23,13,1146,3048,1331,-1717
2018,11,23,14,1089,3236,1300,-1936
2018,11,23,15,956,3415,1224,-2191
2018,11,23,16,991,3557,1253,-2304
2018,11,23,17,961,3749,1359,-2390
2018,11,23,18,1048,3913,1448,-2465
2018,11,23,19,1135,3958,1476,-2482
2018,11,23,20,1202,3943,1488,-2455
2018,11,23,21,1226,3913,1499,-2414
2018,11,23,22,1248,3880,1282,-2598
2018,11,23,23,1215,3781,1157,-2624
2018,11,24,0,1272,3806,1175,-2631
2018,11,24,1,1372,3955,1269,-2686
2018,11,24,2,1413,4096,1362,-2734
2018,11,24,3,1256,3988,1435,-2553
2018,11,24,4,1246,3928,1460,-2468
2018,11,24,5,1101,3827,1381,-2446
2018,11,24,6,1091,3740,1479,-2261
2018,11,24,7,1225,3565,1511,-2054
2018,11,24,8,1043,3382,1584,-1798
2018,11,24,9,1262,3215,1499,-1716
2018,11,24,10,1190,3122,1489,-1633
2018,11,24,11,1179,3085,1503,-1582
2018,11,24,12,1252,3144,1554,-1590
2018,11,24,13,1290,3252,1541,-1711
2018,11,24,14,1278,3375,1452,-1923
2018,11,24,15,960,3542,1263,-2279
2018,11,24,16,938,3764,1321,-2443
2018,11,24,17,1083,3951,1416,-2535
2018,11,24,18,1073,3968,1297,-2671
2018,11,24,19,1075,3921,1208,-2713
2018,11,24,20,1032,3867,1254,-2613
2018,11,24,21,982,3785,1258,-2527
2018,11,24,22,959,3685,1206,-2479
2018,11,24,23,1025,3700,1211,-2489
2018,11,25,0,1028,3763,1342,-2421
2018,11,25,1,1115,4016,1423,-2593
2018,11,25,2,1219,4090,1352,-2738
2018,11,25,3,1176,4069,1388,-2681
2018,11,25,4,1127,4013,1383,-2630
2018,11,25,5,1126,3950,1321,-2629
2018,11,25,6,1009,3800,1273,-2527
2018,11,25,7,1165,3646,1323,-2323
2018,11,25,8,1164,3446,1314,-2132
2018,11,25,9,905,3212,1062,-2150
2018,11,25,10,902,3128,1037,-2091
2018,11,25,11,898,3079,1004,-2075
2018,11,25,12,930,3081,880,-2201
2018,11,25,13,1047,3234,979,-2255
2018,11,25,14,1033,3485,1195,-2290
2018,11,25,15,948,3655,1152,-2503
2018,11,25,16,1048,3858,1146,-2712
2018,11,25,17,1234,3995,1178,-2817
2018,11,25,18,1242,4102,1217,-2885
2018,11,25,19,1140,4074,1212,-2862
2018,11,25,20,1065,4012,1228,-2784
2018,11,25,21,1034,3978,1219,-2759
2018,11,25,22,1026,3965,1222,-2743
2018,11,25,23,940,3983,1286,-2697
2018,11,26,0,1156,4014,1392,-2622
2018,11,26,1,1111,4218,1513,-2705
2018,11,26,2,1227,4394,1528,-2866
2018,11,26,3,1215,4348,1514,-2834
2018,11,26,4,1263,4211,1438,-2773
2018,11,26,5,1163,4070,1438,-2632
2018,11,26,6,983,3833,1321,-2512
2018,11,26,7,1139,3547,1382,-2165
2018,11,26,8,1017,3280,1337,-1943
2018,11,26,9,1216,3137,1320,-1817
2018,11,26,10,1131,3039,1349,-1690
2018,11,26,11,1089,3025,1349,-1676
2018,11,26,12,1117,3060,1190,-1870
2018,11,26,13,1083,3218,1151,-2067
2018,11,26,14,1128,3510,1183,-2327
2018,11,26,15,1318,3964,1293,-2671
2018,11,26,16,1229,4197,1363,-2834
2018,11,26,17,1309,4160,1342,-2818
2018,11,26,18,1300,4103,1298,-2805
2018,11,26,19,1226,4114,1319,-2795
2018,11,26,20,1141,4089,1383,-2706
2018,11,26,21,1075,4096,1443,-2653
2018,11,26,22,1021,4052,1456,-2596
2018,11,26,23,1005,4019,1457,-2562
2018,11,27,0,1066,4087,1496,-2591
2018,11,27,1,1271,4264,1509,-2755
2018,11,27,2,1489,4375,1487,-2888
2018,11,27,3,1478,4307,1444,-2863
2018,11,27,4,1352,4196,1406,-2790
2018,11,27,5,1185,4045,1327,-2718
2018,11,27,6,985,3764,1236,-2528
2018,11,27,7,985,3513,1360,-2153
2018,11,27,8,985,3212,1325,-1887
2018,11,27,9,1186,3042,1315,-1727
2018,11,27,10,1198,2905,1368,-1537
2018,11,27,11,1259,2845,1412,-1433
2018,11,27,12,1335,2839,1518,-1321
2018,11,27,13,1363,2973,1556,-1417
2018,11,27,14,1317,3245,1547,-1698
2018,11,27,15,1245,3590,1506,-2084
2018,11,27,16,1244,3846,1613,-2233
2018,11,27,17,1220,3799,1596,-2203
2018,11,27,18,1186,3745,1499,-2246
2018,11,27,19,1207,3737,1493,-2244
2018,11,27,20,1191,3681,1483,-2198
2018,11,27,21,1167,3659,1451,-2208
2018,11,27,22,1152,3646,1472,-2174
2018,11,27,23,1154,3636,1539,-2097
2018,11,28,0,1188,3708,1566,-2142
2018,11,28,1,1370,3948,1552,-2396
2018,11,28,2,1563,4167,1568,-2599
2018,11,28,3,1512,4150,1586,-2564
2018,11,28,4,1408,4083,1561,-2522
2018,11,28,5,1245,3981,1499,-2482
2018,11,28,6,1083,3736,1535,-2201
2018,11,28,7,1123,3422,1517,-1905
2018,11,28,8,1084,3154,1447,-1707
2018,11,28,9,1296,2994,1428,-1566
2018,11,28,10,1261,2878,1389,-1489
2018,11,28,11,1287,2896,1543,-1353
2018,11,28,12,1319,2962,1571,-1391
2018,11,28,13,1450,3052,1537,-1515
2018,11,28,14,1503,3432,1674,-1758
2018,11,28,15,1440,3766,1571,-2195
2018,11,28,16,1235,4024,1628,-2396
2018,11,28,17,1240,4020,1338,-2682
2018,11,28,18,1223,3992,1375,-2617
2018,11,28,19,1384,3975,1338,-2637
2018,11,28,20,1404,3885,1267,-2618
2018,11,28,21,1426,3871,1285,-2586
2018,11,28,22,1280,3855,1425,-2430
2018,11,28,23,1291,3859,1320,-2539
2018,11,29,0,1234,3872,1409,-2463
2018,11,29,1,1325,4076,1439,-2637
2018,11,29,2,1566,4241,1470,-2771
2018,11,29,3,1505,4270,1544,-2726
2018,11,29,4,1403,4223,1555,-2668
2018,11,29,5,1301,4038,1456,-2582
2018,11,29,6,1214,3801,1463,-2338
2018,11,29,7,1503,3524,1480,-2044
2018,11,29,8,1210,3234,1482,-1752
2018,11,29,9,1175,3009,1292,-1717
2018,11,29,10,1110,2918,1304,-1614
2018,11,29,11,1074,2888,1333,-1555
2018,11,29,12,1097,2929,1213,-1716
2018,11,29,13,1198,3119,1319,-1800
2018,11,29,14,1381,3448,1465,-1983
2018,11,29,15,1280,3874,1452,-2422
2018,11,29,16,1294,4134,1542,-2592
2018,11,29,17,1163,4123,1531,-2592
2018,11,29,18,1064,4046,1494,-2552
2018,11,29,19,1051,3991,1468,-2523
2018,11,29,20,1050,3944,1505,-2439
2018,11,29,21,1014,3844,1427,-2417
2018,11,29,22,1014,3819,1415,-2404
2018,11,29,23,1014,3807,1426,-2381
2018,11,30,0,1022,3887,1454,-2433
2018,11,30,1,1185,4163,1478,-2685
2018,11,30,2,1346,4321,1433,-2888
2018,11,30,3,1346,4306,1450,-2856
2018,11,30,4,1303,4196,1342,-2854
2018,11,30,5,1085,4092,1382,-2710
2018,11,30,6,1009,3862,1330,-2532
2018,11,30,7,1346,3532,1272,-2260
2018,11,30,8,1332,3250,1230,-2020
2018,11,30,9,1196,3099,1254,-1845
2018,11,30,10,1165,3031,1273,-1758
2018,11,30,11,1105,2991,1239,-1752
2018,11,30,12,1089,2993,1173,-1820
2018,11,30,13,1151,3113,1093,-2020
2018,11,30,14,1310,3488,1169,-2319
2018,11,30,15,1198,3833,1218,-2615
2018,11,30,16,1352,4096,1474,-2622
2018,11,30,17,1372,4101,1566,-2535
2018,11,30,18,1151,4019,1384,-2635
2018,11,30,19,1109,3916,1294,-2622
2018,11,30,20,1198,3855,1287,-2568
2018,11,30,21,1154,3849,1319,-2530
2018,11,30,22,1159,3795,1291,-2504
2018,11,30,23,1177,3776,1299,-2477
2018,12,1,0,1031,3906,1378,-2528
2018,12,1,1,1106,4232,1508,-2724
2018,12,1,2,1308,4386,1531,-2855
2018,12,1,3,1296,4367,1613,-2754
2018,12,1,4,1205,4225,1514,-2711
2018,12,1,5,1103,4143,1511,-2632
2018,12,1,6,999,3962,1457,-2505
2018,12,1,7,1374,3765,1530,-2235
2018,12,1,8,1290,3517,1482,-2035
2018,12,1,9,1298,3287,1398,-1889
2018,12,1,10,1212,3155,1218,-1937
2018,12,1,11,1128,3092,1129,-1963
2018,12,1,12,1153,3174,1280,-1894
2018,12,1,13,1220,3252,1411,-1841
2018,12,1,14,1357,3390,1429,-1961
2018,12,1,15,1068,3620,1287,-2333
2018,12,1,16,1164,3876,1362,-2514
2018,12,1,17,1350,4071,1529,-2542
2018,12,1,18,1454,4152,1628,-2524
2018,12,1,19,1467,4142,1724,-2418
2018,12,1,20,1413,4088,1693,-2395
2018,12,1,21,1363,4019,1757,-2262
2018,12,1,22,1315,3968,1734,-2234
2018,12,1,23,1314,3952,1680,-2272
2018,12,2,0,1282,4001,1752,-2249
2018,12,2,1,1481,4190,1769,-2421
2018,12,2,2,1531,4306,1754,-2552
2018,12,2,3,1430,4247,1778,-2469
2018,12,2,4,1467,4162,1738,-2424
2018,12,2,5,1359,4072,1728,-2344
2018,12,2,6,1206,3919,1709,-2210
2018,12,2,7,1583,3704,1681,-2023
2018,12,2,8,1372,3414,1490,-1924
2018,12,2,9,1171,3175,1349,-1826
2018,12,2,10,1172,3070,1323,-1747
2018,12,2,11,1130,3018,1301,-1717
2018,12,2,12,1155,3002,1308,-1694
2018,12,2,13,1235,3129,1393,-1736
2018,12,2,14,1322,3264,1438,-1826
2018,12,2,15,1197,3507,1400,-2107
2018,12,2,16,1138,3710,1432,-2278
2018,12,2,17,1444,3984,1526,-2458
2018,12,2,18,1509,4103,1560,-2543
2018,12,2,19,1553,4094,1553,-2541
2018,12,2,20,1445,4053,1465,-2588
2018,12,2,21,1231,4042,1604,-2438
2018,12,2,22,1219,3925,1513,-2412
2018,12,2,23,1212,3916,1561,-2355
2018,12,3,0,1218,3984,1599,-2385
2018,12,3,1,1417,4261,1643,-2618
2018,12,3,2,1575,4486,1744,-2742
2018,12,3,3,1565,4484,1778,-2706
2018,12,3,4,1553,4393,1750,-2643
2018,12,3,5,1534,4286,1709,-2577
2018,12,3,6,1464,4067,1704,-2363
2018,12,3,7,1507,3774,1709,-2065
2018,12,3,8,1457,3450,1592,-1858
2018,12,3,9,1384,3311,1464,-1847
2018,12,3,10,1322,3236,1380,-1856
2018,12,3,11,1324,3256,1382,-1874
2018,12,3,12,1275,3318,1324,-1994
2018,12,3,13,1336,3518,1340,-2178
2018,12,3,14,1671,3936,1676,-2260
2018,12,3,15,1646,4376,1735,-2641
2018,12,3,16,1650,4612,1716,-2896
2018,12,3,17,1632,4618,1693,-2925
2018,12,3,18,1572,4541,1654,-2887
2018,12,3,19,1521,4407,1423,-2984
2018,12,3,20,1398,4324,1358,-2966
2018,12,3,21,1341,4183,1287,-2896
2018,12,3,22,1301,4111,1248,-2863
2018,12,3,23,1410,4034,1257,-2777
2018,12,4,0,1358,4156,1543,-2613
2018,12,4,1,1506,4520,1758,-2762
2018,12,4,2,1753,4767,1790,-2977
2018,12,4,3,1745,4818,1786,-3032
2018,12,4,4,1658,4761,1786,-2975
2018,12,4,5,1654,4645,1810,-2835
2018,12,4,6,1507,4358,1820,-2538
2018,12,4,7,1817,4022,1834,-2188
2018,12,4,8,1554,3741,1877,-1864
2018,12,4,9,1609,3513,1718,-1795
2018,12,4,10,1888,3536,1835,-1701
2018,12,4,11,1985,3530,1855,-1675
2018,12,4,12,2048,3620,1878,-1742
2018,12,4,13,2189,3823,2021,-1802
2018,12,4,14,2423,4203,2338,-1865
2018,12,4,15,2418,4679,2335,-2344
2018,12,4,16,2556,4927,2414,-2513
2018,12,4,17,2461,4841,2331,-2510
2018,12,4,18,2338,4675,2237,-2438
2018,12,4,19,2338,4476,2062,-2414
2018,12,4,20,2239,4407,2013,-2394
2018,12,4,21,2090,4309,1948,-2361
2018,12,4,22,2015,4228,1924,-2304
2018,12,4,23,1981,4196,1900,-2296
2018,12,5,0,2074,4249,1950,-2299
2018,12,5,1,2362,4595,2251,-2344
2018,12,5,2,2612,4886,2486,-2400
2018,12,5,3,2618,4922,2398,-2524
2018,12,5,4,2545,4884,2412,-2472
2018,12,5,5,2425,4757,2369,-2388
2018,12,5,6,2197,4532,2137,-2395
2018,12,5,7,2335,4206,2304,-1902
2018,12,5,8,2205,3940,2151,-1789
2018,12,5,9,1722,3756,1866,-1890
2018,12,5,10,1772,3729,1822,-1907
2018,12,5,11,1823,3728,1789,-1939
2018,12,5,12,1842,3812,1771,-2041
2018,12,5,13,2006,4019,1908,-2111
2018,12,5,14,2180,4389,2120,-2269
2018,12,5,15,2142,4815,2131,-2684
2018,12,5,16,2372,5076,2238,-2838
2018,12,5,17,2271,5020,2293,-2727
2018,12,5,18,2123,4849,2265,-2584
2018,12,5,19,1993,4690,2123,-2567
2018,12,5,20,1922,4533,2090,-2443
2018,12,5,21,1927,4408,2012,-2396
2018,12,5,22,1748,4333,2003,-2330
2018,12,5,23,1762,4282,1936,-2346
2018,12,6,0,1813,4373,2061,-2312
2018,12,6,1,2185,4687,2297,-2390
2018,12,6,2,2450,4975,2475,-2500
2018,12,6,3,2442,4994,2440,-2554
2018,12,6,4,2364,4944,2378,-2566
2018,12,6,5,2230,4823,2319,-2504
2018,12,6,6,2013,4600,2138,-2462
2018,12,6,7,2190,4251,2178,-2073
2018,12,6,8,2031,3995,1967,-2028
2018,12,6,9,1841,3820,2016,-1804
2018,12,6,10,1840,3784,1968,-1816
2018,12,6,11,1943,3789,1881,-1908
2018,12,6,12,2025,3865,1901,-1964
2018,12,6,13,2138,4081,1987,-2094
2018,12,6,14,2287,4442,2282,-2160
2018,12,6,15,2149,4938,2422,-2516
2018,12,6,16,2320,5157,2477,-2680
2018,12,6,17,2274,5072,2413,-2659
2018,12,6,18,2271,4804,2316,-2488
2018,12,6,19,2053,4603,2297,-2306
2018,12,6,20,1955,4548,2136,-2412
2018,12,6,21,1878,4445,2071,-2374
2018,12,6,22,1901,4333,2072,-2261
2018,12,6,23,1814,4259,1981,-2278
2018,12,7,0,1758,4379,1966,-2413
2018,12,7,1,2089,4710,2192,-2518
2018,12,7,2,2288,4968,2372,-2596
2018,12,7,3,2238,4991,2397,-2594
2018,12,7,4,2123,4956,2381,-2575
2018,12,7,5,2125,4842,2266,-2576
2018,12,7,6,1941,4654,2075,-2579
2018,12,7,7,2044,4299,2214,-2085
2018,12,7,8,1921,4057,2062,-1995
2018,12,7,9,1483,3899,1584,-2315
2018,12,7,10,1469,3856,1378,-2478
2018,12,7,11,1517,3884,1419,-2465
2018,12,7,12,1471,3956,1451,-2505
2018,12,7,13,1541,4149,1638,-2511
2018,12,7,14,1662,4461,1753,-2708
2018,12,7,15,1642,4878,1764,-3114
2018,12,7,16,1751,5140,1822,-3318
2018,12,7,17,1684,5108,1839,-3269
2018,12,7,18,1618,4968,1731,-3237
2018,12,7,19,1553,4787,1687,-3100
2018,12,7,20,1347,4581,1461,-3120
2018,12,7,21,1331,4469,1451,-3018
2018,12,7,22,1208,4385,1454,-2931
2018,12,7,23,1213,4363,1448,-2915
2018,12,8,0,1306,4467,1504,-2963
2018,12,8,1,1537,4739,1730,-3009
2018,12,8,2,1746,4886,1748,-3138
2018,12,8,3,1678,4789,1733,-3056
2018,12,8,4,1570,4688,1727,-2961
2018,12,8,5,1450,4568,1598,-2970
2018,12,8,6,1301,4384,1562,-2822
2018,12,8,7,1366,4130,1610,-2520
2018,12,8,8,1310,3846,1548,-2298
2018,12,8,9,1515,3671,1563,-2108
2018,12,8,10,1443,3539,1517,-2022
2018,12,8,11,1455,3497,1518,-1979
2018,12,8,12,1407,3512,1535,-1977
2018,12,8,13,1491,3563,1556,-2007
2018,12,8,14,1498,3711,1532,-2179
2018,12,8,15,1485,3910,1475,-2435
2018,12,8,16,1468,4124,1604,-2520
2018,12,8,17,1624,4304,1721,-2583
2018,12,8,18,1689,4409,1728,-2681
2018,12,8,19,1678,4418,1702,-2716
2018,12,8,20,1610,4383,1616,-2767
2018,12,8,21,1524,4308,1691,-2617
2018,12,8,22,1447,4198,1547,-2651
2018,12,8,23,1510,4099,1323,-2776
2018,12,9,0,1440,4147,1454,-2693
2018,12,9,1,1675,4401,1681,-2720
2018,12,9,2,1811,4518,1721,-2797
2018,12,9,3,1787,4444,1716,-2728
2018,12,9,4,1690,4354,1749,-2605
2018,12,9,5,1595,4278,1726,-2552
2018,12,9,6,1410,4119,1708,-2411
2018,12,9,7,1681,3913,1684,-2229
2018,12,9,8,1648,3688,1657,-2031
2018,12,9,9,1449,3453,1533,-1920
2018,12,9,10,1416,3343,1542,-1801
2018,12,9,11,1473,3295,1419,-1876
2018,12,9,12,1354,3290,1410,-1880
2018,12,9,13,1484,3344,1357,-1987
2018,12,9,14,1314,3441,1359,-2082
2018,12,9,15,1273,3659,1481,-2178
2018,12,9,16,1377,3853,1515,-2338
2018,12,9,17,1522,4060,1566,-2494
2018,12,9,18,1782,4218,1694,-2524
2018,12,9,19,1672,4260,1564,-2696
2018,12,9,20,1537,4302,1591,-2711
2018,12,9,21,1568,4317,1621,-2696
2018,12,9,22,1582,4299,1649,-2650
2018,12,9,23,1526,4302,1674,-2628
2018,12,10,0,1456,4287,1626,-2661
2018,12,10,1,1545,4463,1669,-2794
2018,12,10,2,1676,4556,1667,-2889
2018,12,10,3,1665,4490,1655,-2835
2018,12,10,4,1562,4391,1593,-2798
2018,12,10,5,1622,4247,1611,-2636
2018,12,10,6,1459,4008,1588,-2420
2018,12,10,7,1614,3763,1680,-2083
2018,12,10,8,1541,3453,1540,-1913
2018,12,10,9,1400,3316,1502,-1814
2018,12,10,10,1414,3242,1492,-1750
2018,12,10,11,1446,3221,1429,-1792
2018,12,10,12,1413,3299,1314,-1985
2018,12,10,13,1489,3473,1502,-1971
2018,12,10,14,1480,3805,1576,-2229
2018,12,10,15,1556,4183,1631,-2552
2018,12,10,16,1804,4449,1755,-2694
2018,12,10,17,1835,4416,1865,-2551
2018,12,10,18,1762,4325,1855,-2470
2018,12,10,19,1834,4275,1871,-2404
2018,12,10,20,1739,4226,1865,-2361
2018,12,10,21,1670,4158,1858,-2300
2018,12,10,22,1615,4099,1913,-2186
2018,12,10,23,1603,4069,1937,-2132
2018,12,11,0,1677,4151,1950,-2201
2018,12,11,1,1940,4446,2091,-2355
2018,12,11,2,2203,4645,2080,-2565
2018,12,11,3,2171,4605,2073,-2532
2018,12,11,4,2071,4506,2067,-2439
2018,12,11,5,1917,4368,2026,-2342
2018,12,11,6,1677,4121,1944,-2177
2018,12,11,7,1866,3789,1957,-1832
2018,12,11,8,1587,3487,1711,-1776
2018,12,11,9,1738,3338,1760,-1578
2018,12,11,10,1696,3236,1819,-1417
2018,12,11,11,1749,3205,1818,-1387
2018,12,11,12,1787,3262,1855,-1407
2018,12,11,13,1840,3383,1844,-1539
2018,12,11,14,2001,3724,2003,-1721
2018,12,11,15,1993,4074,2022,-2052
2018,12,11,16,2019,4350,2126,-2224
2018,12,11,17,1976,4317,2054,-2263
2018,12,11,18,1946,4319,2080,-2239
2018,12,11,19,1989,4273,2040,-2233
2018,12,11,20,1763,4268,2108,-2160
2018,12,11,21,1667,4232,2053,-2179
2018,12,11,22,1664,4223,2153,-2070
2018,12,11,23,1602,4232,2065,-2167
2018,12,12,0,1594,4313,2144,-2169
2018,12,12,1,1866,4480,2278,-2202
2018,12,12,2,1985,4540,2247,-2293
2018,12,12,3,1898,4444,2195,-2249
2018,12,12,4,1878,4262,2103,-2159
2018,12,12,5,2027,4162,2162,-2000
2018,12,12,6,1874,3981,2063,-1918
2018,12,12,7,2066,3714,2205,-1509
2018,12,12,8,1753,3418,2050,-1368
2018,12,12,9,2022,3301,2181,-1120
2018,12,12,10,1996,3199,2011,-1188
2018,12,12,11,1985,3180,1945,-1235
2018,12,12,12,1900,3232,1992,-1240
2018,12,12,13,2009,3393,1995,-1398
2018,12,12,14,1878,3725,1907,-1818
2018,12,12,15,1965,4149,1907,-2242
2018,12,12,16,2104,4429,2121,-2308
2018,12,12,17,2073,4405,2099,-2306
2018,12,12,18,2102,4299,2008,-2291
2018,12,12,19,1928,4216,2032,-2184
2018,12,12,20,1995,4142,2000,-2142
2018,12,12,21,1858,4115,1904,-2211
2018,12,12,22,1938,4097,1845,-2252
2018,12,12,23,1866,4084,1792,-2292
2018,12,13,0,1936,4167,1841,-2326
2018,12,13,1,2254,4429,2008,-2421
2018,12,13,2,2455,4566,2011,-2555
2018,12,13,3,2462,4552,2100,-2452
2018,12,13,4,2399,4467,2169,-2298
2018,12,13,5,2316,4351,2181,-2170
2018,12,13,6,2111,4083,2243,-1840
2018,12,13,7,2423,3723,2183,-1540
2018,12,13,8,2242,3437,2215,-1222
2018,12,13,9,2002,3242,1988,-1254
2018,12,13,10,1961,3167,1962,-1205
2018,12,13,11,1982,3155,1875,-1280
2018,12,13,12,1981,3197,1886,-1311
2018,12,13,13,2142,3385,1952,-1433
2018,12,13,14,1812,3658,1869,-1789
2018,12,13,15,1781,4001,1740,-2261
2018,12,13,16,1842,4244,1809,-2435
2018,12,13,17,1891,4203,1790,-2413
2018,12,13,18,1835,4135,1856,-2279
2018,12,13,19,1792,4134,1806,-2328
2018,12,13,20,1867,4085,1784,-2301
2018,12,13,21,1732,4035,1779,-2256
2018,12,13,22,1811,4012,1778,-2234
2018,12,13,23,1726,3995,1753,-2242
2018,12,14,0,1928,4052,1906,-2146
2018,12,14,1,1861,4273,2111,-2162
2018,12,14,2,2040,4372,2100,-2272
2018,12,14,3,1931,4263,1976,-2287
2018,12,14,4,1861,4183,2029,-2154
2018,12,14,5,1780,4040,1974,-2066
2018,12,14,6,1677,3810,1852,-1958
2018,12,14,7,1947,3503,1828,-1675
2018,12,14,8,1869,3180,1703,-1477
2018,12,14,9,1515,2967,1507,-1460
2018,12,14,10,1445,2789,1454,-1335
2018,12,14,11,1452,2755,1462,-1293
2018,12,14,12,1459,2861,1436,-1425
2018,12,14,13,1606,3020,1583,-1437
2018,12,14,14,1708,3315,1633,-1682
2018,12,14,15,1660,3736,1691,-2045
2018,12,14,16,1656,3959,1635,-2324
2018,12,14,17,1699,4001,1695,-2306
2018,12,14,18,1697,3960,1715,-2245
2018,12,14,19,1809,3931,1693,-2238
2018,12,14,20,1771,3868,1667,-2201
2018,12,14,21,1708,3825,1651,-2174
2018,12,14,22,1633,3764,1727,-2037
2018,12,14,23,1588,3796,1755,-2041
2018,12,15,0,1570,3855,1682,-2173
2018,12,15,1,1712,4094,1655,-2439
2018,12,15,2,1810,4149,1749,-2400
2018,12,15,3,1705,3933,1788,-2145
2018,12,15,4,1700,3782,1776,-2006
2018,12,15,5,1559,3732,1898,-1834
2018,12,15,6,1564,3592,1825,-1767
2018,12,15,7,1783,3374,1856,-1518
2018,12,15,8,1560,3182,1809,-1373
2018,12,15,9,1431,3047,1765,-1282
2018,12,15,10,1379,2976,1703,-1273
2018,12,15,11,1551,2916,1596,-1320
2018,12,15,12,1536,2951,1535,-1416
2018,12,15,13,1593,3024,1538,-1486
2018,12,15,14,1458,3165,1517,-1648
2018,12,15,15,1430,3369,1345,-2024
2018,12,15,16,1529,3630,1421,-2209
2018,12,15,17,1726,3832,1521,-2311
2018,12,15,18,1707,3951,1621,-2330
2018,12,15,19,1805,3917,1642,-2275
2018,12,15,20,1804,3860,1547,-2313
2018,12,15,21,1757,3822,1492,-2330
2018,12,15,22,1662,3772,1519,-2253
2018,12,15,23,1512,3778,1631,-2147
2018,12,16,0,1586,3867,1735,-2132
2018,12,16,1,1775,4053,1963,-2090
2018,12,16,2,1934,4135,2034,-2101
2018,12,16,3,1872,4035,2004,-2031
2018,12,16,4,1849,3975,2014,-1961
2018,12,16,5,1739,3875,2073,-1802
2018,12,16,6,1607,3733,2052,-1681
2018,12,16,7,2057,3530,2034,-1496
2018,12,16,8,1964,3280,1928,-1352
2018,12,16,9,1798,3133,1920,-1213
2018,12,16,10,1537,3027,1858,-1169
2018,12,16,11,1604,2977,1907,-1070
2018,12,16,12,1613,2961,1922,-1039
2018,12,16,13,1675,2904,1812,-1092
2018,12,16,14,1867,3006,1845,-1161
2018,12,16,15,1602,3176,1783,-1393
2018,12,16,16,1780,3359,1680,-1679
2018,12,16,17,1949,3529,1625,-1904
2018,12,16,18,1990,3656,1598,-2058
2018,12,16,19,1927,3704,1750,-1954
2018,12,16,20,1990,3718,1939,-1779
2018,12,16,21,1655,3720,1883,-1837
2018,12,16,22,1747,3720,1817,-1903
2018,12,16,23,1698,3709,1781,-1928
2018,12,17,0,1653,3716,1802,-1914
2018,12,17,1,1885,3956,1918,-2038
2018,12,17,2,2098,4058,1912,-2146
2018,12,17,3,2046,4012,1991,-2021
2018,12,17,4,2078,3952,2133,-1819
2018,12,17,5,1957,3866,2308,-1558
2018,12,17,6,1768,3634,2307,-1327
2018,12,17,7,1934,3358,2308,-1050
2018,12,17,8,1692,3093,2246,-847
2018,12,17,9,1792,2883,1974,-909
2018,12,17,10,1830,2715,1879,-836
2018,12,17,11,1898,2697,1726,-971
2018,12,17,12,1883,2719,1676,-1043
2018,12,17,13,1980,3003,1876,-1127
2018,12,17,14,2122,3312,1980,-1332
2018,12,17,15,2139,3675,1946,-1729
2018,12,17,16,2117,3922,2038,-1884
2018,12,17,17,2004,3940,2075,-1865
2018,12,17,18,1948,3881,2151,-1730
2018,12,17,19,1917,3793,2150,-1643
2018,12,17,20,2005,3665,2011,-1654
2018,12,17,21,1995,3727,1959,-1768
2018,12,17,22,1860,3730,1988,-1742
2018,12,17,23,1888,3747,2031,-1716
2018,12,18,0,1985,3847,2087,-1760
2018,12,18,1,2250,4092,2072,-2020
2018,12,18,2,2254,4221,2134,-2087
2018,12,18,3,2159,4206,2120,-2086
2018,12,18,4,2235,4116,2048,-2068
2018,12,18,5,2121,3977,2104,-1873
2018,12,18,6,1870,3751,1980,-1771
2018,12,18,7,1994,3452,1928,-1524
2018,12,18,8,1820,3174,1787,-1387
2018,12,18,9,1482,2989,1726,-1263
2018,12,18,10,1645,2873,1631,-1242
2018,12,18,11,1532,2828,1546,-1282
2018,12,18,12,1543,2853,1487,-1366
2018,12,18,13,1572,2987,1481,-1506
2018,12,18,14,1813,3275,1653,-1622
2018,12,18,15,1701,3669,1797,-1872
2018,12,18,16,1926,3944,1976,-1968
2018,12,18,17,1770,3964,1923,-2041
2018,12,18,18,1589,3933,1645,-2288
2018,12,18,19,1587,3888,1592,-2296
2018,12,18,20,1558,3811,1581,-2230
2018,12,18,21,1656,3776,1572,-2204
2018,12,18,22,1613,3782,1538,-2244
2018,12,18,23,1614,3745,1597,-2148
2018,12,19,0,1669,3799,1586,-2213
2018,12,19,1,1780,4079,1873,-2206
2018,12,19,2,1906,4243,1876,-2367
2018,12,19,3,1889,4218,1873,-2345
2018,12,19,4,1930,4103,1877,-2226
2018,12,19,5,1758,3861,1775,-2086
2018,12,19,6,1539,3554,1583,-1971
2018,12,19,7,1623,3231,1461,-1770
2018,12,19,8,1540,2952,1230,-1722
2018,12,19,9,1353,2765,1284,-1481
2018,12,19,10,1298,2664,1283,-1381
2018,12,19,11,1328,2634,1085,-1549
2018,12,19,12,1181,2667,1095,-1572
2018,12,19,13,1299,2827,1167,-1660
2018,12,19,14,1220,3230,1548,-1682
2018,12,19,15,1294,3505,1304,-2201
2018,12,19,16,1407,3735,1294,-2441
2018,12,19,17,1432,3742,1244,-2498
2018,12,19,18,1434,3730,1106,-2624
2018,12,19,19,1423,3788,1203,-2585
2018,12,19,20,1388,3748,1180,-2568
2018,12,19,21,1384,3715,1239,-2476
2018,12,19,22,1432,3709,1354,-2355
2018,12,19,23,1505,3714,1497,-2217
2018,12,20,0,1339,3779,1424,-2355
2018,12,20,1,1719,4014,1575,-2439
2018,12,20,2,1908,4230,1673,-2557
2018,12,20,3,1811,4194,1668,-2526
2018,12,20,4,1778,4104,1653,-2451
2018,12,20,5,1854,3997,1523,-2474
2018,12,20,6,1812,3753,1479,-2274
2018,12,20,7,1892,3445,1433,-2012
2018,12,20,8,1986,3150,1331,-1819
2018,12,20,9,1060,2952,1177,-1775
2018,12,20,10,923,2826,1107,-1719
2018,12,20,11,985,2787,1030,-1757
2018,12,20,12,1045,2878,1131,-1747
2018,12,20,13,1149,3002,1228,-1774
2018,12,20,14,1391,3305,1351,-1954
2018,12,20,15,1300,3666,1409,-2257
2018,12,20,16,1512,3841,1454,-2387
2018,12,20,17,1466,3777,1481,-2296
2018,12,20,18,1495,3752,1533,-2219
2018,12,20,19,1481,3700,1526,-2174
2018,12,20,20,1510,3381,1135,-2246
2018,12,20,21,1425,3213,1143,-2070
2018,12,20,22,1326,3203,1388,-1815
2018,12,20,23,1275,3234,1283,-1951
2018,12,21,0,1295,3314,1202,-2112
2018,12,21,1,1385,3562,1099,-2463
2018,12,21,2,1459,3783,1382,-2401
2018,12,21,3,1399,3794,1393,-2401
2018,12,21,4,1347,3743,1524,-2219
2018,12,21,5,1358,3777,1616,-2161
2018,12,21,6,1363,3625,1595,-2030
2018,12,21,7,1534,3390,1564,-1826
2018,12,21,8,1352,3167,1596,-1571
2018,12,21,9,1335,3033,1613,-1420
2018,12,21,10,1349,3007,1610,-1397
2018,12,21,11,1341,2994,1580,-1414
2018,12,21,12,1359,3055,1360,-1695
2018,12,21,13,1375,3226,1471,-1755
2018,12,21,14,1441,3598,1529,-2069
2018,12,21,15,1330,3965,1523,-2442
2018,12,21,16,1352,4257,1604,-2653
2018,12,21,17,1424,4286,1567,-2719
2018,12,21,18,1449,4258,1520,-2738
2018,12,21,19,1431,4203,1510,-2693
2018,12,21,20,1292,4149,1513,-2636
2018,12,21,21,1299,4060,1509,-2551
2018,12,21,22,1247,3979,1443,-2536
2018,12,21,23,1309,3954,1425,-2529
2018,12,22,0,1398,3981,1747,-2234
2018,12,22,1,1553,4192,1907,-2285
2018,12,22,2,1687,4371,1965,-2406
2018,12,22,3,1609,4354,2008,-2346
2018,12,22,4,1504,4278,1824,-2454
2018,12,22,5,1358,4190,1741,-2449
2018,12,22,6,1339,4048,1783,-2265
2018,12,22,7,1565,3875,1832,-2043
2018,12,22,8,1610,3536,1712,-1824
2018,12,22,9,1448,3382,1576,-1806
2018,12,22,10,1432,3252,1570,-1682
2018,12,22,11,1463,3175,1448,-1727
2018,12,22,12,1496,3150,1464,-1686
2018,12,22,13,1573,3214,1556,-1658
2018,12,22,14,1675,3354,1578,-1776
2018,12,22,15,1490,3562,1544,-2018
2018,12,22,16,1464,3797,1632,-2165
2018,12,22,17,1666,3986,1619,-2367
2018,12,22,18,1652,4129,1718,-2411
2018,12,22,19,1749,4138,1719,-2419
2018,12,22,20,1651,4087,1650,-2437
2018,12,22,21,1429,4028,1757,-2271
2018,12,22,22,1436,3971,1722,-2249
2018,12,22,23,1448,3923,1623,-2300
2018,12,23,0,1442,3951,1677,-2274
2018,12,23,1,1610,4148,1814,-2334
2018,12,23,2,1675,4216,1918,-2298
2018,12,23,3,1685,4176,1914,-2262
2018,12,23,4,1613,4132,1880,-2252
2018,12,23,5,1514,4040,1945,-2095
2018,12,23,6,1430,3875,1922,-1953
2018,12,23,7,1712,3644,1893,-1751
2018,12,23,8,1620,3422,1762,-1660
2018,12,23,9,1506,3248,1722,-1526
2018,12,23,10,1446,3155,1642,-1513
2018,12,23,11,1495,3102,1555,-1547
2018,12,23,12,1417,3095,1475,-1620
2018,12,23,13,1429,3182,1507,-1675
2018,12,23,14,1522,3307,1678,-1629
2018,12,23,15,1357,3466,1744,-1722
2018,12,23,16,1514,3653,1696,-1957
2018,12,23,17,1667,3897,1740,-2157
2018,12,23,18,1612,4073,1871,-2202
2018,12,23,19,1573,4082,1857,-2225
2018,12,23,20,1612,4026,1839,-2187
2018,12,23,21,1563,3994,1762,-2232
2018,12,23,22,1502,3953,1817,-2136
2018,12,23,23,1367,3931,1817,-2114
2018,12,24,0,1565,3942,1733,-2209
2018,12,24,1,1648,4125,2019,-2106
2018,12,24,2,1667,4266,2089,-2177
2018,12,24,3,1657,4220,2095,-2125
2018,12,24,4,1652,4168,2054,-2114
2018,12,24,5,1651,4109,2121,-1988
2018,12,24,6,1552,4008,1997,-2011
2018,12,24,7,1628,3772,2018,-1754
2018,12,24,8,1597,3458,1863,-1595
2018,12,24,9,1767,3274,1659,-1615
2018,12,24,10,1584,3147,1577,-1570
2018,12,24,11,1545,3067,1533,-1534
2018,12,24,12,1611,3112,1589,-1523
2018,12,24,13,1799,3163,1601,-1562
2018,12,24,14,1873,3379,1724,-1655
2018,12,24,15,1870,3612,1713,-1899
2018,12,24,16,2050,3859,1983,-1876
2018,12,24,17,2082,4014,2002,-2012
2018,12,24,18,2176,4114,2008,-2106
2018,12,24,19,2214,4107,2036,-2071
2018,12,24,20,2111,4048,2011,-2037
2018,12,24,21,2004,3972,1917,-2055
2018,12,24,22,1967,3920,1912,-2008
2018,12,24,23,1995,3898,2002,-1896
2018,12,25,0,2025,3925,2056,-1869
2018,12,25,1,2148,4117,2209,-1908
2018,12,25,2,2202,4229,2242,-1987
2018,12,25,3,2079,4122,2220,-1902
2018,12,25,4,1975,4031,2183,-1848
2018,12,25,5,1898,3961,2161,-1800
2018,12,25,6,1830,3863,2103,-1760
2018,12,25,7,1860,3708,2022,-1686
2018,12,25,8,1669,3515,1755,-1760
2018,12,25,9,2170,3355,2104,-1251
2018,12,25,10,2117,3274,2052,-1222
2018,12,25,11,2071,3246,2085,-1161
2018,12,25,12,2161,3252,2071,-1181
2018,12,25,13,2186,3342,2098,-1244
2018,12,25,14,2254,3527,2133,-1394
2018,12,25,15,2041,3719,2140,-1579
2018,12,25,16,2226,3929,2179,-1750
2018,12,25,17,2376,4101,2284,-1817
2018,12,25,18,2429,4190,2354,-1836
2018,12,25,19,2428,4185,2408,-1777
2018,12,25,20,2317,4119,2338,-1781
2018,12,25,21,2171,4037,2127,-1910
2018,12,25,22,1993,3980,2066,-1914
2018,12,25,23,2072,3950,2048,-1902
2018,12,26,0,2016,3969,2108,-1861
2018,12,26,1,2187,4097,2371,-1726
2018,12,26,2,2433,4142,2469,-1673
2018,12,26,3,2373,4068,2323,-1745
2018,12,26,4,2337,4031,2359,-1672
2018,12,26,5,2263,3987,2382,-1605
2018,12,26,6,2048,3862,2279,-1583
2018,12,26,7,2387,3648,2289,-1359
2018,12,26,8,2372,3420,2074,-1346
2018,12,26,9,2137,3286,2045,-1241
2018,12,26,10,2100,3220,1954,-1266
2018,12,26,11,2058,3214,2087,-1127
2018,12,26,12,2105,3253,2132,-1121
2018,12,26,13,2241,3392,2164,-1228
2018,12,26,14,2080,3650,2133,-1517
2018,12,26,15,2159,3998,2284,-1714
2018,12,26,16,2207,4173,2331,-1842
2018,12,26,17,2282,4297,2372,-1925
2018,12,26,18,2219,4448,2341,-2107
2018,12,26,19,2204,4518,2339,-2179
2018,12,26,20,2201,4481,2341,-2140
2018,12,26,21,2119,4441,2270,-2171
2018,12,26,22,2140,4400,2320,-2080
2018,12,26,23,2094,4381,2321,-2060
2018,12,27,0,2132,4452,2467,-1985
2018,12,27,1,2240,4545,2526,-2019
2018,12,27,2,2400,4513,2467,-2046
2018,12,27,3,2365,4427,2491,-1936
2018,12,27,4,2295,4329,2390,-1939
2018,12,27,5,2140,4159,2328,-1831
2018,12,27,6,1947,3958,2255,-1703
2018,12,27,7,2304,3662,2256,-1406
2018,12,27,8,2119,3397,2125,-1272
2018,12,27,9,2052,3196,1974,-1222
2018,12,27,10,1969,3083,1985,-1098
2018,12,27,11,1919,3001,1846,-1155
2018,12,27,12,1941,3043,1874,-1169
2018,12,27,13,2094,3169,2020,-1149
2018,12,27,14,2080,3497,2101,-1396
2018,12,27,15,1983,3767,2060,-1707
2018,12,27,16,2142,3961,2111,-1850
2018,12,27,17,2224,4040,2021,-2019
2018,12,27,18,2243,4092,1911,-2181
2018,12,27,19,2248,4101,2036,-2065
2018,12,27,20,2204,4052,1976,-2076
2018,12,27,21,2273,4027,2025,-2002
2018,12,27,22,2107,3966,2021,-1945
2018,12,27,23,2101,3980,2154,-1826
2018,12,28,0,2282,4038,2187,-1851
2018,12,28,1,2368,4249,2404,-1845
2018,12,28,2,2539,4400,2348,-2052
2018,12,28,3,2545,4358,2400,-1958
2018,12,28,4,2480,4196,2238,-1958
2018,12,28,5,2310,4042,2207,-1835
2018,12,28,6,1956,3808,2163,-1645
2018,12,28,7,2112,3509,2110,-1399
2018,12,28,8,1939,3249,1935,-1314
2018,12,28,9,1739,3027,1760,-1267
2018,12,28,10,1683,2974,1863,-1111
2018,12,28,11,1633,2947,1912,-1035
2018,12,28,12,1648,2973,1876,-1097
2018,12,28,13,1751,3099,1898,-1201
2018,12,28,14,2045,3395,2149,-1246
2018,12,28,15,2006,3646,2116,-1530
2018,12,28,16,1868,3842,2127,-1715
2018,12,28,17,1974,3936,2059,-1877
2018,12,28,18,2047,4016,1992,-2024
2018,12,28,19,2063,4006,1902,-2104
2018,12,28,20,2038,4017,1933,-2084
2018,12,28,21,1993,4050,2050,-2000
2018,12,28,22,1943,3979,1887,-2092
2018,12,28,23,1926,3929,1822,-2107
2018,12,29,0,1926,3965,1890,-2075
2018,12,29,1,2094,4154,2031,-2123
2018,12,29,2,2221,4234,2151,-2083
2018,12,29,3,2086,4096,2090,-2006
2018,12,29,4,1924,3957,2131,-1826
2018,12,29,5,1746,3791,1995,-1796
2018,12,29,6,1574,3618,1875,-1743
2018,12,29,7,1747,3402,1903,-1499
2018,12,29,8,1510,3198,1564,-1634
2018,12,29,9,1509,3043,1576,-1467
2018,12,29,10,1375,2975,1464,-1511
2018,12,29,11,1394,2911,1508,-1403
2018,12,29,12,1472,2878,1466,-1412
2018,12,29,13,1424,2904,1594,-1310
2018,12,29,14,1420,3012,1648,-1364
2018,12,29,15,1441,3199,1640,-1559
2018,12,29,16,1650,3404,1898,-1506
2018,12,29,17,1465,3513,1769,-1744
2018,12,29,18,1609,3639,1710,-1929
2018,12,29,19,1660,3764,1800,-1964
2018,12,29,20,1644,3801,1792,-2009
2018,12,29,21,1609,3731,1631,-2100
2018,12,29,22,1551,3691,1651,-2040
2018,12,29,23,1559,3664,1601,-2063
2018,12,30,0,1598,3700,1682,-2018
2018,12,30,1,1711,3835,1853,-1982
2018,12,30,2,1806,3915,1942,-1973
2018,12,30,3,1740,3836,1841,-1995
2018,12,30,4,1709,3841,1840,-2001
2018,12,30,5,1559,3749,1748,-2001
2018,12,30,6,1433,3613,1697,-1916
2018,12,30,7,1601,3429,1707,-1722
2018,12,30,8,1400,3219,1546,-1673
2018,12,30,9,1458,3028,1618,-1410
2018,12,30,10,1415,2937,1666,-1271
2018,12,30,11,1620,2887,1569,-1318
2018,12,30,12,1619,2890,1586,-1304
2018,12,30,13,1714,2952,1669,-1283
2018,12,30,14,1529,3091,1650,-1441
2018,12,30,15,1472,3291,1784,-1507
2018,12,30,16,1433,3536,1838,-1698
2018,12,30,17,1658,3675,1909,-1766
2018,12,30,18,1805,3774,1864,-1910
2018,12,30,19,1792,3783,1794,-1989
2018,12,30,20,1828,3731,1706,-2025
2018,12,30,21,1764,3610,1629,-1981
2018,12,30,22,1790,3691,1737,-1954
2018,12,30,23,1730,3588,1644,-1944
2018,12,31,0,1831,3627,1794,-1833
2018,12,31,1,2099,3875,2064,-1811
2018,12,31,2,2256,4106,2156,-1950
2018,12,31,3,2246,4069,2082,-1987
2018,12,31,4,2184,4094,2230,-1864
2018,12,31,5,2086,3971,2172,-1799
2018,12,31,6,1985,3815,2137,-1678
2018,12,31,7,2136,3575,2299,-1276
2018,12,31,8,2013,3360,2144,-1216
2018,12,31,9,2094,3228,2123,-1105
2018,12,31,10,2048,3166,2051,-1115
2018,12,31,11,2057,3146,1927,-1219
2018,12,31,12,2077,3237,1953,-1284
2018,12,31,13,2170,3399,2036,-1363
2018,12,31,14,2254,3654,2264,-1390
2018,12,31,15,2248,3994,2385,-1609
2018,12,31,16,2114,4197,2311,-1886
2018,12,31,17,2254,4311,2383,-1928
2018,12,31,18,2295,4368,2460,-1908
2018,12,31,19,2281,4377,2483,-1894
2018,12,31,20,2144,4275,2289,-1986
2018,12,31,21,2076,4145,2208,-1937
2018,12,31,22,1995,4032,2141,-1891
2018,12,31,23,1987,3945,2040,-1905
2019,1,1,0,2040,4037,2099,-1938
2019,1,1,1,2213,4356,2337,-2019
2019,1,1,2,2398,4537,2349,-2188
2019,1,1,3,2338,4472,2351,-2121
2019,1,1,4,2278,4278,2241,-2037
2019,1,1,5,2106,4179,2237,-1942
2019,1,1,6,1971,3999,2174,-1825
2019,1,1,7,2371,3838,2388,-1450
2019,1,1,8,2269,3681,2348,-1333
2019,1,1,9,1807,3481,1980,-1501
2019,1,1,10,1866,3428,1979,-1449
2019,1,1,11,1848,3370,1940,-1430
2019,1,1,12,1792,3386,2076,-1310
2019,1,1,13,1783,3468,2134,-1334
2019,1,1,14,1888,3593,2100,-1493
2019,1,1,15,1830,3746,1983,-1763
2019,1,1,16,1969,3862,2124,-1738
2019,1,1,17,2016,3970,2007,-1963
2019,1,1,18,2122,4111,1899,-2212
2019,1,1,19,2163,4158,1887,-2271
2019,1,1,20,2117,4096,1869,-2227
2019,1,1,21,2076,4016,1953,-2063
2019,1,1,22,1952,3948,1957,-1991
2019,1,1,23,1991,3913,1919,-1994
2019,1,2,0,2028,3999,2156,-1843
2019,1,2,1,2242,4211,2390,-1821
2019,1,2,2,2592,4437,2417,-2020
2019,1,2,3,2586,4421,2373,-2048
2019,1,2,4,2440,4403,2428,-1975
2019,1,2,5,2291,4285,2492,-1793
2019,1,2,6,2096,4037,2437,-1600
2019,1,2,7,2027,3739,2336,-1403
2019,1,2,8,1924,3481,2188,-1293
2019,1,2,9,1858,3418,2016,-1402
2019,1,2,10,1904,3443,2036,-1407
2019,1,2,11,1930,3490,2060,-1430
2019,1,2,12,1885,3585,2091,-1494
2019,1,2,13,1962,3781,2236,-1545
2019,1,2,14,2019,4036,2164,-1872
2019,1,2,15,2166,4410,2447,-1963
2019,1,2,16,2520,4594,2475,-2119
2019,1,2,17,2489,4631,2459,-2172
2019,1,2,18,2364,4583,2422,-2161
2019,1,2,19,2235,4563,2367,-2196
2019,1,2,20,2082,4507,2382,-2125
2019,1,2,21,2091,4450,2327,-2123
2019,1,2,22,1951,4410,2279,-2131
2019,1,2,23,1930,4329,2245,-2084
2019,1,3,0,1913,4374,2314,-2060
2019,1,3,1,2093,4608,2546,-2062
2019,1,3,2,2332,4729,2602,-2127
2019,1,3,3,2342,4656,2589,-2067
2019,1,3,4,2256,4513,2557,-1956
2019,1,3,5,2207,4389,2520,-1869
2019,1,3,6,2046,4142,2465,-1677
2019,1,3,7,2040,3740,2352,-1388
2019,1,3,8,2002,3434,2034,-1400
2019,1,3,9,1823,3272,2088,-1184
2019,1,3,10,1791,3148,2025,-1123
2019,1,3,11,1860,3212,1986,-1226
2019,1,3,12,1910,3228,1840,-1388
2019,1,3,13,1897,3378,1966,-1412
2019,1,3,14,2028,3676,2106,-1570
2019,1,3,15,1879,3992,2028,-1964
2019,1,3,16,2015,4209,2112,-2097
2019,1,3,17,2099,4243,2114,-2129
2019,1,3,18,2137,4231,2178,-2053
2019,1,3,19,1986,4189,2128,-2061
2019,1,3,20,1910,4157,2163,-1994
2019,1,3,21,1894,4121,2012,-2109
2019,1,3,22,1916,4082,1929,-2153
2019,1,3,23,1845,4028,1903,-2125
2019,1,4,0,1912,4052,1979,-2073
2019,1,4,1,2067,4224,2186,-2038
2019,1,4,2,2289,4379,2277,-2102
2019,1,4,3,2259,4351,2297,-2054
2019,1,4,4,2144,4235,2296,-1939
2019,1,4,5,1970,4087,2390,-1697
2019,1,4,6,1803,3887,2402,-1485
2019,1,4,7,2070,3582,2387,-1195
2019,1,4,8,1818,3344,2282,-1062
2019,1,4,9,1919,3176,2271,-905
2019,1,4,10,1853,3051,2138,-913
2019,1,4,11,2009,3020,2060,-960
2019,1,4,12,1898,3048,2009,-1039
2019,1,4,13,1946,3185,2027,-1158
2019,1,4,14,2205,3468,2211,-1257
2019,1,4,15,1840,3810,2256,-1554
2019,1,4,16,1950,4050,2274,-1776
2019,1,4,17,1894,4094,2201,-1893
2019,1,4,18,1868,4059,2144,-1915
2019,1,4,19,1863,4007,2167,-1840
2019,1,4,20,1896,3957,2137,-1820
2019,1,4,21,1930,3953,2055,-1898
2019,1,4,22,1964,3921,1977,-1944
2019,1,4,23,2006,3915,2031,-1884
2019,1,5,0,2073,3950,2050,-1900
2019,1,5,1,2089,4124,2116,-2008
2019,1,5,2,2261,4275,2178,-2097
2019,1,5,3,2214,4207,2152,-2055
2019,1,5,4,2127,4099,2138,-1961
2019,1,5,5,2059,4000,2123,-1877
2019,1,5,6,1787,3844,2185,-1659
2019,1,5,7,2062,3599,2172,-1427
2019,1,5,8,2008,3391,2163,-1228
2019,1,5,9,2061,3202,2133,-1069
2019,1,5,10,2024,3082,1975,-1107
2019,1,5,11,1968,3055,1990,-1065
2019,1,5,12,1960,2991,1953,-1038
2019,1,5,13,1870,2989,1853,-1136
2019,1,5,14,1879,3114,1860,-1254
2019,1,5,15,1702,3297,1861,-1436
2019,1,5,16,1774,3526,1910,-1616
2019,1,5,17,1948,3703,1997,-1706
2019,1,5,18,2121,3875,2188,-1687
2019,1,5,19,2081,3915,2157,-1758
2019,1,5,20,2103,3897,2165,-1732
2019,1,5,21,2033,3853,2144,-1709
2019,1,5,22,1904,3798,2151,-1647
2019,1,5,23,1873,3806,2165,-1641
2019,1,6,0,1997,3844,2136,-1708
2019,1,6,1,1886,4019,2077,-1942
2019,1,6,2,2048,4020,1992,-2028
2019,1,6,3,2001,3941,1937,-2004
2019,1,6,4,1905,3834,1890,-1944
2019,1,6,5,1774,3728,1945,-1783
2019,1,6,6,1710,3613,1887,-1726
2019,1,6,7,2017,3403,2020,-1383
2019,1,6,8,1930,3213,1910,-1303
2019,1,6,9,1387,3025,1498,-1527
2019,1,6,10,1323,2820,1457,-1363
2019,1,6,11,1312,2507,1245,-1262
2019,1,6,12,1176,2414,1371,-1043
2019,1,6,13,1127,2402,1353,-1049
2019,1,6,14,1111,2700,1379,-1321
2019,1,6,15,1087,2861,1413,-1448
2019,1,6,16,1158,3037,1446,-1591
2019,1,6,17,1206,3207,1417,-1790
2019,1,6,18,1455,3373,1709,-1664
2019,1,6,19,1579,3442,1696,-1746
2019,1,6,20,1694,3506,1634,-1872
2019,1,6,21,1699,3546,1819,-1727
2019,1,6,22,1745,3559,1992,-1567
2019,1,6,23,1810,3608,2033,-1575
2019,1,7,0,1911,3690,2020,-1670
2019,1,7,1,1951,3881,2039,-1842
2019,1,7,2,2146,4075,2070,-2005
2019,1,7,3,1866,4047,1989,-2058
2019,1,7,4,1825,3972,1992,-1980
2019,1,7,5,1702,3862,1940,-1922
2019,1,7,6,1570,3680,1800,-1880
2019,1,7,7,1612,3434,1824,-1610
2019,1,7,8,1611,3113,1742,-1371
2019,1,7,9,1441,3022,1572,-1450
2019,1,7,10,1408,2961,1597,-1364
2019,1,7,11,1510,2984,1609,-1375
2019,1,7,12,1488,3106,1667,-1439
2019,1,7,13,1621,3278,1650,-1628
2019,1,7,14,1770,3603,1823,-1780
2019,1,7,15,1756,4015,1774,-2241
2019,1,7,16,1711,4292,1956,-2336
2019,1,7,17,1723,4347,2023,-2324
2019,1,7,18,1490,4270,1898,-2372
2019,1,7,19,1374,4206,1745,-2461
2019,1,7,20,1372,4136,1555,-2581
2019,1,7,21,1440,4069,1597,-2472
2019,1,7,22,1460,3997,1626,-2371
2019,1,7,23,1547,3981,1750,-2231
2019,1,8,0,1638,4023,1804,-2219
2019,1,8,1,1780,4317,2073,-2244
2019,1,8,2,2013,4650,2325,-2325
2019,1,8,3,2086,4694,2368,-2326
2019,1,8,4,2079,4654,2301,-2353
2019,1,8,5,1996,4554,2291,-2263
2019,1,8,6,1790,4292,2118,-2174
2019,1,8,7,2200,3975,2100,-1875
2019,1,8,8,1959,3682,2066,-1616
2019,1,8,9,1819,3525,2019,-1506
2019,1,8,10,1812,3447,1968,-1479
2019,1,8,11,1928,3430,2027,-1403
2019,1,8,12,2031,3486,2117,-1369
2019,1,8,13,1996,3651,2109,-1542
2019,1,8,14,2135,3963,2291,-1672
2019,1,8,15,2161,4374,2287,-2087
2019,1,8,16,2302,4611,2407,-2204
2019,1,8,17,2249,4583,2351,-2232
2019,1,8,18,2170,4519,2282,-2237
2019,1,8,19,2105,4504,2404,-2100
2019,1,8,20,2054,4465,2422,-2043
2019,1,8,21,2127,4448,2395,-2053
2019,1,8,22,2065,4432,2406,-2026
2019,1,8,23,1980,4400,2299,-2101
2019,1,9,0,2057,4422,2289,-2133
2019,1,9,1,2201,4590,2449,-2141
2019,1,9,2,2452,4730,2472,-2258
2019,1,9,3,2456,4670,2436,-2234
2019,1,9,4,2354,4564,2408,-2156
2019,1,9,5,2206,4367,2288,-2079
2019,1,9,6,1951,4097,2190,-1907
2019,1,9,7,2089,3685,2110,-1575
2019,1,9,8,1976,3349,1994,-1355
2019,1,9,9,1796,3168,1926,-1242
2019,1,9,10,1732,3070,1886,-1184
2019,1,9,11,1740,3041,1825,-1216
2019,1,9,12,1774,3082,1820,-1262
2019,1,9,13,1775,3263,1830,-1433
2019,1,9,14,1820,3560,1958,-1602
2019,1,9,15,1838,3928,1965,-1963
2019,1,9,16,1787,4164,1964,-2200
2019,1,9,17,1810,4150,1988,-2162
2019,1,9,18,1771,4093,1909,-2184
2019,1,9,19,1735,4031,1974,-2057
2019,1,9,20,1647,3986,1995,-1991
2019,1,9,21,1755,3978,1983,-1995
2019,1,9,22,1675,3948,1999,-1949
2019,1,9,23,1673,3965,1957,-2008
2019,1,10,0,1727,3980,1937,-2043
2019,1,10,1,1878,4135,2044,-2091
2019,1,10,2,2051,4266,2098,-2168
2019,1,10,3,2013,4254,2062,-2192
2019,1,10,4,1879,4141,2102,-2039
2019,1,10,5,1729,3994,2016,-1978
2019,1,10,6,1517,3731,2009,-1722
2019,1,10,7,1867,3464,2100,-1364
2019,1,10,8,1725,3162,2104,-1058
2019,1,10,9,1788,2989,1964,-1025
2019,1,10,10,1747,2945,1980,-965
2019,1,10,11,1835,2970,2031,-939
2019,1,10,12,1798,2989,1992,-997
2019,1,10,13,1950,3130,1965,-1165
2019,1,10,14,1948,3444,1991,-1453
2019,1,10,15,1862,3840,1953,-1887
2019,1,10,16,1853,4108,2090,-2018
2019,1,10,17,1831,4093,2087,-2006
2019,1,10,18,1859,4038,2068,-1970
2019,1,10,19,1827,3979,1943,-2036
2019,1,10,20,1799,3916,1928,-1988
2019,1,10,21,1791,3877,1927,-1950
2019,1,10,22,1775,3858,1996,-1862
2019,1,10,23,1791,3824,2003,-1821
2019,1,11,0,1846,3855,2023,-1832
2019,1,11,1,2001,4041,2209,-1832
2019,1,11,2,2228,4263,2361,-1902
2019,1,11,3,2233,4238,2361,-1877
2019,1,11,4,2149,4157,2320,-1837
2019,1,11,5,2008,4058,2235,-1823
2019,1,11,6,1815,3884,2196,-1688
2019,1,11,7,2015,3584,2113,-1471
2019,1,11,8,1894,3379,2067,-1312
2019,1,11,9,1868,3173,1986,-1187
2019,1,11,10,1795,3038,1866,-1172
2019,1,11,11,1818,3056,1943,-1113
2019,1,11,12,1836,3091,1919,-1172
2019,1,11,13,1950,3258,1877,-1381
2019,1,11,14,2025,3574,2157,-1417
2019,1,11,15,1893,3963,2158,-1805
2019,1,11,16,2138,4192,2115,-2077
2019,1,11,17,2068,4193,2217,-1976
2019,1,11,18,2065,4116,2230,-1886
2019,1,11,19,1953,4028,2125,-1903
2019,1,11,20,1937,3916,2089,-1827
2019,1,11,21,1899,3868,2091,-1777
2019,1,11,22,1744,3832,2038,-1794
2019,1,11,23,1816,3780,2075,-1705
2019,1,12,0,1839,3795,2089,-1706
2019,1,12,1,1996,3997,2220,-1777
2019,1,12,2,2085,4224,2267,-1957
2019,1,12,3,2076,4168,2194,-1974
2019,1,12,4,1975,4106,1992,-2114
2019,1,12,5,1864,4019,1937,-2082
2019,1,12,6,1706,3863,2059,-1804
2019,1,12,7,1916,3669,2078,-1591
2019,1,12,8,1928,3432,1958,-1474
2019,1,12,9,1944,3270,1948,-1322
2019,1,12,10,1901,3179,1921,-1258
2019,1,12,11,1903,3152,1888,-1264
2019,1,12,12,1931,3175,1882,-1293
2019,1,12,13,1966,3267,1882,-1385
2019,1,12,14,1840,3434,1917,-1517
2019,1,12,15,1840,3651,1890,-1761
2019,1,12,16,1848,3944,2024,-1920
2019,1,12,17,1852,4156,2047,-2109
2019,1,12,18,1936,4200,2117,-2083
2019,1,12,19,1898,4146,2034,-2112
2019,1,12,20,1819,4003,1934,-2069
2019,1,12,21,1750,3876,1889,-1987
2019,1,12,22,1789,3744,1785,-1959
2019,1,12,23,1743,3671,1811,-1860
2019,1,13,0,1668,3703,1972,-1731
2019,1,13,1,1937,3887,2027,-1860
2019,1,13,2,1993,4130,2049,-2081
2019,1,13,3,1965,4112,2009,-2103
2019,1,13,4,2009,4045,2033,-2012
2019,1,13,5,1915,3969,2038,-1931
2019,1,13,6,1716,3851,2070,-1781
2019,1,13,7,2055,3645,2138,-1507
2019,1,13,8,1862,3470,1981,-1489
2019,1,13,9,1899,3363,1954,-1409
2019,1,13,10,1762,3241,1849,-1392
2019,1,13,11,1747,3266,1892,-1374
2019,1,13,12,1764,3301,1849,-1452
2019,1,13,13,1806,3393,1856,-1537
2019,1,13,14,1983,3507,1881,-1626
2019,1,13,15,1828,3764,2008,-1756
2019,1,13,16,1962,3977,2108,-1869
2019,1,13,17,2125,4192,2284,-1908
2019,1,13,18,2202,4286,2302,-1984
2019,1,13,19,2175,4211,2262,-1949
2019,1,13,20,2143,4100,2269,-1831
2019,1,13,21,2106,3951,2241,-1710
2019,1,13,22,2152,3863,2274,-1589
2019,1,13,23,1991,3808,2324,-1484
2019,1,14,0,1958,3831,2354,-1477
2019,1,14,1,2174,4037,2463,-1574
2019,1,14,2,2291,4360,2515,-1845
2019,1,14,3,2278,4400,2517,-1883
2019,1,14,4,2294,4356,2498,-1858
2019,1,14,5,2278,4275,2496,-1779
2019,1,14,6,2067,4068,2365,-1703
2019,1,14,7,2122,3779,2330,-1449
2019,1,14,8,1901,3557,2253,-1304
2019,1,14,9,2080,3414,2272,-1142
2019,1,14,10,2059,3373,2249,-1124
2019,1,14,11,2140,3397,2236,-1161
2019,1,14,12,2171,3510,2174,-1336
2019,1,14,13,2097,3719,2304,-1415
2019,1,14,14,2283,4086,2461,-1625
2019,1,14,15,2308,4528,2464,-2064
2019,1,14,16,2405,4824,2724,-2100
2019,1,14,17,2393,4803,2725,-2078
2019,1,14,18,2369,4659,2593,-2066
2019,1,14,19,2254,4491,2507,-1984
2019,1,14,20,2157,4343,2464,-1879
2019,1,14,21,2091,4221,2387,-1834
2019,1,14,22,2021,4114,2382,-1732
2019,1,14,23,1934,4065,2363,-1702
2019,1,15,0,2014,4105,2440,-1665
2019,1,15,1,2213,4317,2572,-1745
2019,1,15,2,2455,4641,2636,-2005
2019,1,15,3,2490,4692,2631,-2061
2019,1,15,4,2432,4643,2639,-2004
2019,1,15,5,2314,4510,2607,-1903
2019,1,15,6,2164,4287,2600,-1687
2019,1,15,7,2311,3964,2586,-1378
2019,1,15,8,2051,3701,2525,-1176
2019,1,15,9,2149,3543,2369,-1174
2019,1,15,10,2130,3491,2317,-1174
2019,1,15,11,2305,3480,2298,-1182
2019,1,15,12,2224,3516,2234,-1282
2019,1,15,13,2385,3736,2420,-1316
2019,1,15,14,2534,4089,2583,-1506
2019,1,15,15,2557,4554,2638,-1916
2019,1,15,16,2560,4790,2682,-2108
2019,1,15,17,2425,4780,2677,-2103
2019,1,15,18,2393,4609,2650,-1959
2019,1,15,19,2370,4459,2464,-1995
2019,1,15,20,2184,4329,2232,-2097
2019,1,15,21,2111,4204,2241,-1963
2019,1,15,22,2247,4186,2325,-1861
2019,1,15,23,2168,4134,2456,-1678
2019,1,16,0,2277,4166,2415,-1751
2019,1,16,1,2338,4349,2415,-1934
2019,1,16,2,2488,4617,2463,-2154
2019,1,16,3,2489,4663,2385,-2278
2019,1,16,4,2486,4621,2403,-2218
2019,1,16,5,2372,4468,2430,-2038
2019,1,16,6,2183,4237,2484,-1753
2019,1,16,7,2450,3910,2514,-1396
2019,1,16,8,2325,3648,2368,-1280
2019,1,16,9,2296,3544,2329,-1215
2019,1,16,10,2214,3489,2303,-1186
2019,1,16,11,2316,3490,2311,-1179
2019,1,16,12,2400,3574,2396,-1178
2019,1,16,13,2555,3718,2436,-1282
2019,1,16,14,2520,4051,2617,-1434
2019,1,16,15,2546,4487,2503,-1984
2019,1,16,16,2556,4747,2508,-2239
2019,1,16,17,2547,4643,2382,-2261
2019,1,16,18,2540,4575,2299,-2276
2019,1,16,19,2403,4484,2322,-2162
2019,1,16,20,2292,4288,2239,-2049
2019,1,16,21,2188,4196,2350,-1846
2019,1,16,22,2099,4107,2344,-1763
2019,1,16,23,2206,4070,2439,-1631
2019,1,17,0,2262,4107,2387,-1720
2019,1,17,1,2462,4275,2382,-1893
2019,1,17,2,2584,4534,2661,-1873
2019,1,17,3,2537,4519,2623,-1896
2019,1,17,4,2568,4432,2633,-1799
2019,1,17,5,2467,4264,2536,-1728
2019,1,17,6,2262,4025,2452,-1573
2019,1,17,7,2520,3676,2472,-1204
2019,1,17,8,2415,3428,2442,-986
2019,1,17,9,1646,3229,2327,-902
2019,1,17,10,2025,3124,2256,-868
2019,1,17,11,1968,3123,2103,-1020
2019,1,17,12,1952,3192,2006,-1186
2019,1,17,13,2148,3325,2048,-1277
2019,1,17,14,2226,3637,2082,-1555
2019,1,17,15,2195,4033,1988,-2045
2019,1,17,16,2041,4291,2066,-2225
2019,1,17,17,2140,4293,2098,-2195
2019,1,17,18,2109,4177,2106,-2071
2019,1,17,19,2000,4128,2070,-2058
2019,1,17,20,1972,4076,2106,-1970
2019,1,17,21,1943,4009,2113,-1896
2019,1,17,22,1874,3950,2047,-1903
2019,1,17,23,1797,3929,2105,-1824
2019,1,18,0,1814,3978,2105,-1873
2019,1,18,1,1986,4148,2064,-2084
2019,1,18,2,2049,4345,2203,-2142
2019,1,18,3,2089,4317,2201,-2116
2019,1,18,4,2000,4220,2214,-2006
2019,1,18,5,1757,4078,2042,-2036
2019,1,18,6,1552,3826,1740,-2086
2019,1,18,7,1833,3557,1861,-1696
2019,1,18,8,1852,3306,1664,-1642
2019,1,18,9,1461,3162,1643,-1519
2019,1,18,10,1530,3057,1608,-1449
2019,1,18,11,1471,3051,1627,-1424
2019,1,18,12,1603,3081,1599,-1482
2019,1,18,13,1612,3239,1664,-1575
2019,1,18,14,1600,3551,1717,-1834
2019,1,18,15,1434,3932,1717,-2215
2019,1,18,16,1675,4238,1797,-2441
2019,1,18,17,1654,4241,1608,-2633
2019,1,18,18,1636,4185,1658,-2527
2019,1,18,19,1542,4139,1657,-2482
2019,1,18,20,1564,4079,1569,-2510
2019,1,18,21,1595,4031,1907,-2124
2019,1,18,22,1626,3994,2026,-1968
2019,1,18,23,1807,3989,1911,-2078
2019,1,19,0,1826,3996,1903,-2093
2019,1,19,1,1972,4146,2084,-2062
2019,1,19,2,2045,4287,2130,-2157
2019,1,19,3,1999,4228,2106,-2122
2019,1,19,4,1964,4128,2056,-2072
2019,1,19,5,1706,4016,2008,-2008
2019,1,19,6,1629,3852,1963,-1889
2019,1,19,7,1876,3615,2005,-1610
2019,1,19,8,1804,3381,1933,-1448
2019,1,19,9,1731,3188,1914,-1274
2019,1,19,10,1649,3076,1878,-1198
2019,1,19,11,1607,3014,1784,-1230
2019,1,19,12,1602,2998,1783,-1215
2019,1,19,13,1629,3041,1798,-1243
2019,1,19,14,1674,3178,1828,-1350
2019,1,19,15,1616,3358,1845,-1513
2019,1,19,16,1650,3604,2002,-1602
2019,1,19,17,1751,3842,1935,-1907
2019,1,19,18,1812,3921,1959,-1962
2019,1,19,19,1787,3942,1899,-2043
2019,1,19,20,1784,3911,1856,-2055
2019,1,19,21,1746,3865,1965,-1900
2019,1,19,22,1694,3781,1865,-1916
2019,1,19,23,1651,3745,1850,-1895
2019,1,20,0,1628,3766,1882,-1884
2019,1,20,1,1614,3938,1978,-1960
2019,1,20,2,1763,4082,1971,-2111
2019,1,20,3,1793,4018,1895,-2123
2019,1,20,4,1827,3997,2028,-1969
2019,1,20,5,1780,3911,2081,-1830
2019,1,20,6,1737,3745,2030,-1715
2019,1,20,7,1802,3557,2081,-1476
2019,1,20,8,1640,3336,1834,-1502
2019,1,20,9,1805,3209,1734,-1475
2019,1,20,10,1750,3117,1680,-1437
2019,1,20,11,1682,3086,1576,-1510
2019,1,20,12,1675,3091,1563,-1528
2019,1,20,13,1781,3139,1522,-1617
2019,1,20,14,1806,3282,1566,-1716
2019,1,20,15,1605,3464,1521,-1943
2019,1,20,16,1611,3678,1537,-2141
2019,1,20,17,1717,3891,1706,-2185
2019,1,20,18,1835,4057,1792,-2265
2019,1,20,19,1793,4145,1799,-2346
2019,1,20,20,1592,4091,1689,-2402
2019,1,20,21,1585,4028,1702,-2326
2019,1,20,22,1580,3960,1688,-2272
2019,1,20,23,1578,3951,2024,-1927
2019,1,21,0,1576,3928,1986,-1942
2019,1,21,1,1674,4069,1900,-2169
2019,1,21,2,1789,4275,1844,-2431
2019,1,21,3,1803,4222,1794,-2428
2019,1,21,4,1758,4193,1741,-2452
2019,1,21,5,1658,4130,1944,-2186
2019,1,21,6,1671,3978,1909,-2069
2019,1,21,7,1949,3764,2000,-1764
2019,1,21,8,1917,3552,1893,-1659
2019,1,21,9,1982,3408,1795,-1613
2019,1,21,10,1935,3324,1687,-1637
2019,1,21,11,1927,3297,1702,-1595
2019,1,21,12,1972,3346,1849,-1497
2019,1,21,13,1920,3505,1856,-1649
2019,1,21,14,1963,3805,2162,-1643
2019,1,21,15,1821,4105,2157,-1948
2019,1,21,16,1796,4333,2249,-2084
2019,1,21,17,1787,4433,2259,-2174
2019,1,21,18,1777,4435,2096,-2339
2019,1,21,19,1685,4403,1785,-2618
2019,1,21,20,1626,4385,1768,-2617
2019,1,21,21,1622,4285,1767,-2518
2019,1,21,22,1618,4214,1926,-2288
2019,1,21,23,1616,4145,1982,-2163
2019,1,22,0,1614,4139,1962,-2177
2019,1,22,1,1772,4311,2246,-2065
2019,1,22,2,1999,4613,2308,-2305
2019,1,22,3,2056,4633,2249,-2384
2019,1,22,4,1996,4542,2196,-2346
2019,1,22,5,1840,4414,1998,-2416
2019,1,22,6,1623,4111,1866,-2245
2019,1,22,7,1964,3816,1930,-1886
2019,1,22,8,1976,3438,1879,-1559
2019,1,22,9,1942,3230,1849,-1381
2019,1,22,10,1897,3171,1815,-1356
2019,1,22,11,1982,3173,1879,-1294
2019,1,22,12,2097,3329,2012,-1317
2019,1,22,13,1909,3493,2015,-1478
2019,1,22,14,2196,3830,2211,-1619
2019,1,22,15,1972,4233,2295,-1938
2019,1,22,16,2146,4445,2386,-2059
2019,1,22,17,2078,4361,2228,-2133
2019,1,22,18,1954,4358,2239,-2119
2019,1,22,19,1806,4320,1886,-2434
2019,1,22,20,1746,4307,1846,-2461
2019,1,22,21,1661,4309,1951,-2358
2019,1,22,22,1626,4225,1813,-2412
2019,1,22,23,1634,4285,1894,-2391
2019,1,23,0,1680,4314,1990,-2324
2019,1,23,1,1829,4475,1999,-2476
2019,1,23,2,2013,4645,2104,-2541
2019,1,23,3,1984,4606,2192,-2414
2019,1,23,4,1838,4486,2176,-2310
2019,1,23,5,1735,4308,2084,-2224
2019,1,23,6,1480,4050,1999,-2051
2019,1,23,7,1638,3707,1959,-1748
2019,1,23,8,1371,3316,1830,-1486
2019,1,23,9,2000,3133,1916,-1217
2019,1,23,10,1939,3131,1892,-1239
2019,1,23,11,1933,3077,1806,-1271
2019,1,23,12,1773,3110,1698,-1412
2019,1,23,13,1854,3280,1931,-1349
2019,1,23,14,2012,3562,2159,-1403
2019,1,23,15,1824,3955,1960,-1995
2019,1,23,16,1956,4179,1984,-2195
2019,1,23,17,2027,4166,1929,-2237
2019,1,23,18,1986,4102,1916,-2186
2019,1,23,19,1907,4325,2170,-2155
2019,1,23,20,1878,4296,2165,-2131
2019,1,23,21,1789,4246,2108,-2138
2019,1,23,22,1730,4203,2107,-2096
2019,1,23,23,1792,3872,1791,-2081
2019,1,24,0,1891,3885,1941,-1944
2019,1,24,1,1988,4035,2337,-1698
2019,1,24,2,2106,4295,2396,-1899
2019,1,24,3,2153,4336,2333,-2003
2019,1,24,4,2125,4240,2280,-1960
2019,1,24,5,2099,4125,2142,-1983
2019,1,24,6,1875,3883,2027,-1856
2019,1,24,7,2006,3582,2017,-1565
2019,1,24,8,1933,3324,1948,-1376
2019,1,24,9,1870,3168,1857,-1311
2019,1,24,10,1852,3103,1798,-1305
2019,1,24,11,1821,3065,1782,-1283
2019,1,24,12,1938,3093,1910,-1183
2019,1,24,13,2061,3268,1956,-1312
2019,1,24,14,2294,3579,2410,-1169
2019,1,24,15,2158,3963,2354,-1609
2019,1,24,16,2375,4187,2382,-1805
2019,1,24,17,2334,4148,2235,-1913
2019,1,24,18,2232,4064,2061,-2003
2019,1,24,19,2022,4053,1871,-2182
2019,1,24,20,1953,3920,1742,-2178
2019,1,24,21,2013,3936,1790,-2146
2019,1,24,22,1867,3933,1845,-2088
2019,1,24,23,1984,3936,1823,-2113
2019,1,25,0,2024,3980,2022,-1958
2019,1,25,1,2157,4118,2291,-1827
2019,1,25,2,2339,4346,2542,-1804
2019,1,25,3,2382,4349,2570,-1779
2019,1,25,4,2332,4296,2484,-1812
2019,1,25,5,2206,4169,2369,-1800
2019,1,25,6,1992,3937,2198,-1739
2019,1,25,7,2240,3639,2336,-1303
2019,1,25,8,2094,3375,2151,-1224
2019,1,25,9,1979,3219,2027,-1192
2019,1,25,10,1928,3148,1953,-1195
2019,1,25,11,1799,3115,1975,-1140
2019,1,25,12,1809,3165,2014,-1151
2019,1,25,13,1889,3319,2063,-1256
2019,1,25,14,2179,3610,2041,-1569
2019,1,25,15,1863,4009,2047,-1962
2019,1,25,16,2106,4266,2082,-2184
2019,1,25,17,1987,4266,1952,-2314
2019,1,25,18,2031,4213,1828,-2385
2019,1,25,19,1863,4138,1791,-2347
2019,1,25,20,1870,4039,1878,-2161
2019,1,25,21,1774,3954,1797,-2157
2019,1,25,22,1725,3871,1810,-2061
2019,1,25,23,1688,3819,1917,-1902
2019,1,26,0,1712,3833,1920,-1913
2019,1,26,1,1865,3969,2034,-1935
2019,1,26,2,2081,4247,2250,-1997
2019,1,26,3,2058,4239,2279,-1960
2019,1,26,4,1948,4197,2339,-1858
2019,1,26,5,1830,4111,2150,-1961
2019,1,26,6,1721,3915,2092,-1823
2019,1,26,7,1889,3737,2237,-1500
2019,1,26,8,1988,3520,2182,-1338
2019,1,26,9,1840,3367,1966,-1401
2019,1,26,10,1716,3308,1834,-1474
2019,1,26,11,1717,3283,1766,-1517
2019,1,26,12,1714,3304,1772,-1532
2019,1,26,13,1899,3375,1844,-1531
2019,1,26,14,1883,3559,1883,-1676
2019,1,26,15,1695,3752,1710,-2042
2019,1,26,16,1810,4006,1778,-2228
2019,1,26,17,1962,4180,1722,-2458
2019,1,26,18,2035,4296,1835,-2461
2019,1,26,19,1988,4245,1799,-2446
2019,1,26,20,1866,4091,1755,-2336
2019,1,26,21,1769,3936,1673,-2263
2019,1,26,22,1642,3799,1696,-2103
2019,1,26,23,1611,3706,1663,-2043
2019,1,27,0,1611,3721,1666,-2055
2019,1,27,1,1860,3877,1780,-2097
2019,1,27,2,1985,4150,2045,-2105
2019,1,27,3,2072,4188,2030,-2158
2019,1,27,4,1928,4096,1953,-2143
2019,1,27,5,1946,3997,1988,-2009
2019,1,27,6,1798,3830,1975,-1855
2019,1,27,7,1999,3634,2037,-1597
2019,1,27,8,1856,3422,1952,-1470
2019,1,27,9,1870,3227,1907,-1320
2019,1,27,10,1883,3151,1880,-1271
2019,1,27,11,1874,3137,2015,-1122
2019,1,27,12,1915,3136,1992,-1144
2019,1,27,13,1994,3191,2011,-1180
2019,1,27,14,2022,3379,2072,-1307
2019,1,27,15,1749,3591,2081,-1510
2019,1,27,16,1843,3822,2142,-1680
2019,1,27,17,1921,4015,2110,-1905
2019,1,27,18,2046,4129,2012,-2117
2019,1,27,19,2065,4151,1827,-2324
2019,1,27,20,2033,4148,1774,-2374
2019,1,27,21,1973,4139,1695,-2444
2019,1,27,22,1907,4116,1669,-2447
2019,1,27,23,1830,4099,1661,-2438
2019,1,28,0,1878,4129,1746,-2383
2019,1,28,1,1887,4299,2033,-2266
2019,1,28,2,2052,4462,2142,-2320
2019,1,28,3,2063,4439,2235,-2204
2019,1,28,4,2088,4323,2221,-2102
2019,1,28,5,1981,4206,2256,-1950
2019,1,28,6,1899,3955,2057,-1898
2019,1,28,7,2047,3671,2129,-1542
2019,1,28,8,1947,3439,1994,-1445
2019,1,28,9,1858,3269,1885,-1384
2019,1,28,10,1868,3206,1801,-1405
2019,1,28,11,1794,3208,1905,-1303
2019,1,28,12,1844,3297,1952,-1345
2019,1,28,13,1873,3464,2057,-1407
2019,1,28,14,2046,3859,2394,-1465
2019,1,28,15,1867,4252,2316,-1936
2019,1,28,16,2104,4513,2281,-2232
2019,1,28,17,2124,4531,2176,-2355
2019,1,28,18,2079,4447,2187,-2260
2019,1,28,19,1979,4335,2112,-2223
2019,1,28,20,1929,4137,1927,-2210
2019,1,28,21,1824,4028,1928,-2100
2019,1,28,22,1753,3953,1932,-2021
2019,1,28,23,1712,3928,1983,-1945
2019,1,29,0,1773,3929,1945,-1984
2019,1,29,1,1966,4125,2072,-2053
2019,1,29,2,2173,4462,2233,-2229
2019,1,29,3,2201,4544,2278,-2266
2019,1,29,4,2141,4509,2273,-2236
2019,1,29,5,2051,4370,2205,-2165
2019,1,29,6,1891,4145,2164,-1981
2019,1,29,7,2057,3850,2162,-1688
2019,1,29,8,1925,3586,1964,-1622
2019,1,29,9,1561,3365,1641,-1724
2019,1,29,10,1681,3309,1699,-1610
2019,1,29,11,1731,3331,1717,-1614
2019,1,29,12,1787,3433,1843,-1590
2019,1,29,13,1800,3638,1848,-1790
2019,1,29,14,2020,4068,1956,-2112
2019,1,29,15,2026,4556,2087,-2469
2019,1,29,16,1994,4784,2125,-2659
2019,1,29,17,1947,4743,2035,-2708
2019,1,29,18,1904,4570,2069,-2501
2019,1,29,19,1809,4418,1972,-2446
2019,1,29,20,1778,4202,1895,-2307
2019,1,29,21,1723,4081,1886,-2195
2019,1,29,22,1714,3970,1880,-2090
2019,1,29,23,1724,3886,1860,-2026
2019,1,30,0,1755,3873,1814,-2059
2019,1,30,1,1928,4021,1873,-2148
2019,1,30,2,2039,4378,2097,-2281
2019,1,30,3,2071,4486,2107,-2379
2019,1,30,4,2022,4442,2090,-2352
2019,1,30,5,1953,4343,2017,-2326
2019,1,30,6,1781,4164,1994,-2170
2019,1,30,7,1959,3864,1999,-1865
2019,1,30,8,1803,3621,1936,-1685
2019,1,30,9,1653,3480,1888,-1592
2019,1,30,10,1636,3421,1860,-1561
2019,1,30,11,1633,3463,1899,-1564
2019,1,30,12,1643,3547,1786,-1761
2019,1,30,13,1880,3750,1966,-1784
2019,1,30,14,2006,4135,2138,-1997
2019,1,30,15,1919,4558,2079,-2479
2019,1,30,16,2086,4828,2126,-2702
2019,1,30,17,2047,4777,2045,-2732
2019,1,30,18,1931,4601,1925,-2676
2019,1,30,19,1810,4420,1875,-2545
2019,1,30,20,1720,4265,1756,-2509
2019,1,30,21,1695,4153,1801,-2352
2019,1,30,22,1615,4097,1876,-2221
2019,1,30,23,1539,4059,1881,-2178
2019,1,31,0,1595,4094,1868,-2226
2019,1,31,1,1696,4211,1967,-2244
2019,1,31,2,1971,4481,2062,-2419
2019,1,31,3,2036,4536,2115,-2421
2019,1,31,4,1979,4424,2104,-2320
2019,1,31,5,1847,4292,1987,-2305
2019,1,31,6,1676,4006,1865,-2141
2019,1,31,7,1857,3643,1831,-1812
2019,1,31,8,1679,3323,1725,-1598
2019,1,31,9,1694,3197,1683,-1514
2019,1,31,10,1630,3070,1730,-1340
2019,1,31,11,1586,3061,1764,-1297
2019,1,31,12,1642,3104,1791,-1313
2019,1,31,13,1775,3284,1815,-1469
2019,1,31,14,1741,3622,1905,-1717
2019,1,31,15,1750,4118,2008,-2110
2019,1,31,16,1921,4333,1927,-2406
2019,1,31,17,1855,4275,1946,-2329
2019,1,31,18,1789,4147,1914,-2233
2019,1,31,19,1690,3999,1776,-2223
2019,1,31,20,1652,3844,1646,-2198
2019,1,31,21,1679,3752,1736,-2016
2019,1,31,22,1651,3687,1760,-1927
2019,1,31,23,1500,3612,1704,-1908
2019,2,1,0,1596,3726,1699,-2027
2019,2,1,1,1738,3889,1848,-2041
2019,2,1,2,1940,4103,1984,-2119
2019,2,1,3,2009,4106,2003,-2103
2019,2,1,4,1962,4013,1978,-2035
2019,2,1,5,1808,3875,1916,-1959
2019,2,1,6,1584,3661,1863,-1798
2019,2,1,7,1712,3367,1878,-1489
2019,2,1,8,1468,3031,1748,-1283
2019,2,1,9,1696,2854,1613,-1241
2019,2,1,10,1599,2752,1584,-1168
2019,2,1,11,1594,2692,1452,-1240
2019,2,1,12,1763,2829,1604,-1225
2019,2,1,13,1738,2974,1711,-1263
2019,2,1,14,1907,3335,1955,-1380
2019,2,1,15,1629,3682,1902,-1780
2019,2,1,16,1888,3939,1890,-2049
2019,2,1,17,1833,3962,1812,-2150
2019,2,1,18,1725,3969,1771,-2198
2019,2,1,19,1675,3982,1869,-2113
2019,2,1,20,1646,3929,1962,-1967
2019,2,1,21,1648,3888,1897,-1991
2019,2,1,22,1549,3853,1887,-1966
2019,2,1,23,1476,3810,1864,-1946
2019,2,2,0,1531,3804,1929,-1875
2019,2,2,1,1619,3888,1980,-1908
2019,2,2,2,1803,4042,2117,-1925
2019,2,2,3,1800,3967,2010,-1957
2019,2,2,4,1736,3867,1968,-1899
2019,2,2,5,1611,3770,1935,-1835
2019,2,2,6,1467,3605,1950,-1655
2019,2,2,7,1773,3353,2080,-1273
2019,2,2,8,1651,3112,1899,-1213
2019,2,2,9,1628,2861,1771,-1090
2019,2,2,10,1670,2748,1810,-938
2019,2,2,11,1671,2698,1835,-863
2019,2,2,12,1687,2663,1765,-898
2019,2,2,13,1602,2822,1851,-971
2019,2,2,14,1843,2994,1900,-1094
2019,2,2,15,1864,3212,1839,-1373
2019,2,2,16,1707,3420,1873,-1547
2019,2,2,17,1883,3672,2201,-1471
2019,2,2,18,2023,3739,2119,-1620
2019,2,2,19,2062,3738,1965,-1773
2019,2,2,20,2011,3719,1891,-1828
2019,2,2,21,1929,3683,1845,-1838
2019,2,2,22,1871,3636,1848,-1788
2019,2,2,23,1860,3576,1767,-1809
2019,2,3,0,1867,3593,1925,-1668
2019,2,3,1,1973,3669,1858,-1811
2019,2,3,2,2117,3898,1923,-1975
2019,2,3,3,2108,3962,1976,-1986
2019,2,3,4,2042,3905,1928,-1977
2019,2,3,5,2015,3767,1869,-1898
2019,2,3,6,1882,3669,1878,-1791
2019,2,3,7,2168,3480,1970,-1510
2019,2,3,8,1970,3233,1826,-1407
2019,2,3,9,1759,3070,1619,-1451
2019,2,3,10,1488,2974,1489,-1485
2019,2,3,11,1453,2929,1485,-1444
2019,2,3,12,1411,2919,1455,-1464
2019,2,3,13,1357,2964,1401,-1563
2019,2,3,14,1707,3120,1510,-1610
2019,2,3,15,1672,3319,1416,-1903
2019,2,3,16,1698,3614,1624,-1990
2019,2,3,17,1830,3873,1738,-2135
2019,2,3,18,1939,4025,1783,-2242
2019,2,3,19,1955,4105,1821,-2284
2019,2,3,20,1931,4116,1732,-2384
2019,2,3,21,1920,4109,1669,-2440
2019,2,3,22,1870,4153,1685,-2468
2019,2,3,23,1838,4123,1740,-2383
2019,2,4,0,1855,4128,1918,-2210
2019,2,4,1,2087,4222,1984,-2238
2019,2,4,2,2104,4442,2152,-2290
2019,2,4,3,2191,4418,2234,-2184
2019,2,4,4,2210,4444,2307,-2137
2019,2,4,5,2196,4375,2305,-2070
2019,2,4,6,2247,4149,2198,-1951
2019,2,4,7,2366,3848,2177,-1671
2019,2,4,8,2182,3597,2086,-1511
2019,2,4,9,1981,3452,1913,-1539
2019,2,4,10,1945,3430,1838,-1592
2019,2,4,11,1911,3464,1784,-1680
2019,2,4,12,1992,3575,1855,-1720
2019,2,4,13,2215,3784,2076,-1708
2019,2,4,14,2411,4123,2224,-1899
2019,2,4,15,2315,4540,2316,-2224
2019,2,4,16,2443,4796,2458,-2338
2019,2,4,17,2454,4933,2465,-2468
2019,2,4,18,2356,5001,2490,-2511
2019,2,4,19,2274,5059,2471,-2588
2019,2,4,20,2196,5049,2455,-2594
2019,2,4,21,2081,4952,2280,-2672
2019,2,4,22,2092,4896,2269,-2627
2019,2,4,23,2110,4849,2332,-2517
2019,2,5,0,2166,4851,2386,-2465
2019,2,5,1,2270,4932,2541,-2391
2019,2,5,2,2604,5198,2700,-2498
2019,2,5,3,2611,5227,2664,-2563
2019,2,5,4,2569,5101,2746,-2355
2019,2,5,5,2483,4958,2647,-2311
2019,2,5,6,2202,4731,2627,-2104
2019,2,5,7,2540,4410,2592,-1818
2019,2,5,8,2277,4185,2486,-1699
2019,2,5,9,1871,4123,2263,-1860
2019,2,5,10,1985,4119,2230,-1889
2019,2,5,11,2018,4140,2124,-2016
2019,2,5,12,1941,4157,2138,-2019
2019,2,5,13,2058,4339,1991,-2348
2019,2,5,14,2216,4655,2170,-2485
2019,2,5,15,2256,4890,1922,-2968
2019,2,5,16,2430,5226,2129,-3097
2019,2,5,17,2444,5226,2132,-3094
2019,2,5,18,2345,5126,2072,-3054
2019,2,5,19,2102,4968,1853,-3115
2019,2,5,20,1961,4874,2026,-2848
2019,2,5,21,1823,4748,1998,-2750
2019,2,5,22,1745,4647,2034,-2613
2019,2,5,23,1739,4570,1988,-2582
2019,2,6,0,1782,4561,2009,-2552
2019,2,6,1,1891,4759,2141,-2618
2019,2,6,2,2211,5078,2243,-2835
2019,2,6,3,2221,5155,2276,-2879
2019,2,6,4,2211,5061,2274,-2787
2019,2,6,5,2241,4936,2310,-2626
2019,2,6,6,2029,4699,2087,-2612
2019,2,6,7,2054,4336,1973,-2363
2019,2,6,8,1995,4161,1818,-2343
2019,2,6,9,1565,4062,1658,-2404
2019,2,6,10,1765,4090,1553,-2537
2019,2,6,11,1791,4129,1587,-2542
2019,2,6,12,1803,4217,1545,-2672
2019,2,6,13,2010,4428,1684,-2744
2019,2,6,14,2136,4769,1727,-3042
2019,2,6,15,2235,5210,1953,-3257
2019,2,6,16,2426,5419,2054,-3365
2019,2,6,17,2248,5431,1870,-3561
2019,2,6,18,2101,5247,1850,-3397
2019,2,6,19,1899,5022,1897,-3125
2019,2,6,20,1761,4824,1808,-3016
2019,2,6,21,1749,4661,1741,-2920
2019,2,6,22,1571,4559,1755,-2804
2019,2,6,23,1558,4448,1640,-2808
2019,2,7,0,1698,4488,1844,-2644
2019,2,7,1,1829,4651,1857,-2794
2019,2,7,2,2161,4988,2008,-2980
2019,2,7,3,2309,5160,2385,-2775
2019,2,7,4,2264,4964,2349,-2615
2019,2,7,5,2160,4798,2095,-2703
2019,2,7,6,1919,4506,1719,-2787
2019,2,7,7,2021,4188,1719,-2469
2019,2,7,8,1962,3969,1701,-2268
2019,2,7,9,1582,3775,1557,-2218
2019,2,7,10,1597,3716,1270,-2446
2019,2,7,11,1524,3656,1195,-2461
2019,2,7,12,1585,3817,1265,-2552
2019,2,7,13,1911,4191,1617,-2574
2019,2,7,14,2116,4616,1847,-2769
2019,2,7,15,2313,5105,2275,-2830
2019,2,7,16,2380,5380,2347,-3033
2019,2,7,17,2370,5306,2118,-3188
2019,2,7,18,2138,5108,2033,-3075
2019,2,7,19,2117,4932,1836,-3096
2019,2,7,20,1980,4775,1864,-2911
2019,2,7,21,1855,4612,1850,-2762
2019,2,7,22,1755,4529,1819,-2710
2019,2,7,23,1700,4483,1819,-2664
2019,2,8,0,1747,4499,1879,-2620
2019,2,8,1,1973,4746,2172,-2574
2019,2,8,2,2272,4912,2233,-2679
2019,2,8,3,2355,5023,2293,-2730
2019,2,8,4,2341,5022,2373,-2649
2019,2,8,5,2214,4884,2335,-2549
2019,2,8,6,1980,4670,2011,-2659
2019,2,8,7,2246,4409,2036,-2373
2019,2,8,8,2152,4161,1997,-2164
2019,2,8,9,1343,3959,1572,-2387
2019,2,8,10,1158,3749,1364,-2385
2019,2,8,11,1223,3767,1349,-2418
2019,2,8,12,1303,3887,1471,-2416
2019,2,8,13,1506,4144,1680,-2464
2019,2,8,14,1848,4467,1866,-2601
2019,2,8,15,1687,4843,1861,-2982
2019,2,8,16,1819,5043,1852,-3191
2019,2,8,17,1660,5004,1731,-3273
2019,2,8,18,1745,4902,1657,-3245
2019,2,8,19,1627,4869,1668,-3201
2019,2,8,20,1547,4816,1695,-3121
2019,2,8,21,1441,4788,1673,-3115
2019,2,8,22,1359,4873,1754,-3119
2019,2,8,23,1366,4887,1747,-3140
2019,2,9,0,1390,4877,1626,-3251
2019,2,9,1,1507,4964,1738,-3226
2019,2,9,2,1704,5092,1932,-3160
2019,2,9,3,1735,5059,1962,-3097
2019,2,9,4,1593,4872,1893,-2979
2019,2,9,5,1454,4674,1910,-2764
2019,2,9,6,1271,4498,1766,-2732
2019,2,9,7,1570,4262,1807,-2455
2019,2,9,8,1340,4058,1857,-2201
2019,2,9,9,1501,3908,1857,-2051
2019,2,9,10,1601,3848,1897,-1951
2019,2,9,11,1498,3817,1900,-1917
2019,2,9,12,1478,3821,1907,-1914
2019,2,9,13,1439,3862,1882,-1980
2019,2,9,14,1444,4030,1901,-2129
2019,2,9,15,1419,4183,1905,-2278
2019,2,9,16,1657,4417,1986,-2431
2019,2,9,17,1657,4596,2007,-2589
2019,2,9,18,1678,4753,2068,-2685
2019,2,9,19,1679,4805,2046,-2759
2019,2,9,20,1673,4725,1939,-2786
2019,2,9,21,1675,4662,1870,-2792
2019,2,9,22,1670,4574,1822,-2752
2019,2,9,23,1682,4471,1782,-2689
2019,2,10,0,1705,4456,1712,-2744
2019,2,10,1,1705,4567,1882,-2685
2019,2,10,2,1821,4857,2014,-2843
2019,2,10,3,1871,4967,2017,-2950
2019,2,10,4,1807,4850,1935,-2915
2019,2,10,5,1682,4730,1980,-2750
2019,2,10,6,1582,4543,1940,-2603
2019,2,10,7,1899,4332,1976,-2356
2019,2,10,8,1748,4127,1852,-2275
2019,2,10,9,1732,4023,1848,-2175
2019,2,10,10,1597,3985,1748,-2237
2019,2,10,11,1690,3991,1636,-2355
2019,2,10,12,1598,4040,1519,-2521
2019,2,10,13,1548,4133,1500,-2633
2019,2,10,14,1441,4288,1491,-2797
2019,2,10,15,1418,4488,1451,-3037
2019,2,10,16,1407,4727,1450,-3277
2019,2,10,17,1522,4902,1457,-3445
2019,2,10,18,1520,4982,1502,-3480
2019,2,10,19,1501,4908,1533,-3375
2019,2,10,20,1386,4826,1564,-3262
2019,2,10,21,1384,4774,1490,-3284
2019,2,10,22,1384,4773,1673,-3100
2019,2,10,23,1384,4780,1687,-3093
2019,2,11,0,1383,4813,1681,-3132
2019,2,11,1,1382,4950,1691,-3259
2019,2,11,2,1615,5132,1719,-3413
2019,2,11,3,1695,5150,1655,-3495
2019,2,11,4,1677,4980,1758,-3222
2019,2,11,5,1567,4774,1761,-3013
2019,2,11,6,1385,4522,1683,-2839
2019,2,11,7,1519,4213,1760,-2453
2019,2,11,8,1392,4004,1779,-2225
2019,2,11,9,1385,3881,1543,-2338
2019,2,11,10,1603,3839,1551,-2288
2019,2,11,11,1627,3830,1574,-2256
2019,2,11,12,1643,3894,1626,-2268
2019,2,11,13,1755,4029,1657,-2372
2019,2,11,14,1773,4302,1873,-2429
2019,2,11,15,1902,4585,1929,-2656
2019,2,11,16,1891,4809,2033,-2776
2019,2,11,17,1809,4976,1732,-3244
2019,2,11,18,1804,5062,1531,-3531
2019,2,11,19,1696,5053,1700,-3353
2019,2,11,20,1688,5008,1735,-3273
2019,2,11,21,1681,4970,1642,-3328
2019,2,11,22,1674,4920,1376,-3544
2019,2,11,23,1669,4881,1545,-3336
2019,2,12,0,1660,4840,1612,-3228
2019,2,12,1,1664,4931,1715,-3216
2019,2,12,2,1723,5070,1947,-3123
2019,2,12,3,1844,5005,1846,-3159
2019,2,12,4,1731,4778,1724,-3054
2019,2,12,5,1665,4552,1715,-2837
2019,2,12,6,1660,4311,1661,-2650
2019,2,12,7,1655,3941,1537,-2404
2019,2,12,8,1651,3692,1490,-2202
2019,2,12,9,1233,3563,1391,-2172
2019,2,12,10,1206,3513,1279,-2234
2019,2,12,11,1378,3558,1327,-2231
2019,2,12,12,1339,3599,1337,-2262
2019,2,12,13,1217,3734,1336,-2398
2019,2,12,14,1535,3985,1438,-2547
2019,2,12,15,1401,4239,1585,-2654
2019,2,12,16,1490,4473,1648,-2825
2019,2,12,17,1378,4601,1644,-2957
2019,2,12,18,1299,4714,1619,-3095
2019,2,12,19,1276,4730,1658,-3072
2019,2,12,20,1286,4725,1696,-3029
2019,2,12,21,1286,4726,1707,-3019
2019,2,12,22,1288,4706,1708,-2998
2019,2,12,23,1325,4671,1718,-2953
2019,2,13,0,1271,4577,1623,-2954
2019,2,13,1,1250,4640,1665,-2975
2019,2,13,2,1596,4823,1706,-3117
2019,2,13,3,1725,4883,1702,-3181
2019,2,13,4,1726,4767,1727,-3040
2019,2,13,5,1641,4612,1760,-2852
2019,2,13,6,1636,4357,1667,-2690
2019,2,13,7,1668,4071,1550,-2521
2019,2,13,8,1561,3818,1435,-2383
2019,2,13,9,1237,3599,1179,-2420
2019,2,13,10,1209,3495,1132,-2363
2019,2,13,11,1217,3517,1152,-2365
2019,2,13,12,1254,3545,1129,-2416
2019,2,13,13,1455,3781,1263,-2518
2019,2,13,14,1598,4103,1411,-2692
2019,2,13,15,1515,4407,1523,-2884
2019,2,13,16,1834,4635,1715,-2920
2019,2,13,17,1822,4770,1847,-2923
2019,2,13,18,1709,4751,1813,-2938
2019,2,13,19,1604,4655,1462,-3193
2019,2,13,20,1579,4563,1386,-3177
2019,2,13,21,1458,4592,1678,-2914
2019,2,13,22,1525,4539,1719,-2820
2019,2,13,23,1512,4412,1632,-2780
2019,2,14,0,1492,4401,1438,-2963
2019,2,14,1,1550,4509,1705,-2804
2019,2,14,2,1807,4755,1976,-2779
2019,2,14,3,2070,4909,2071,-2838
2019,2,14,4,1994,4866,2050,-2816
2019,2,14,5,1767,4747,2027,-2720
2019,2,14,6,1539,4532,1883,-2649
2019,2,14,7,1793,4214,1829,-2385
2019,2,14,8,1466,3938,1394,-2544
2019,2,14,9,1071,3696,1053,-2643
2019,2,14,10,1050,3641,1071,-2570
2019,2,14,11,1020,3669,1064,-2605
2019,2,14,12,1028,3718,1119,-2599
2019,2,14,13,1142,3960,1439,-2521
2019,2,14,14,1194,4239,1571,-2668
2019,2,14,15,1273,4588,1575,-3013
2019,2,14,16,1430,4748,1519,-3229
2019,2,14,17,1400,4808,1592,-3216
2019,2,14,18,1295,4787,1622,-3165
2019,2,14,19,1166,4706,1558,-3148
2019,2,14,20,1144,4578,1536,-3042
2019,2,14,21,1120,4523,1517,-3006
2019,2,14,22,1071,4492,1412,-3080
2019,2,14,23,1106,4516,1393,-3123
2019,2,15,0,1046,4535,1346,-3189
2019,2,15,1,1171,4635,1428,-3207
2019,2,15,2,1246,4805,1330,-3475
2019,2,15,3,1260,4853,1284,-3569
2019,2,15,4,1305,4721,1234,-3487
2019,2,15,5,1141,4610,1226,-3384
2019,2,15,6,981,4361,1228,-3133
2019,2,15,7,1198,4023,1113,-2910
2019,2,15,8,983,3807,1146,-2661
2019,2,15,9,1074,3548,975,-2573
2019,2,15,10,1066,3450,957,-2493
2019,2,15,11,1021,3460,955,-2505
2019,2,15,12,1007,3516,970,-2546
2019,2,15,13,1098,3781,1050,-2731
2019,2,15,14,1085,4042,1163,-2879
2019,2,15,15,1068,4359,1172,-3187
2019,2,15,16,1128,4510,1184,-3326
2019,2,15,17,1168,4518,1194,-3324
2019,2,15,18,1021,4382,951,-3431
2019,2,15,19,937,4299,876,-3423
2019,2,15,20,949,4231,900,-3331
2019,2,15,21,1002,4196,1045,-3151
2019,2,15,22,969,4104,1115,-2989
2019,2,15,23,978,4044,1186,-2858
2019,2,16,0,1008,3982,1233,-2749
2019,2,16,1,1078,4060,1237,-2823
2019,2,16,2,1162,4279,1194,-3085
2019,2,16,3,1220,4425,1198,-3227
2019,2,16,4,1206,4351,1160,-3191
2019,2,16,5,1122,4230,1112,-3118
2019,2,16,6,898,4063,1113,-2950
2019,2,16,7,1183,3827,1093,-2734
2019,2,16,8,1037,3611,978,-2633
2019,2,16,9,933,3429,974,-2455
2019,2,16,10,925,3326,943,-2383
2019,2,16,11,949,3290,756,-2534
2019,2,16,12,962,3295,891,-2404
2019,2,16,13,949,3381,996,-2385
2019,2,16,14,1015,3536,917,-2619
2019,2,16,15,861,3769,1004,-2765
2019,2,16,16,875,3984,1007,-2977
2019,2,16,17,1053,4153,953,-3200
2019,2,16,18,1098,4242,965,-3277
2019,2,16,19,1066,4242,1044,-3198
2019,2,16,20,1041,4187,1041,-3146
2019,2,16,21,822,4107,1042,-3065
2019,2,16,22,854,4029,1003,-3026
2019,2,16,23,851,3974,1047,-2927
2019,2,17,0,1022,3974,1022,-2952
2019,2,17,1,1115,4071,1245,-2826
2019,2,17,2,1286,4217,1389,-2828
2019,2,17,3,1266,4279,1480,-2799
2019,2,17,4,1215,4248,1448,-2800
2019,2,17,5,1074,4146,1386,-2760
2019,2,17,6,1028,3976,1231,-2745
2019,2,17,7,1284,3747,1300,-2447
2019,2,17,8,1190,3544,1268,-2276
2019,2,17,9,1037,3406,1134,-2272
2019,2,17,10,1011,3375,1138,-2237
2019,2,17,11,1013,3370,1154,-2216
2019,2,17,12,967,3353,1055,-2298
2019,2,17,13,1012,3445,1033,-2412
2019,2,17,14,1139,3575,1134,-2441
2019,2,17,15,1007,3786,1088,-2698
2019,2,17,16,1048,3990,1142,-2848
2019,2,17,17,1219,4204,1297,-2907
2019,2,17,18,1282,4253,1254,-2999
2019,2,17,19,1274,4207,1250,-2957
2019,2,17,20,1170,4131,1192,-2939
2019,2,17,21,1228,4051,1174,-2877
2019,2,17,22,1162,3972,1142,-2830
2019,2,17,23,1106,3913,1221,-2692
2019,2,18,0,1080,3912,1268,-2644
2019,2,18,1,1142,3986,1378,-2608
2019,2,18,2,1270,4186,1558,-2628
2019,2,18,3,1435,4328,1699,-2629
2019,2,18,4,1344,4282,1542,-2740
2019,2,18,5,1273,4234,1460,-2774
2019,2,18,6,1112,4041,1437,-2604
2019,2,18,7,1333,3841,1475,-2366
2019,2,18,8,1219,3653,1470,-2183
2019,2,18,9,1548,3516,1548,-1968
2019,2,18,10,1538,3463,1545,-1918
2019,2,18,11,1507,3454,1538,-1916
2019,2,18,12,1603,3500,1654,-1846
2019,2,18,13,1763,3661,1715,-1946
2019,2,18,14,1861,3929,1953,-1976
2019,2,18,15,1628,4212,2055,-2157
2019,2,18,16,1836,4408,2011,-2397
2019,2,18,17,1888,4449,1801,-2648
2019,2,18,18,1822,4490,1696,-2794
2019,2,18,19,1681,4462,1502,-2960
2019,2,18,20,1568,4422,1482,-2940
2019,2,18,21,1578,4324,1505,-2819
2019,2,18,22,1493,4225,1500,-2725
2019,2,18,23,1329,4134,1493,-2641
2019,2,19,0,1458,4125,1503,-2622
2019,2,19,1,1589,4229,1650,-2579
2019,2,19,2,1816,4474,2091,-2383
2019,2,19,3,1869,4587,2166,-2421
2019,2,19,4,1790,4511,2188,-2323
2019,2,19,5,1768,4359,2106,-2253
2019,2,19,6,1469,4112,1969,-2143
2019,2,19,7,1883,3790,1780,-2010
2019,2,19,8,1665,3530,1748,-1782
2019,2,19,9,1461,3376,1671,-1705
2019,2,19,10,1673,3330,1848,-1482
2019,2,19,11,1587,3326,1754,-1572
2019,2,19,12,1505,3358,1636,-1722
2019,2,19,13,1658,3527,1765,-1762
2019,2,19,14,1948,3840,1943,-1897
2019,2,19,15,1722,4211,1897,-2314
2019,2,19,16,1926,4425,1963,-2462
2019,2,19,17,1867,4425,1653,-2772
2019,2,19,18,1747,4397,1546,-2851
2019,2,19,19,1639,4382,1381,-3001
2019,2,19,20,1579,4424,1551,-2873
2019,2,19,21,1537,4447,1759,-2688
2019,2,19,22,1503,4410,1834,-2576
2019,2,19,23,1506,4397,1794,-2603
2019,2,20,0,1454,4423,1728,-2695
2019,2,20,1,1541,4531,1807,-2724
2019,2,20,2,1744,4725,2118,-2607
2019,2,20,3,1791,4772,2411,-2361
2019,2,20,4,1758,4720,2251,-2469
2019,2,20,5,1660,4532,1954,-2578
2019,2,20,6,1632,4283,1870,-2413
2019,2,20,7,1652,3955,1851,-2104
2019,2,20,8,1653,3702,1903,-1799
2019,2,20,9,2061,3558,1927,-1631
2019,2,20,10,2094,3523,1944,-1579
2019,2,20,11,2057,3501,1928,-1573
2019,2,20,12,2175,3571,1971,-1600
2019,2,20,13,2244,3748,2144,-1604
2019,2,20,14,2200,4065,2319,-1746
2019,2,20,15,2142,4442,2316,-2126
2019,2,20,16,2290,4623,2252,-2371
2019,2,20,17,2293,4632,2265,-2367
2019,2,20,18,2219,4546,2334,-2212
2019,2,20,19,2065,4441,2107,-2334
2019,2,20,20,2088,4282,1872,-2410
2019,2,20,21,2068,4248,1942,-2306
2019,2,20,22,2060,4241,2122,-2119
2019,2,20,23,2073,4252,2394,-1858
2019,2,21,0,2106,4227,2207,-2020
2019,2,21,1,2165,4296,2144,-2152
2019,2,21,2,2344,4519,2403,-2116
2019,2,21,3,2469,4714,2459,-2255
2019,2,21,4,2417,4682,2363,-2319
2019,2,21,5,2274,4592,2366,-2226
2019,2,21,6,2138,4370,2430,-1940
2019,2,21,7,2297,4070,2417,-1653
2019,2,21,8,2231,3819,2356,-1463
2019,2,21,9,1795,3582,2150,-1432
2019,2,21,10,1640,3539,2119,-1420
2019,2,21,11,1612,3572,2109,-1463
2019,2,21,12,1646,3648,2173,-1475
2019,2,21,13,1991,3938,2441,-1497
2019,2,21,14,2350,4272,2548,-1724
2019,2,21,15,2222,4693,2608,-2085
2019,2,21,16,2404,4890,2713,-2177
2019,2,21,17,2330,4818,2693,-2125
2019,2,21,18,2190,4612,2556,-2056
2019,2,21,19,2089,4383,2322,-2061
2019,2,21,20,1968,4238,2174,-2064
2019,2,21,21,1900,4130,2100,-2030
2019,2,21,22,1877,4031,2039,-1992
2019,2,21,23,1887,3975,2048,-1927
2019,2,22,0,1827,4018,2227,-1791
2019,2,22,1,1875,4121,2299,-1822
2019,2,22,2,2107,4368,2401,-1967
2019,2,22,3,2311,4615,2513,-2102
2019,2,22,4,2276,4613,2526,-2087
2019,2,22,5,2153,4533,2438,-2095
2019,2,22,6,1995,4335,2439,-1896
2019,2,22,7,2263,4040,2445,-1595
2019,2,22,8,2052,3771,2327,-1444
2019,2,22,9,1863,3618,2182,-1436
2019,2,22,10,1755,3585,2178,-1407
2019,2,22,11,1795,3588,2216,-1372
2019,2,22,12,1817,3632,2349,-1283
2019,2,22,13,2115,3828,2420,-1408
2019,2,22,14,2165,4128,2503,-1625
2019,2,22,15,2039,4492,2386,-2106
2019,2,22,16,2231,4714,2348,-2366
2019,2,22,17,2154,4742,2219,-2523
2019,2,22,18,2017,4709,2099,-2610
2019,2,22,19,1889,4689,2106,-2583
2019,2,22,20,1794,4627,2016,-2611
2019,2,22,21,1795,4540,1908,-2632
2019,2,22,22,1646,4627,1773,-2854
2019,2,22,23,1571,4589,1693,-2896
2019,2,23,0,1585,4457,1594,-2863
2019,2,23,1,1603,4551,1793,-2758
2019,2,23,2,1626,4699,1968,-2731
2019,2,23,3,1653,4753,2001,-2752
2019,2,23,4,1679,4648,1984,-2664
2019,2,23,5,1701,4520,2045,-2475
2019,2,23,6,1689,4323,1963,-2360
2019,2,23,7,1716,4078,2152,-1926
2019,2,23,8,1716,3858,1974,-1884
2019,2,23,9,1403,3693,1874,-1819
2019,2,23,10,1409,3594,1733,-1861
2019,2,23,11,1413,3515,1711,-1804
2019,2,23,12,1526,3531,1664,-1867
2019,2,23,13,1673,3611,1622,-1989
2019,2,23,14,1648,3803,1647,-2156
2019,2,23,15,1484,4020,1541,-2479
2019,2,23,16,1368,4186,1458,-2728
2019,2,23,17,1535,4368,1488,-2880
2019,2,23,18,1562,4403,1525,-2878
2019,2,23,19,1557,4350,1515,-2835
2019,2,23,20,1473,4271,1567,-2704
2019,2,23,21,1420,4163,1536,-2627
2019,2,23,22,1409,4094,1554,-2540
2019,2,23,23,1367,4040,1564,-2476
2019,2,24,0,1265,4031,1572,-2459
2019,2,24,1,1394,4113,1510,-2603
2019,2,24,2,1554,4264,1495,-2769
2019,2,24,3,1680,4384,1547,-2837
2019,2,24,4,1652,4314,1539,-2775
2019,2,24,5,1529,4225,1386,-2839
2019,2,24,6,1384,4089,1579,-2510
2019,2,24,7,1486,3864,1555,-2309
2019,2,24,8,1524,3702,1586,-2116
2019,2,24,9,1396,3541,1483,-2058
2019,2,24,10,1404,3426,1470,-1956
2019,2,24,11,1438,3420,1509,-1911
2019,2,24,12,1436,3437,1573,-1864
2019,2,24,13,1440,3508,1587,-1921
2019,2,24,14,1323,3650,1623,-2027
2019,2,24,15,1293,3852,1656,-2196
2019,2,24,16,1301,4043,1490,-2553
2019,2,24,17,1442,4228,1408,-2820
2019,2,24,18,1538,4317,1514,-2803
2019,2,24,19,1520,4319,1464,-2855
2019,2,24,20,1477,4297,1478,-2819
2019,2,24,21,1438,4228,1405,-2823
2019,2,24,22,1368,4154,1346,-2808
2019,2,24,23,1301,4111,1280,-2831
2019,2,25,0,1264,4113,1308,-2805
2019,2,25,1,1154,4235,1352,-2883
2019,2,25,2,1322,4394,1330,-3064
2019,2,25,3,1443,4531,1281,-3250
2019,2,25,4,1429,4503,1316,-3187
2019,2,25,5,1372,4415,1293,-3122
2019,2,25,6,1181,4212,1331,-2881
2019,2,25,7,1479,3923,1340,-2583
2019,2,25,8,1356,3701,1364,-2337
2019,2,25,9,1485,3588,1363,-2225
2019,2,25,10,1503,3556,1393,-2163
2019,2,25,11,1548,3593,1419,-2174
2019,2,25,12,1547,3680,1400,-2280
2019,2,25,13,1578,3891,1433,-2458
2019,2,25,14,1727,4285,1683,-2602
2019,2,25,15,1517,4738,1637,-3101
2019,2,25,16,1777,4959,1731,-3228
2019,2,25,17,1684,4857,1635,-3222
2019,2,25,18,1474,4664,1610,-3054
2019,2,25,19,1368,4494,1607,-2887
2019,2,25,20,1364,4364,1602,-2762
2019,2,25,21,1355,4282,1588,-2694
2019,2,25,22,1340,4208,1562,-2646
2019,2,25,23,1319,4180,1500,-2680
2019,2,26,0,1312,4226,1472,-2754
2019,2,26,1,1296,4354,1426,-2928
2019,2,26,2,1502,4602,1469,-3133
2019,2,26,3,1643,4834,1530,-3304
2019,2,26,4,1547,4785,1459,-3326
2019,2,26,5,1342,4652,1395,-3257
2019,2,26,6,1131,4398,1371,-3027
2019,2,26,7,1422,4066,1394,-2672
2019,2,26,8,1198,3814,1188,-2626
2019,2,26,9,1062,3621,1030,-2591
2019,2,26,10,1169,3574,1002,-2572
2019,2,26,11,1119,3601,1013,-2588
2019,2,26,12,1135,3683,1015,-2668
2019,2,26,13,1185,3895,1027,-2868
2019,2,26,14,1259,4290,1128,-3162
2019,2,26,15,1184,4762,1104,-3658
2019,2,26,16,1224,4964,1210,-3754
2019,2,26,17,1143,4840,1238,-3602
2019,2,26,18,1103,4635,1213,-3422
2019,2,26,19,1001,4487,1255,-3232
2019,2,26,20,957,4358,1254,-3104
2019,2,26,21,970,4300,1405,-2895
2019,2,26,22,924,4168,1334,-2834
2019,2,26,23,974,4145,1271,-2874
2019,2,27,0,994,4205,1335,-2870
2019,2,27,1,1018,4332,1311,-3021
2019,2,27,2,1041,4614,1373,-3241
2019,2,27,3,1195,4910,1591,-3319
2019,2,27,4,1213,4876,1675,-3201
2019,2,27,5,1135,4781,1585,-3196
2019,2,27,6,1112,4544,1597,-2947
2019,2,27,7,1220,4191,1584,-2607
2019,2,27,8,1113,3923,1577,-2346
2019,2,27,9,1055,3704,1266,-2438
2019,2,27,10,1023,3638,1203,-2435
2019,2,27,11,1177,3637,1195,-2442
2019,2,27,12,1148,3688,1177,-2511
2019,2,27,13,1224,3935,1250,-2685
2019,2,27,14,1252,4263,1256,-3007
2019,2,27,15,1178,4695,1261,-3434
2019,2,27,16,1318,4911,1423,-3488
2019,2,27,17,1127,4836,1456,-3380
2019,2,27,18,1109,4715,1429,-3286
2019,2,27,19,1090,4626,1392,-3234
2019,2,27,20,1072,4528,1437,-3091
2019,2,27,21,1055,4420,1391,-3029
2019,2,27,22,1040,4363,1440,-2923
2019,2,27,23,1059,4346,1474,-2872
2019,2,28,0,1041,4366,1474,-2892
2019,2,28,1,926,4487,1381,-3106
2019,2,28,2,1002,4647,1363,-3284
2019,2,28,3,1055,4768,1384,-3384
2019,2,28,4,1062,4712,1412,-3300
2019,2,28,5,943,4575,1280,-3295
2019,2,28,6,889,4314,1214,-3100
2019,2,28,7,887,4008,1217,-2791
2019,2,28,8,887,3765,1249,-2516
2019,2,28,9,1054,3686,1127,-2559
2019,2,28,10,1008,3651,1086,-2565
2019,2,28,11,1026,3668,1034,-2634
2019,2,28,12,1015,3755,1032,-2723
2019,2,28,13,1113,3970,1036,-2934
2019,2,28,14,960,4325,1123,-3202
2019,2,28,15,1119,4784,1246,-3538
2019,2,28,16,1361,4987,1232,-3755
2019,2,28,17,1364,4863,1314,-3549
2019,2,28,18,1266,4612,1299,-3313
2019,2,28,19,1177,4376,1190,-3186
2019,2,28,20,1134,4172,1106,-3066
2019,2,28,21,1136,4034,1149,-2885
2019,2,28,22,1062,3922,1139,-2783
2019,2,28,23,980,3860,1159,-2701
2019,3,1,0,1093,3881,1143,-2738
2019,3,1,1,1120,3990,1105,-2885
2019,3,1,2,1200,4234,1188,-3046
2019,3,1,3,1343,4473,1224,-3249
2019,3,1,4,1309,4472,1245,-3227
2019,3,1,5,1243,4411,1243,-3168
2019,3,1,6,1074,4202,1137,-3065
2019,3,1,7,1091,3917,1171,-2746
2019,3,1,8,955,3660,1013,-2647
2019,3,1,9,964,3426,987,-2439
2019,3,1,10,966,3368,1002,-2366
2019,3,1,11,1072,3368,1132,-2236
2019,3,1,12,1151,3472,1214,-2258
2019,3,1,13,1494,3735,1399,-2336
2019,3,1,14,1421,4097,1554,-2543
2019,3,1,15,1494,4540,1732,-2808
2019,3,1,16,1655,4795,1887,-2908
2019,3,1,17,1623,4644,1635,-3009
2019,3,1,18,1471,4473,1558,-2915
2019,3,1,19,1457,4284,1439,-2845
2019,3,1,20,1421,4142,1489,-2653
2019,3,1,21,1421,4025,1493,-2532
2019,3,1,22,1421,3950,1572,-2378
2019,3,1,23,1421,3854,1777,-2077
2019,3,2,0,1421,3831,1817,-2014
2019,3,2,1,1470,3909,1817,-2092
2019,3,2,2,1590,4084,1770,-2314
2019,3,2,3,1597,4292,1740,-2552
2019,3,2,4,1562,4302,1763,-2539
2019,3,2,5,1445,4250,1758,-2492
2019,3,2,6,1421,4112,1762,-2350
2019,3,2,7,1421,3909,1772,-2137
2019,3,2,8,1181,3673,1419,-2254
2019,3,2,9,1004,3498,1098,-2400
2019,3,2,10,1037,3484,1223,-2261
2019,3,2,11,1011,3501,1268,-2233
2019,3,2,12,1146,3503,1061,-2442
2019,3,2,13,1092,3623,1091,-2532
2019,3,2,14,1143,3801,1091,-2710
2019,3,2,15,968,4072,1275,-2797
2019,3,2,16,1176,4375,1398,-2977
2019,3,2,17,1332,4497,1540,-2957
2019,3,2,18,1272,4410,1386,-3024
2019,3,2,19,1140,4253,1347,-2906
2019,3,2,20,1056,4117,1323,-2794
2019,3,2,21,1047,3981,1346,-2635
2019,3,2,22,1032,3833,1349,-2484
2019,3,2,23,1030,3784,1320,-2464
2019,3,3,0,1012,3747,1245,-2502
2019,3,3,1,958,3815,1196,-2619
2019,3,3,2,1143,4007,1317,-2690
2019,3,3,3,961,4209,1297,-2912
2019,3,3,4,957,4247,1294,-2953
2019,3,3,5,954,4149,1201,-2948
2019,3,3,6,943,3980,1138,-2842
2019,3,3,7,1123,3808,1275,-2533
2019,3,3,8,943,3606,1253,-2353
2019,3,3,9,1073,3488,1275,-2213
2019,3,3,10,1067,3438,1258,-2180
2019,3,3,11,1089,3497,1317,-2180
2019,3,3,12,1098,3512,1316,-2196
2019,3,3,13,1243,3653,1465,-2188
2019,3,3,14,1420,3822,1618,-2204
2019,3,3,15,1362,4092,1725,-2367
2019,3,3,16,1434,4327,1706,-2621
2019,3,3,17,1398,4433,1644,-2789
2019,3,3,18,1443,4427,1672,-2755
2019,3,3,19,1353,4303,1686,-2617
2019,3,3,20,1293,4169,1650,-2519
2019,3,3,21,1363,3960,1476,-2484
2019,3,3,22,1312,3852,1416,-2436
2019,3,3,23,1323,3767,1317,-2450
2019,3,4,0,1077,3767,1371,-2396
2019,3,4,1,1152,3937,1629,-2308
2019,3,4,2,1218,4181,1676,-2505
2019,3,4,3,1396,4509,1718,-2791
2019,3,4,4,1227,4535,1665,-2870
2019,3,4,5,1237,4429,1465,-2964
2019,3,4,6,1082,4251,1361,-2890
2019,3,4,7,1062,3951,1345,-2606
2019,3,4,8,946,3745,1351,-2394
2019,3,4,9,1001,3618,1159,-2459
2019,3,4,10,1017,3636,1197,-2439
2019,3,4,11,1038,3659,1233,-2426
2019,3,4,12,1201,3870,1294,-2576
2019,3,4,13,1268,4095,1465,-2630
2019,3,4,14,1502,4479,1634,-2845
2019,3,4,15,1414,4945,1725,-3220
2019,3,4,16,1609,5154,1942,-3212
2019,3,4,17,1450,5004,1859,-3145
2019,3,4,18,1386,4775,1857,-2918
2019,3,4,19,1259,4583,1783,-2800
2019,3,4,20,1211,4397,1672,-2725
2019,3,4,21,1274,4311,1661,-2650
2019,3,4,22,1350,4208,1715,-2493
2019,3,4,23,1410,4127,1746,-2381
2019,3,5,0,1288,4120,1717,-2403
2019,3,5,1,1358,4214,1695,-2519
2019,3,5,2,1349,4444,1699,-2745
2019,3,5,3,1305,4726,1678,-3048
2019,3,5,4,1238,4769,1685,-3084
2019,3,5,5,1250,4692,1683,-3009
2019,3,5,6,1244,4438,1691,-2747
2019,3,5,7,1235,4122,1637,-2485
2019,3,5,8,962,3842,1449,-2393
2019,3,5,9,1086,3700,1194,-2506
2019,3,5,10,1015,3663,1072,-2591
2019,3,5,11,949,3709,1184,-2525
2019,3,5,12,1192,3842,1342,-2500
2019,3,5,13,1197,4133,1498,-2635
2019,3,5,14,1188,4503,1514,-2989
2019,3,5,15,1171,4972,1564,-3408
2019,3,5,16,1387,5135,1583,-3552
2019,3,5,17,1315,4972,1520,-3452
2019,3,5,18,1222,4735,1377,-3358
2019,3,5,19,1180,4526,1324,-3202
2019,3,5,20,1092,4343,1400,-2943
2019,3,5,21,1186,4210,1432,-2778
2019,3,5,22,1110,4092,1396,-2696
2019,3,5,23,1045,4006,1424,-2582
2019,3,6,0,1083,3946,1384,-2562
2019,3,6,1,1155,4059,1437,-2622
2019,3,6,2,1159,4261,1417,-2844
2019,3,6,3,1172,4584,1506,-3078
2019,3,6,4,1151,4604,1398,-3206
2019,3,6,5,1095,4526,1377,-3149
2019,3,6,6,1069,4279,1278,-3001
2019,3,6,7,1018,4017,1339,-2678
2019,3,6,8,857,3787,1364,-2423
2019,3,6,9,1136,3626,1348,-2278
2019,3,6,10,1218,3602,1363,-2239
2019,3,6,11,1499,3632,1563,-2069
2019,3,6,12,1665,3707,1834,-1873
2019,3,6,13,1767,3930,1932,-1998
2019,3,6,14,1555,4258,1929,-2329
2019,3,6,15,1537,4666,1946,-2720
2019,3,6,16,1616,4841,2120,-2721
2019,3,6,17,1787,4797,2164,-2633
2019,3,6,18,1716,4699,2046,-2653
2019,3,6,19,1674,4648,2053,-2595
2019,3,6,20,1579,4564,2076,-2488
2019,3,6,21,1542,4528,2018,-2510
2019,3,6,22,1518,4529,1954,-2575
2019,3,6,23,1540,4542,1902,-2640
2019,3,7,0,1583,4624,1876,-2748
2019,3,7,1,1685,4720,1757,-2963
2019,3,7,2,1833,4820,1822,-2998
2019,3,7,3,2000,4893,2001,-2892
2019,3,7,4,1855,4862,2031,-2831
2019,3,7,5,1780,4671,1875,-2796
2019,3,7,6,1506,4407,1862,-2545
2019,3,7,7,1668,4090,1978,-2112
2019,3,7,8,1477,3788,1739,-2049
2019,3,7,9,1514,3617,1605,-2012
2019,3,7,10,1382,3576,1629,-1947
2019,3,7,11,1456,3588,1665,-1923
2019,3,7,12,1383,3658,1659,-1999
2019,3,7,13,1554,3831,1743,-2088
2019,3,7,14,1505,4168,1731,-2437
2019,3,7,15,1521,4605,1683,-2922
2019,3,7,16,1594,4789,1639,-3150
2019,3,7,17,1578,4786,1652,-3134
2019,3,7,18,1521,4590,1508,-3082
2019,3,7,19,1460,4553,1531,-3022
2019,3,7,20,1463,4460,1496,-2964
2019,3,7,21,1494,4396,1616,-2780
2019,3,7,22,1433,4241,1612,-2629
2019,3,7,23,1430,4179,1641,-2538
2019,3,8,0,1403,4170,1657,-2513
2019,3,8,1,1573,4291,1851,-2440
2019,3,8,2,1684,4446,1935,-2511
2019,3,8,3,1817,4668,2105,-2563
2019,3,8,4,1745,4711,2124,-2587
2019,3,8,5,1849,4609,2030,-2579
2019,3,8,6,1651,4373,1970,-2403
2019,3,8,7,1721,4040,1883,-2157
2019,3,8,8,1625,3802,1801,-2001
2019,3,8,9,1672,3597,1721,-1876
2019,3,8,10,1653,3528,1706,-1822
2019,3,8,11,1610,3543,1692,-1851
2019,3,8,12,1627,3624,1701,-1923
2019,3,8,13,1771,3888,1712,-2176
2019,3,8,14,1784,4215,1775,-2440
2019,3,8,15,1776,4617,1854,-2763
2019,3,8,16,1964,4793,1789,-3004
2019,3,8,17,1886,4762,1789,-2973
2019,3,8,18,1758,4695,1770,-2925
2019,3,8,19,1856,4588,1693,-2895
2019,3,8,20,1744,4500,1723,-2777
2019,3,8,21,1657,4436,1619,-2817
2019,3,8,22,1599,4323,1580,-2743
2019,3,8,23,1581,4239,1581,-2658
2019,3,9,0,1643,4210,1582,-2628
2019,3,9,1,1700,4265,1652,-2613
2019,3,9,2,1852,4385,1776,-2609
2019,3,9,3,2022,4589,1948,-2641
2019,3,9,4,1901,4586,1933,-2653
2019,3,9,5,1798,4535,1884,-2651
2019,3,9,6,1674,4364,1795,-2569
2019,3,9,7,1771,4138,1764,-2374
2019,3,9,8,1563,3927,1739,-2188
2019,3,9,9,1689,3793,1708,-2085
2019,3,9,10,1660,3756,1667,-2089
2019,3,9,11,1672,3750,1773,-1977
2019,3,9,12,1690,3784,1804,-1980
2019,3,9,13,1642,3881,1835,-2046
2019,3,9,14,1713,4048,1797,-2251
2019,3,9,15,1442,4271,1514,-2757
2019,3,9,16,1459,4494,1446,-3048
2019,3,9,17,1542,4613,1440,-3173
2019,3,9,18,1522,4524,1410,-3114
2019,3,9,19,1362,4386,1497,-2889
2019,3,9,20,1217,4210,1450,-2760
2019,3,9,21,1130,4046,1416,-2630
2019,3,9,22,1130,3909,1461,-2448
2019,3,9,23,1130,3800,1452,-2348
2019,3,10,0,1129,3747,1462,-2285
2019,3,10,1,1167,3806,1495,-2311
2019,3,10,2,1303,3965,1509,-2456
2019,3,10,3,1471,4207,1549,-2658
2019,3,10,4,1465,4248,1487,-2761
2019,3,10,5,1458,4236,1510,-2726
2019,3,10,6,1300,4133,1519,-2614
2019,3,10,7,1551,3939,1572,-2367
2019,3,10,8,1615,3779,1684,-2095
2019,3,10,9,1596,3636,1814,-1822
2019,3,10,10,1569,3629,1744,-1885
2019,3,10,11,1569,3646,1621,-2025
2019,3,10,12,1593,3739,1633,-2106
2019,3,10,13,1731,3904,1688,-2216
2019,3,10,14,1864,4110,1710,-2400
2019,3,10,15,1832,4335,1770,-2565
2019,3,10,16,1900,4510,1950,-2560
2019,3,10,17,2010,4524,1995,-2529
2019,3,10,18,1911,4414,1884,-2530
2019,3,10,19,1734,4198,1763,-2435
2019,3,10,20,1675,4022,1711,-2311
2019,3,10,21,1672,3880,1740,-2140
2019,3,10,22,1672,3747,1724,-2023
2019,3,10,23,1671,3673,1743,-1930
2019,3,11,0,1671,3704,1799,-1905
2019,3,11,1,1779,3814,1920,-1894
2019,3,11,2,1907,3934,1980,-1954
2019,3,11,3,1917,4217,2126,-2091
2019,3,11,4,1739,4238,2161,-2077
2019,3,11,5,1694,4104,2100,-2004
2019,3,11,6,1712,3842,1998,-1844
2019,3,11,7,1708,3602,1896,-1706
2019,3,11,8,1841,3469,1949,-1520
2019,3,11,9,1787,3429,1916,-1513
2019,3,11,10,1830,3456,1889,-1567
2019,3,11,11,1857,3564,1894,-1670
2019,3,11,12,1760,3740,1857,-1883
2019,3,11,13,1869,4089,1978,-2111
2019,3,11,14,2009,4570,2041,-2529
2019,3,11,15,2172,4864,2119,-2745
2019,3,11,16,1992,4801,1936,-2865
2019,3,11,17,2130,4590,1838,-2752
2019,3,11,18,1826,4416,1742,-2674
2019,3,11,19,1878,4299,1825,-2474
2019,3,11,20,1787,4208,1916,-2292
2019,3,11,21,1852,4129,1946,-2183
2019,3,11,22,1778,4096,1905,-2191
2019,3,11,23,1632,4079,1913,-2166
2019,3,12,0,1661,4127,1792,-2335
2019,3,12,1,1880,4296,1857,-2439
2019,3,12,2,1937,4402,1961,-2441
2019,3,12,3,1902,4471,2033,-2438
2019,3,12,4,1830,4378,1950,-2428
2019,3,12,5,1657,4151,1975,-2176
2019,3,12,6,1772,3891,2143,-1748
2019,3,12,7,1675,3566,1967,-1599
2019,3,12,8,2047,3329,1919,-1410
2019,3,12,9,2002,3226,1995,-1231
2019,3,12,10,1990,3205,1944,-1261
2019,3,12,11,2031,3251,2000,-1251
2019,3,12,12,2010,3491,2102,-1389
2019,3,12,13,2078,3814,2155,-1659
2019,3,12,14,2243,4226,2178,-2048
2019,3,12,15,2091,4498,2218,-2280
2019,3,12,16,2189,4547,2296,-2251
2019,3,12,17,2396,4415,2291,-2124
2019,3,12,18,2348,4333,2246,-2087
2019,3,12,19,2348,4281,2096,-2185
2019,3,12,20,2082,4234,2114,-2120
2019,3,12,21,2192,4153,2012,-2141
2019,3,12,22,2143,4017,1944,-2073
2019,3,12,23,2118,3891,1782,-2109
2019,3,13,0,2173,3967,1997,-1970
2019,3,13,1,2261,4097,2222,-1875
2019,3,13,2,2269,4231,2422,-1809
2019,3,13,3,2428,4398,2481,-1917
2019,3,13,4,2428,4387,2418,-1969
2019,3,13,5,2095,4205,2324,-1881
2019,3,13,6,2142,3871,2192,-1679
2019,3,13,7,1918,3568,2123,-1445
2019,3,13,8,1804,3345,2075,-1270
2019,3,13,9,1718,3229,1937,-1292
2019,3,13,10,1726,3214,1939,-1275
2019,3,13,11,1806,3282,1931,-1351
2019,3,13,12,1923,3504,2012,-1492
2019,3,13,13,2026,3851,2071,-1780
2019,3,13,14,2109,4310,2067,-2243
2019,3,13,15,2217,4621,2129,-2492
2019,3,13,16,2284,4541,2114,-2427
2019,3,13,17,2063,4402,1928,-2474
2019,3,13,18,2106,4266,1904,-2362
2019,3,13,19,2021,4099,1785,-2314
2019,3,13,20,1947,3985,1677,-2308
2019,3,13,21,2050,3882,1639,-2243
2019,3,13,22,2000,3807,1676,-2131
2019,3,13,23,1993,3755,1676,-2079
2019,3,14,0,1912,3733,1663,-2070
2019,3,14,1,2125,3836,2009,-1827
2019,3,14,2,2189,3986,2258,-1728
2019,3,14,3,2254,4197,2372,-1825
2019,3,14,4,2206,4204,2338,-1866
2019,3,14,5,2126,4042,2265,-1777
2019,3,14,6,2184,3783,2263,-1520
2019,3,14,7,2085,3559,2159,-1400
2019,3,14,8,1801,3314,1928,-1386
2019,3,14,9,1825,3308,1970,-1338
2019,3,14,10,1873,3273,2012,-1261
2019,3,14,11,1936,3357,2083,-1274
2019,3,14,12,2107,3527,2224,-1303
2019,3,14,13,2225,3851,2407,-1444
2019,3,14,14,2325,4309,2460,-1849
2019,3,14,15,2179,4574,2436,-2138
2019,3,14,16,2322,4531,2299,-2232
2019,3,14,17,2297,4450,2225,-2225
2019,3,14,18,2226,4295,2131,-2164
2019,3,14,19,2110,4096,2027,-2069
2019,3,14,20,2248,3936,1974,-1962
2019,3,14,21,2173,3839,1915,-1924
2019,3,14,22,2097,3727,1834,-1893
2019,3,14,23,1919,3697,1884,-1813
2019,3,15,0,1922,3771,1853,-1918
2019,3,15,1,2066,3874,1947,-1927
2019,3,15,2,1982,3995,2232,-1763
2019,3,15,3,2170,4107,2255,-1852
2019,3,15,4,2173,4077,2303,-1774
2019,3,15,5,2112,3807,2167,-1640
2019,3,15,6,2177,3487,2147,-1340
2019,3,15,7,1955,3205,2090,-1115
2019,3,15,8,1746,3038,1879,-1159
2019,3,15,9,1714,2977,1821,-1156
2019,3,15,10,1716,2970,1791,-1179
2019,3,15,11,1740,3056,1793,-1263
2019,3,15,12,1823,3220,1834,-1386
2019,3,15,13,2053,3544,2006,-1538
2019,3,15,14,2086,4036,2062,-1974
2019,3,15,15,2122,4306,2078,-2228
2019,3,15,16,2122,4282,2071,-2211
2019,3,15,17,2072,4117,2024,-2093
2019,3,15,18,2053,3960,1881,-2079
2019,3,15,19,1997,3808,1840,-1968
2019,3,15,20,1848,3707,1660,-2047
2019,3,15,21,1923,3577,1674,-1903
2019,3,15,22,1673,3453,1597,-1856
2019,3,15,23,1628,3382,1571,-1811
2019,3,16,0,1647,3380,1618,-1762
2019,3,16,1,1833,3452,1773,-1679
2019,3,16,2,1868,3524,1937,-1587
2019,3,16,3,1833,3666,2035,-1631
2019,3,16,4,1950,3689,1804,-1885
2019,3,16,5,1741,3597,1804,-1793
2019,3,16,6,2046,3406,1814,-1592
2019,3,16,7,1784,3143,1720,-1423
2019,3,16,8,1582,2989,1631,-1358
2019,3,16,9,1531,2917,1630,-1287
2019,3,16,10,1521,2889,1530,-1359
2019,3,16,11,1536,2914,1532,-1382
2019,3,16,12,1571,3032,1690,-1342
2019,3,16,13,1726,3183,1692,-1491
2019,3,16,14,1593,3408,1680,-1728
2019,3,16,15,1712,3672,1790,-1882
2019,3,16,16,1754,3872,1844,-2028
2019,3,16,17,1745,3876,1779,-2097
2019,3,16,18,1720,3823,1767,-2056
2019,3,16,19,1774,3754,1791,-1963
2019,3,16,20,1675,3588,1711,-1877
2019,3,16,21,1546,3460,1559,-1901
2019,3,16,22,1493,3258,1334,-1924
2019,3,16,23,1493,3216,1304,-1912
2019,3,17,0,1492,3306,1633,-1673
2019,3,17,1,1492,3366,1772,-1594
2019,3,17,2,1523,3420,1835,-1585
2019,3,17,3,1605,3544,1850,-1694
2019,3,17,4,1616,3532,1770,-1762
2019,3,17,5,1619,3435,1759,-1676
2019,3,17,6,1839,3294,1808,-1486
2019,3,17,7,1677,3116,1763,-1353
2019,3,17,8,1636,3036,1806,-1230
2019,3,17,9,1631,2962,1825,-1137
2019,3,17,10,1624,2973,1829,-1144
2019,3,17,11,1616,3026,1911,-1115
2019,3,17,12,1603,3108,1957,-1151
2019,3,17,13,1653,3250,1956,-1294
2019,3,17,14,1514,3483,1930,-1553
2019,3,17,15,1669,3734,1951,-1783
2019,3,17,16,1841,3911,1905,-2006
2019,3,17,17,1839,3922,1892,-2030
2019,3,17,18,1617,3818,1882,-1936
2019,3,17,19,1554,3587,1659,-1928
2019,3,17,20,1552,3467,1682,-1785
2019,3,17,21,1505,3363,1604,-1759
2019,3,17,22,1502,3287,1610,-1677
2019,3,17,23,1503,3237,1520,-1717
2019,3,18,0,1546,3372,1653,-1719
2019,3,18,1,1661,3454,1709,-1745
2019,3,18,2,1711,3549,1804,-1745
2019,3,18,3,1832,3675,1888,-1787
2019,3,18,4,1855,3723,1834,-1889
2019,3,18,5,1723,3595,1868,-1727
2019,3,18,6,1861,3334,1845,-1489
2019,3,18,7,1629,3079,1806,-1273
2019,3,18,8,1425,2946,1701,-1245
2019,3,18,9,1437,2937,1738,-1199
2019,3,18,10,1446,2915,1713,-1202
2019,3,18,11,1499,3002,1787,-1215
2019,3,18,12,1679,3187,1849,-1338
2019,3,18,13,1880,3534,1930,-1604
2019,3,18,14,1917,3981,2021,-1960
2019,3,18,15,1934,4264,2162,-2102
2019,3,18,16,1991,4209,2038,-2171
2019,3,18,17,1996,4079,1872,-2207
2019,3,18,18,1994,3895,1971,-1924
2019,3,18,19,1853,3756,2042,-1714
2019,3,18,20,1683,3629,1975,-1654
2019,3,18,21,1638,3560,1994,-1566
2019,3,18,22,1652,3438,1904,-1534
2019,3,18,23,1632,3424,1835,-1589
2019,3,19,0,1652,3427,1815,-1612
2019,3,19,1,1681,3549,1913,-1636
2019,3,19,2,1716,3569,1992,-1577
2019,3,19,3,1811,3652,1931,-1721
2019,3,19,4,1787,3681,1959,-1722
2019,3,19,5,1656,3506,1982,-1524
2019,3,19,6,1757,3230,1975,-1255
2019,3,19,7,1617,2996,1908,-1088
2019,3,19,8,1555,2865,1900,-965
2019,3,19,9,1537,2804,1892,-912
2019,3,19,10,1503,2800,1851,-949
2019,3,19,11,1559,2855,1869,-986
2019,3,19,12,1493,3044,1909,-1135
2019,3,19,13,2068,3357,2054,-1303
2019,3,19,14,1923,3781,2081,-1700
2019,3,19,15,2093,4036,2150,-1886
2019,3,19,16,2166,3976,2177,-1799
2019,3,19,17,1926,3853,2113,-1740
2019,3,19,18,1862,3738,2142,-1596
2019,3,19,19,1757,3717,2099,-1618
2019,3,19,20,1694,3583,1948,-1635
2019,3,19,21,1670,3539,1934,-1605
2019,3,19,22,1800,3514,1970,-1544
2019,3,19,23,1791,3506,2001,-1505
2019,3,20,0,1795,3511,1961,-1550
2019,3,20,1,1724,3565,1997,-1568
2019,3,20,2,1749,3580,2039,-1541
2019,3,20,3,1827,3669,2153,-1516
2019,3,20,4,1823,3671,2100,-1571
2019,3,20,5,1647,3455,2049,-1406
2019,3,20,6,1809,3155,1996,-1159
2019,3,20,7,1556,2889,1883,-1006
2019,3,20,8,1661,2761,1955,-806
2019,3,20,9,1633,2678,1882,-796
2019,3,20,10,1830,2641,1849,-792
2019,3,20,11,1869,2664,1890,-774
2019,3,20,12,1735,2815,1999,-816
2019,3,20,13,2057,3125,2343,-782
2019,3,20,14,2133,3547,2402,-1145
2019,3,20,15,2364,3795,2504,-1291
2019,3,20,16,2244,3760,2530,-1230
2019,3,20,17,2159,3633,2386,-1247
2019,3,20,18,2222,3561,2250,-1311
2019,3,20,19,1988,3469,2180,-1289
2019,3,20,20,1966,3486,2257,-1229
2019,3,20,21,2105,3513,2339,-1174
2019,3,20,22,2100,3463,2335,-1128
2019,3,20,23,2098,3453,2253,-1200
2019,3,21,0,1997,3429,2169,-1260
2019,3,21,1,1991,3487,2060,-1427
2019,3,21,2,2010,3505,2182,-1323
2019,3,21,3,2087,3567,2181,-1386
2019,3,21,4,2202,3601,2260,-1341
2019,3,21,5,2044,3405,2166,-1239
2019,3,21,6,1993,3138,2184,-954
2019,3,21,7,1900,2869,2021,-848
2019,3,21,8,1597,2723,1672,-1051
2019,3,21,9,1515,2641,1638,-1003
2019,3,21,10,1559,2630,1666,-964
2019,3,21,11,1517,2630,1646,-984
2019,3,21,12,1688,2798,1685,-1113
2019,3,21,13,2049,3079,1836,-1243
2019,3,21,14,2174,3497,1915,-1582
2019,3,21,15,2314,3787,2167,-1620
2019,3,21,16,2061,3720,2027,-1693
2019,3,21,17,1974,3619,1927,-1692
2019,3,21,18,1887,3563,1891,-1672
2019,3,21,19,1787,3528,1982,-1546
2019,3,21,20,1725,3439,1851,-1588
2019,3,21,21,1819,3401,1865,-1536
2019,3,21,22,1642,3352,1836,-1516
2019,3,21,23,1655,3313,1736,-1577
2019,3,22,0,1641,3370,1835,-1535
2019,3,22,1,1763,3449,1863,-1586
2019,3,22,2,1786,3546,1921,-1625
2019,3,22,3,1870,3637,2002,-1635
2019,3,22,4,1886,3658,1995,-1663
2019,3,22,5,1593,3520,2138,-1382
2019,3,22,6,1904,3259,2116,-1143
2019,3,22,7,1648,3029,1748,-1281
2019,3,22,8,1350,2838,1448,-1390
2019,3,22,9,1322,2754,1398,-1356
2019,3,22,10,1273,2732,1350,-1382
2019,3,22,11,1235,2767,1393,-1374
2019,3,22,12,1373,2938,1480,-1458
2019,3,22,13,1296,3216,1471,-1745
2019,3,22,14,1549,3561,1328,-2233
2019,3,22,15,1516,3841,1572,-2269
2019,3,22,16,1532,3831,1457,-2374
2019,3,22,17,1513,3682,1366,-2316
2019,3,22,18,1406,3592,1481,-2111
2019,3,22,19,1393,3547,1398,-2149
2019,3,22,20,1287,3491,1394,-2097
2019,3,22,21,1211,3414,1492,-1922
2019,3,22,22,1200,3394,1521,-1873
2019,3,22,23,1215,3407,1494,-1913
2019,3,23,0,1215,3454,1435,-2019
2019,3,23,1,1261,3488,1482,-2006
2019,3,23,2,1272,3513,1559,-1954
2019,3,23,3,1291,3606,1743,-1863
2019,3,23,4,1321,3577,1661,-1916
2019,3,23,5,1351,3415,1584,-1831
2019,3,23,6,1265,3205,1606,-1599
2019,3,23,7,1142,2974,1502,-1472
2019,3,23,8,1229,2853,1551,-1302
2019,3,23,9,1257,2776,1568,-1208
2019,3,23,10,1227,2743,1530,-1213
2019,3,23,11,1289,2750,1471,-1279
2019,3,23,12,1341,2820,1491,-1329
2019,3,23,13,1319,2939,1438,-1501
2019,3,23,14,1256,3095,1355,-1740
2019,3,23,15,1397,3327,1464,-1863
2019,3,23,16,1456,3516,1462,-2054
2019,3,23,17,1603,3549,1406,-2143
2019,3,23,18,1551,3490,1411,-2079
2019,3,23,19,1465,3403,1334,-2069
2019,3,23,20,1359,3305,1278,-2027
2019,3,23,21,1275,3203,1274,-1929
2019,3,23,22,1336,3135,1286,-1849
2019,3,23,23,1287,3099,1255,-1844
2019,3,24,0,1252,3103,1277,-1826
2019,3,24,1,1316,3234,1491,-1743
2019,3,24,2,1380,3276,1516,-1760
2019,3,24,3,1501,3385,1476,-1909
2019,3,24,4,1461,3365,1405,-1960
2019,3,24,5,1419,3221,1277,-1944
2019,3,24,6,1432,3067,1280,-1787
2019,3,24,7,1379,2890,1294,-1596
2019,3,24,8,1378,2833,1442,-1391
2019,3,24,9,1288,2776,1559,-1217
2019,3,24,10,1397,2744,1602,-1142
2019,3,24,11,1408,2764,1717,-1047
2019,3,24,12,1313,2833,1762,-1071
2019,3,24,13,1365,2957,1721,-1236
2019,3,24,14,1280,3185,1770,-1415
2019,3,24,15,1497,3396,1813,-1583
2019,3,24,16,1700,3550,1586,-1964
2019,3,24,17,1608,3639,1410,-2229
2019,3,24,18,1543,3624,1392,-2232
2019,3,24,19,1433,3581,1426,-2155
2019,3,24,20,1374,3493,1288,-2205
2019,3,24,21,1267,3419,1287,-2132
2019,3,24,22,1208,3327,1251,-2076
2019,3,24,23,1189,3314,1241,-2073
2019,3,25,0,1249,3333,1339,-1994
2019,3,25,1,1377,3433,1606,-1827
2019,3,25,2,1465,3142,1468,-1674
2019,3,25,3,1637,3169,1415,-1754
2019,3,25,4,1728,3206,1400,-1806
2019,3,25,5,1597,3040,1334,-1706
2019,3,25,6,1642,2804,1275,-1529
2019,3,25,7,1513,2585,1283,-1302
2019,3,25,8,1301,2424,1240,-1184
2019,3,25,9,1279,2385,1240,-1145
2019,3,25,10,1356,2371,1281,-1090
2019,3,25,11,1464,2434,1286,-1148
2019,3,25,12,1463,2605,1321,-1284
2019,3,25,13,1596,2987,1421,-1566
2019,3,25,14,1632,3410,1514,-1896
2019,3,25,15,1641,3545,1420,-2125
2019,3,25,16,1657,3566,1541,-2025
2019,3,25,17,1419,3392,1387,-2005
2019,3,25,18,1291,3277,1319,-1958
2019,3,25,19,1805,3225,1357,-1868
2019,3,25,20,1723,3374,1582,-1792
2019,3,25,21,1513,3379,1670,-1709
2019,3,25,22,1501,3393,1730,-1663
2019,3,25,23,1490,3453,1556,-1897
2019,3,26,0,1600,3581,1558,-2023
2019,3,26,1,1679,3777,1648,-2129
2019,3,26,2,1770,3945,1713,-2232
2019,3,26,3,1786,3977,1695,-2282
2019,3,26,4,1778,3962,1685,-2277
2019,3,26,5,1650,3743,1733,-2010
2019,3,26,6,1787,3479,1844,-1635
2019,3,26,7,1416,3231,1874,-1357
2019,3,26,8,1511,3053,1897,-1156
2019,3,26,9,1465,2942,1946,-996
2019,3,26,10,1584,2969,1920,-1049
2019,3,26,11,1707,3028,1973,-1055
2019,3,26,12,1657,3148,1979,-1169
2019,3,26,13,2002,3470,1997,-1473
2019,3,26,14,1699,3898,2079,-1819
2019,3,26,15,1897,4143,2281,-1862
2019,3,26,16,1790,4097,2228,-1869
2019,3,26,17,1705,3899,2033,-1866
2019,3,26,18,1650,3752,1735,-2017
2019,3,26,19,1611,3631,1568,-2063
2019,3,26,20,1583,3547,1396,-2151
2019,3,26,21,1557,3467,1406,-2061
2019,3,26,22,1536,3459,1473,-1986
2019,3,26,23,1534,3424,1418,-2006
2019,3,27,0,1606,3474,1600,-1874
2019,3,27,1,1677,3566,1805,-1761
2019,3,27,2,1732,3621,1860,-1761
2019,3,27,3,1868,3720,1664,-2056
2019,3,27,4,1888,3754,1663,-2091
2019,3,27,5,1754,3597,1711,-1886
2019,3,27,6,1763,3374,1795,-1579
2019,3,27,7,1676,3145,1745,-1400
2019,3,27,8,1601,2996,1699,-1297
2019,3,27,9,1584,2947,1658,-1289
2019,3,27,10,1578,2955,1554,-1401
2019,3,27,11,1632,3016,1572,-1444
2019,3,27,12,1517,3198,1636,-1562
2019,3,27,13,1872,3546,1780,-1766
2019,3,27,14,1800,3944,1843,-2101
2019,3,27,15,2033,4160,1950,-2210
2019,3,27,16,1966,4106,2015,-2091
2019,3,27,17,1813,3898,1978,-1920
2019,3,27,18,1749,3684,1807,-1877
2019,3,27,19,1616,3545,1725,-1820
2019,3,27,20,1571,3496,1660,-1836
2019,3,27,21,1569,3434,1585,-1849
2019,3,27,22,1546,3383,1556,-1827
2019,3,27,23,1496,3394,1575,-1819
2019,3,28,0,1477,3453,1616,-1837
2019,3,28,1,1665,3575,1678,-1897
2019,3,28,2,1554,3653,1725,-1928
2019,3,28,3,1746,3684,1557,-2127
2019,3,28,4,1736,3678,1569,-2109
2019,3,28,5,1700,3477,1572,-1905
2019,3,28,6,1723,3204,1568,-1636
2019,3,28,7,1546,2937,1549,-1388
2019,3,28,8,1330,2793,1506,-1287
2019,3,28,9,1261,2715,1416,-1299
2019,3,28,10,1234,2674,1386,-1288
2019,3,28,11,1332,2711,1357,-1354
2019,3,28,12,1435,2876,1362,-1514
2019,3,28,13,1508,3190,1462,-1728
2019,3,28,14,1566,3595,1500,-2095
2019,3,28,15,1507,3856,1649,-2207
2019,3,28,16,1527,3807,1612,-2195
2019,3,28,17,1577,3669,1518,-2151
2019,3,28,18,1610,3563,1407,-2156
2019,3,28,19,1521,3446,1308,-2138
2019,3,28,20,1425,3340,1169,-2171
2019,3,28,21,1353,3259,1107,-2152
2019,3,28,22,1308,3203,1047,-2156
2019,3,28,23,1343,3152,1019,-2133
2019,3,29,0,1378,3197,1056,-2141
2019,3,29,1,1362,3312,1383,-1929
2019,3,29,2,1403,3347,1588,-1759
2019,3,29,3,1481,3484,1679,-1805
2019,3,29,4,1387,3559,1706,-1853
2019,3,29,5,1416,3411,1526,-1885
2019,3,29,6,1639,3146,1651,-1495
2019,3,29,7,1436,2832,1462,-1370
2019,3,29,8,1316,2697,1383,-1314
2019,3,29,9,1281,2637,1378,-1259
2019,3,29,10,1282,2610,1358,-1252
2019,3,29,11,1326,2662,1359,-1303
2019,3,29,12,1484,2815,1411,-1404
2019,3,29,13,1408,3158,1626,-1532
2019,3,29,14,1505,3575,1627,-1948
2019,3,29,15,1479,3801,1639,-2162
2019,3,29,16,1602,3743,1500,-2243
2019,3,29,17,1354,3578,1344,-2234
2019,3,29,18,1500,3450,1273,-2177
2019,3,29,19,1356,3296,1206,-2090
2019,3,29,20,1271,3192,1005,-2187
2019,3,29,21,1227,3124,954,-2170
2019,3,29,22,1179,3061,994,-2067
2019,3,29,23,1116,3002,896,-2106
2019,3,30,0,1119,3044,938,-2106
2019,3,30,1,1226,3149,1184,-1965
2019,3,30,2,1151,3192,1589,-1603
2019,3,30,3,1156,3261,1730,-1531
2019,3,30,4,1159,3275,1643,-1632
2019,3,30,5,1242,3206,1503,-1703
2019,3,30,6,1507,3029,1640,-1389
2019,3,30,7,1324,2749,1430,-1319
2019,3,30,8,976,2607,1330,-1277
2019,3,30,9,963,2519,1302,-1217
2019,3,30,10,934,2494,1056,-1438
2019,3,30,11,926,2516,1019,-1497
2019,3,30,12,1014,2713,1179,-1534
2019,3,30,13,949,2888,1252,-1636
2019,3,30,14,1032,3097,1214,-1883
2019,3,30,15,1059,3329,1227,-2102
2019,3,30,16,1115,3463,1275,-2188
2019,3,30,17,1212,3433,1282,-2151
2019,3,30,18,1084,3340,1287,-2053
2019,3,30,19,1045,3218,1269,-1949
2019,3,30,20,826,3090,1102,-1988
2019,3,30,21,871,3021,1122,-1899
2019,3,30,22,824,2864,932,-1932
2019,3,30,23,871,2833,928,-1905
2019,3,31,0,901,2856,1024,-1832
2019,3,31,1,928,2866,988,-1878
2019,3,31,2,914,2888,1038,-1850
2019,3,31,3,875,2927,1073,-1854
2019,3,31,4,968,3000,1039,-1961
2019,3,31,5,843,2960,1095,-1865
2019,3,31,6,973,2801,1133,-1668
2019,3,31,7,802,2432,847,-1585
2019,3,31,8,626,2463,971,-1492
2019,3,31,9,704,2397,954,-1443
2019,3,31,10,666,2374,809,-1565
2019,3,31,11,719,2397,670,-1727
2019,3,31,12,742,2507,715,-1792
2019,3,31,13,714,2662,747,-1915
2019,3,31,14,545,2866,914,-1952
2019,3,31,15,711,3078,818,-2260
2019,3,31,16,892,3256,859,-2397
2019,3,31,17,932,3265,881,-2384
2019,3,31,18,862,3195,895,-2300
2019,3,31,19,751,3090,858,-2232
2019,3,31,20,667,3011,756,-2255
2019,3,31,21,604,2915,700,-2215
2019,3,31,22,547,2857,690,-2167
2019,3,31,23,547,2824,665,-2159
2019,4,1,0,547,2865,719,-2146
2019,4,1,1,547,2995,923,-2072
2019,4,1,2,550,3053,906,-2147
2019,4,1,3,594,3155,970,-2185
2019,4,1,4,632,3218,1020,-2198
2019,4,1,5,575,3062,979,-2083
2019,4,1,6,686,2842,942,-1900
2019,4,1,7,737,2600,1006,-1594
2019,4,1,8,1051,2464,999,-1465
2019,4,1,9,1006,2418,1064,-1354
2019,4,1,10,1131,2408,1205,-1203
2019,4,1,11,1156,2433,1219,-1214
2019,4,1,12,1217,2591,1273,-1318
2019,4,1,13,1382,2906,1502,-1404
2019,4,1,14,1439,3314,1574,-1740
2019,4,1,15,1505,3550,1622,-1928
2019,4,1,16,1483,3482,1582,-1900
2019,4,1,17,1444,3230,1433,-1797
2019,4,1,18,1358,3078,1548,-1530
2019,4,1,19,1274,3176,1618,-1558
2019,4,1,20,1218,3189,1574,-1615
2019,4,1,21,1202,3134,1476,-1658
2019,4,1,22,1201,3058,1395,-1663
2019,4,1,23,1199,3065,1471,-1594
2019,4,2,0,1250,3107,1434,-1673
2019,4,2,1,1320,3204,1546,-1658
2019,4,2,2,1296,3189,1519,-1670
2019,4,2,3,1355,3263,1573,-1690
2019,4,2,4,1409,3288,1566,-1722
2019,4,2,5,1237,3111,1509,-1602
2019,4,2,6,1352,2879,1581,-1298
2019,4,2,7,1219,2649,1614,-1035
2019,4,2,8,1579,2431,1573,-858
2019,4,2,9,1577,2351,1535,-816
2019,4,2,10,1451,2322,1516,-806
2019,4,2,11,1595,2363,1553,-810
2019,4,2,12,1609,2490,1684,-806
2019,4,2,13,1704,2780,1839,-941
2019,4,2,14,1713,3145,1965,-1180
2019,4,2,15,1917,3328,1992,-1336
2019,4,2,16,1910,3327,1965,-1362
2019,4,2,17,1824,3265,2006,-1259
2019,4,2,18,1799,3221,1923,-1298
2019,4,2,19,1737,3153,1847,-1306
2019,4,2,20,1741,3107,1776,-1331
2019,4,2,21,1716,3113,1784,-1329
2019,4,2,22,1634,3063,1611,-1452
2019,4,2,23,1610,3050,1680,-1370
2019,4,3,0,1648,3083,1635,-1448
2019,4,3,1,1682,3146,1761,-1385
2019,4,3,2,1760,3231,1930,-1301
2019,4,3,3,1797,3286,1946,-1340
2019,4,3,4,1793,3266,1908,-1358
2019,4,3,5,1606,3057,1811,-1246
2019,4,3,6,1664,2820,1861,-959
2019,4,3,7,1495,2578,1666,-912
2019,4,3,8,1627,2406,1572,-834
2019,4,3,9,1567,2328,1599,-729
2019,4,3,10,1564,2317,1646,-671
2019,4,3,11,1563,2317,1619,-698
2019,4,3,12,1573,2382,1622,-760
2019,4,3,13,1687,2615,1723,-892
2019,4,3,14,1678,2943,1712,-1231
2019,4,3,15,1860,3211,1876,-1335
2019,4,3,16,1964,3271,1910,-1361
2019,4,3,17,1865,3268,1834,-1434
2019,4,3,18,1634,3263,1809,-1454
2019,4,3,19,1679,3221,1792,-1429
2019,4,3,20,1634,3188,1836,-1352
2019,4,3,21,1656,3138,1841,-1297
2019,4,3,22,1678,3102,1750,-1352
2019,4,3,23,1700,3096,1875,-1221
2019,4,4,0,1717,3167,1975,-1192
2019,4,4,1,1731,3255,2090,-1165
2019,4,4,2,1756,3324,2107,-1217
2019,4,4,3,1791,3367,2159,-1208
2019,4,4,4,1772,3394,2171,-1223
2019,4,4,5,1774,3202,2126,-1076
2019,4,4,6,1807,2939,2125,-814
2019,4,4,7,1781,2680,1991,-689
2019,4,4,8,1837,2537,1844,-693
2019,4,4,9,1822,2498,1820,-678
2019,4,4,10,1730,2533,1786,-747
2019,4,4,11,1482,2547,1903,-644
2019,4,4,12,1874,2709,1959,-750
2019,4,4,13,1977,2996,2089,-907
2019,4,4,14,2052,3319,2118,-1201
2019,4,4,15,2131,3465,2066,-1399
2019,4,4,16,2108,3541,2226,-1315
2019,4,4,17,2001,3438,2164,-1274
2019,4,4,18,2013,3311,2012,-1299
2019,4,4,19,2048,3244,1953,-1291
2019,4,4,20,1814,3165,1852,-1313
2019,4,4,21,1899,3154,1905,-1249
2019,4,4,22,1850,3087,1790,-1297
2019,4,4,23,1828,3069,1866,-1203
2019,4,5,0,1842,3102,1971,-1131
2019,4,5,1,1883,3126,1919,-1207
2019,4,5,2,1760,3179,1850,-1329
2019,4,5,3,1953,3208,1965,-1243
2019,4,5,4,1881,3243,1941,-1302
2019,4,5,5,1751,3088,1923,-1165
2019,4,5,6,1966,2841,1926,-915
2019,4,5,7,1797,2596,1890,-706
2019,4,5,8,1491,2430,1561,-869
2019,4,5,9,1369,2394,1565,-829
2019,4,5,10,1320,2307,1412,-895
2019,4,5,11,1340,2316,1358,-958
2019,4,5,12,1379,2420,1402,-1018
2019,4,5,13,1538,2678,1499,-1179
2019,4,5,14,1597,2972,1499,-1473
2019,4,5,15,1634,3188,1540,-1648
2019,4,5,16,1660,3247,1600,-1647
2019,4,5,17,1620,3250,1591,-1659
2019,4,5,18,1585,3283,1558,-1725
2019,4,5,19,1566,3251,1512,-1739
2019,4,5,20,1551,3288,1544,-1744
2019,4,5,21,1526,3263,1554,-1709
2019,4,5,22,1620,3281,1622,-1659
2019,4,5,23,1464,3270,1613,-1657
2019,4,6,0,1489,3247,1546,-1701
2019,4,6,1,1428,3257,1669,-1588
2019,4,6,2,1450,3264,1894,-1370
2019,4,6,3,1463,3279,1776,-1503
2019,4,6,4,1296,3333,1558,-1775
2019,4,6,5,1176,3219,1471,-1748
2019,4,6,6,1480,3013,1621,-1392
2019,4,6,7,1355,2788,1507,-1281
2019,4,6,8,1207,2621,1285,-1336
2019,4,6,9,1158,2533,1157,-1376
2019,4,6,10,1258,2505,1131,-1374
2019,4,6,11,1201,2500,1125,-1375
2019,4,6,12,1256,2609,1288,-1321
2019,4,6,13,1250,2802,1436,-1366
2019,4,6,14,1078,3005,1445,-1560
2019,4,6,15,1270,3222,1453,-1769
2019,4,6,16,1333,3418,1399,-2019
2019,4,6,17,1336,3529,1419,-2110
2019,4,6,18,1218,3505,1458,-2047
2019,4,6,19,1094,3328,1410,-1918
2019,4,6,20,1071,3207,1244,-1963
2019,4,6,21,1102,3117,1139,-1978
2019,4,6,22,1104,2987,1251,-1736
2019,4,6,23,1153,2863,1179,-1684
2019,4,7,0,1181,2750,1003,-1747
2019,4,7,1,1288,3004,1134,-1870
2019,4,7,2,1353,3167,1493,-1674
2019,4,7,3,1444,3199,1559,-1640
2019,4,7,4,1408,3199,1429,-1770
2019,4,7,5,1369,3080,1418,-1662
2019,4,7,6,1601,2935,1557,-1378
2019,4,7,7,1443,2751,1503,-1248
2019,4,7,8,1090,2690,1572,-1118
2019,4,7,9,1059,2569,1446,-1123
2019,4,7,10,1315,2505,1429,-1076
2019,4,7,11,1306,2482,1497,-985
2019,4,7,12,1297,2539,1522,-1017
2019,4,7,13,1298,2639,1551,-1088
2019,4,7,14,1299,2853,1559,-1294
2019,4,7,15,1350,2912,1313,-1599
2019,4,7,16,1358,3059,1055,-2004
2019,4,7,17,1373,3153,1109,-2044
2019,4,7,18,1391,3188,1383,-1805
2019,4,7,19,1411,3133,1350,-1783
2019,4,7,20,1382,3094,1261,-1833
2019,4,7,21,1355,3027,1231,-1796
2019,4,7,22,1355,2954,1361,-1593
2019,4,7,23,1348,2908,1381,-1527
2019,4,8,0,1369,2952,1589,-1363
2019,4,8,1,1354,3019,1565,-1454
2019,4,8,2,1341,3077,1533,-1544
2019,4,8,3,1356,3209,1639,-1570
2019,4,8,4,1506,3277,1574,-1703
2019,4,8,5,1421,3201,1695,-1506
2019,4,8,6,1523,3004,1679,-1325
2019,4,8,7,1468,2728,1463,-1265
2019,4,8,8,1157,2597,1497,-1100
2019,4,8,9,1194,2531,1448,-1083
2019,4,8,10,1355,2518,1464,-1054
2019,4,8,11,1364,2467,1365,-1102
2019,4,8,12,1486,2600,1473,-1127
2019,4,8,13,1515,2983,1749,-1234
2019,4,8,14,1657,3311,1732,-1579
2019,4,8,15,1624,3434,1731,-1703
2019,4,8,16,1714,3426,1614,-1812
2019,4,8,17,1607,3403,1678,-1725
2019,4,8,18,1559,3328,1484,-1844
2019,4,8,19,1594,3264,1478,-1786
2019,4,8,20,1536,3250,1631,-1619
2019,4,8,21,1468,3189,1594,-1595
2019,4,8,22,1439,3124,1548,-1576
2019,4,8,23,1393,3105,1503,-1602
2019,4,9,0,1401,3171,1518,-1653
2019,4,9,1,1621,3366,1739,-1627
2019,4,9,2,1493,3400,1788,-1612
2019,4,9,3,1539,3421,1796,-1625
2019,4,9,4,1794,3390,1713,-1677
2019,4,9,5,1619,3224,1602,-1622
2019,4,9,6,1662,2985,1648,-1337
2019,4,9,7,1529,2678,1507,-1171
2019,4,9,8,1028,2542,1051,-1491
2019,4,9,9,915,2459,1002,-1457
2019,4,9,10,843,2434,1112,-1322
2019,4,9,11,903,2268,1033,-1235
2019,4,9,12,666,2341,829,-1512
2019,4,9,13,852,2624,927,-1697
2019,4,9,14,852,2961,979,-1982
2019,4,9,15,1012,3223,1016,-2207
2019,4,9,16,830,3232,1004,-2228
2019,4,9,17,957,3380,1134,-2246
2019,4,9,18,1076,3372,1092,-2280
2019,4,9,19,1051,3278,1024,-2254
2019,4,9,20,1002,3173,1018,-2155
2019,4,9,21,838,3101,1003,-2098
2019,4,9,22,842,3042,1184,-1858
2019,4,9,23,969,2996,1077,-1919
2019,4,10,0,998,3082,1063,-2019
2019,4,10,1,1060,3190,1239,-1951
2019,4,10,2,905,3344,1362,-1982
2019,4,10,3,1175,3383,1387,-1996
2019,4,10,4,1071,3440,1359,-2081
2019,4,10,5,971,3223,1298,-1925
2019,4,10,6,899,2820,1102,-1718
2019,4,10,7,852,2534,1026,-1508
2019,4,10,8,755,2342,929,-1413
2019,4,10,9,723,2251,840,-1411
2019,4,10,10,695,2219,824,-1395
2019,4,10,11,796,2267,916,-1351
2019,4,10,12,694,2442,913,-1529
2019,4,10,13,901,2793,1039,-1754
2019,4,10,14,957,3141,1045,-2096
2019,4,10,15,1084,3502,1183,-2319
2019,4,10,16,1179,3545,1118,-2427
2019,4,10,17,943,3520,1069,-2451
2019,4,10,18,1046,3495,1069,-2426
2019,4,10,19,1006,3505,1082,-2423
2019,4,10,20,989,3475,1141,-2334
2019,4,10,21,963,3425,1065,-2360
2019,4,10,22,946,3378,1066,-2312
2019,4,10,23,924,3363,1140,-2223
2019,4,11,0,972,3375,1290,-2085
2019,4,11,1,1000,3475,1387,-2088
2019,4,11,2,1038,3536,1401,-2135
2019,4,11,3,1063,3614,1266,-2348
2019,4,11,4,1146,3618,1336,-2282
2019,4,11,5,984,3438,1299,-2139
2019,4,11,6,1226,3153,1347,-1806
2019,4,11,7,973,2893,1287,-1606
2019,4,11,8,927,2656,1014,-1642
2019,4,11,9,843,2562,904,-1658
2019,4,11,10,785,2521,856,-1665
2019,4,11,11,785,2545,906,-1639
2019,4,11,12,871,2676,1040,-1636
2019,4,11,13,1162,3001,1237,-1764
2019,4,11,14,1228,3373,1403,-1970
2019,4,11,15,1440,3545,1429,-2116
2019,4,11,16,1202,3539,1443,-2096
2019,4,11,17,1182,3515,1473,-2042
2019,4,11,18,1147,3500,1415,-2085
2019,4,11,19,1272,3480,1526,-1954
2019,4,11,20,1216,3454,1384,-2070
2019,4,11,21,1176,3391,1336,-2055
2019,4,11,22,1265,3303,1261,-2042
2019,4,11,23,1273,3259,1118,-2141
2019,4,12,0,1340,3324,1153,-2171
2019,4,12,1,1209,3416,1255,-2161
2019,4,12,2,1240,3471,1402,-2069
2019,4,12,3,1296,3497,1447,-2050
2019,4,12,4,1466,3493,1418,-2075
2019,4,12,5,1373,3313,1290,-2023
2019,4,12,6,1394,3076,1256,-1820
2019,4,12,7,1130,2797,1150,-1647
2019,4,12,8,1038,2613,1054,-1559
2019,4,12,9,1045,2526,1038,-1488
2019,4,12,10,1002,2481,1093,-1388
2019,4,12,11,1053,2500,1104,-1396
2019,4,12,12,1112,2659,1109,-1550
2019,4,12,13,1196,2931,1153,-1778
2019,4,12,14,1120,3259,1223,-2036
2019,4,12,15,1193,3490,1417,-2073
2019,4,12,16,1230,3522,1355,-2167
2019,4,12,17,1184,3487,1232,-2255
2019,4,12,18,1129,3409,1262,-2147
2019,4,12,19,1249,3303,1140,-2163
2019,4,12,20,1196,3230,1127,-2103
2019,4,12,21,1125,3151,1077,-2074
2019,4,12,22,933,3057,1007,-2050
2019,4,12,23,994,3009,984,-2025
2019,4,13,0,1062,3027,1015,-2012
2019,4,13,1,1134,3053,1202,-1851
2019,4,13,2,1164,3102,1564,-1538
2019,4,13,3,1222,3178,1655,-1523
2019,4,13,4,1140,3231,1596,-1635
2019,4,13,5,1263,3150,1429,-1721
2019,4,13,6,1269,2954,1362,-1592
2019,4,13,7,1042,2704,1211,-1493
2019,4,13,8,869,2536,1030,-1506
2019,4,13,9,1002,2461,1057,-1404
2019,4,13,10,946,2416,1070,-1346
2019,4,13,11,1001,2415,1101,-1314
2019,4,13,12,956,2482,1085,-1397
2019,4,13,13,861,2593,1004,-1589
2019,4,13,14,868,2827,1012,-1815
2019,4,13,15,845,3051,1072,-1979
2019,4,13,16,966,3340,1259,-2081
2019,4,13,17,1039,3505,1378,-2127
2019,4,13,18,982,3588,1342,-2246
2019,4,13,19,970,3596,1350,-2246
2019,4,13,20,771,3431,1120,-2311
2019,4,13,21,735,3326,968,-2358
2019,4,13,22,736,3228,864,-2364
2019,4,13,23,742,3177,995,-2182
2019,4,14,0,754,3236,1105,-2131
2019,4,14,1,774,3258,1141,-2117
2019,4,14,2,797,3212,1281,-1931
2019,4,14,3,830,3245,1314,-1931
2019,4,14,4,828,3340,1436,-1904
2019,4,14,5,890,3264,1435,-1829
2019,4,14,6,923,3075,1481,-1594
2019,4,14,7,883,2894,1406,-1488
2019,4,14,8,1051,2725,1372,-1353
2019,4,14,9,1084,2645,1378,-1267
2019,4,14,10,1069,2609,1377,-1232
2019,4,14,11,1077,2602,1347,-1255
2019,4,14,12,1056,2656,1344,-1312
2019,4,14,13,1097,2775,1301,-1474
2019,4,14,14,1052,2940,1295,-1645
2019,4,14,15,1045,3164,1351,-1813
2019,4,14,16,1188,3311,1407,-1904
2019,4,14,17,1125,3356,1380,-1976
2019,4,14,18,1218,3354,1250,-2104
2019,4,14,19,1161,3320,1207,-2113
2019,4,14,20,1105,3242,1281,-1961
2019,4,14,21,1062,3171,1330,-1841
2019,4,14,22,1041,3122,1248,-1874
2019,4,14,23,1050,3151,1363,-1788
2019,4,15,0,1124,3280,1378,-1902
2019,4,15,1,1161,3421,1555,-1866
2019,4,15,2,1178,3444,1646,-1798
2019,4,15,3,1446,3525,1721,-1804
2019,4,15,4,1530,3592,1733,-1859
2019,4,15,5,1268,3422,1702,-1720
2019,4,15,6,1438,3105,1613,-1492
2019,4,15,7,1179,2825,1345,-1480
2019,4,15,8,1309,2681,1369,-1312
2019,4,15,9,1230,2610,1345,-1265
2019,4,15,10,1247,2604,1442,-1162
2019,4,15,11,1333,2665,1454,-1211
2019,4,15,12,1366,2870,1511,-1359
2019,4,15,13,1687,3205,1743,-1462
2019,4,15,14,1737,3664,1993,-1671
2019,4,15,15,2036,3822,2028,-1794
2019,4,15,16,1963,3694,1980,-1714
2019,4,15,17,1838,3536,1948,-1588
2019,4,15,18,1894,3428,1914,-1514
2019,4,15,19,1905,3298,1728,-1570
2019,4,15,20,1652,3215,1773,-1442
2019,4,15,21,1749,3128,1724,-1404
2019,4,15,22,1672,3059,1724,-1335
2019,4,15,23,1625,3098,1815,-1283
2019,4,16,0,1662,3125,1831,-1294
2019,4,16,1,1728,3224,1873,-1351
2019,4,16,2,1594,3326,1987,-1339
2019,4,16,3,1687,3404,2068,-1336
2019,4,16,4,1963,3463,2062,-1401
2019,4,16,5,1652,3301,1946,-1355
2019,4,16,6,1605,2949,1876,-1073
2019,4,16,7,1362,2686,1825,-861
2019,4,16,8,1635,2567,1763,-804
2019,4,16,9,1551,2513,1770,-743
2019,4,16,10,1673,2503,1760,-743
2019,4,16,11,1623,2567,1719,-848
2019,4,16,12,1688,2748,1766,-982
2019,4,16,13,1824,3054,1959,-1095
2019,4,16,14,1775,3419,1971,-1448
2019,4,16,15,1916,3612,1805,-1807
2019,4,16,16,1876,3528,1778,-1750
2019,4,16,17,1628,3420,1789,-1631
2019,4,16,18,1526,3399,1761,-1638
2019,4,16,19,1477,3330,1637,-1693
2019,4,16,20,1540,3315,1634,-1681
2019,4,16,21,1404,3261,1639,-1622
2019,4,16,22,1375,3255,1669,-1586
2019,4,16,23,1414,3259,1645,-1614
2019,4,17,0,1468,3303,1398,-1905
2019,4,17,1,1549,3400,1448,-1952
2019,4,17,2,1562,3477,1646,-1831
2019,4,17,3,1593,3514,1828,-1686
2019,4,17,4,1665,3522,1847,-1675
2019,4,17,5,1666,3318,1857,-1461
2019,4,17,6,1595,3010,1724,-1286
2019,4,17,7,1446,2734,1525,-1209
2019,4,17,8,1139,2579,1180,-1399
2019,4,17,9,1085,2474,1122,-1352
2019,4,17,10,1087,2439,1232,-1207
2019,4,17,11,1251,2497,1272,-1225
2019,4,17,12,1171,2629,1241,-1388
2019,4,17,13,1444,2893,1449,-1444
2019,4,17,14,1365,3310,1557,-1753
2019,4,17,15,1481,3522,1479,-2043
2019,4,17,16,1378,3451,1332,-2119
2019,4,17,17,1360,3428,1431,-1997
2019,4,17,18,1255,3256,1198,-2058
2019,4,17,19,1180,3044,1074,-1970
2019,4,17,20,1162,3019,1220,-1799
2019,4,17,21,1122,2961,1239,-1722
2019,4,17,22,1091,2910,1237,-1673
2019,4,17,23,1105,2872,1085,-1787
2019,4,18,0,1156,2884,1204,-1680
2019,4,18,1,1277,2933,1315,-1618
2019,4,18,2,1358,2997,1440,-1557
2019,4,18,3,1482,3278,1685,-1593
2019,4,18,4,1606,3344,1554,-1790
2019,4,18,5,1523,3193,1642,-1551
2019,4,18,6,1637,2967,1728,-1239
2019,4,18,7,1653,2651,1729,-922
2019,4,18,8,1636,2527,1902,-625
2019,4,18,9,1638,2404,1815,-589
2019,4,18,10,1665,2317,1716,-601
2019,4,18,11,1618,2325,1719,-606
2019,4,18,12,1715,2492,1816,-676
2019,4,18,13,1919,2785,1881,-904
2019,4,18,14,1672,3119,1930,-1189
2019,4,18,15,1775,3313,1934,-1379
2019,4,18,16,1693,3319,1846,-1473
2019,4,18,17,1641,3326,1723,-1603
2019,4,18,18,1618,3299,1660,-1639
2019,4,18,19,1577,3260,1681,-1579
2019,4,18,20,1555,3276,1809,-1467
2019,4,18,21,1523,3197,1771,-1426
2019,4,18,22,1505,3140,1658,-1482
2019,4,18,23,1519,3134,1750,-1384
2019,4,19,0,1543,3128,1746,-1382
2019,4,19,1,1573,3171,1774,-1397
2019,4,19,2,1593,3199,1800,-1399
2019,4,19,3,1604,3239,2044,-1195
2019,4,19,4,1629,3281,1975,-1306
2019,4,19,5,1615,3127,1834,-1293
2019,4,19,6,1878,2895,2072,-823
2019,4,19,7,1657,2598,1873,-725
2019,4,19,8,1510,2460,1726,-734
2019,4,19,9,1472,2343,1755,-588
2019,4,19,10,1555,2281,1746,-535
2019,4,19,11,1518,2314,1698,-616
2019,4,19,12,1464,2413,1674,-739
2019,4,19,13,1589,2659,1811,-848
2019,4,19,14,1633,3036,1875,-1161
2019,4,19,15,1648,3239,1819,-1420
2019,4,19,16,1653,3324,1846,-1478
2019,4,19,17,1697,3335,1803,-1532
2019,4,19,18,1710,3329,1808,-1521
2019,4,19,19,1726,3249,1723,-1526
2019,4,19,20,1731,3187,1787,-1400
2019,4,19,21,1735,3128,1925,-1203
2019,4,19,22,1730,3062,1819,-1243
2019,4,19,23,1738,3072,1859,-1213
2019,4,20,0,1716,3136,1915,-1221
2019,4,20,1,1724,3208,1937,-1271
2019,4,20,2,1638,3211,1900,-1311
2019,4,20,3,1624,3217,1862,-1355
2019,4,20,4,1660,3253,1798,-1455
2019,4,20,5,1630,3187,1772,-1415
2019,4,20,6,1600,2921,1687,-1234
2019,4,20,7,1519,2698,1681,-1017
2019,4,20,8,1411,2511,1510,-1001
2019,4,20,9,1253,2412,1388,-1024
2019,4,20,10,1269,2351,1336,-1015
2019,4,20,11,1274,2410,1414,-996
2019,4,20,12,1283,2463,1409,-1054
2019,4,20,13,1528,2629,1530,-1099
2019,4,20,14,1224,2718,1469,-1249
2019,4,20,15,1560,2974,1575,-1399
2019,4,20,16,1551,3118,1544,-1574
2019,4,20,17,1616,3176,1562,-1614
2019,4,20,18,1461,3103,1455,-1648
2019,4,20,19,1616,3051,1419,-1632
2019,4,20,20,1353,3008,1336,-1672
2019,4,20,21,1261,2923,1283,-1640
2019,4,20,22,1235,2855,1169,-1686
2019,4,20,23,1362,2828,1175,-1653
2019,4,21,0,1198,2834,1130,-1704
2019,4,21,1,1515,2851,1144,-1707
2019,4,21,2,1463,2937,1404,-1533
2019,4,21,3,1318,2998,1674,-1324
2019,4,21,4,1332,3110,1756,-1354
2019,4,21,5,1368,3049,1726,-1323
2019,4,21,6,1586,2892,1686,-1206
2019,4,21,7,1340,2690,1592,-1098
2019,4,21,8,752,2496,944,-1552
2019,4,21,9,783,2391,865,-1526
2019,4,21,10,783,2350,837,-1513
2019,4,21,11,738,2355,831,-1524
2019,4,21,12,679,2410,826,-1584
2019,4,21,13,724,2523,827,-1696
2019,4,21,14,680,2707,853,-1854
2019,4,21,15,799,2892,807,-2085
2019,4,21,16,903,3054,753,-2301
2019,4,21,17,956,3106,718,-2388
2019,4,21,18,771,2965,624,-2341
2019,4,21,19,691,2839,556,-2283
2019,4,21,20,927,2770,594,-2176
2019,4,21,21,892,2704,596,-2108
2019,4,21,22,834,2688,624,-2064
2019,4,21,23,854,2718,756,-1962
2019,4,22,0,799,2731,793,-1938
2019,4,22,1,971,2782,846,-1936
2019,4,22,2,806,2911,1101,-1810
2019,4,22,3,868,3005,1155,-1850
2019,4,22,4,1058,3151,1218,-1933
2019,4,22,5,942,3082,1219,-1863
2019,4,22,6,871,2850,1195,-1655
2019,4,22,7,880,2639,1159,-1480
2019,4,22,8,777,2441,948,-1493
2019,4,22,9,744,2377,929,-1448
2019,4,22,10,689,2308,857,-1451
2019,4,22,11,762,2369,865,-1504
2019,4,22,12,887,2603,1141,-1462
2019,4,22,13,1323,2942,1468,-1474
2019,4,22,14,1315,3336,1522,-1814
2019,4,22,15,1350,3492,1465,-2027
2019,4,22,16,1340,3527,1511,-2016
2019,4,22,17,1198,3404,1363,-2041
2019,4,22,18,1205,3305,1281,-2024
2019,4,22,19,1160,3282,1256,-2026
2019,4,22,20,1184,3226,1185,-2041
2019,4,22,21,1185,3237,1208,-2029
2019,4,22,22,1085,3259,1297,-1962
2019,4,22,23,1007,3290,1297,-1993
2019,4,23,0,1023,3364,1303,-2061
2019,4,23,1,1057,3490,1307,-2183
2019,4,23,2,1108,3501,1469,-2032
2019,4,23,3,1124,3487,1573,-1914
2019,4,23,4,1193,3471,1535,-1936
2019,4,23,5,1121,3258,1260,-1998
2019,4,23,6,1129,2945,1104,-1841
2019,4,23,7,1153,2612,859,-1753
2019,4,23,8,839,2509,960,-1549
2019,4,23,9,765,2437,947,-1490
2019,4,23,10,764,2393,930,-1463
2019,4,23,11,726,2438,1023,-1415
2019,4,23,12,918,2584,1118,-1466
2019,4,23,13,765,2837,1123,-1714
2019,4,23,14,983,3158,1073,-2085
2019,4,23,15,1072,3361,1136,-2225
2019,4,23,16,1002,3336,1115,-2221
2019,4,23,17,989,3291,1189,-2102
2019,4,23,18,932,3220,1137,-2083
2019,4,23,19,969,3145,1115,-2030
2019,4,23,20,929,3116,1223,-1893
2019,4,23,21,899,3099,1277,-1822
2019,4,23,22,870,3010,1207,-1803
2019,4,23,23,866,2980,1273,-1707
2019,4,24,0,895,2994,1276,-1718
2019,4,24,1,957,3087,1347,-1740
2019,4,24,2,1032,3166,1406,-1760
2019,4,24,3,1056,3210,1383,-1827
2019,4,24,4,1145,3350,1432,-1918
2019,4,24,5,1104,3171,1354,-1817
2019,4,24,6,1152,2929,1382,-1547
2019,4,24,7,1153,2638,1349,-1289
2019,4,24,8,920,2465,1245,-1220
2019,4,24,9,967,2365,1192,-1173
2019,4,24,10,1010,2348,1188,-1160
2019,4,24,11,1079,2404,1159,-1245
2019,4,24,12,1074,2646,1123,-1523
2019,4,24,13,1065,2955,1190,-1765
2019,4,24,14,1151,3329,1304,-2025
2019,4,24,15,1165,3511,1238,-2273
2019,4,24,16,1101,3468,1270,-2198
2019,4,24,17,1108,3376,1284,-2092
2019,4,24,18,1041,3291,1321,-1970
2019,4,24,19,1000,3198,1288,-1910
2019,4,24,20,1123,3128,1242,-1886
2019,4,24,21,918,3065,1296,-1769
2019,4,24,22,895,3028,1300,-1728
2019,4,24,23,901,3008,1273,-1735
2019,4,25,0,1002,3025,1388,-1637
2019,4,25,1,1068,3071,1474,-1597
2019,4,25,2,1123,3099,1462,-1637
2019,4,25,3,1127,3131,1437,-1694
2019,4,25,4,1207,3246,1483,-1763
2019,4,25,5,1163,3179,1485,-1694
2019,4,25,6,1262,2934,1521,-1413
2019,4,25,7,1243,2717,1465,-1252
2019,4,25,8,1105,2580,1366,-1214
2019,4,25,9,1029,2527,1221,-1306
2019,4,25,10,1062,2528,1335,-1193
2019,4,25,11,1119,2579,1384,-1195
2019,4,25,12,1473,2745,1613,-1132
2019,4,25,13,1457,3030,1741,-1289
2019,4,25,14,1484,3414,1711,-1703
2019,4,25,15,1788,3558,1771,-1787
2019,4,25,16,1779,3530,1875,-1655
2019,4,25,17,1672,3413,1909,-1504
2019,4,25,18,1573,3352,1813,-1539
2019,4,25,19,1500,3264,1755,-1509
2019,4,25,20,1546,3189,1714,-1475
2019,4,25,21,1414,3129,1692,-1437
2019,4,25,22,1370,3092,1753,-1339
2019,4,25,23,1362,3070,1681,-1389
2019,4,26,0,1438,3111,1668,-1443
2019,4,26,1,1488,3165,1779,-1386
2019,4,26,2,1502,3190,1783,-1407
2019,4,26,3,1616,3219,1792,-1427
2019,4,26,4,1622,3260,1792,-1468
2019,4,26,5,1539,3187,1796,-1391
2019,4,26,6,1575,2907,1764,-1143
2019,4,26,7,1308,2639,1620,-1019
2019,4,26,8,964,2540,1225,-1315
2019,4,26,9,946,2474,1197,-1277
2019,4,26,10,969,2452,1131,-1321
2019,4,26,11,810,2474,1156,-1318
2019,4,26,12,913,2594,1066,-1528
2019,4,26,13,995,2832,1075,-1757
2019,4,26,14,1047,3118,1085,-2033
2019,4,26,15,1187,3318,1065,-2253
2019,4,26,16,1203,3271,1107,-2164
2019,4,26,17,1224,3185,1164,-2021
2019,4,26,18,1269,3199,1294,-1905
2019,4,26,19,1217,3067,1222,-1845
2019,4,26,20,1174,3028,1240,-1788
2019,4,26,21,1134,2965,1199,-1766
2019,4,26,22,1089,2992,1340,-1652
2019,4,26,23,1068,3015,1380,-1635
2019,4,27,0,1049,3006,1381,-1625
2019,4,27,1,1083,3009,1194,-1815
2019,4,27,2,1077,3024,1397,-1627
2019,4,27,3,1046,3016,1395,-1621
2019,4,27,4,1117,3109,1395,-1714
2019,4,27,5,995,3089,1382,-1707
2019,4,27,6,1018,2905,1367,-1538
2019,4,27,7,996,2670,1318,-1352
2019,4,27,8,1027,2357,1191,-1166
2019,4,27,9,858,2253,998,-1255
2019,4,27,10,848,2146,826,-1320
2019,4,27,11,853,2133,817,-1316
2019,4,27,12,834,2198,812,-1386
2019,4,27,13,823,2364,858,-1506
2019,4,27,14,879,2590,897,-1693
2019,4,27,15,804,2778,780,-1998
2019,4,27,16,943,2925,792,-2133
2019,4,27,17,1032,2960,848,-2112
2019,4,27,18,1048,2881,836,-2045
2019,4,27,19,1041,2808,830,-1978
2019,4,27,20,1081,2724,875,-1849
2019,4,27,21,1082,2677,838,-1839
2019,4,27,22,1083,2641,950,-1691
2019,4,27,23,1079,2644,940,-1704
2019,4,28,0,1070,2662,837,-1825
2019,4,28,1,1082,2687,837,-1850
2019,4,28,2,1028,2742,1016,-1726
2019,4,28,3,1024,2755,1037,-1718
2019,4,28,4,992,2864,1031,-1833
2019,4,28,5,995,2861,949,-1912
2019,4,28,6,1000,2714,988,-1726
2019,4,28,7,945,2545,1104,-1441
2019,4,28,8,813,2434,1156,-1278
2019,4,28,9,907,2375,1253,-1122
2019,4,28,10,1000,2366,1215,-1151
2019,4,28,11,1017,2398,1244,-1154
2019,4,28,12,1072,2496,1220,-1276
2019,4,28,13,1060,2626,1406,-1220
2019,4,28,14,940,2823,1314,-1509
2019,4,28,15,1066,3002,1235,-1767
2019,4,28,16,1185,3089,1225,-1864
2019,4,28,17,1229,3032,1303,-1729
2019,4,28,18,1205,2922,1329,-1593
2019,4,28,19,1123,2819,1232,-1587
2019,4,28,20,1240,2730,1108,-1622
2019,4,28,21,1193,2646,1192,-1454
2019,4,28,22,1101,2613,1325,-1288
2019,4,28,23,1080,2584,1270,-1314
2019,4,29,0,1140,2602,1213,-1389
2019,4,29,1,889,2691,1297,-1394
2019,4,29,2,1256,2729,1292,-1437
2019,4,29,3,1305,2776,1298,-1478
2019,4,29,4,1269,2886,1288,-1598
2019,4,29,5,1199,2846,1381,-1465
2019,4,29,6,1087,2639,1379,-1260
2019,4,29,7,945,2437,1368,-1069
2019,4,29,8,989,2311,1339,-972
2019,4,29,9,978,2250,1310,-940
2019,4,29,10,944,2262,1277,-985
2019,4,29,11,1068,2337,1417,-920
2019,4,29,12,1235,2512,1504,-1008
2019,4,29,13,1395,2772,1613,-1159
2019,4,29,14,1319,3135,1575,-1560
2019,4,29,15,1424,3310,1601,-1709
2019,4,29,16,1434,3207,1665,-1542
2019,4,29,17,1336,3097,1559,-1538
2019,4,29,18,1282,3003,1346,-1657
2019,4,29,19,1296,2947,1443,-1504
2019,4,29,20,1326,2908,1469,-1439
2019,4,29,21,1289,2880,1442,-1438
2019,4,29,22,1254,2842,1416,-1426
2019,4,29,23,1229,2835,1471,-1364
2019,4,30,0,1211,2861,1380,-1481
2019,4,30,1,1263,2905,1339,-1566
2019,4,30,2,1284,2909,1347,-1562
2019,4,30,3,1294,2916,1447,-1469
2019,4,30,4,1358,2988,1450,-1538
2019,4,30,5,1274,2898,1396,-1502
2019,4,30,6,1398,2666,1447,-1219
2019,4,30,7,1176,2436,1510,-926
2019,4,30,8,1139,2316,1547,-769
2019,4,30,9,1066,2260,1534,-726
2019,4,30,10,1071,2265,1519,-746
2019,4,30,11,1207,2326,1444,-882
2019,4,30,12,1230,2489,1548,-941
2019,4,30,13,1353,2818,1722,-1096
2019,4,30,14,1340,3139,1573,-1566
2019,4,30,15,1337,3333,1494,-1839
2019,4,30,16,1374,3232,1442,-1790
2019,4,30,17,1272,3107,1355,-1752
2019,4,30,18,1240,3009,1368,-1641
2019,4,30,19,1105,2925,1312,-1613
2019,4,30,20,1059,2880,1283,-1597
2019,4,30,21,1072,2826,1279,-1547
2019,4,30,22,1035,2804,1179,-1625
2019,4,30,23,1029,2788,1199,-1589
2019,5,1,0,1065,2811,1207,-1604
2019,5,1,1,1040,2857,1274,-1583
2019,5,1,2,1068,2885,1353,-1532
2019,5,1,3,1079,2891,1391,-1500
2019,5,1,4,1086,2957,1465,-1492
2019,5,1,5,1090,2890,1457,-1433
2019,5,1,6,1048,2643,1474,-1169
2019,5,1,7,1255,2404,1454,-950
2019,5,1,8,1183,2261,1444,-817
2019,5,1,9,1126,2206,1414,-792
2019,5,1,10,1076,2197,1433,-764
2019,5,1,11,1103,2245,1460,-785
2019,5,1,12,1205,2396,1509,-887
2019,5,1,13,1317,2709,1578,-1131
2019,5,1,14,1310,3069,1533,-1536
2019,5,1,15,1292,3207,1413,-1794
2019,5,1,16,1283,3159,1479,-1680
2019,5,1,17,1189,3054,1416,-1638
2019,5,1,18,1155,2964,1271,-1693
2019,5,1,19,1145,2902,1211,-1691
2019,5,1,20,1111,2873,1151,-1722
2019,5,1,21,1164,2821,941,-1880
2019,5,1,22,1132,2801,1046,-1755
2019,5,1,23,1130,2765,1055,-1710
2019,5,2,0,1156,2750,1019,-1731
2019,5,2,1,1254,2822,1209,-1613
2019,5,2,2,1307,2873,1555,-1318
2019,5,2,3,1298,2876,1662,-1214
2019,5,2,4,1284,2963,1662,-1301
2019,5,2,5,1221,2899,1654,-1245
2019,5,2,6,1263,2658,1647,-1011
2019,5,2,7,1086,2417,1497,-920
2019,5,2,8,1319,2275,1630,-645
2019,5,2,9,1183,2194,1645,-549
2019,5,2,10,1199,2183,1652,-531
2019,5,2,11,1237,2202,1564,-638
2019,5,2,12,1335,2320,1606,-714
2019,5,2,13,1392,2604,1784,-820
2019,5,2,14,1329,2931,1698,-1233
2019,5,2,15,1342,3107,1673,-1434
2019,5,2,16,1343,3128,1633,-1495
2019,5,2,17,1338,3094,1606,-1488
2019,5,2,18,1262,3019,1235,-1784
2019,5,2,19,1236,2977,1148,-1829
2019,5,2,20,1272,2932,1134,-1798
2019,5,2,21,1297,2900,1390,-1510
2019,5,2,22,1313,2857,1400,-1457
2019,5,2,23,1344,2845,1387,-1458
2019,5,3,0,1340,2860,1400,-1460
2019,5,3,1,1350,2889,1496,-1393
2019,5,3,2,1340,2914,1588,-1326
2019,5,3,3,1384,2933,1755,-1178
2019,5,3,4,1414,3005,1779,-1226
2019,5,3,5,1446,2921,1730,-1191
2019,5,3,6,1463,2679,1704,-975
2019,5,3,7,1298,2436,1549,-887
2019,5,3,8,1130,2287,1592,-695
2019,5,3,9,1076,2216,1514,-702
2019,5,3,10,940,2156,1384,-772
2019,5,3,11,872,2187,1318,-869
2019,5,3,12,933,2296,1258,-1038
2019,5,3,13,1263,2559,1373,-1186
2019,5,3,14,1271,2885,1332,-1553
2019,5,3,15,1312,3087,1288,-1799
2019,5,3,16,1340,3099,1326,-1773
2019,5,3,17,1227,3026,1390,-1636
2019,5,3,18,1281,2964,1344,-1620
2019,5,3,19,1204,2898,1202,-1696
2019,5,3,20,1148,2892,1264,-1628
2019,5,3,21,1129,2831,1282,-1549
2019,5,3,22,1125,2772,1294,-1478
2019,5,3,23,1125,2751,1288,-1463
2019,5,4,0,1168,2775,1216,-1559
2019,5,4,1,1193,2806,1452,-1354
2019,5,4,2,1188,2791,1509,-1282
2019,5,4,3,1162,2765,1559,-1206
2019,5,4,4,1213,2829,1642,-1187
2019,5,4,5,1179,2804,1642,-1162
2019,5,4,6,1336,2633,1587,-1046
2019,5,4,7,1146,2440,1331,-1109
2019,5,4,8,847,2234,1062,-1172
2019,5,4,9,925,2102,989,-1113
2019,5,4,10,952,2057,920,-1137
2019,5,4,11,967,2079,984,-1095
2019,5,4,12,990,2139,1065,-1074
2019,5,4,13,1102,2309,1206,-1103
2019,5,4,14,983,2437,967,-1470
2019,5,4,15,999,2609,961,-1648
2019,5,4,16,979,2695,914,-1781
2019,5,4,17,968,2771,1047,-1724
2019,5,4,18,962,2687,983,-1704
2019,5,4,19,1086,2626,816,-1810
2019,5,4,20,863,2594,809,-1785
2019,5,4,21,882,2549,804,-1745
2019,5,4,22,826,2539,853,-1686
2019,5,4,23,841,2546,866,-1680
2019,5,5,0,887,2606,972,-1634
2019,5,5,1,931,2656,1183,-1473
2019,5,5,2,953,2664,1405,-1259
2019,5,5,3,1025,2651,1392,-1259
2019,5,5,4,987,2688,1339,-1349
2019,5,5,5,990,2686,1240,-1446
2019,5,5,6,1008,2530,1353,-1177
2019,5,5,7,912,2335,1334,-1001
2019,5,5,8,1030,2124,1235,-889
2019,5,5,9,994,2046,1137,-909
2019,5,5,10,898,2001,985,-1016
2019,5,5,11,752,1953,936,-1017
2019,5,5,12,806,1928,877,-1051
2019,5,5,13,872,2018,925,-1093
2019,5,5,14,781,2147,948,-1199
2019,5,5,15,775,2354,922,-1432
2019,5,5,16,915,2505,931,-1574
2019,5,5,17,966,2589,1009,-1580
2019,5,5,18,961,2597,999,-1598
2019,5,5,19,958,2553,997,-1556
2019,5,5,20,927,2535,928,-1607
2019,5,5,21,871,2493,895,-1598
2019,5,5,22,880,2476,885,-1591
2019,5,5,23,951,2476,886,-1590
2019,5,6,0,744,2525,891,-1634
2019,5,6,1,902,2621,940,-1681
2019,5,6,2,983,2637,1041,-1596
2019,5,6,3,1073,2648,1277,-1371
2019,5,6,4,1062,2727,1340,-1387
2019,5,6,5,1096,2735,1385,-1350
2019,5,6,6,1002,2458,1199,-1259
2019,5,6,7,1158,2203,1175,-1028
2019,5,6,8,1014,2087,1241,-846
2019,5,6,9,964,2015,1252,-763
2019,5,6,10,923,1988,1108,-880
2019,5,6,11,942,2023,1111,-912
2019,5,6,12,1049,2139,1118,-1021
2019,5,6,13,1008,2375,1117,-1258
2019,5,6,14,994,2675,1121,-1554
2019,5,6,15,1135,2849,1100,-1749
2019,5,6,16,1140,2848,1116,-1732
2019,5,6,17,1018,2845,1139,-1706
2019,5,6,18,826,2834,1123,-1711
2019,5,6,19,838,2819,1171,-1648
2019,5,6,20,855,2836,1229,-1607
2019,5,6,21,1009,2803,1222,-1581
2019,5,6,22,1080,2815,1260,-1555
2019,5,6,23,1027,2826,1264,-1562
2019,5,7,0,1021,2874,1286,-1588
2019,5,7,1,1035,2916,1276,-1640
2019,5,7,2,1113,2924,1444,-1480
2019,5,7,3,1218,2878,1582,-1296
2019,5,7,4,1234,2902,1573,-1329
2019,5,7,5,1128,2801,1445,-1356
2019,5,7,6,1125,2539,1467,-1072
2019,5,7,7,1138,2252,1368,-884
2019,5,7,8,979,2098,1172,-926
2019,5,7,9,994,2014,1126,-888
2019,5,7,10,1021,2032,1165,-867
2019,5,7,11,1069,2097,1212,-885
2019,5,7,12,1118,2241,1298,-943
2019,5,7,13,1202,2472,1376,-1096
2019,5,7,14,1110,2772,1303,-1469
2019,5,7,15,1197,3023,1430,-1593
2019,5,7,16,1217,3073,1486,-1587
2019,5,7,17,1205,3068,1561,-1507
2019,5,7,18,1199,3068,1562,-1506
2019,5,7,19,1195,3066,1481,-1585
2019,5,7,20,1211,3083,1374,-1709
2019,5,7,21,1231,3064,1357,-1707
2019,5,7,22,1249,3023,1304,-1719
2019,5,7,23,1260,3031,1291,-1740
2019,5,8,0,1228,3070,1335,-1735
2019,5,8,1,1271,3195,1580,-1615
2019,5,8,2,1151,3193,1671,-1522
2019,5,8,3,1115,3156,1583,-1573
2019,5,8,4,1129,3169,1544,-1625
2019,5,8,5,1055,3092,1477,-1615
2019,5,8,6,1251,2829,1461,-1368
2019,5,8,7,1040,2545,1399,-1146
2019,5,8,8,1105,2361,1348,-1013
2019,5,8,9,1142,2235,1249,-986
2019,5,8,10,1054,2248,1204,-1044
2019,5,8,11,1034,2245,1173,-1072
2019,5,8,12,1114,2392,1312,-1080
2019,5,8,13,1160,2588,1454,-1134
2019,5,8,14,1061,2835,1392,-1443
2019,5,8,15,1184,3043,1412,-1631
2019,5,8,16,1246,3052,1449,-1603
2019,5,8,17,1244,3048,1435,-1613
2019,5,8,18,1216,3022,1412,-1610
2019,5,8,19,1203,3015,1443,-1572
2019,5,8,20,1218,2989,1389,-1600
2019,5,8,21,1195,3048,1381,-1667
2019,5,8,22,1188,3020,1345,-1675
2019,5,8,23,1171,3075,1373,-1702
2019,5,9,0,1160,3131,1330,-1801
2019,5,9,1,1299,3176,1459,-1717
2019,5,9,2,1332,3156,1474,-1682
2019,5,9,3,1371,3184,1491,-1693
2019,5,9,4,1378,3188,1536,-1652
2019,5,9,5,1280,3120,1516,-1604
2019,5,9,6,1310,2861,1591,-1270
2019,5,9,7,1041,2550,1484,-1066
2019,5,9,8,1194,2313,1479,-834
2019,5,9,9,1199,2253,1412,-841
2019,5,9,10,1037,2147,1355,-792
2019,5,9,11,971,2137,1268,-869
2019,5,9,12,1049,2262,1275,-987
2019,5,9,13,1095,2466,1284,-1182
2019,5,9,14,970,2743,1227,-1516
2019,5,9,15,1119,2955,1182,-1773
2019,5,9,16,1145,3000,1296,-1704
2019,5,9,17,1148,3049,1338,-1711
2019,5,9,18,1169,3063,1262,-1801
2019,5,9,19,1182,3136,1222,-1914
2019,5,9,20,1200,3199,1333,-1866
2019,5,9,21,1237,3217,1312,-1905
2019,5,9,22,1270,3238,1320,-1918
2019,5,9,23,1314,3260,1323,-1937
2019,5,10,0,1355,3292,1320,-1972
2019,5,10,1,1386,3352,1490,-1862
2019,5,10,2,1374,3338,1519,-1819
2019,5,10,3,1358,3298,1517,-1781
2019,5,10,4,1381,3269,1524,-1745
2019,5,10,5,1313,3189,1431,-1758
2019,5,10,6,1427,2906,1441,-1465
2019,5,10,7,1198,2619,1542,-1077
2019,5,10,8,1057,2361,1314,-1047
2019,5,10,9,1103,2262,1329,-933
2019,5,10,10,1087,2208,1318,-890
2019,5,10,11,1087,2198,1310,-888
2019,5,10,12,1164,2366,1410,-956
2019,5,10,13,1064,2525,1415,-1110
2019,5,10,14,1060,2769,1389,-1380
2019,5,10,15,1128,2967,1468,-1499
2019,5,10,16,1229,3073,1513,-1560
2019,5,10,17,1280,3124,1614,-1510
2019,5,10,18,1325,3169,1602,-1567
2019,5,10,19,1462,3171,1604,-1567
2019,5,10,20,1483,3214,1461,-1753
2019,5,10,21,1506,3283,1699,-1584
2019,5,10,22,1529,3311,1699,-1612
2019,5,10,23,1546,3364,1699,-1665
2019,5,11,0,1564,3417,1781,-1636
2019,5,11,1,1577,3444,1803,-1641
2019,5,11,2,1515,3401,1811,-1590
2019,5,11,3,1458,3323,1826,-1497
2019,5,11,4,1442,3253,1823,-1430
2019,5,11,5,1388,3181,1843,-1338
2019,5,11,6,1500,2944,1809,-1135
2019,5,11,7,1302,2696,1628,-1068
2019,5,11,8,1064,2442,1358,-1084
2019,5,11,9,978,2320,1305,-1015
2019,5,11,10,896,2248,1312,-936
2019,5,11,11,859,2221,1315,-906
2019,5,11,12,853,2248,1334,-914
2019,5,11,13,913,2277,1324,-953
2019,5,11,14,670,2337,1171,-1166
2019,5,11,15,996,2535,1229,-1306
2019,5,11,16,991,2741,1246,-1495
2019,5,11,17,1127,2882,1135,-1747
2019,5,11,18,1124,2945,1165,-1780
2019,5,11,19,1124,2982,1174,-1808
2019,5,11,20,1045,3019,1154,-1865
2019,5,11,21,1153,3028,1294,-1734
2019,5,11,22,1272,3045,1311,-1734
2019,5,11,23,1258,3093,1323,-1770
2019,5,12,0,1277,3148,1346,-1802
2019,5,12,1,1262,3173,1388,-1785
2019,5,12,2,1231,3202,1476,-1726
2019,5,12,3,1210,3123,1585,-1538
2019,5,12,4,1165,3061,1511,-1550
2019,5,12,5,1094,3022,1549,-1473
2019,5,12,6,1063,2824,1597,-1227
2019,5,12,7,1023,2607,1545,-1062
2019,5,12,8,1026,2345,1405,-940
2019,5,12,9,892,2214,1154,-1060
2019,5,12,10,761,2126,1095,-1031
2019,5,12,11,622,2096,963,-1133
2019,5,12,12,698,1986,1054,-932
2019,5,12,13,678,2033,1022,-1011
2019,5,12,14,484,2096,836,-1260
2019,5,12,15,631,2222,772,-1450
2019,5,12,16,738,2375,631,-1744
2019,5,12,17,883,2547,686,-1861
2019,5,12,18,955,2698,855,-1843
2019,5,12,19,981,2689,845,-1844
2019,5,12,20,995,2585,792,-1793
2019,5,12,21,1009,2575,1002,-1573
2019,5,12,22,946,2552,1086,-1466
2019,5,12,23,970,2596,1159,-1437
2019,5,13,0,1024,2638,1138,-1500
2019,5,13,1,1077,2910,1396,-1514
2019,5,13,2,1102,2960,1417,-1543
2019,5,13,3,1099,2983,1461,-1522
2019,5,13,4,1098,2998,1458,-1540
2019,5,13,5,1071,2995,1395,-1600
2019,5,13,6,1141,2767,1363,-1404
2019,5,13,7,975,2493,1300,-1193
2019,5,13,8,822,2208,1080,-1128
2019,5,13,9,801,1977,841,-1136
2019,5,13,10,718,1950,782,-1168
2019,5,13,11,641,2009,927,-1082
2019,5,13,12,732,2241,1035,-1206
2019,5,13,13,850,2528,1112,-1416
2019,5,13,14,990,2894,1250,-1644
2019,5,13,15,1212,3072,1325,-1747
2019,5,13,16,1255,3159,1495,-1664
2019,5,13,17,1253,3146,1598,-1548
2019,5,13,18,1245,3160,1551,-1609
2019,5,13,19,1231,3144,1493,-1651
2019,5,13,20,1125,3108,1412,-1696
2019,5,13,21,1127,3082,1428,-1654
2019,5,13,22,1097,3091,1474,-1617
2019,5,13,23,1218,3084,1522,-1562
2019,5,14,0,1271,3111,1518,-1593
2019,5,14,1,1351,3166,1522,-1644
2019,5,14,2,1373,3178,1556,-1622
2019,5,14,3,1364,3160,1515,-1645
2019,5,14,4,1399,3178,1478,-1700
2019,5,14,5,1364,3101,1468,-1633
2019,5,14,6,1325,2872,1398,-1474
2019,5,14,7,1256,2591,1377,-1214
2019,5,14,8,604,2202,976,-1226
2019,5,14,9,607,2114,833,-1281
2019,5,14,10,588,2075,835,-1240
2019,5,14,11,558,2104,852,-1252
2019,5,14,12,600,2201,900,-1301
2019,5,14,13,597,2622,1158,-1464
2019,5,14,14,883,2932,1104,-1828
2019,5,14,15,924,3130,1101,-2029
2019,5,14,16,1104,3208,1304,-1904
2019,5,14,17,1074,3230,1302,-1928
2019,5,14,18,1066,3204,1311,-1893
2019,5,14,19,1037,3162,1267,-1895
2019,5,14,20,1014,3178,1268,-1910
2019,5,14,21,1023,3178,1274,-1904
2019,5,14,22,1000,3148,1236,-1912
2019,5,14,23,982,3130,1282,-1848
2019,5,15,0,961,3152,1365,-1787
2019,5,15,1,987,3207,1475,-1732
2019,5,15,2,980,3225,1430,-1795
2019,5,15,3,969,3214,1385,-1829
2019,5,15,4,1016,3209,1419,-1790
2019,5,15,5,1004,3141,1442,-1699
2019,5,15,6,1006,2885,1363,-1522
2019,5,15,7,819,2643,1268,-1375
2019,5,15,8,792,2425,1151,-1274
2019,5,15,9,716,2285,1030,-1255
2019,5,15,10,741,2261,955,-1306
2019,5,15,11,737,2271,942,-1329
2019,5,15,12,738,2385,947,-1438
2019,5,15,13,827,2702,1052,-1650
2019,5,15,14,875,2980,1049,-1931
2019,5,15,15,996,3174,1159,-2015
2019,5,15,16,983,3182,1165,-2017
2019,5,15,17,991,3162,1181,-1981
2019,5,15,18,950,3145,1208,-1937
2019,5,15,19,910,3125,1148,-1977
2019,5,15,20,894,3136,1173,-1963
2019,5,15,21,889,3129,1166,-1963
2019,5,15,22,905,3124,1128,-1996
2019,5,15,23,904,3098,1107,-1991
2019,5,16,0,899,3154,1083,-2071
2019,5,16,1,905,3220,1162,-2058
2019,5,16,2,915,3206,1142,-2064
2019,5,16,3,897,3207,1143,-2064
2019,5,16,4,912,3201,1138,-2063
2019,5,16,5,882,3101,1152,-1949
2019,5,16,6,990,2868,1140,-1728
2019,5,16,7,899,2630,1050,-1580
2019,5,16,8,823,2461,1048,-1413
2019,5,16,9,689,2283,954,-1329
2019,5,16,10,710,2219,934,-1285
2019,5,16,11,700,2228,939,-1289
2019,5,16,12,721,2327,952,-1375
2019,5,16,13,818,2626,1072,-1554
2019,5,16,14,810,2854,1017,-1837
2019,5,16,15,911,2993,1063,-1930
2019,5,16,16,922,2947,943,-2004
2019,5,16,17,906,2902,881,-2021
2019,5,16,18,941,2848,827,-2021
2019,5,16,19,867,2841,737,-2104
2019,5,16,20,921,2831,726,-2105
2019,5,16,21,956,2794,684,-2110
2019,5,16,22,969,2760,683,-2077
2019,5,16,23,852,2779,808,-1971
2019,5,17,0,855,2828,797,-2031
2019,5,17,1,959,2852,930,-1922
2019,5,17,2,827,2876,1029,-1847
2019,5,17,3,768,2890,945,-1945
2019,5,17,4,745,2901,906,-1995
2019,5,17,5,679,2797,949,-1848
2019,5,17,6,841,2556,1007,-1549
2019,5,17,7,813,2327,959,-1368
2019,5,17,8,797,2174,1133,-1041
2019,5,17,9,808,2094,1157,-937
2019,5,17,10,845,2057,1162,-895
2019,5,17,11,824,2052,1178,-874
2019,5,17,12,847,2144,1181,-963
2019,5,17,13,774,2362,1192,-1170
2019,5,17,14,695,2625,1149,-1476
2019,5,17,15,808,2802,1032,-1770
2019,5,17,16,842,2854,991,-1863
2019,5,17,17,837,2892,1121,-1771
2019,5,17,18,826,2906,1114,-1792
2019,5,17,19,803,2823,1039,-1784
2019,5,17,20,808,2808,1078,-1730
2019,5,17,21,818,2724,903,-1821
2019,5,17,22,821,2684,821,-1863
2019,5,17,23,816,2668,837,-1831
2019,5,18,0,810,2676,929,-1747
2019,5,18,1,801,2685,884,-1801
2019,5,18,2,832,2693,1111,-1582
2019,5,18,3,813,2715,1206,-1509
2019,5,18,4,803,2733,1202,-1531
2019,5,18,5,794,2711,1198,-1513
2019,5,18,6,788,2540,1205,-1335
2019,5,18,7,779,2347,1175,-1172
2019,5,18,8,827,2190,1121,-1069
2019,5,18,9,792,2094,1108,-986
2019,5,18,10,764,2049,1041,-1008
2019,5,18,11,638,2034,991,-1043
2019,5,18,12,690,2070,941,-1129
2019,5,18,13,648,2138,868,-1270
2019,5,18,14,667,2253,835,-1418
2019,5,18,15,673,2378,737,-1641
2019,5,18,16,680,2514,668,-1846
2019,5,18,17,714,2611,778,-1833
2019,5,18,18,710,2707,893,-1814
2019,5,18,19,677,2685,878,-1807
2019,5,18,20,681,2667,891,-1776
2019,5,18,21,691,2624,924,-1700
2019,5,18,22,696,2609,890,-1719
2019,5,18,23,706,2615,876,-1739
2019,5,19,0,702,2602,791,-1811
2019,5,19,1,695,2622,814,-1808
2019,5,19,2,698,2601,861,-1740
2019,5,19,3,715,2555,869,-1686
2019,5,19,4,730,2571,932,-1639
2019,5,19,5,750,2609,1062,-1547
2019,5,19,6,777,2492,1197,-1295
2019,5,19,7,785,2229,1072,-1157
2019,5,19,8,876,2114,1115,-999
2019,5,19,9,887,2019,1114,-905
2019,5,19,10,878,1954,1099,-855
2019,5,19,11,842,1946,1121,-825
2019,5,19,12,837,1926,1114,-812
2019,5,19,13,785,1966,1089,-877
2019,5,19,14,753,2083,1073,-1010
2019,5,19,15,816,2217,1059,-1158
2019,5,19,16,778,2407,1019,-1388
2019,5,19,17,811,2549,1019,-1530
2019,5,19,18,799,2648,1031,-1617
2019,5,19,19,792,2657,995,-1662
2019,5,19,20,798,2632,930,-1702
2019,5,19,21,792,2649,994,-1655
2019,5,19,22,788,2645,986,-1659
2019,5,19,23,763,2609,891,-1718
2019,5,20,0,726,2665,859,-1806
2019,5,20,1,717,2744,873,-1871
2019,5,20,2,703,2763,866,-1897
2019,5,20,3,511,2754,850,-1904
2019,5,20,4,541,2753,840,-1913
2019,5,20,5,699,2701,938,-1763
2019,5,20,6,708,2474,875,-1599
2019,5,20,7,667,2252,913,-1339
2019,5,20,8,650,2106,921,-1185
2019,5,20,9,614,2014,964,-1050
2019,5,20,10,632,1970,987,-983
2019,5,20,11,625,1978,920,-1058
2019,5,20,12,623,2067,863,-1204
2019,5,20,13,627,2258,852,-1406
2019,5,20,14,575,2511,802,-1709
2019,5,20,15,641,2735,924,-1811
2019,5,20,16,574,2825,844,-1981
2019,5,20,17,588,2863,807,-2056
2019,5,20,18,605,2894,770,-2124
2019,5,20,19,656,2902,791,-2111
2019,5,20,20,683,2897,810,-2087
2019,5,20,21,703,2895,895,-2000
2019,5,20,22,728,2805,774,-2031
2019,5,20,23,681,2786,773,-2013
2019,5,21,0,631,2822,821,-2001
2019,5,21,1,677,2925,829,-2096
2019,5,21,2,578,2965,917,-2048
2019,5,21,3,558,3005,1039,-1966
2019,5,21,4,562,3000,1065,-1935
2019,5,21,5,733,2905,1078,-1827
2019,5,21,6,769,2697,1164,-1533
2019,5,21,7,736,2356,1044,-1312
2019,5,21,8,651,2176,835,-1341
2019,5,21,9,686,2118,938,-1180
2019,5,21,10,683,2094,975,-1119
2019,5,21,11,694,2104,994,-1110
2019,5,21,12,603,2219,1000,-1219
2019,5,21,13,705,2574,1088,-1486
2019,5,21,14,697,2860,1037,-1823
2019,5,21,15,705,3051,952,-2099
2019,5,21,16,707,3075,956,-2119
2019,5,21,17,719,3023,975,-2048
2019,5,21,18,725,3022,1005,-2017
2019,5,21,19,709,2971,944,-2027
2019,5,21,20,707,2917,937,-1980
2019,5,21,21,681,2876,941,-1935
2019,5,21,22,675,2814,871,-1943
2019,5,21,23,669,2820,947,-1873
2019,5,22,0,659,2860,922,-1938
2019,5,22,1,644,2952,911,-2041
2019,5,22,2,656,2971,968,-2003
2019,5,22,3,631,2946,970,-1976
2019,5,22,4,642,2957,1005,-1952
2019,5,22,5,632,2921,1027,-1894
2019,5,22,6,619,2710,1062,-1648
2019,5,22,7,618,2461,1011,-1450
2019,5,22,8,602,2208,912,-1296
2019,5,22,9,609,2101,906,-1195
2019,5,22,10,580,2071,920,-1151
2019,5,22,11,589,2088,903,-1185
2019,5,22,12,675,2307,1003,-1304
2019,5,22,13,778,2524,1042,-1482
2019,5,22,14,636,2800,924,-1876
2019,5,22,15,733,2969,902,-2067
2019,5,22,16,740,2987,924,-2063
2019,5,22,17,750,2941,892,-2049
2019,5,22,18,754,2922,926,-1996
2019,5,22,19,783,2917,917,-2000
2019,5,22,20,756,2936,933,-2003
2019,5,22,21,743,2933,919,-2014
2019,5,22,22,743,2920,832,-2088
2019,5,22,23,761,2941,813,-2128
2019,5,23,0,756,2975,825,-2150
2019,5,23,1,781,3039,921,-2118
2019,5,23,2,754,3033,965,-2068
2019,5,23,3,737,3005,940,-2065
2019,5,23,4,754,2998,950,-2048
2019,5,23,5,762,2982,986,-1996
2019,5,23,6,831,2740,1111,-1629
2019,5,23,7,730,2436,949,-1487
2019,5,23,8,779,2289,988,-1301
2019,5,23,9,760,2193,1023,-1170
2019,5,23,10,751,2138,1060,-1078
2019,5,23,11,809,2120,1089,-1031
2019,5,23,12,756,2212,1123,-1089
2019,5,23,13,980,2383,1266,-1117
2019,5,23,14,935,2634,1213,-1421
2019,5,23,15,945,2828,1161,-1667
2019,5,23,16,1018,2894,1216,-1678
2019,5,23,17,1024,2919,1223,-1696
2019,5,23,18,1054,2941,1249,-1692
2019,5,23,19,1055,2935,1196,-1739
2019,5,23,20,1086,2872,1192,-1680
2019,5,23,21,1105,2987,1268,-1719
2019,5,23,22,1121,3005,1253,-1752
2019,5,23,23,1129,3041,1228,-1813
2019,5,24,0,1125,3103,1234,-1869
2019,5,24,1,1145,3144,1221,-1923
2019,5,24,2,1113,3159,1441,-1718
2019,5,24,3,1057,3090,1509,-1581
2019,5,24,4,1015,3073,1399,-1674
2019,5,24,5,988,3027,1248,-1779
2019,5,24,6,1064,2767,1354,-1413
2019,5,24,7,844,2484,1314,-1170
2019,5,24,8,868,2299,1097,-1202
2019,5,24,9,732,2173,1057,-1116
2019,5,24,10,621,2046,1004,-1042
2019,5,24,11,674,1923,971,-952
2019,5,24,12,595,1981,1014,-967
2019,5,24,13,598,2200,1095,-1105
2019,5,24,14,500,2405,954,-1451
2019,5,24,15,683,2797,1162,-1635
2019,5,24,16,752,2796,963,-1833
2019,5,24,17,776,2816,992,-1824
2019,5,24,18,791,2828,893,-1935
2019,5,24,19,792,2767,909,-1858
2019,5,24,20,796,2733,892,-1841
2019,5,24,21,791,2674,969,-1705
2019,5,24,22,777,2632,878,-1754
2019,5,24,23,775,2609,885,-1724
2019,5,25,0,787,2629,967,-1662
2019,5,25,1,827,2728,1057,-1671
2019,5,25,2,836,2731,1123,-1608
2019,5,25,3,812,2837,1226,-1611
2019,5,25,4,820,2837,1147,-1690
2019,5,25,5,841,2828,1063,-1765
2019,5,25,6,905,2662,1067,-1595
2019,5,25,7,761,2333,928,-1405
2019,5,25,8,463,2125,834,-1291
2019,5,25,9,441,2042,803,-1239
2019,5,25,10,429,2028,838,-1190
2019,5,25,11,422,1997,844,-1153
2019,5,25,12,477,2034,858,-1176
2019,5,25,13,545,2088,875,-1213
2019,5,25,14,396,2155,834,-1321
2019,5,25,15,380,2297,668,-1629
2019,5,25,16,516,2488,703,-1785
2019,5,25,17,682,2662,876,-1786
2019,5,25,18,776,2746,868,-1878
2019,5,25,19,795,2809,942,-1867
2019,5,25,20,779,2870,1004,-1866
2019,5,25,21,748,2888,985,-1903
2019,5,25,22,713,2771,899,-1872
2019,5,25,23,710,2741,917,-1824
2019,5,26,0,713,2811,1014,-1797
2019,5,26,1,728,2831,1100,-1731
2019,5,26,2,703,2790,1102,-1688
2019,5,26,3,685,2776,1112,-1664
2019,5,26,4,697,2772,1215,-1557
2019,5,26,5,737,2788,1208,-1580
2019,5,26,6,979,2626,1190,-1436
2019,5,26,7,808,2428,1156,-1272
2019,5,26,8,898,2298,1180,-1118
2019,5,26,9,830,2220,1116,-1104
2019,5,26,10,802,2045,1075,-970
2019,5,26,11,912,2175,1223,-952
2019,5,26,12,751,2196,1185,-1011
2019,5,26,13,772,2255,1204,-1051
2019,5,26,14,627,2325,1154,-1171
2019,5,26,15,745,2459,1071,-1388
2019,5,26,16,734,2603,1038,-1565
2019,5,26,17,843,2760,1210,-1550
2019,5,26,18,863,2797,1238,-1559
2019,5,26,19,819,2780,1213,-1567
2019,5,26,20,780,2643,1131,-1512
2019,5,26,21,779,2548,1087,-1461
2019,5,26,22,781,2479,981,-1498
2019,5,26,23,782,2485,1075,-1410
2019,5,27,0,772,2492,1093,-1399
2019,5,27,1,760,2544,1100,-1444
2019,5,27,2,759,2555,1119,-1436
2019,5,27,3,756,2558,1113,-1445
2019,5,27,4,755,2589,1154,-1435
2019,5,27,5,750,2693,1250,-1443
2019,5,27,6,748,2564,1215,-1349
2019,5,27,7,781,2378,1148,-1230
2019,5,27,8,810,2213,1026,-1187
2019,5,27,9,782,2120,1021,-1099
2019,5,27,10,702,2107,1005,-1102
2019,5,27,11,728,2048,979,-1069
2019,5,27,12,742,2089,975,-1114
2019,5,27,13,760,2152,1001,-1151
2019,5,27,14,440,2115,815,-1300
2019,5,27,15,478,2234,811,-1423
2019,5,27,16,499,2520,935,-1585
2019,5,27,17,665,2652,944,-1708
2019,5,27,18,692,2740,942,-1798
2019,5,27,19,700,2712,845,-1867
2019,5,27,20,791,2657,860,-1797
2019,5,27,21,791,2685,902,-1783
2019,5,27,22,788,2700,897,-1803
2019,5,27,23,782,2688,861,-1827
2019,5,28,0,755,2789,911,-1878
2019,5,28,1,732,2899,942,-1957
2019,5,28,2,717,3033,1126,-1907
2019,5,28,3,714,2996,1186,-1810
2019,5,28,4,709,2963,1123,-1840
2019,5,28,5,800,2883,1038,-1845
2019,5,28,6,733,2630,1027,-1603
2019,5,28,7,695,2360,987,-1373
2019,5,28,8,811,2198,991,-1207
2019,5,28,9,574,1980,779,-1201
2019,5,28,10,501,1930,821,-1109
2019,5,28,11,486,1910,816,-1094
2019,5,28,12,487,2027,823,-1204
2019,5,28,13,812,2309,1009,-1300
2019,5,28,14,620,2556,904,-1652
2019,5,28,15,702,2763,925,-1838
2019,5,28,16,791,2887,956,-1931
2019,5,28,17,807,2951,961,-1990
2019,5,28,18,818,3048,1017,-2031
2019,5,28,19,883,3045,1092,-1953
2019,5,28,20,883,3104,1111,-1993
2019,5,28,21,883,3042,1071,-1971
2019,5,28,22,883,3002,1064,-1938
2019,5,28,23,878,3031,1108,-1923
2019,5,29,0,803,2951,1071,-1880
2019,5,29,1,790,2976,972,-2004
2019,5,29,2,770,3020,1250,-1770
2019,5,29,3,763,3058,1312,-1746
2019,5,29,4,767,3047,1265,-1782
2019,5,29,5,764,3035,1236,-1799
2019,5,29,6,897,2810,1216,-1594
2019,5,29,7,654,2555,1128,-1427
2019,5,29,8,742,2379,1051,-1328
2019,5,29,9,632,2160,929,-1231
2019,5,29,10,632,2117,916,-1201
2019,5,29,11,612,2098,894,-1204
2019,5,29,12,680,2178,901,-1277
2019,5,29,13,713,2366,912,-1454
2019,5,29,14,449,2629,897,-1732
2019,5,29,15,683,2834,873,-1961
2019,5,29,16,742,2890,873,-2017
2019,5,29,17,756,2923,977,-1946
2019,5,29,18,786,2974,1049,-1925
2019,5,29,19,868,2964,1052,-1912
2019,5,29,20,888,2949,1047,-1902
2019,5,29,21,907,2963,1033,-1930
2019,5,29,22,910,2984,1056,-1928
2019,5,29,23,895,3003,1067,-1936
2019,5,30,0,881,3057,1110,-1947
2019,5,30,1,935,3104,1104,-2000
2019,5,30,2,890,3097,1113,-1984
2019,5,30,3,832,3078,1118,-1960
2019,5,30,4,835,3062,1138,-1924
2019,5,30,5,837,3037,1136,-1901
2019,5,30,6,892,2821,1141,-1680
2019,5,30,7,845,2567,1150,-1417
2019,5,30,8,813,2387,1072,-1315
2019,5,30,9,725,2247,1022,-1225
2019,5,30,10,687,2198,1013,-1185
2019,5,30,11,682,2198,1006,-1192
2019,5,30,12,760,2312,1048,-1264
2019,5,30,13,744,2495,1042,-1453
2019,5,30,14,794,2756,1028,-1728
2019,5,30,15,830,2935,1018,-1917
2019,5,30,16,855,2997,1068,-1929
2019,5,30,17,831,3027,1089,-1938
2019,5,30,18,885,3026,1094,-1932
2019,5,30,19,889,3022,1106,-1916
2019,5,30,20,1032,3027,1111,-1916
2019,5,30,21,1096,3033,1108,-1925
2019,5,30,22,1118,3039,1155,-1884
2019,5,30,23,1126,3076,1254,-1822
2019,5,31,0,957,3167,1329,-1838
2019,5,31,1,1280,3224,1329,-1895
2019,5,31,2,1270,3224,1291,-1933
2019,5,31,3,1237,3192,1170,-2022
2019,5,31,4,1184,3154,1226,-1928
2019,5,31,5,1156,3113,1302,-1811
2019,5,31,6,1271,2892,1337,-1555
2019,5,31,7,1002,2622,1410,-1212
2019,5,31,8,907,2416,1313,-1103
2019,5,31,9,821,2311,1264,-1047
2019,5,31,10,770,2247,1198,-1049
2019,5,31,11,839,2238,1223,-1015
2019,5,31,12,873,2301,1271,-1030
2019,5,31,13,886,2449,1306,-1143
2019,5,31,14,933,2697,1257,-1440
2019,5,31,15,1042,2923,1308,-1615
2019,5,31,16,1105,3012,1310,-1702
2019,5,31,17,1149,3028,1298,-1730
2019,5,31,18,1176,3045,1363,-1682
2019,5,31,19,1178,3042,1379,-1663
2019,5,31,20,1182,3041,1384,-1657
2019,5,31,21,1198,3066,1383,-1683
2019,5,31,22,1206,3091,1384,-1707
2019,5,31,23,1217,3121,1382,-1739
2019,6,1,0,1233,3172,1392,-1780
2019,6,1,1,1253,3214,1412,-1802
2019,6,1,2,1195,3183,1404,-1779
2019,6,1,3,1130,3114,1510,-1604
2019,6,1,4,1120,3051,1487,-1564
2019,6,1,5,1120,3036,1443,-1593
2019,6,1,6,1262,2866,1449,-1417
2019,6,1,7,1063,2630,1436,-1194
2019,6,1,8,864,2397,1286,-1111
2019,6,1,9,819,2274,1279,-995
2019,6,1,10,805,2162,1229,-933
2019,6,1,11,802,2178,1031,-1147
2019,6,1,12,801,2088,927,-1161
2019,6,1,13,606,2097,910,-1187
2019,6,1,14,707,2200,907,-1293
2019,6,1,15,719,2368,869,-1499
2019,6,1,16,754,2547,931,-1616
2019,6,1,17,839,2665,920,-1745
2019,6,1,18,899,2725,984,-1741
2019,6,1,19,916,2723,970,-1753
2019,6,1,20,917,2791,997,-1794
2019,6,1,21,918,2785,928,-1857
2019,6,1,22,923,2785,814,-1971
2019,6,1,23,933,2810,791,-2019
2019,6,2,0,947,2938,865,-2073
2019,6,2,1,962,3014,1125,-1889
2019,6,2,2,973,3024,1213,-1811
2019,6,2,3,964,2973,1210,-1763
2019,6,2,4,982,2923,1210,-1713
2019,6,2,5,978,3015,1325,-1690
2019,6,2,6,974,2876,1302,-1574
2019,6,2,7,964,2654,1322,-1332
2019,6,2,8,1078,2473,1337,-1136
2019,6,2,9,1033,2341,1298,-1043
2019,6,2,10,950,2273,1233,-1040
2019,6,2,11,923,2241,1229,-1012
2019,6,2,12,873,2246,1212,-1034
2019,6,2,13,847,2239,1175,-1064
2019,6,2,14,685,2094,770,-1324
2019,6,2,15,689,2169,580,-1589
2019,6,2,16,678,2623,982,-1641
2019,6,2,17,806,2781,1003,-1778
2019,6,2,18,883,2837,1079,-1758
2019,6,2,19,913,2871,1077,-1794
2019,6,2,20,921,2993,1167,-1826
2019,6,2,21,909,2985,1131,-1854
2019,6,2,22,892,3014,1134,-1880
2019,6,2,23,913,3060,1173,-1887
2019,6,3,0,950,3166,1287,-1879
2019,6,3,1,987,3225,1363,-1862
2019,6,3,2,1019,3253,1402,-1851
2019,6,3,3,1052,3218,1438,-1780
2019,6,3,4,963,3178,1396,-1782
2019,6,3,5,803,3085,1348,-1737
2019,6,3,6,984,2873,1398,-1475
2019,6,3,7,986,2573,1325,-1248
2019,6,3,8,763,2184,1115,-1069
2019,6,3,9,718,2080,1114,-966
2019,6,3,10,683,2032,1110,-922
2019,6,3,11,636,1988,1079,-909
2019,6,3,12,649,2075,1070,-1005
2019,6,3,13,827,2246,1010,-1236
2019,6,3,14,778,2502,997,-1505
2019,6,3,15,1054,2881,1245,-1636
2019,6,3,16,1179,3062,1350,-1712
2019,6,3,17,1239,3107,1331,-1776
2019,6,3,18,1162,3110,1304,-1806
2019,6,3,19,1185,3123,1335,-1788
2019,6,3,20,1210,3107,1411,-1696
2019,6,3,21,1195,3096,1527,-1569
2019,6,3,22,1256,3067,1594,-1473
2019,6,3,23,1341,3053,1671,-1382
2019,6,4,0,1469,3079,1685,-1394
2019,6,4,1,1536,3244,1695,-1549
2019,6,4,2,1534,3264,1716,-1548
2019,6,4,3,1531,3222,1711,-1511
2019,6,4,4,1543,3189,1719,-1470
2019,6,4,5,1434,3144,1766,-1378
2019,6,4,6,1498,2930,1760,-1170
2019,6,4,7,1248,2512,1387,-1125
2019,6,4,8,1028,2188,1284,-904
2019,6,4,9,1021,2102,1242,-860
2019,6,4,10,999,2076,1283,-793
2019,6,4,11,966,2103,1251,-852
2019,6,4,12,925,2180,1249,-931
2019,6,4,13,1256,2558,1586,-972
2019,6,4,14,1296,2795,1577,-1218
2019,6,4,15,1480,3059,1810,-1249
2019,6,4,16,1519,3096,1809,-1287
2019,6,4,17,1512,3106,1808,-1298
2019,6,4,18,1506,3069,1718,-1351
2019,6,4,19,1545,3094,1880,-1214
2019,6,4,20,1558,3108,1860,-1248
2019,6,4,21,1540,3126,1848,-1278
2019,6,4,22,1484,3109,1795,-1314
2019,6,4,23,1561,3107,1860,-1247
2019,6,5,0,1623,3179,1859,-1320
2019,6,5,1,1612,3250,1826,-1424
2019,6,5,2,1615,3247,1887,-1360
2019,6,5,3,1591,3202,1882,-1320
2019,6,5,4,1623,3155,1893,-1262
2019,6,5,5,1597,3110,1802,-1308
2019,6,5,6,1585,2857,1824,-1033
2019,6,5,7,1478,2608,1674,-934
2019,6,5,8,1000,2391,1189,-1202
2019,6,5,9,975,2246,1049,-1197
2019,6,5,10,855,2204,1094,-1110
2019,6,5,11,832,2189,1004,-1185
2019,6,5,12,930,2377,1218,-1159
2019,6,5,13,1140,2539,1361,-1178
2019,6,5,14,1143,2839,1242,-1597
2019,6,5,15,1410,3029,1331,-1698
2019,6,5,16,1476,3012,1436,-1576
2019,6,5,17,1504,3013,1458,-1555
2019,6,5,18,1684,3014,1551,-1463
2019,6,5,19,1604,3026,1587,-1439
2019,6,5,20,1564,3034,1660,-1374
2019,6,5,21,1580,2996,1582,-1414
2019,6,5,22,1582,2972,1599,-1373
2019,6,5,23,1517,2985,1838,-1147
2019,6,6,0,1630,2999,1928,-1071
2019,6,6,1,1629,3064,2029,-1035
2019,6,6,2,1630,3166,2118,-1048
2019,6,6,3,1627,3140,2108,-1032
2019,6,6,4,1644,3125,2101,-1024
2019,6,6,5,1635,3039,1985,-1054
2019,6,6,6,1804,2885,1993,-892
2019,6,6,7,1591,2640,1847,-793
2019,6,6,8,1122,2480,1611,-869
2019,6,6,9,999,2368,1515,-853
2019,6,6,10,981,2319,1534,-785
2019,6,6,11,1012,2360,1572,-788
2019,6,6,12,913,2456,1448,-1008
2019,6,6,13,1039,2659,1405,-1254
2019,6,6,14,962,2942,1322,-1620
2019,6,6,15,1165,3061,1387,-1674
2019,6,6,16,1053,3086,1290,-1796
2019,6,6,17,1041,3062,1261,-1801
2019,6,6,18,1131,3085,1286,-1799
2019,6,6,19,1091,3057,1288,-1769
2019,6,6,20,1020,3136,1359,-1777
2019,6,6,21,980,3112,1376,-1736
2019,6,6,22,1002,3066,1362,-1704
2019,6,6,23,1030,3078,1439,-1639
2019,6,7,0,1174,3091,1537,-1554
2019,6,7,1,1202,3133,1504,-1629
2019,6,7,2,1124,3146,1493,-1653
2019,6,7,3,1113,3115,1492,-1623
2019,6,7,4,1163,3107,1486,-1621
2019,6,7,5,1011,3105,1382,-1723
2019,6,7,6,1194,2888,1473,-1415
2019,6,7,7,1072,2422,1113,-1309
2019,6,7,8,906,2217,1127,-1090
2019,6,7,9,842,2136,1162,-974
2019,6,7,10,799,2102,1139,-963
2019,6,7,11,818,2114,1125,-989
2019,6,7,12,890,2211,1142,-1069
2019,6,7,13,1162,2580,1320,-1260
2019,6,7,14,1033,2877,1323,-1554
2019,6,7,15,1222,3062,1263,-1799
2019,6,7,16,1313,3140,1326,-1814
2019,6,7,17,1171,3125,1288,-1837
2019,6,7,18,1284,3117,1280,-1837
2019,6,7,19,1288,3064,1258,-1806
2019,6,7,20,1171,3051,1241,-1810
2019,6,7,21,1278,3027,1198,-1829
2019,6,7,22,1095,2976,1169,-1807
2019,6,7,23,1294,2968,1237,-1731
2019,6,8,0,1276,3021,1272,-1749
2019,6,8,1,1297,3062,1236,-1826
2019,6,8,2,1281,3098,1500,-1598
2019,6,8,3,1275,3055,1571,-1484
2019,6,8,4,1235,3070,1624,-1446
2019,6,8,5,1235,3086,1537,-1549
2019,6,8,6,1116,2946,1534,-1412
2019,6,8,7,939,2710,1464,-1246
2019,6,8,8,978,2351,1194,-1157
2019,6,8,9,864,2173,1134,-1039
2019,6,8,10,820,2075,1021,-1054
2019,6,8,11,834,1997,918,-1079
2019,6,8,12,855,2094,1140,-954
2019,6,8,13,968,2207,1258,-949
2019,6,8,14,785,2396,1115,-1281
2019,6,8,15,1058,2739,1148,-1591
2019,6,8,16,1056,2871,1117,-1754
2019,6,8,17,1197,2934,1099,-1835
2019,6,8,18,1253,2966,1090,-1876
2019,6,8,19,1255,2904,1075,-1829
2019,6,8,20,1227,2978,1336,-1642
2019,6,8,21,1201,2937,1369,-1568
2019,6,8,22,1176,2909,1379,-1530
2019,6,8,23,1177,2890,1408,-1482
2019,6,9,0,1209,2900,1462,-1438
2019,6,9,1,1331,2929,1635,-1294
2019,6,9,2,1364,2953,1840,-1113
2019,6,9,3,1366,2930,1863,-1067
2019,6,9,4,1356,2904,1837,-1067
2019,6,9,5,1412,2942,1886,-1056
2019,6,9,6,1463,2832,1899,-933
2019,6,9,7,1257,2641,1760,-881
2019,6,9,8,1251,2483,1697,-786
2019,6,9,9,1245,2390,1608,-782
2019,6,9,10,1140,2342,1548,-794
2019,6,9,11,1153,2325,1498,-827
2019,6,9,12,1023,2358,1489,-869
2019,6,9,13,1065,2356,1429,-927
2019,6,9,14,1116,2451,1309,-1142
2019,6,9,15,1113,2505,1097,-1408
2019,6,9,16,1465,2690,1167,-1523
2019,6,9,17,1382,2798,1271,-1527
2019,6,9,18,1424,2909,1311,-1598
2019,6,9,19,1439,2928,1378,-1550
2019,6,9,20,1397,2928,1613,-1315
2019,6,9,21,1376,2907,1554,-1353
2019,6,9,22,1347,2865,1508,-1357
2019,6,9,23,1363,2822,1465,-1357
2019,6,10,0,1409,2896,1595,-1301
2019,6,10,1,1461,3047,1730,-1317
2019,6,10,2,1573,3111,1898,-1213
2019,6,10,3,1563,3021,1863,-1158
2019,6,10,4,1544,2897,1791,-1106
2019,6,10,5,1529,2845,1720,-1125
2019,6,10,6,1536,2672,1646,-1026
2019,6,10,7,1482,2414,1574,-840
2019,6,10,8,1217,2234,1559,-675
2019,6,10,9,1295,2128,1498,-630
2019,6,10,10,1334,2010,1443,-567
2019,6,10,11,1374,1993,1582,-411
2019,6,10,12,1448,2123,1710,-413
2019,6,10,13,1429,2352,1729,-623
2019,6,10,14,1642,2634,1843,-791
2019,6,10,15,1865,2861,1926,-935
2019,6,10,16,1972,2969,2125,-844
2019,6,10,17,1977,3007,2111,-896
2019,6,10,18,1989,3039,2127,-912
2019,6,10,19,2005,3073,2138,-935
2019,6,10,20,2016,3036,2146,-890
2019,6,10,21,2010,3037,2204,-833
2019,6,10,22,2003,2987,2237,-750
2019,6,10,23,2132,3072,2345,-727
2019,6,11,0,2243,3167,2463,-704
2019,6,11,1,2283,3276,2521,-755
2019,6,11,2,2286,3282,2574,-708
2019,6,11,3,2254,3232,2614,-618
2019,6,11,4,2216,3163,2518,-645
2019,6,11,5,2100,3112,2420,-692
2019,6,11,6,1898,2861,2232,-629
2019,6,11,7,1616,2520,1946,-574
2019,6,11,8,1747,2317,1897,-420
2019,6,11,9,1708,2175,1869,-306
2019,6,11,10,1716,2124,1892,-232
2019,6,11,11,1763,2130,1850,-280
2019,6,11,12,1707,2193,1850,-343
2019,6,11,13,1601,2337,1861,-476
2019,6,11,14,1398,2602,1791,-811
2019,6,11,15,1490,2818,1776,-1042
2019,6,11,16,1655,2942,1935,-1007
2019,6,11,17,1706,3041,2015,-1026
2019,6,11,18,1757,3139,2071,-1068
2019,6,11,19,1820,3204,2177,-1027
2019,6,11,20,1868,3259,2286,-973
2019,6,11,21,1902,3312,2290,-1022
2019,6,11,22,2016,3372,2271,-1101
2019,6,11,23,2097,3441,2352,-1089
2019,6,12,0,2106,3533,2366,-1167
2019,6,12,1,2089,3594,2409,-1185
2019,6,12,2,2066,3577,2394,-1183
2019,6,12,3,2091,3528,2403,-1125
2019,6,12,4,2082,3435,2358,-1077
2019,6,12,5,2086,3311,2330,-981
2019,6,12,6,2142,3040,2269,-771
2019,6,12,7,1855,2683,2108,-575
2019,6,12,8,1826,2457,2006,-451
2019,6,12,9,1729,2401,2110,-291
2019,6,12,10,1727,2329,2073,-256
2019,6,12,11,1712,2295,2014,-281
2019,6,12,12,1702,2355,2037,-318
2019,6,12,13,1722,2481,2074,-407
2019,6,12,14,1651,2738,2055,-683
2019,6,12,15,1694,2992,2104,-888
2019,6,12,16,1809,3073,1972,-1101
2019,6,12,17,1833,3205,2019,-1186
2019,6,12,18,1999,3315,2175,-1140
2019,6,12,19,1999,3432,2188,-1244
2019,6,12,20,1993,3529,2199,-1330
2019,6,12,21,1986,3610,2173,-1437
2019,6,12,22,2024,3688,2223,-1465
2019,6,12,23,2023,3735,2203,-1532
2019,6,13,0,2022,3781,2154,-1627
2019,6,13,1,2021,3809,2157,-1652
2019,6,13,2,2032,3786,2212,-1574
2019,6,13,3,2042,3732,2225,-1507
2019,6,13,4,2056,3629,2231,-1398
2019,6,13,5,2068,3509,2147,-1362
2019,6,13,6,2083,3251,2168,-1083
2019,6,13,7,2210,2877,2111,-766
2019,6,13,8,1910,2684,2125,-559
2019,6,13,9,1866,2515,2141,-374
2019,6,13,10,1881,2367,2050,-317
2019,6,13,11,1838,2314,1992,-322
2019,6,13,12,1805,2349,2029,-320
2019,6,13,13,1774,2454,2045,-409
2019,6,13,14,1661,2709,2022,-687
2019,6,13,15,1815,3013,2065,-948
2019,6,13,16,1794,3141,1993,-1148
2019,6,13,17,1812,3206,2072,-1134
2019,6,13,18,1849,3273,2172,-1101
2019,6,13,19,1893,3305,2120,-1185
2019,6,13,20,1917,3349,2132,-1217
2019,6,13,21,2048,3407,2242,-1165
2019,6,13,22,2064,3425,2255,-1170
2019,6,13,23,2172,3460,2274,-1186
2019,6,14,0,2171,3468,2287,-1181
2019,6,14,1,2259,3461,2306,-1155
2019,6,14,2,2233,3395,2308,-1087
2019,6,14,3,2158,3328,2405,-923
2019,6,14,4,2167,3169,2395,-774
2019,6,14,5,1887,3098,2259,-839
2019,6,14,6,1797,2855,2215,-640
2019,6,14,7,1563,2582,2047,-535
2019,6,14,8,1757,2352,2163,-189
2019,6,14,9,1758,2227,2122,-105
2019,6,14,10,1704,2143,1989,-154
2019,6,14,11,1694,2142,1914,-228
2019,6,14,12,1558,2158,1962,-196
2019,6,14,13,1480,2294,1922,-372
2019,6,14,14,1390,2531,1732,-799
2019,6,14,15,1414,2735,1608,-1127
2019,6,14,16,1566,2891,1505,-1386
2019,6,14,17,1747,2925,1695,-1230
2019,6,14,18,1738,2995,1709,-1286
2019,6,14,19,1763,3005,1798,-1207
2019,6,14,20,1784,2981,1793,-1188
2019,6,14,21,1923,3062,1967,-1095
2019,6,14,22,1938,3072,2044,-1028
2019,6,14,23,2020,3039,2158,-881
2019,6,15,0,2031,3041,2152,-889
2019,6,15,1,2051,3054,2202,-852
2019,6,15,2,2073,3103,2358,-745
2019,6,15,3,2059,3064,2346,-718
2019,6,15,4,2022,3053,2338,-715
2019,6,15,5,1888,2995,2297,-698
2019,6,15,6,2000,2805,2244,-561
2019,6,15,7,1912,2530,2045,-485
2019,6,15,8,1723,2306,1991,-315
2019,6,15,9,1689,2168,1924,-244
2019,6,15,10,1639,2040,1824,-216
2019,6,15,11,1568,2014,1779,-235
2019,6,15,12,1729,2032,1755,-277
2019,6,15,13,1668,2094,1745,-349
2019,6,15,14,1445,2179,1674,-505
2019,6,15,15,1640,2372,1640,-732
2019,6,15,16,1667,2599,1690,-909
2019,6,15,17,1888,2696,1758,-938
2019,6,15,18,1983,2746,1740,-1006
2019,6,15,19,2001,2751,1759,-992
2019,6,15,20,1974,2750,1760,-990
2019,6,15,21,1954,2744,1863,-881
2019,6,15,22,1961,2756,1896,-860
2019,6,15,23,1966,2776,1887,-889
2019,6,16,0,1885,2826,1864,-962
2019,6,16,1,1983,2892,1909,-983
2019,6,16,2,1992,2904,1984,-920
2019,6,16,3,1939,2885,2102,-783
2019,6,16,4,1911,2827,2257,-570
2019,6,16,5,1904,2780,2138,-642
2019,6,16,6,2118,2665,2052,-613
2019,6,16,7,1914,2478,2016,-462
2019,6,16,8,1647,2297,1840,-457
2019,6,16,9,1685,2174,1892,-282
2019,6,16,10,1699,2085,1984,-101
2019,6,16,11,1658,2062,1952,-110
2019,6,16,12,1677,2057,1913,-144
2019,6,16,13,1629,2088,1843,-245
2019,6,16,14,1257,2085,1566,-519
2019,6,16,15,1356,2301,1479,-822
2019,6,16,16,1455,2549,1582,-967
2019,6,16,17,1615,2671,1756,-915
2019,6,16,18,1700,2770,1831,-939
2019,6,16,19,1766,2824,1870,-954
2019,6,16,20,1785,2822,1828,-994
2019,6,16,21,1731,2871,1993,-878
2019,6,16,22,1904,2812,1931,-881
2019,6,16,23,1933,2874,1960,-914
2019,6,17,0,1879,2930,2043,-887
2019,6,17,1,2011,3010,2201,-809
2019,6,17,2,2002,3034,2336,-698
2019,6,17,3,1997,3032,2410,-622
2019,6,17,4,2056,3004,2326,-678
2019,6,17,5,2029,2981,2282,-699
2019,6,17,6,2111,2799,2233,-566
2019,6,17,7,1813,2510,1784,-726
2019,6,17,8,1483,2301,1652,-649
2019,6,17,9,1239,2301,1658,-643
2019,6,17,10,1048,2334,1796,-538
2019,6,17,11,1101,2271,1691,-580
2019,6,17,12,1397,2429,1803,-626
2019,6,17,13,1438,2483,1698,-785
2019,6,17,14,1420,2785,1715,-1070
2019,6,17,15,1549,2998,1703,-1295
2019,6,17,16,1670,3047,1659,-1388
2019,6,17,17,1813,3088,1778,-1310
2019,6,17,18,1799,3118,1839,-1279
2019,6,17,19,1878,3099,1788,-1311
2019,6,17,20,1791,3121,1800,-1321
2019,6,17,21,1830,3139,1926,-1213
2019,6,17,22,1865,3181,1958,-1223
2019,6,17,23,1927,3214,1943,-1271
2019,6,18,0,2030,3331,2141,-1190
2019,6,18,1,2061,3404,2299,-1105
2019,6,18,2,2066,3415,2349,-1066
2019,6,18,3,2006,3380,2401,-979
2019,6,18,4,2056,3320,2408,-912
2019,6,18,5,2007,3298,2420,-878
2019,6,18,6,2035,3061,2375,-686
2019,6,18,7,2581,2777,2165,-612
2019,6,18,8,1494,2531,1800,-731
2019,6,18,9,1392,2394,1589,-805
2019,6,18,10,1274,2344,1577,-767
2019,6,18,11,1260,2295,1565,-730
2019,6,18,12,1379,2417,1643,-774
2019,6,18,13,1472,2553,1585,-968
2019,6,18,14,1330,2752,1551,-1201
2019,6,18,15,1495,2931,1609,-1322
2019,6,18,16,1402,3005,1683,-1322
2019,6,18,17,1436,3020,1717,-1303
2019,6,18,18,1488,3059,1685,-1374
2019,6,18,19,1530,3104,1707,-1397
2019,6,18,20,1552,3095,1695,-1400
2019,6,18,21,1579,3142,1797,-1345
2019,6,18,22,1591,3071,1731,-1340
2019,6,18,23,1681,3070,1743,-1327
2019,6,19,0,1850,3060,1804,-1256
2019,6,19,1,1853,3131,1889,-1242
2019,6,19,2,1851,3219,2035,-1184
2019,6,19,3,1848,3211,2024,-1187
2019,6,19,4,1817,3174,2016,-1158
2019,6,19,5,1644,3134,1946,-1188
2019,6,19,6,1837,2956,1990,-966
2019,6,19,7,1556,2634,1746,-888
2019,6,19,8,1508,2437,1676,-761
2019,6,19,9,1473,2336,1669,-667
2019,6,19,10,1412,2344,1767,-577
2019,6,19,11,1522,2387,1849,-538
2019,6,19,12,1538,2458,1844,-614
2019,6,19,13,1571,2614,1901,-713
2019,6,19,14,1464,2854,1753,-1101
2019,6,19,15,1430,2958,1742,-1216
2019,6,19,16,1381,3057,1665,-1392
2019,6,19,17,1342,3077,1555,-1522
2019,6,19,18,1353,3080,1544,-1536
2019,6,19,19,1350,3091,1574,-1517
2019,6,19,20,1362,3102,1590,-1512
2019,6,19,21,1368,3108,1598,-1510
2019,6,19,22,1361,3091,1583,-1508
2019,6,19,23,1460,3088,1583,-1505
2019,6,20,0,1515,3103,1683,-1420
2019,6,20,1,1515,3153,1701,-1452
2019,6,20,2,1557,3123,1682,-1441
2019,6,20,3,1712,3109,1744,-1365
2019,6,20,4,1716,3126,1744,-1382
2019,6,20,5,1657,3078,1945,-1133
2019,6,20,6,1830,2908,2033,-875
2019,6,20,7,1757,2684,1916,-768
2019,6,20,8,1273,2499,1477,-1022
2019,6,20,9,1236,2411,1493,-918
2019,6,20,10,1116,2371,1401,-970
2019,6,20,11,1141,2380,1541,-839
2019,6,20,12,1161,2500,1563,-937
2019,6,20,13,1229,2666,1493,-1173
2019,6,20,14,1186,2902,1446,-1456
2019,6,20,15,1230,3047,1231,-1816
2019,6,20,16,1151,3098,1386,-1712
2019,6,20,17,1190,3097,1410,-1687
2019,6,20,18,1219,3177,1504,-1673
2019,6,20,19,1231,3179,1546,-1633
2019,6,20,20,1282,3151,1592,-1559
2019,6,20,21,1206,3138,1585,-1553
2019,6,20,22,1184,3120,1585,-1535
2019,6,20,23,1285,3155,1638,-1517
2019,6,21,0,1413,3141,1565,-1576
2019,6,21,1,1463,3189,1666,-1523
2019,6,21,2,1465,3191,1673,-1518
2019,6,21,3,1448,3176,1695,-1481
2019,6,21,4,1403,3148,1629,-1519
2019,6,21,5,1296,3116,1503,-1613
2019,6,21,6,1431,2937,1569,-1368
2019,6,21,7,1356,2704,1482,-1222
2019,6,21,8,1120,2500,1443,-1057
2019,6,21,9,1076,2415,1440,-975
2019,6,21,10,1182,2296,1434,-862
2019,6,21,11,1192,2302,1326,-976
2019,6,21,12,894,2372,1324,-1048
2019,6,21,13,1200,2610,1437,-1173
2019,6,21,14,870,2799,1320,-1479
2019,6,21,15,982,2947,1257,-1690
2019,6,21,16,1223,3005,1072,-1933
2019,6,21,17,1125,3041,1187,-1854
2019,6,21,18,1203,3131,1348,-1783
2019,6,21,19,1202,3180,1392,-1788
2019,6,21,20,1294,3183,1437,-1746
2019,6,21,21,1307,3189,1460,-1729
2019,6,21,22,1312,3142,1416,-1726
2019,6,21,23,1382,3116,1354,-1762
2019,6,22,0,1320,3165,1402,-1763
2019,6,22,1,1334,3132,1386,-1746
2019,6,22,2,1350,3136,1450,-1686
2019,6,22,3,1361,3062,1535,-1527
2019,6,22,4,1367,3008,1569,-1439
2019,6,22,5,1246,2995,1558,-1437
2019,6,22,6,1360,2862,1574,-1288
2019,6,22,7,1254,2610,1503,-1107
2019,6,22,8,1202,2401,1366,-1035
2019,6,22,9,1179,2311,1370,-941
2019,6,22,10,1128,2246,1314,-932
2019,6,22,11,1044,2243,1293,-950
2019,6,22,12,1037,2268,1259,-1009
2019,6,22,13,1201,2334,1242,-1092
2019,6,22,14,874,2388,1178,-1210
2019,6,22,15,1154,2517,1167,-1350
2019,6,22,16,1074,2749,1199,-1550
2019,6,22,17,1126,2881,1167,-1714
2019,6,22,18,1219,2920,1168,-1752
2019,6,22,19,1233,2976,1350,-1626
2019,6,22,20,1244,2959,1363,-1596
2019,6,22,21,1273,2926,1375,-1551
2019,6,22,22,1184,2840,1384,-1456
2019,6,22,23,1328,2832,1513,-1319
2019,6,23,0,1171,2845,1522,-1323
2019,6,23,1,1378,2809,1478,-1331
2019,6,23,2,1270,2818,1488,-1330
2019,6,23,3,1361,2780,1289,-1491
2019,6,23,4,1126,2779,1352,-1427
2019,6,23,5,1265,2794,1354,-1440
2019,6,23,6,1225,2672,1328,-1344
2019,6,23,7,1168,2493,1321,-1172
2019,6,23,8,1224,2360,1363,-997
2019,6,23,9,1204,2276,1353,-923
2019,6,23,10,1098,2274,1404,-870
2019,6,23,11,883,2124,1275,-849
2019,6,23,12,874,2115,1164,-951
2019,6,23,13,882,2149,1125,-1024
2019,6,23,14,969,2165,1005,-1160
2019,6,23,15,930,2415,1064,-1351
2019,6,23,16,1028,2639,1104,-1535
2019,6,23,17,1096,2823,1230,-1593
2019,6,23,18,1189,2914,1433,-1481
2019,6,23,19,1233,2960,1536,-1424
2019,6,23,20,1263,3001,1591,-1410
2019,6,23,21,1267,2927,1519,-1408
2019,6,23,22,1256,2820,1373,-1447
2019,6,23,23,1282,2836,1395,-1441
2019,6,24,0,1445,2856,1387,-1469
2019,6,24,1,1509,2930,1453,-1477
2019,6,24,2,1500,2947,1483,-1464
2019,6,24,3,1513,3000,1552,-1448
2019,6,24,4,1454,2990,1569,-1421
2019,6,24,5,1222,2945,1451,-1494
2019,6,24,6,1270,2769,1485,-1284
2019,6,24,7,1171,2547,1299,-1248
2019,6,24,8,1088,2389,1278,-1111
2019,6,24,9,1063,2304,1264,-1040
2019,6,24,10,1032,2295,1269,-1026
2019,6,24,11,1057,2302,1284,-1018
2019,6,24,12,1093,2378,1370,-1008
2019,6,24,13,1173,2520,1409,-1111
2019,6,24,14,1262,2710,1383,-1327
2019,6,24,15,1333,2987,1563,-1424
2019,6,24,16,1422,3114,1583,-1531
2019,6,24,17,1584,3139,1636,-1503
2019,6,24,18,1587,3169,1641,-1528
2019,6,24,19,1581,3145,1710,-1435
2019,6,24,20,1630,3145,1727,-1418
2019,6,24,21,1549,3123,1730,-1393
2019,6,24,22,1546,3088,1736,-1352
2019,6,24,23,1562,3091,1756,-1335
2019,6,25,0,1721,3137,1894,-1243
2019,6,25,1,1732,3183,1917,-1266
2019,6,25,2,1681,3179,1939,-1240
2019,6,25,3,1675,3138,1958,-1180
2019,6,25,4,1690,3084,1964,-1120
2019,6,25,5,1736,3032,1954,-1078
2019,6,25,6,1765,2902,2051,-851
2019,6,25,7,1726,2645,1887,-758
2019,6,25,8,1391,2488,1695,-793
2019,6,25,9,1336,2380,1675,-705
2019,6,25,10,1345,2349,1625,-724
2019,6,25,11,1335,2325,1545,-780
2019,6,25,12,1367,2427,1561,-866
2019,6,25,13,1317,2583,1553,-1030
2019,6,25,14,1336,2788,1530,-1258
2019,6,25,15,1538,2918,1544,-1374
2019,6,25,16,1611,2982,1548,-1434
2019,6,25,17,1620,3031,1670,-1361
2019,6,25,18,1619,3048,1701,-1347
2019,6,25,19,1631,3086,1756,-1330
2019,6,25,20,1630,3128,1775,-1353
2019,6,25,21,1631,3164,1804,-1360
2019,6,25,22,1640,3137,1753,-1384
2019,6,25,23,1671,3173,1820,-1353
2019,6,26,0,1709,3267,1890,-1377
2019,6,26,1,1741,3311,2024,-1287
2019,6,26,2,1730,3302,2188,-1114
2019,6,26,3,1685,3268,2133,-1135
2019,6,26,4,1742,3249,2153,-1096
2019,6,26,5,1682,3207,2146,-1061
2019,6,26,6,1793,3001,2107,-894
2019,6,26,7,1633,2754,2025,-729
2019,6,26,8,1622,2654,2016,-638
2019,6,26,9,1573,2551,1860,-691
2019,6,26,10,1514,2500,1817,-683
2019,6,26,11,1534,2403,1702,-701
2019,6,26,12,1529,2471,1717,-754
2019,6,26,13,1710,2640,1875,-765
2019,6,26,14,1548,2859,1866,-993
2019,6,26,15,1675,3027,1832,-1195
2019,6,26,16,1709,3106,1807,-1299
2019,6,26,17,1600,3140,1767,-1373
2019,6,26,18,1611,3202,1748,-1454
2019,6,26,19,1612,3245,1760,-1485
2019,6,26,20,1615,3326,1796,-1530
2019,6,26,21,1607,3367,1823,-1544
2019,6,26,22,1608,3412,1848,-1564
2019,6,26,23,1657,3393,1845,-1548
2019,6,27,0,1795,3361,2049,-1312
2019,6,27,1,1796,3347,2062,-1285
2019,6,27,2,1851,3308,2281,-1027
2019,6,27,3,1857,3261,2293,-968
2019,6,27,4,1783,3232,2089,-1143
2019,6,27,5,1620,3184,1892,-1292
2019,6,27,6,1956,3027,2022,-1005
2019,6,27,7,1679,2798,1947,-851
2019,6,27,8,1479,2530,1797,-733
2019,6,27,9,1439,2505,1799,-706
2019,6,27,10,1303,2372,1473,-899
2019,6,27,11,1314,2367,1430,-937
2019,6,27,12,1167,2429,1374,-1055
2019,6,27,13,1420,2580,1430,-1150
2019,6,27,14,1430,2839,1612,-1227
2019,6,27,15,1477,3037,1597,-1440
2019,6,27,16,1486,3200,1604,-1596
2019,6,27,17,1482,3272,1623,-1649
2019,6,27,18,1474,3287,1595,-1692
2019,6,27,19,1469,3325,1675,-1650
2019,6,27,20,1485,3295,1684,-1611
2019,6,27,21,1505,3315,1741,-1574
2019,6,27,22,1511,3271,1757,-1514
2019,6,27,23,1653,3258,1751,-1507
2019,6,28,0,1742,3273,1855,-1418
2019,6,28,1,1737,3288,1876,-1412
2019,6,28,2,1747,3266,1876,-1390
2019,6,28,3,1787,3263,1957,-1306
2019,6,28,4,1769,3232,1948,-1284
2019,6,28,5,1655,3220,1843,-1377
2019,6,28,6,1670,3051,1918,-1133
2019,6,28,7,1519,2821,1830,-991
2019,6,28,8,1544,2575,1658,-917
2019,6,28,9,1459,2479,1639,-840
2019,6,28,10,1434,2413,1540,-873
2019,6,28,11,1275,2429,1633,-796
2019,6,28,12,1352,2551,1697,-854
2019,6,28,13,1469,2670,1706,-964
2019,6,28,14,1423,2832,1661,-1171
2019,6,28,15,1769,2963,1726,-1237
2019,6,28,16,1611,3141,1788,-1353
2019,6,28,17,1662,3164,1783,-1381
2019,6,28,18,1700,3247,1864,-1383
2019,6,28,19,1699,3270,1913,-1357
2019,6,28,20,1700,3304,1926,-1378
2019,6,28,21,1692,3292,1920,-1372
2019,6,28,22,1673,3290,1962,-1328
2019,6,28,23,1777,3294,1952,-1342
2019,6,29,0,1857,3287,1987,-1300
2019,6,29,1,1901,3319,2029,-1290
2019,6,29,2,1903,3268,2033,-1235
2019,6,29,3,1844,3213,2084,-1129
2019,6,29,4,1805,3159,2136,-1023
2019,6,29,5,1617,3154,2049,-1105
2019,6,29,6,1941,3027,2184,-843
2019,6,29,7,1809,2789,2083,-706
2019,6,29,8,1959,2602,2118,-484
2019,6,29,9,1912,2490,2060,-430
2019,6,29,10,1857,2436,2017,-419
2019,6,29,11,1861,2381,1984,-397
2019,6,29,12,1869,2358,1834,-524
2019,6,29,13,1815,2359,1796,-563
2019,6,29,14,1706,2471,1804,-667
2019,6,29,15,1787,2654,1898,-756
2019,6,29,16,1971,2869,1950,-919
2019,6,29,17,2096,2987,2054,-933
2019,6,29,18,2150,3087,2175,-912
2019,6,29,19,2152,3106,2172,-934
2019,6,29,20,2137,3111,2170,-941
2019,6,29,21,2123,3078,2152,-926
2019,6,29,22,2100,3086,2152,-934
2019,6,29,23,2103,3134,2155,-979
2019,6,30,0,2120,3166,2241,-925
2019,6,30,1,2145,3142,2187,-955
2019,6,30,2,2147,3158,2166,-992
2019,6,30,3,2127,3125,2164,-961
2019,6,30,4,2086,3071,2156,-915
2019,6,30,5,2082,3034,2058,-976
2019,6,30,6,2282,2920,2212,-708
2019,6,30,7,2087,2699,2026,-673
2019,6,30,8,1861,2503,1937,-566
2019,6,30,9,1923,2377,1907,-470
2019,6,30,10,1879,2316,1907,-409
2019,6,30,11,1821,2282,1907,-375
2019,6,30,12,1816,2397,1961,-436
2019,6,30,13,1709,2432,2010,-422
2019,6,30,14,1705,2510,2007,-503
2019,6,30,15,1791,2680,2061,-619
2019,6,30,16,1997,2855,2121,-734
2019,6,30,17,2165,2958,2084,-874
2019,6,30,18,2256,3049,2090,-959
2019,6,30,19,2292,3123,2092,-1031
2019,6,30,20,2315,3121,2113,-1008
2019,6,30,21,2322,3129,2131,-998
2019,6,30,22,2329,3162,2122,-1040
2019,6,30,23,2366,3211,2125,-1086
2019,7,1,0,2418,3300,2223,-1077
2019,7,1,1,2470,3384,2229,-1155
2019,7,1,2,2493,3455,2275,-1180
2019,7,1,3,2486,3481,2347,-1134
2019,7,1,4,2426,3400,2403,-997
2019,7,1,5,2413,3341,2311,-1030
2019,7,1,6,2372,3151,2283,-868
2019,7,1,7,2102,2913,2141,-772
2019,7,1,8,2092,2724,2100,-624
2019,7,1,9,2011,2569,2062,-507
2019,7,1,10,1976,2492,2044,-448
2019,7,1,11,2029,2456,1984,-472
2019,7,1,12,2118,2607,2132,-475
2019,7,1,13,2092,2762,2270,-492
2019,7,1,14,1922,2847,2070,-777
2019,7,1,15,2280,3055,2108,-947
2019,7,1,16,2256,3197,2284,-913
2019,7,1,17,2379,3256,2173,-1083
2019,7,1,18,2467,3338,2195,-1143
2019,7,1,19,2537,3449,2308,-1141
2019,7,1,20,2544,3483,2299,-1184
2019,7,1,21,2588,3534,2272,-1262
2019,7,1,22,2611,3715,2414,-1301
2019,7,1,23,2729,3792,2485,-1307
2019,7,2,0,2816,3812,2655,-1157
2019,7,2,1,2831,3851,2740,-1111
2019,7,2,2,2852,3835,2788,-1047
2019,7,2,3,2779,3710,2808,-902
2019,7,2,4,2692,3587,2630,-957
2019,7,2,5,2453,3491,2583,-908
2019,7,2,6,2465,3306,2665,-641
2019,7,2,7,2204,2992,2649,-343
2019,7,2,8,2209,2827,2618,-209
2019,7,2,9,2057,2722,2584,-138
2019,7,2,10,2051,2619,2525,-94
2019,7,2,11,2087,2559,2405,-154
2019,7,2,12,2147,2601,2381,-220
2019,7,2,13,2175,2710,2363,-347
2019,7,2,14,1901,2865,2001,-864
2019,7,2,15,1900,3060,2033,-1027
2019,7,2,16,2160,3269,2151,-1118
2019,7,2,17,2214,3405,2258,-1147
2019,7,2,18,2137,3461,2325,-1136
2019,7,2,19,2225,3471,2260,-1211
2019,7,2,20,2280,3490,2388,-1102
2019,7,2,21,2312,3466,2479,-987
2019,7,2,22,2325,3456,2544,-912
2019,7,2,23,2419,3396,2727,-669
2019,7,3,0,2543,3404,2907,-497
2019,7,3,1,2553,3465,2883,-582
2019,7,3,2,2557,3451,2792,-659
2019,7,3,3,2550,3424,2751,-673
2019,7,3,4,2535,3382,2677,-705
2019,7,3,5,2269,3295,2498,-797
2019,7,3,6,2500,3126,2591,-535
2019,7,3,7,2213,2836,2445,-391
2019,7,3,8,2102,2668,2401,-267
2019,7,3,9,2004,2563,2385,-178
2019,7,3,10,2088,2511,2223,-288
2019,7,3,11,2056,2513,2193,-320
2019,7,3,12,1933,2589,2100,-489
2019,7,3,13,2046,2764,2127,-637
2019,7,3,14,1795,2896,2020,-876
2019,7,3,15,2027,3055,1975,-1080
2019,7,3,16,2023,3246,2048,-1198
2019,7,3,17,2114,3332,2295,-1037
2019,7,3,18,2211,3388,2297,-1091
2019,7,3,19,2281,3411,2360,-1051
2019,7,3,20,2333,3420,2332,-1088
2019,7,3,21,2369,3404,2419,-985
2019,7,3,22,2388,3388,2431,-957
2019,7,3,23,2558,3370,2356,-1014
2019,7,4,0,2666,3383,2486,-897
2019,7,4,1,2669,3387,2614,-773
2019,7,4,2,2681,3341,2607,-734
2019,7,4,3,2699,3257,2670,-587
2019,7,4,4,2682,3197,2658,-539
2019,7,4,5,2435,3188,2547,-641
2019,7,4,6,2810,3104,2751,-353
2019,7,4,7,2581,2903,2602,-301
2019,7,4,8,2009,2666,2318,-348
2019,7,4,9,2046,2563,2194,-369
2019,7,4,10,1849,2439,2141,-298
2019,7,4,11,1802,2383,2044,-339
2019,7,4,12,1862,2473,2049,-424
2019,7,4,13,1759,2523,1974,-549
2019,7,4,14,1874,2586,1916,-670
2019,7,4,15,1777,2725,1840,-885
2019,7,4,16,1865,2951,1918,-1033
2019,7,4,17,2114,3120,2161,-959
2019,7,4,18,2046,3225,2251,-974
2019,7,4,19,2084,3258,2360,-898
2019,7,4,20,2093,3275,2472,-803
2019,7,4,21,2088,3257,2484,-773
2019,7,4,22,2059,3258,2388,-870
2019,7,4,23,2216,3221,2373,-848
2019,7,5,0,2224,3244,2250,-994
2019,7,5,1,2227,3216,2325,-891
2019,7,5,2,2107,3182,2480,-702
2019,7,5,3,2188,3129,2501,-628
2019,7,5,4,2011,3043,2367,-676
2019,7,5,5,1970,3036,2400,-636
2019,7,5,6,2208,2948,2445,-503
2019,7,5,7,2132,2890,2303,-587
2019,7,5,8,2004,2687,2199,-488
2019,7,5,9,1977,2531,2113,-418
2019,7,5,10,1978,2458,1947,-511
2019,7,5,11,1875,2439,1950,-489
2019,7,5,12,2006,2482,2014,-468
2019,7,5,13,2038,2564,2134,-430
2019,7,5,14,1780,2695,2040,-655
2019,7,5,15,1987,2894,2037,-857
2019,7,5,16,2075,3045,2059,-986
2019,7,5,17,2121,3180,2144,-1036
2019,7,5,18,2153,3268,2210,-1058
2019,7,5,19,2100,3310,2272,-1038
2019,7,5,20,2098,3337,2290,-1047
2019,7,5,21,2109,3340,2345,-995
2019,7,5,22,2100,3327,2368,-959
2019,7,5,23,2329,3284,2442,-842
2019,7,6,0,2393,3276,2402,-874
2019,7,6,1,2404,3305,2437,-868
2019,7,6,2,2388,3306,2535,-771
2019,7,6,3,2334,3243,2544,-699
2019,7,6,4,2279,3197,2526,-671
2019,7,6,5,2141,3203,2493,-710
2019,7,6,6,2339,3103,2568,-535
2019,7,6,7,2245,2821,2336,-485
2019,7,6,8,2311,2737,2450,-287
2019,7,6,9,2123,2563,2231,-332
2019,7,6,10,1992,2472,2112,-360
2019,7,6,11,1974,2409,2005,-404
2019,7,6,12,1967,2433,2049,-384
2019,7,6,13,1959,2462,2073,-389
2019,7,6,14,1949,2581,2080,-501
2019,7,6,15,2073,2686,2009,-677
2019,7,6,16,1978,2834,2008,-826
2019,7,6,17,2142,3004,2073,-931
2019,7,6,18,2241,3138,2228,-910
2019,7,6,19,2381,3139,2354,-785
2019,7,6,20,2387,3137,2384,-753
2019,7,6,21,2283,3209,2451,-758
2019,7,6,22,2259,3211,2413,-798
2019,7,6,23,2245,3218,2488,-730
2019,7,7,0,2258,3212,2503,-709
2019,7,7,1,2441,3220,2548,-672
2019,7,7,2,2466,3182,2633,-549
2019,7,7,3,2339,3124,2570,-554
2019,7,7,4,2312,3147,2619,-528
2019,7,7,5,2310,3147,2580,-567
2019,7,7,6,2463,3032,2589,-443
2019,7,7,7,2331,2833,2515,-318
2019,7,7,8,2010,2668,2431,-237
2019,7,7,9,1684,2344,2218,-126
2019,7,7,10,1668,2246,2185,-61
2019,7,7,11,1650,2198,2025,-173
2019,7,7,12,1699,2206,1951,-255
2019,7,7,13,1646,2215,1929,-286
2019,7,7,14,1629,2250,1887,-363
2019,7,7,15,1613,2428,2043,-385
2019,7,7,16,1858,2808,2043,-765
2019,7,7,17,1979,3025,2088,-937
2019,7,7,18,2115,3188,2265,-923
2019,7,7,19,2198,3131,2236,-895
2019,7,7,20,2253,3084,2159,-925
2019,7,7,21,2285,3075,2157,-918
2019,7,7,22,2297,3037,2259,-778
2019,7,7,23,2318,3007,2363,-644
2019,7,8,0,2371,2965,2356,-609
2019,7,8,1,2496,2992,2500,-492
2019,7,8,2,2522,3057,2604,-453
2019,7,8,3,2511,3029,2614,-415
2019,7,8,4,2484,3009,2630,-379
2019,7,8,5,2435,3071,2599,-472
2019,7,8,6,2589,2910,2549,-361
2019,7,8,7,2344,2679,2430,-249
2019,7,8,8,2235,2392,2266,-126
2019,7,8,9,1902,2249,2124,-125
2019,7,8,10,1888,2192,2063,-129
2019,7,8,11,1876,2167,1905,-262
2019,7,8,12,1905,2257,1991,-266
2019,7,8,13,1943,2482,2027,-455
2019,7,8,14,1693,2639,1949,-690
2019,7,8,15,1848,2884,2082,-802
2019,7,8,16,1946,2947,2049,-898
2019,7,8,17,2050,3023,2021,-1002
2019,7,8,18,2142,3087,2125,-962
2019,7,8,19,2187,3196,2216,-980
2019,7,8,20,2190,3253,2319,-934
2019,7,8,21,2214,3293,2434,-859
2019,7,8,22,2228,3315,2475,-840
2019,7,8,23,2274,3317,2403,-914
2019,7,9,0,2306,3338,2439,-899
2019,7,9,1,2635,3432,2493,-939
2019,7,9,2,2644,3399,2469,-930
2019,7,9,3,2651,3383,2537,-846
2019,7,9,4,2660,3308,2548,-760
2019,7,9,5,2666,3228,2398,-830
2019,7,9,6,2667,3040,2422,-618
2019,7,9,7,2514,2769,2330,-439
2019,7,9,8,1670,2503,1800,-703
2019,7,9,9,1660,2429,1830,-599
2019,7,9,10,1605,2316,1706,-610
2019,7,9,11,1577,2310,1701,-609
2019,7,9,12,1577,2371,1720,-651
2019,7,9,13,1675,2534,1804,-730
2019,7,9,14,1597,2632,1647,-985
2019,7,9,15,1653,2785,1629,-1156
2019,7,9,16,1760,2890,1748,-1142
2019,7,9,17,1873,2983,1794,-1189
2019,7,9,18,1803,3056,1839,-1217
2019,7,9,19,1841,3160,1956,-1204
2019,7,9,20,1856,3237,2071,-1166
2019,7,9,21,1877,3262,2093,-1169
2019,7,9,22,1887,3262,2173,-1089
2019,7,9,23,2035,3270,2199,-1071
2019,7,10,0,2146,3252,2167,-1085
2019,7,10,1,2142,3323,2127,-1196
2019,7,10,2,2145,3256,2211,-1045
2019,7,10,3,2146,3254,2217,-1037
2019,7,10,4,2144,3226,2204,-1022
2019,7,10,5,1904,3158,2107,-1051
2019,7,10,6,2142,2964,2199,-765
2019,7,10,7,1895,2732,1928,-804
2019,7,10,8,1803,2690,2104,-586
2019,7,10,9,1737,2669,2132,-537
2019,7,10,10,1878,2531,2117,-414
2019,7,10,11,1594,2399,1968,-431
2019,7,10,12,1695,2370,1736,-634
2019,7,10,13,1759,2554,1838,-716
2019,7,10,14,1687,2821,1899,-922
2019,7,10,15,1956,3024,1895,-1129
2019,7,10,16,2196,3198,2053,-1145
2019,7,10,17,2248,3313,2113,-1200
2019,7,10,18,2270,3373,2138,-1235
2019,7,10,19,2253,3443,2219,-1224
2019,7,10,20,2169,3533,2311,-1222
2019,7,10,21,2195,3533,2334,-1199
2019,7,10,22,2112,3512,2361,-1151
2019,7,10,23,2249,3505,2540,-965
2019,7,11,0,2281,3539,2541,-998
2019,7,11,1,2291,3562,2531,-1031
2019,7,11,2,2269,3569,2520,-1049
2019,7,11,3,2268,3511,2605,-906
2019,7,11,4,2291,3437,2602,-835
2019,7,11,5,2121,3419,2485,-934
2019,7,11,6,2173,3226,2506,-720
2019,7,11,7,2013,2941,2253,-688
2019,7,11,8,2177,2804,2363,-441
2019,7,11,9,2112,2647,2127,-520
2019,7,11,10,1971,2600,2113,-487
2019,7,11,11,1928,2540,2050,-490
2019,7,11,12,1981,2613,2019,-594
2019,7,11,13,2148,2753,2043,-710
2019,7,11,14,1848,2933,2017,-916
2019,7,11,15,1880,3121,2013,-1108
2019,7,11,16,1922,3242,2111,-1131
2019,7,11,17,2040,3314,2291,-1023
2019,7,11,18,2132,3380,2403,-977
2019,7,11,19,2189,3442,2516,-926
2019,7,11,20,2135,3557,2624,-933
2019,7,11,21,2166,3546,2588,-958
2019,7,11,22,2168,3523,2547,-976
2019,7,11,23,2297,3536,2603,-933
2019,7,12,0,2448,3595,2649,-946
2019,7,12,1,2406,3586,2629,-957
2019,7,12,2,2434,3577,2782,-795
2019,7,12,3,2455,3581,2893,-688
2019,7,12,4,2472,3547,2898,-649
2019,7,12,5,2264,3506,2877,-629
2019,7,12,6,2701,3333,2832,-501
2019,7,12,7,2499,3091,2758,-333
2019,7,12,8,2325,2861,2717,-144
2019,7,12,9,2264,2760,2652,-108
2019,7,12,10,2181,2691,2530,-161
2019,7,12,11,1992,2576,2465,-111
2019,7,12,12,1995,2595,2480,-115
2019,7,12,13,2067,2738,2519,-219
2019,7,12,14,1933,2898,2517,-381
2019,7,12,15,1973,3153,2412,-741
2019,7,12,16,2078,3277,2439,-838
2019,7,12,17,2167,3368,2444,-924
2019,7,12,18,2275,3491,2503,-988
2019,7,12,19,2335,3521,2537,-984
2019,7,12,20,2366,3595,2554,-1041
2019,7,12,21,2435,3638,2651,-987
2019,7,12,22,2561,3668,2775,-893
2019,7,12,23,2586,3707,2812,-895
2019,7,13,0,2602,3758,2830,-928
2019,7,13,1,2621,3773,2786,-987
2019,7,13,2,2555,3751,2827,-924
2019,7,13,3,2552,3664,2855,-809
2019,7,13,4,2563,3561,2871,-690
2019,7,13,5,2480,3508,2890,-618
2019,7,13,6,2619,3360,2977,-383
2019,7,13,7,2544,3127,2899,-228
2019,7,13,8,2414,2939,2809,-130
2019,7,13,9,2391,2698,2678,-20
2019,7,13,10,2310,2564,2539,-25
2019,7,13,11,2267,2518,2415,-103
2019,7,13,12,2199,2507,2320,-187
2019,7,13,13,2245,2539,2284,-255
2019,7,13,14,2090,2600,2228,-372
2019,7,13,15,2224,2775,2293,-482
2019,7,13,16,2286,2990,2323,-667
2019,7,13,17,2291,3133,2368,-765
2019,7,13,18,2280,3240,2382,-858
2019,7,13,19,2349,3316,2484,-832
2019,7,13,20,2338,3346,2505,-841
2019,7,13,21,2434,3356,2597,-759
2019,7,13,22,2601,3374,2738,-636
2019,7,13,23,2568,3371,2791,-580
2019,7,14,0,2709,3493,2936,-557
2019,7,14,1,2674,3531,2962,-569
2019,7,14,2,2740,3508,2978,-530
2019,7,14,3,2690,3439,2912,-527
2019,7,14,4,2580,3398,2814,-584
2019,7,14,5,2526,3374,2770,-604
2019,7,14,6,2544,3229,2707,-522
2019,7,14,7,2381,2974,2617,-357
2019,7,14,8,2193,2774,2516,-258
2019,7,14,9,2130,2636,2483,-153
2019,7,14,10,2199,2573,2462,-111
2019,7,14,11,2097,2517,2437,-80
2019,7,14,12,2123,2494,2428,-66
2019,7,14,13,2054,2478,2407,-71
2019,7,14,14,1997,2553,2467,-86
2019,7,14,15,2078,2703,2421,-282
2019,7,14,16,2022,2904,2433,-471
2019,7,14,17,2072,3071,2316,-755
2019,7,14,18,2214,3198,2407,-791
2019,7,14,19,2196,3262,2490,-772
2019,7,14,20,2251,3306,2527,-779
2019,7,14,21,2283,3339,2514,-825
2019,7,14,22,2315,3378,2477,-901
2019,7,14,23,2362,3444,2471,-973
2019,7,15,0,2569,3552,2659,-893
2019,7,15,1,2695,3647,2649,-998
2019,7,15,2,2729,3664,2696,-968
2019,7,15,3,2725,3627,2753,-874
2019,7,15,4,2683,3518,2651,-867
2019,7,15,5,2629,3440,2580,-860
2019,7,15,6,2826,3254,2592,-662
2019,7,15,7,2581,2982,2469,-513
2019,7,15,8,2284,2765,2375,-390
2019,7,15,9,2221,2671,2327,-344
2019,7,15,10,2126,2598,2260,-338
2019,7,15,11,2106,2553,2193,-360
2019,7,15,12,2109,2643,2297,-346
2019,7,15,13,2275,2798,2375,-423
2019,7,15,14,2013,2912,2147,-765
2019,7,15,15,2038,3119,2176,-943
2019,7,15,16,2150,3243,2286,-957
2019,7,15,17,2187,3331,2318,-1013
2019,7,15,18,2225,3416,2408,-1008
2019,7,15,19,2301,3457,2393,-1064
2019,7,15,20,2483,3503,2518,-985
2019,7,15,21,2539,3536,2660,-876
2019,7,15,22,2413,3497,2641,-856
2019,7,15,23,2549,3496,2647,-849
2019,7,16,0,2792,3505,2666,-839
2019,7,16,1,2776,3581,2793,-788
2019,7,16,2,2732,3580,2839,-741
2019,7,16,3,2667,3511,2797,-714
2019,7,16,4,2640,3531,2910,-621
2019,7,16,5,2480,3516,2812,-704
2019,7,16,6,2671,3295,2863,-432
2019,7,16,7,2527,3052,2685,-367
2019,7,16,8,2247,2879,2662,-217
2019,7,16,9,2123,2760,2619,-141
2019,7,16,10,2208,2680,2579,-101
2019,7,16,11,2167,2642,2522,-120
2019,7,16,12,2165,2705,2473,-232
2019,7,16,13,2179,2793,2362,-431
2019,7,16,14,2048,3007,2476,-531
2019,7,16,15,2026,3122,2281,-841
2019,7,16,16,2191,3260,2292,-968
2019,7,16,17,2298,3344,2365,-979
2019,7,16,18,2378,3472,2415,-1057
2019,7,16,19,2437,3535,2409,-1126
2019,7,16,20,2468,3601,2438,-1163
2019,7,16,21,2497,3639,2455,-1184
2019,7,16,22,2501,3698,2497,-1201
2019,7,16,23,2669,3750,2662,-1088
2019,7,17,0,2690,3817,2703,-1114
2019,7,17,1,2612,3853,2788,-1065
2019,7,17,2,2617,3833,2843,-990
2019,7,17,3,2620,3766,2878,-888
2019,7,17,4,2605,3667,2900,-767
2019,7,17,5,2550,3602,2896,-706
2019,7,17,6,2671,3368,2866,-502
2019,7,17,7,2354,3091,2722,-369
2019,7,17,8,2348,2904,2550,-354
2019,7,17,9,2283,2735,2481,-254
2019,7,17,10,2165,2671,2395,-276
2019,7,17,11,2116,2660,2411,-249
2019,7,17,12,2151,2742,2437,-305
2019,7,17,13,2088,2878,2356,-522
2019,7,17,14,2059,3032,2287,-745
2019,7,17,15,2047,3186,2294,-892
2019,7,17,16,2109,3329,2407,-922
2019,7,17,17,2162,3388,2428,-960
2019,7,17,18,2248,3458,2376,-1082
2019,7,17,19,2280,3482,2497,-985
2019,7,17,20,2294,3518,2520,-998
2019,7,17,21,2321,3522,2498,-1024
2019,7,17,22,2331,3520,2487,-1033
2019,7,17,23,2245,3508,2467,-1041
2019,7,18,0,2281,3499,2435,-1064
2019,7,18,1,2305,3433,2523,-910
2019,7,18,2,2271,3332,2498,-834
2019,7,18,3,2251,3212,2377,-835
2019,7,18,4,2187,3212,2425,-787
2019,7,18,5,2028,3166,2525,-641
2019,7,18,6,2124,2964,2536,-428
2019,7,18,7,1980,2720,2425,-295
2019,7,18,8,1980,2548,2294,-254
2019,7,18,9,1915,2437,2279,-158
2019,7,18,10,1864,2363,2215,-148
2019,7,18,11,1902,2346,2194,-152
2019,7,18,12,1924,2317,2053,-264
2019,7,18,13,1867,2465,2056,-409
2019,7,18,14,1858,2668,2036,-632
2019,7,18,15,1852,2828,2061,-767
2019,7,18,16,1829,2925,1999,-926
2019,7,18,17,1893,3000,2128,-872
2019,7,18,18,1936,3072,2285,-787
2019,7,18,19,1955,3104,2346,-758
2019,7,18,20,1979,3151,2421,-730
2019,7,18,21,1997,3188,2490,-698
2019,7,18,22,2015,3244,2534,-710
2019,7,18,23,2166,3267,2568,-699
2019,7,19,0,2164,3295,2599,-696
2019,7,19,1,2273,3311,2593,-718
2019,7,19,2,2284,3290,2605,-685
2019,7,19,3,2290,3222,2642,-580
2019,7,19,4,2289,3203,2634,-569
2019,7,19,5,2380,3185,2633,-552
2019,7,19,6,2373,3002,2658,-344
2019,7,19,7,2255,2775,2644,-131
2019,7,19,8,1892,2538,2330,-208
2019,7,19,9,1843,2433,2268,-165
2019,7,19,10,1740,2378,2178,-200
2019,7,19,11,1681,2323,2072,-251
2019,7,19,12,1679,2379,2088,-291
2019,7,19,13,1850,2516,2087,-429
2019,7,19,14,1815,2691,2030,-661
2019,7,19,15,1854,2863,1947,-916
2019,7,19,16,1745,2982,2054,-928
2019,7,19,17,1829,3082,2150,-932
2019,7,19,18,1901,3112,2184,-928
2019,7,19,19,1934,3193,2393,-800
2019,7,19,20,1981,3176,2346,-830
2019,7,19,21,2039,3179,2422,-757
2019,7,19,22,2082,3159,2446,-713
2019,7,19,23,2347,3194,2461,-733
2019,7,20,0,2358,3212,2449,-763
2019,7,20,1,2360,3242,2453,-789
2019,7,20,2,2348,3223,2518,-705
2019,7,20,3,2357,3183,2589,-594
2019,7,20,4,2320,3105,2536,-569
2019,7,20,5,2175,3104,2539,-565
2019,7,20,6,2305,2951,2542,-409
2019,7,20,7,2092,2737,2432,-305
2019,7,20,8,1877,2570,2094,-476
2019,7,20,9,1743,2448,2057,-391
2019,7,20,10,1714,2307,1964,-343
2019,7,20,11,1662,2225,1897,-328
2019,7,20,12,1802,2206,1896,-310
2019,7,20,13,1703,2256,1951,-305
2019,7,20,14,1645,2324,1937,-387
2019,7,20,15,1656,2438,1801,-637
2019,7,20,16,1796,2683,1822,-861
2019,7,20,17,1939,2804,1917,-887
2019,7,20,18,2009,2874,2028,-846
2019,7,20,19,2031,2912,2057,-855
2019,7,20,20,2031,2911,2042,-869
2019,7,20,21,2029,2919,2049,-870
2019,7,20,22,2032,2948,2077,-871
2019,7,20,23,2001,2981,2098,-883
2019,7,21,0,2148,3088,2209,-879
2019,7,21,1,2194,3170,2285,-885
2019,7,21,2,2198,3187,2315,-872
2019,7,21,3,2059,3169,2327,-842
2019,7,21,4,2010,3107,2327,-780
2019,7,21,5,2002,3083,2315,-768
2019,7,21,6,2283,3010,2507,-503
2019,7,21,7,1988,2734,2230,-504
2019,7,21,8,2012,2524,2077,-447
2019,7,21,9,1939,2402,2138,-264
2019,7,21,10,1745,2258,1984,-274
2019,7,21,11,1693,2212,1960,-252
2019,7,21,12,1678,2172,1899,-273
2019,7,21,13,1696,2217,1993,-224
2019,7,21,14,1652,2275,1989,-286
2019,7,21,15,1788,2421,1974,-447
2019,7,21,16,1876,2613,2060,-553
2019,7,21,17,2070,2855,2112,-743
2019,7,21,18,2190,2975,2226,-749
2019,7,21,19,2263,3064,2285,-779
2019,7,21,20,2267,3145,2397,-748
2019,7,21,21,2298,3229,2487,-742
2019,7,21,22,2134,3313,2511,-802
2019,7,21,23,2196,3404,2542,-862
2019,7,22,0,2271,3485,2537,-948
2019,7,22,1,2343,3494,2360,-1134
2019,7,22,2,2429,3515,2314,-1201
2019,7,22,3,2322,3492,2482,-1010
2019,7,22,4,2306,3382,2468,-914
2019,7,22,5,2225,3284,2479,-805
2019,7,22,6,2506,3109,2539,-570
2019,7,22,7,2483,2812,2440,-372
2019,7,22,8,2042,2626,2240,-386
2019,7,22,9,2096,2512,2160,-352
2019,7,22,10,1994,2470,2120,-350
2019,7,22,11,1984,2322,2025,-297
2019,7,22,12,1956,2382,2006,-376
2019,7,22,13,2062,2517,2112,-405
2019,7,22,14,1945,2652,1952,-700
2019,7,22,15,1937,3074,2158,-916
2019,7,22,16,2071,3249,2299,-950
2019,7,22,17,2204,3428,2395,-1033
2019,7,22,18,2305,3530,2589,-941
2019,7,22,19,2378,3592,2653,-939
2019,7,22,20,2249,3663,2707,-956
2019,7,22,21,2297,3768,2796,-972
2019,7,22,22,2316,3842,2877,-965
2019,7,22,23,2540,3931,2855,-1076
2019,7,23,0,2632,3990,2833,-1157
2019,7,23,1,2643,4073,2857,-1216
2019,7,23,2,2596,4052,2823,-1229
2019,7,23,3,2501,3938,2858,-1080
2019,7,23,4,2617,3806,2871,-935
2019,7,23,5,2408,3710,2837,-873
2019,7,23,6,2572,3466,2863,-603
2019,7,23,7,2522,3170,2776,-394
2019,7,23,8,2460,2970,2747,-223
2019,7,23,9,2380,2842,2717,-125
2019,7,23,10,2295,2762,2684,-78
2019,7,23,11,2277,2667,2519,-148
2019,7,23,12,2322,2682,2548,-134
2019,7,23,13,2475,2834,2689,-145
2019,7,23,14,2452,3006,2604,-402
2019,7,23,15,2426,3176,2568,-608
2019,7,23,16,2525,3350,2670,-680
2019,7,23,17,2493,3450,2738,-712
2019,7,23,18,2488,3510,2696,-814
2019,7,23,19,2529,3534,2675,-859
2019,7,23,20,2523,3561,2718,-843
2019,7,23,21,2654,3570,2839,-731
2019,7,23,22,2728,3563,2878,-685
2019,7,23,23,2758,3576,2855,-721
2019,7,24,0,2726,3569,2841,-728
2019,7,24,1,2706,3582,2836,-746
2019,7,24,2,2706,3584,3001,-583
2019,7,24,3,2723,3532,2932,-600
2019,7,24,4,2721,3495,2735,-760
2019,7,24,5,2436,3472,2756,-716
2019,7,24,6,2311,3259,2779,-480
2019,7,24,7,2280,2978,2616,-362
2019,7,24,8,2060,2658,2156,-502
2019,7,24,9,1977,2533,2071,-462
2019,7,24,10,1999,2452,1983,-469
2019,7,24,11,1987,2448,1984,-464
2019,7,24,12,2053,2606,2074,-532
2019,7,24,13,1934,2790,2107,-683
2019,7,24,14,2081,2948,2078,-870
2019,7,24,15,2291,3136,2346,-790
2019,7,24,16,2369,3249,2373,-876
2019,7,24,17,2414,3342,2418,-924
2019,7,24,18,2510,3433,2693,-740
2019,7,24,19,2596,3479,2717,-762
2019,7,24,20,2584,3517,2752,-765
2019,7,24,21,2613,3563,2802,-761
2019,7,24,22,2765,3594,2870,-724
2019,7,24,23,2951,3636,2943,-693
2019,7,25,0,2981,3718,2913,-805
2019,7,25,1,3060,3776,2901,-875
2019,7,25,2,3059,3773,2918,-855
2019,7,25,3,3003,3696,2881,-815
2019,7,25,4,2994,3626,2892,-734
2019,7,25,5,2909,3576,2923,-653
2019,7,25,6,2963,3334,2927,-407
2019,7,25,7,2669,3001,2802,-199
2019,7,25,8,2228,2810,2592,-218
2019,7,25,9,2261,2684,2515,-169
2019,7,25,10,2159,2538,2423,-115
2019,7,25,11,2135,2525,2327,-198
2019,7,25,12,2137,2593,2255,-338
2019,7,25,13,2252,2795,2391,-404
2019,7,25,14,2279,2911,2407,-504
2019,7,25,15,2380,3125,2533,-592
2019,7,25,16,2495,3279,2712,-567
2019,7,25,17,2435,3373,2697,-676
2019,7,25,18,2512,3416,2638,-778
2019,7,25,19,2668,3499,2624,-875
2019,7,25,20,2578,3570,2632,-938
2019,7,25,21,2566,3615,2671,-944
2019,7,25,22,2706,3680,2808,-872
2019,7,25,23,2689,3753,2878,-875
2019,7,26,0,2672,3896,2987,-909
2019,7,26,1,2675,3942,2995,-947
2019,7,26,2,2668,3930,2981,-949
2019,7,26,3,2666,3856,2943,-913
2019,7,26,4,2748,3750,2921,-829
2019,7,26,5,2779,3676,2896,-780
2019,7,26,6,2756,3430,2889,-541
2019,7,26,7,2593,3105,2905,-200
2019,7,26,8,2554,2750,2639,-111
2019,7,26,9,2540,2642,2608,-34
2019,7,26,10,2447,2557,2457,-100
2019,7,26,11,2418,2527,2406,-121
2019,7,26,12,2440,2673,2523,-150
2019,7,26,13,2357,2885,2595,-290
2019,7,26,14,2397,3042,2563,-479
2019,7,26,15,2363,3261,2593,-668
2019,7,26,16,2435,3362,2565,-797
2019,7,26,17,2413,3445,2534,-911
2019,7,26,18,2506,3558,2705,-853
2019,7,26,19,2759,3640,2828,-812
2019,7,26,20,2819,3739,2852,-887
2019,7,26,21,2845,3859,2909,-950
2019,7,26,22,2830,3923,2941,-982
2019,7,26,23,2818,4017,2951,-1066
2019,7,27,0,2834,4110,2972,-1138
2019,7,27,1,2871,4099,2957,-1142
2019,7,27,2,2862,4042,3078,-964
2019,7,27,3,2885,3937,3137,-800
2019,7,27,4,2729,3716,2905,-811
2019,7,27,5,2817,3727,3035,-692
2019,7,27,6,2969,3506,3097,-409
2019,7,27,7,2814,3248,3061,-187
2019,7,27,8,2396,3011,2896,-115
2019,7,27,9,2239,2874,2833,-41
2019,7,27,10,2163,2722,2605,-117
2019,7,27,11,2163,2677,2580,-97
2019,7,27,12,2242,2640,2535,-105
2019,7,27,13,2199,2674,2642,-32
2019,7,27,14,2172,2712,2563,-149
2019,7,27,15,2206,2837,2477,-360
2019,7,27,16,2491,3046,2472,-574
2019,7,27,17,2518,3217,2649,-568
2019,7,27,18,2567,3276,2754,-522
2019,7,27,19,2708,3332,2764,-568
2019,7,27,20,2643,3344,2752,-592
2019,7,27,21,2673,3338,2675,-663
2019,7,27,22,2711,3324,2696,-628
2019,7,27,23,2762,3318,2836,-482
2019,7,28,0,2827,3373,2884,-489
2019,7,28,1,2888,3425,3002,-423
2019,7,28,2,2918,3432,3014,-418
2019,7,28,3,2949,3422,3115,-307
2019,7,28,4,2950,3386,3167,-219
2019,7,28,5,2982,3391,3235,-156
2019,7,28,6,2836,3241,3226,-15
2019,7,28,7,2863,2964,2916,-48
2019,7,28,8,2415,2771,2629,-142
2019,7,28,9,2359,2649,2532,-117
2019,7,28,10,2344,2574,2481,-93
2019,7,28,11,2295,2555,2437,-118
2019,7,28,12,2301,2558,2429,-129
2019,7,28,13,2248,2575,2412,-163
2019,7,28,14,2089,2624,2357,-267
2019,7,28,15,2086,2764,2369,-395
2019,7,28,16,2291,2947,2485,-462
2019,7,28,17,2477,3090,2597,-493
2019,7,28,18,2578,3212,2695,-517
2019,7,28,19,2647,3258,2727,-531
2019,7,28,20,2513,3374,2855,-519
2019,7,28,21,2655,3435,2889,-546
2019,7,28,22,2614,3495,2917,-578
2019,7,28,23,2615,3563,2914,-649
2019,7,29,0,2745,3662,2974,-688
2019,7,29,1,2706,3720,2911,-809
2019,7,29,2,2718,3737,2883,-854
2019,7,29,3,2721,3689,2904,-785
2019,7,29,4,2824,3637,2966,-671
2019,7,29,5,2813,3599,2965,-634
2019,7,29,6,2815,3356,2978,-378
2019,7,29,7,2625,3088,2888,-200
2019,7,29,8,2521,2794,2519,-275
2019,7,29,9,2515,2674,2439,-235
2019,7,29,10,2489,2579,2366,-213
2019,7,29,11,2469,2566,2360,-206
2019,7,29,12,2525,2635,2534,-101
2019,7,29,13,2317,2798,2497,-301
2019,7,29,14,2254,2958,2447,-511
2019,7,29,15,2199,3167,2472,-695
2019,7,29,16,2281,3315,2656,-659
2019,7,29,17,2389,3460,2782,-678
2019,7,29,18,2471,3545,2778,-767
2019,7,29,19,2589,3622,2782,-840
2019,7,29,20,2614,3696,2820,-876
2019,7,29,21,2659,3764,2951,-813
2019,7,29,22,2688,3815,2850,-965
2019,7,29,23,2718,3915,2996,-919
2019,7,30,0,2744,3972,2982,-990
2019,7,30,1,2788,4035,2978,-1057
2019,7,30,2,2752,4007,2932,-1075
2019,7,30,3,2676,3922,2848,-1074
2019,7,30,4,2741,3789,2796,-993
2019,7,30,5,2667,3711,2847,-864
2019,7,30,6,3066,3447,3058,-389
2019,7,30,7,2707,3144,2973,-171
2019,7,30,8,2300,2943,2743,-200
2019,7,30,9,2187,2822,2707,-115
2019,7,30,10,2239,2720,2572,-148
2019,7,30,11,2167,2576,2351,-225
2019,7,30,12,2261,2634,2470,-164
2019,7,30,13,2206,2747,2539,-208
2019,7,30,14,2157,2928,2092,-836
2019,7,30,15,2167,3172,2271,-901
2019,7,30,16,2225,3253,2416,-837
2019,7,30,17,2324,3389,2549,-840
2019,7,30,18,2408,3493,2575,-918
2019,7,30,19,2475,3528,2523,-1005
2019,7,30,20,2526,3566,2683,-883
2019,7,30,21,2745,3625,2962,-663
2019,7,30,22,2863,3652,3112,-540
2019,7,30,23,2920,3680,3193,-487
2019,7,31,0,2719,3767,3229,-538
2019,7,31,1,2795,3836,3189,-647
2019,7,31,2,2796,3820,3197,-623
2019,7,31,3,2772,3748,3189,-559
2019,7,31,4,2768,3651,3042,-609
2019,7,31,5,2714,3597,3004,-593
2019,7,31,6,2896,3355,3091,-264
2019,7,31,7,2514,3094,2971,-123
2019,7,31,8,2375,2900,2695,-205
2019,7,31,9,2240,2749,2679,-70
2019,7,31,10,2333,2659,2658,-1
2019,7,31,11,2289,2641,2616,-25
2019,7,31,12,2320,2617,2515,-102
2019,7,31,13,2332,2837,2608,-229
2019,7,31,14,2160,2964,2483,-481
2019,7,31,15,2201,3151,2488,-663
2019,7,31,16,2337,3380,2653,-727
2019,7,31,17,2420,3475,2781,-694
2019,7,31,18,2491,3574,2855,-719
2019,7,31,19,2555,3649,2875,-774
2019,7,31,20,2536,3712,2908,-804
2019,7,31,21,2691,3777,3002,-775
2019,7,31,22,2844,3818,2942,-876
2019,7,31,23,2683,3894,2999,-895
2019,8,1,0,2723,3954,2988,-966
2019,8,1,1,2763,4015,2821,-1194
2019,8,1,2,2716,3994,2976,-1018
2019,8,1,3,2652,3909,3097,-812
2019,8,1,4,2729,3823,2959,-864
2019,8,1,5,2667,3745,2914,-831
2019,8,1,6,2795,3478,3050,-428
2019,8,1,7,2536,3190,3004,-186
2019,8,1,8,2498,2976,2732,-244
2019,8,1,9,2265,2849,2659,-190
2019,8,1,10,2278,2774,2561,-213
2019,8,1,11,2103,2751,2509,-242
2019,8,1,12,2120,2808,2611,-197
2019,8,1,13,2356,2928,2647,-281
2019,8,1,14,2072,3086,2596,-490
2019,8,1,15,2063,3278,2638,-640
2019,8,1,16,2285,3404,2608,-796
2019,8,1,17,2400,3507,2685,-822
2019,8,1,18,2588,3610,2759,-851
2019,8,1,19,2697,3688,2757,-931
2019,8,1,20,2636,3773,2762,-1011
2019,8,1,21,2588,3873,2750,-1123
2019,8,1,22,2653,3941,2795,-1146
2019,8,1,23,2667,4015,2777,-1238
2019,8,2,0,2680,4098,2749,-1349
2019,8,2,1,2677,4141,2764,-1377
2019,8,2,2,2700,4125,2780,-1345
2019,8,2,3,2602,4078,2897,-1181
2019,8,2,4,2806,3972,2909,-1063
2019,8,2,5,2712,3922,2990,-932
2019,8,2,6,2746,3637,3107,-530
2019,8,2,7,2558,3345,2965,-380
2019,8,2,8,2450,3082,2694,-388
2019,8,2,9,2572,2847,2732,-115
2019,8,2,10,2526,2733,2679,-54
2019,8,2,11,2429,2698,2574,-124
2019,8,2,12,2349,2748,2458,-290
2019,8,2,13,2348,2878,2439,-439
2019,8,2,14,2337,3038,2414,-624
2019,8,2,15,2426,3240,2538,-702
2019,8,2,16,2315,3464,2726,-738
2019,8,2,17,2375,3597,2788,-809
2019,8,2,18,2453,3676,2994,-682
2019,8,2,19,2528,3718,2963,-755
2019,8,2,20,2527,3765,3018,-747
2019,8,2,21,2712,3714,3002,-712
2019,8,2,22,2914,3748,3049,-699
2019,8,2,23,2942,3783,3137,-646
2019,8,3,0,2961,3812,3151,-661
2019,8,3,1,2977,3848,3179,-669
2019,8,3,2,2733,3786,3137,-649
2019,8,3,3,2662,3735,3153,-582
2019,8,3,4,2706,3695,3094,-601
2019,8,3,5,2734,3632,3013,-619
2019,8,3,6,2712,3430,3081,-349
2019,8,3,7,2496,3105,2781,-324
2019,8,3,8,2560,2908,2607,-301
2019,8,3,9,2425,2738,2496,-242
2019,8,3,10,2321,2641,2441,-200
2019,8,3,11,2318,2599,2363,-236
2019,8,3,12,2244,2642,2371,-271
2019,8,3,13,2117,2737,2395,-342
2019,8,3,14,2071,2741,2331,-410
2019,8,3,15,2187,2859,2316,-543
2019,8,3,16,2271,3007,2269,-738
2019,8,3,17,2468,3151,2550,-601
2019,8,3,18,2571,3270,2698,-572
2019,8,3,19,2758,3323,2735,-588
2019,8,3,20,2695,3384,2717,-667
2019,8,3,21,2721,3421,2739,-682
2019,8,3,22,2746,3527,2823,-704
2019,8,3,23,2778,3622,2807,-815
2019,8,4,0,2763,3686,2853,-833
2019,8,4,1,2859,3725,2934,-791
2019,8,4,2,2834,3719,2871,-848
2019,8,4,3,2710,3651,2962,-689
2019,8,4,4,2821,3587,2940,-647
2019,8,4,5,2731,3544,2883,-661
2019,8,4,6,2690,3360,2860,-500
2019,8,4,7,2893,3133,2849,-284
2019,8,4,8,2436,2853,2698,-155
2019,8,4,9,2305,2680,2632,-48
2019,8,4,10,2305,2509,2466,-43
2019,8,4,11,2301,2438,2410,-28
2019,8,4,12,2292,2488,2386,-102
2019,8,4,13,2313,2532,2420,-112
2019,8,4,14,2090,2561,2431,-130
2019,8,4,15,2195,2763,2570,-193
2019,8,4,16,2173,2997,2534,-463
2019,8,4,17,2370,3141,2541,-600
2019,8,4,18,2441,3293,2713,-580
2019,8,4,19,2530,3408,2800,-608
2019,8,4,20,2323,3438,2585,-853
2019,8,4,21,2479,3557,2698,-859
2019,8,4,22,2573,3697,2778,-919
2019,8,4,23,2505,3806,2921,-885
2019,8,5,0,2467,3818,2766,-1052
2019,8,5,1,2440,4005,2951,-1054
2019,8,5,2,2439,4012,2894,-1118
2019,8,5,3,2398,3957,2944,-1013
2019,8,5,4,2377,3846,2786,-1060
2019,8,5,5,2466,3793,2795,-998
2019,8,5,6,2403,3529,2784,-745
2019,8,5,7,2424,3200,2695,-505
2019,8,5,8,2541,2944,2556,-388
2019,8,5,9,2396,2791,2392,-399
2019,8,5,10,2312,2684,2367,-317
2019,8,5,11,2303,2633,2330,-303
2019,8,5,12,2345,2690,2383,-307
2019,8,5,13,2343,2841,2548,-293
2019,8,5,14,2259,3021,2441,-580
2019,8,5,15,2283,3214,2487,-727
2019,8,5,16,2453,3377,2496,-881
2019,8,5,17,2295,3557,2502,-1055
2019,8,5,18,2454,3713,2620,-1093
2019,8,5,19,2562,3848,2759,-1089
2019,8,5,20,2458,3964,2808,-1156
2019,8,5,21,2553,4060,2864,-1196
2019,8,5,22,2552,4102,2841,-1261
2019,8,5,23,2599,4174,2832,-1342
2019,8,6,0,2493,4243,2824,-1419
2019,8,6,1,2533,4285,2938,-1347
2019,8,6,2,2514,4274,2918,-1356
2019,8,6,3,2518,4159,2918,-1241
2019,8,6,4,2549,4029,2931,-1098
2019,8,6,5,2649,3905,2892,-1013
2019,8,6,6,2900,3602,2958,-644
2019,8,6,7,2668,3280,2942,-338
2019,8,6,8,2149,2994,2750,-244
2019,8,6,9,2082,2828,2770,-58
2019,8,6,10,2005,2719,2704,-15
2019,8,6,11,1949,2615,2580,-35
2019,8,6,12,2032,2740,2657,-83
2019,8,6,13,2378,2869,2654,-215
2019,8,6,14,2245,3042,2630,-412
2019,8,6,15,2355,3204,2729,-475
2019,8,6,16,2370,3310,2718,-592
2019,8,6,17,2504,3397,2712,-685
2019,8,6,18,2546,3456,2684,-772
2019,8,6,19,2604,3525,2688,-837
2019,8,6,20,2456,3633,2704,-929
2019,8,6,21,2531,3691,2637,-1054
2019,8,6,22,2596,3820,2736,-1084
2019,8,6,23,2506,3903,2700,-1203
2019,8,7,0,2479,3995,2772,-1223
2019,8,7,1,2438,4115,2848,-1267
2019,8,7,2,2448,4110,2942,-1168
2019,8,7,3,2471,4026,2973,-1053
2019,8,7,4,2755,3928,2978,-950
2019,8,7,5,2669,3828,2873,-955
2019,8,7,6,2840,3537,2963,-574
2019,8,7,7,2812,3227,2872,-355
2019,8,7,8,2485,3019,2851,-168
2019,8,7,9,2404,2888,2828,-60
2019,8,7,10,2293,2769,2677,-92
2019,8,7,11,2281,2739,2647,-92
2019,8,7,12,2293,2761,2669,-92
2019,8,7,13,2349,2968,2804,-164
2019,8,7,14,2179,3111,2672,-439
2019,8,7,15,2222,3254,2733,-521
2019,8,7,16,2330,3382,2784,-598
2019,8,7,17,2415,3439,2795,-644
2019,8,7,18,2548,3487,2776,-711
2019,8,7,19,2613,3557,2838,-719
2019,8,7,20,2534,3571,2770,-801
2019,8,7,21,2597,3622,2778,-844
2019,8,7,22,2506,3714,2855,-859
2019,8,7,23,2512,3789,2861,-928
2019,8,8,0,2750,3862,2937,-925
2019,8,8,1,2741,3962,3022,-940
2019,8,8,2,2732,3931,3067,-864
2019,8,8,3,2662,3822,2875,-947
2019,8,8,4,2759,3748,3012,-736
2019,8,8,5,2705,3660,2821,-839
2019,8,8,6,2852,3352,2889,-463
2019,8,8,7,2710,2992,2703,-289
2019,8,8,8,2506,2790,2687,-103
2019,8,8,9,2448,2688,2574,-114
2019,8,8,10,2442,2571,2440,-131
2019,8,8,11,2321,2583,2381,-202
2019,8,8,12,2329,2645,2551,-94
2019,8,8,13,2590,2804,2529,-275
2019,8,8,14,2465,3018,2566,-452
2019,8,8,15,2451,3188,2609,-579
2019,8,8,16,2539,3285,2640,-645
2019,8,8,17,2574,3355,2534,-821
2019,8,8,18,2481,3400,2489,-911
2019,8,8,19,2523,3424,2478,-946
2019,8,8,20,2590,3440,2535,-905
2019,8,8,21,2432,3443,2609,-834
2019,8,8,22,2504,3431,2698,-733
2019,8,8,23,2525,3430,2814,-616
2019,8,9,0,2534,3446,2872,-574
2019,8,9,1,2579,3445,2807,-638
2019,8,9,2,2513,3426,2795,-631
2019,8,9,3,2488,3411,2836,-575
2019,8,9,4,2593,3461,2905,-556
2019,8,9,5,2576,3481,2962,-519
2019,8,9,6,2840,3265,3042,-223
2019,8,9,7,2881,3042,2947,-95
2019,8,9,8,2380,2862,2691,-171
2019,8,9,9,2329,2725,2516,-209
2019,8,9,10,2245,2614,2568,-46
2019,8,9,11,2293,2573,2567,-6
2019,8,9,12,2255,2644,2573,-71
2019,8,9,13,2301,2790,2548,-242
2019,8,9,14,2264,2954,2568,-386
2019,8,9,15,2320,3221,2793,-428
2019,8,9,16,2448,3358,2745,-613
2019,8,9,17,2505,3439,2743,-696
2019,8,9,18,2548,3504,2749,-755
2019,8,9,19,2579,3531,2757,-774
2019,8,9,20,2531,3558,2782,-776
2019,8,9,21,2660,3570,2817,-753
2019,8,9,22,2779,3577,2834,-743
2019,8,9,23,2728,3582,2835,-747
2019,8,10,0,2749,3601,2918,-683
2019,8,10,1,2765,3629,2982,-647
2019,8,10,2,2718,3570,2923,-647
2019,8,10,3,2644,3443,2959,-484
2019,8,10,4,2705,3434,2911,-523
2019,8,10,5,2647,3382,2538,-844
2019,8,10,6,2788,3198,2478,-720
2019,8,10,7,2534,2968,2283,-685
2019,8,10,8,2354,2769,2316,-453
2019,8,10,9,2294,2654,2420,-234
2019,8,10,10,2364,2586,2379,-207
2019,8,10,11,2149,2582,2358,-224
2019,8,10,12,2212,2597,2376,-221
2019,8,10,13,2163,2644,2377,-267
2019,8,10,14,2091,2699,2355,-344
2019,8,10,15,2255,2827,2305,-522
2019,8,10,16,2447,3028,2313,-715
2019,8,10,17,2588,3173,2392,-781
2019,8,10,18,2653,3267,2601,-666
2019,8,10,19,2671,3277,2570,-707
2019,8,10,20,2517,3288,2633,-655
2019,8,10,21,2423,3282,2626,-656
2019,8,10,22,2474,3264,2672,-592
2019,8,10,23,2484,3266,2775,-491
2019,8,11,0,2535,3276,2862,-414
2019,8,11,1,2713,3307,2808,-499
2019,8,11,2,2791,3299,2968,-331
2019,8,11,3,2745,3304,3151,-153
2019,8,11,4,2747,3303,3090,-213
2019,8,11,5,2712,3277,2860,-417
2019,8,11,6,2560,3120,2787,-333
2019,8,11,7,2554,2980,2851,-129
2019,8,11,8,2370,2759,2479,-280
2019,8,11,9,2388,2739,2556,-183
2019,8,11,10,2262,2601,2519,-82
2019,8,11,11,2269,2570,2406,-164
2019,8,11,12,2246,2577,2420,-157
2019,8,11,13,2185,2615,2446,-169
2019,8,11,14,2084,2631,2274,-357
2019,8,11,15,2108,2732,2173,-559
2019,8,11,16,2385,2947,2193,-754
2019,8,11,17,2390,3103,2218,-885
2019,8,11,18,2188,3200,2318,-882
2019,8,11,19,2207,3294,2449,-845
2019,8,11,20,2225,3299,2581,-718
2019,8,11,21,2259,3307,2685,-622
2019,8,11,22,2302,3306,2810,-496
2019,8,11,23,2324,3330,2820,-510
2019,8,12,0,2384,3355,2817,-538
2019,8,12,1,2604,3389,2895,-494
2019,8,12,2,2659,3381,2874,-507
2019,8,12,3,2643,3380,2889,-491
2019,8,12,4,2654,3398,2942,-456
2019,8,12,5,2601,3350,2926,-424
2019,8,12,6,2693,3088,2854,-234
2019,8,12,7,2398,2815,2710,-105
2019,8,12,8,2451,2666,2654,-12
2019,8,12,9,2406,2594,2628,0
2019,8,12,10,2372,2561,2565,0
2019,8,12,11,2344,2550,2574,0
2019,8,12,12,2385,2617,2554,-63
2019,8,12,13,2406,2801,2494,-307
2019,8,12,14,2203,3031,2618,-413
2019,8,12,15,2251,3222,2562,-660
2019,8,12,16,2367,3321,2482,-839
2019,8,12,17,2412,3385,2448,-937
2019,8,12,18,2519,3483,2529,-954
2019,8,12,19,2631,3542,2548,-994
2019,8,12,20,2603,3697,2701,-996
2019,8,12,21,2669,3590,2561,-1029
2019,8,12,22,2705,3660,2611,-1049
2019,8,12,23,2742,3723,2641,-1082
2019,8,13,0,2727,3804,2886,-918
2019,8,13,1,2761,3852,2877,-975
2019,8,13,2,2742,3830,2874,-956
2019,8,13,3,2674,3751,2903,-848
2019,8,13,4,2741,3697,2898,-799
2019,8,13,5,2723,3587,2875,-712
2019,8,13,6,2792,3318,2877,-441
2019,8,13,7,2760,3033,2888,-145
2019,8,13,8,2292,2826,2823,-3
2019,8,13,9,2326,2667,2704,0
2019,8,13,10,2257,2578,2527,-51
2019,8,13,11,2255,2569,2481,-88
2019,8,13,12,2269,2668,2540,-128
2019,8,13,13,2473,2840,2681,-159
2019,8,13,14,2357,3078,2648,-430
2019,8,13,15,2472,3230,2597,-633
2019,8,13,16,2590,3355,2615,-740
2019,8,13,17,2684,3436,2706,-730
2019,8,13,18,2764,3560,2727,-833
2019,8,13,19,2803,3620,2776,-844
2019,8,13,20,2567,3713,2716,-997
2019,8,13,21,2685,3812,2881,-931
2019,8,13,22,2704,3857,2860,-997
2019,8,13,23,2742,3934,2889,-1045
2019,8,14,0,2705,4000,2909,-1091
2019,8,14,1,2744,4024,2894,-1130
2019,8,14,2,2704,3958,2878,-1080
2019,8,14,3,2638,3856,2852,-1004
2019,8,14,4,2987,3865,2890,-975
2019,8,14,5,2919,3741,2899,-842
2019,8,14,6,2753,3462,2887,-575
2019,8,14,7,2818,3188,2879,-309
2019,8,14,8,2368,2981,2593,-388
2019,8,14,9,2180,2789,2418,-371
2019,8,14,10,2169,2665,2365,-300
2019,8,14,11,2252,2630,2305,-325
2019,8,14,12,2179,2686,2504,-182
2019,8,14,13,2449,2815,2625,-190
2019,8,14,14,2358,2977,2586,-391
2019,8,14,15,2552,3096,2646,-450
2019,8,14,16,2678,3329,2667,-662
2019,8,14,17,2785,3437,2608,-829
2019,8,14,18,2806,3537,2708,-829
2019,8,14,19,2818,3640,2792,-848
2019,8,14,20,2708,3760,2850,-910
2019,8,14,21,2769,3841,2865,-976
2019,8,14,22,2817,3904,2878,-1026
2019,8,14,23,2775,3961,2914,-1047
2019,8,15,0,2856,4063,3013,-1050
2019,8,15,1,2870,4053,3073,-980
2019,8,15,2,2827,4005,3136,-869
2019,8,15,3,2752,3906,3148,-758
2019,8,15,4,2883,3840,3112,-728
2019,8,15,5,2822,3717,3143,-574
2019,8,15,6,2903,3438,3119,-319
2019,8,15,7,2611,3182,3105,-77
2019,8,15,8,2566,2970,2834,-136
2019,8,15,9,2418,2826,2682,-144
2019,8,15,10,2319,2759,2617,-142
2019,8,15,11,2210,2663,2396,-267
2019,8,15,12,2247,2678,2381,-297
2019,8,15,13,2366,2772,2422,-350
2019,8,15,14,2418,2936,2466,-470
2019,8,15,15,2540,3159,2611,-548
2019,8,15,16,2509,3261,2477,-784
2019,8,15,17,2598,3336,2519,-817
2019,8,15,18,2652,3425,2708,-717
2019,8,15,19,2784,3493,2714,-779
2019,8,15,20,2737,3548,2703,-845
2019,8,15,21,2722,3620,2788,-832
2019,8,15,22,2732,3658,2811,-847
2019,8,15,23,2694,3704,2874,-830
2019,8,16,0,2619,3797,2964,-833
2019,8,16,1,2767,3887,2986,-901
2019,8,16,2,2918,3886,3067,-819
2019,8,16,3,2883,3778,3023,-755
2019,8,16,4,2964,3742,3113,-629
2019,8,16,5,2809,3636,3152,-484
2019,8,16,6,2941,3371,3172,-199
2019,8,16,7,2584,3095,3086,-9
2019,8,16,8,2440,2825,2675,-150
2019,8,16,9,2319,2676,2529,-147
2019,8,16,10,2302,2578,2455,-123
2019,8,16,11,2282,2552,2432,-120
2019,8,16,12,2264,2604,2453,-151
2019,8,16,13,2347,2736,2454,-282
2019,8,16,14,2234,2918,2427,-491
2019,8,16,15,2379,3124,2457,-667
2019,8,16,16,2515,3249,2507,-742
2019,8,16,17,2516,3328,2618,-710
2019,8,16,18,2521,3387,2571,-816
2019,8,16,19,2582,3418,2590,-828
2019,8,16,20,2616,3428,2589,-839
2019,8,16,21,2668,3401,2575,-826
2019,8,16,22,2703,3360,2636,-724
2019,8,16,23,2809,3389,2948,-441
2019,8,17,0,2836,3378,2994,-384
2019,8,17,1,2858,3399,3013,-386
2019,8,17,2,2872,3358,2994,-364
2019,8,17,3,2823,3311,3007,-304
2019,8,17,4,2815,3328,2990,-338
2019,8,17,5,2698,3279,3021,-258
2019,8,17,6,2829,3047,2871,-176
2019,8,17,7,2511,2793,2642,-151
2019,8,17,8,2260,2637,2365,-272
2019,8,17,9,2145,2514,2299,-215
2019,8,17,10,2035,2452,2245,-207
2019,8,17,11,1975,2391,2227,-164
2019,8,17,12,1999,2395,2215,-180
2019,8,17,13,1991,2444,2250,-194
2019,8,17,14,1991,2512,2256,-256
2019,8,17,15,2018,2633,2205,-428
2019,8,17,16,2280,2812,2308,-504
2019,8,17,17,2262,2943,2314,-629
2019,8,17,18,2379,3019,2397,-622
2019,8,17,19,2521,3048,2474,-574
2019,8,17,20,2518,3063,2527,-536
2019,8,17,21,2595,3067,2565,-502
2019,8,17,22,2610,3064,2604,-460
2019,8,17,23,2646,3081,2645,-436
2019,8,18,0,2707,3120,2689,-431
2019,8,18,1,2775,3152,2754,-398
2019,8,18,2,2763,3202,2870,-332
2019,8,18,3,2744,3186,2926,-260
2019,8,18,4,2785,3182,2938,-244
2019,8,18,5,2683,3134,2975,-159
2019,8,18,6,2728,2965,2975,0
2019,8,18,7,2494,2759,2884,0
2019,8,18,8,2299,2566,2476,-90
2019,8,18,9,2199,2462,2387,-75
2019,8,18,10,2227,2409,2323,-86
2019,8,18,11,2084,2359,2188,-171
2019,8,18,12,2043,2348,2166,-182
2019,8,18,13,2079,2389,2135,-254
2019,8,18,14,2057,2429,2132,-297
2019,8,18,15,1980,2563,2135,-428
2019,8,18,16,2092,2735,2193,-542
2019,8,18,17,2212,2886,2228,-658
2019,8,18,18,2222,2994,2286,-708
2019,8,18,19,2264,3062,2363,-699
2019,8,18,20,2261,3113,2428,-685
2019,8,18,21,2264,3132,2456,-676
2019,8,18,22,2273,3169,2486,-683
2019,8,18,23,2285,3228,2506,-722
2019,8,19,0,2248,3309,2561,-748
2019,8,19,1,2327,3400,2645,-755
2019,8,19,2,2454,3405,2779,-626
2019,8,19,3,2405,3371,2787,-584
2019,8,19,4,2459,3361,2713,-648
2019,8,19,5,2440,3265,2668,-597
2019,8,19,6,2472,3019,2653,-366
2019,8,19,7,2183,2768,2441,-327
2019,8,19,8,2317,2590,2409,-181
2019,8,19,9,2162,2484,2259,-225
2019,8,19,10,2105,2429,2302,-127
2019,8,19,11,2045,2428,2316,-112
2019,8,19,12,2201,2500,2324,-176
2019,8,19,13,2243,2656,2413,-243
2019,8,19,14,1962,2838,2469,-369
2019,8,19,15,2096,2993,2459,-534
2019,8,19,16,2206,3119,2569,-550
2019,8,19,17,2289,3207,2557,-650
2019,8,19,18,2374,3271,2589,-682
2019,8,19,19,2464,3320,2542,-778
2019,8,19,20,2415,3357,2565,-792
2019,8,19,21,2506,3416,2593,-823
2019,8,19,22,2580,3437,2616,-821
2019,8,19,23,2641,3527,2676,-851
2019,8,20,0,2451,3597,2733,-864
2019,8,20,1,2616,3649,2773,-876
2019,8,20,2,2609,3668,2782,-886
2019,8,20,3,2556,3631,2795,-836
2019,8,20,4,2711,3642,2829,-813
2019,8,20,5,2601,3524,2819,-705
2019,8,20,6,2512,3262,2820,-442
2019,8,20,7,2431,3027,2809,-218
2019,8,20,8,2415,2795,2596,-199
2019,8,20,9,2342,2665,2507,-158
2019,8,20,10,2270,2658,2608,-50
2019,8,20,11,2221,2631,2580,-51
2019,8,20,12,2295,2704,2679,-25
2019,8,20,13,2364,2833,2660,-173
2019,8,20,14,2216,2993,2645,-348
2019,8,20,15,2299,3162,2519,-643
2019,8,20,16,2190,3302,2409,-893
2019,8,20,17,2270,3392,2428,-964
2019,8,20,18,2337,3481,2474,-1007
2019,8,20,19,2460,3563,2622,-941
2019,8,20,20,2470,3677,2708,-969
2019,8,20,21,2507,3760,2726,-1034
2019,8,20,22,2517,3822,2741,-1081
2019,8,20,23,2501,3877,2752,-1125
2019,8,21,0,2525,3934,2778,-1156
2019,8,21,1,2530,3943,2755,-1188
2019,8,21,2,2539,3892,2774,-1118
2019,8,21,3,2525,3808,2715,-1093
2019,8,21,4,2570,3787,2704,-1083
2019,8,21,5,2502,3623,2717,-906
2019,8,21,6,2609,3362,2835,-527
2019,8,21,7,2573,3095,2815,-280
2019,8,21,8,2412,2892,2591,-301
2019,8,21,9,2389,2777,2664,-113
2019,8,21,10,2320,2704,2649,-55
2019,8,21,11,2303,2678,2619,-59
2019,8,21,12,2369,2750,2660,-90
2019,8,21,13,2360,2924,2594,-330
2019,8,21,14,2212,3055,2480,-575
2019,8,21,15,2404,3192,2353,-839
2019,8,21,16,2446,3267,2426,-841
2019,8,21,17,2550,3364,2547,-817
2019,8,21,18,2634,3468,2681,-787
2019,8,21,19,2686,3557,2894,-663
2019,8,21,20,2803,3604,2986,-618
2019,8,21,21,2931,3586,2918,-668
2019,8,21,22,2915,3522,2876,-646
2019,8,21,23,2875,3499,2878,-621
2019,8,22,0,2860,3457,2916,-541
2019,8,22,1,2818,3495,3043,-452
2019,8,22,2,2739,3480,3024,-456
2019,8,22,3,2645,3573,3120,-453
2019,8,22,4,2740,3583,3132,-451
2019,8,22,5,2681,3457,3172,-285
2019,8,22,6,2852,3212,3125,-87
2019,8,22,7,2662,2929,2801,-128
2019,8,22,8,2389,2734,2743,0
2019,8,22,9,2183,2630,2642,0
2019,8,22,10,2323,2564,2585,0
2019,8,22,11,2268,2553,2578,0
2019,8,22,12,2207,2630,2525,-105
2019,8,22,13,2182,2780,2458,-322
2019,8,22,14,2140,3050,2442,-608
2019,8,22,15,2189,3196,2383,-813
2019,8,22,16,2264,3337,2436,-901
2019,8,22,17,2324,3400,2411,-989
2019,8,22,18,2386,3440,2499,-941
2019,8,22,19,2452,3405,2737,-668
2019,8,22,20,2407,3409,2762,-647
2019,8,22,21,2478,3385,2694,-691
2019,8,22,22,2486,3388,2701,-687
2019,8,22,23,2495,3431,2784,-647
2019,8,23,0,2603,3484,2797,-687
2019,8,23,1,2600,3566,2862,-704
2019,8,23,2,2630,3570,2947,-623
2019,8,23,3,2652,3527,2951,-576
2019,8,23,4,2584,3548,2956,-592
2019,8,23,5,2606,3464,2981,-483
2019,8,23,6,2568,3226,3003,-223
2019,8,23,7,2570,2973,2956,-17
2019,8,23,8,2509,2744,2828,0
2019,8,23,9,2477,2636,2759,0
2019,8,23,10,2471,2572,2618,0
2019,8,23,11,2413,2560,2607,0
2019,8,23,12,2448,2664,2634,-30
2019,8,23,13,2528,2823,2705,-118
2019,8,23,14,2305,2931,2533,-398
2019,8,23,15,2432,3151,2655,-496
2019,8,23,16,2533,3258,2678,-580
2019,8,23,17,2622,3325,2679,-646
2019,8,23,18,2661,3382,2744,-638
2019,8,23,19,2780,3417,2814,-603
2019,8,23,20,2798,3412,2835,-577
2019,8,23,21,2795,3413,2842,-571
2019,8,23,22,2792,3417,2859,-558
2019,8,23,23,2789,3428,2831,-597
2019,8,24,0,2793,3408,2862,-546
2019,8,24,1,2805,3448,2904,-544
2019,8,24,2,2728,3431,2950,-481
2019,8,24,3,2666,3417,3029,-388
2019,8,24,4,2806,3427,2998,-429
2019,8,24,5,2703,3341,2992,-349
2019,8,24,6,2810,3083,2943,-140
2019,8,24,7,2813,2881,3002,0
2019,8,24,8,2366,2708,2806,0
2019,8,24,9,2246,2597,2560,-37
2019,8,24,10,2381,2487,2521,0
2019,8,24,11,2349,2484,2499,0
2019,8,24,12,2237,2495,2522,0
2019,8,24,13,2236,2548,2488,-60
2019,8,24,14,2166,2636,2462,-174
2019,8,24,15,2234,2759,2462,-297
2019,8,24,16,2297,2966,2527,-439
2019,8,24,17,2364,3113,2511,-602
2019,8,24,18,2404,3189,2585,-604
2019,8,24,19,2497,3258,2668,-590
2019,8,24,20,2490,3279,2703,-576
2019,8,24,21,2491,3286,2768,-518
2019,8,24,22,2491,3290,2770,-520
2019,8,24,23,2490,3309,2798,-511
2019,8,25,0,2488,3323,2789,-534
2019,8,25,1,2480,3362,2809,-553
2019,8,25,2,2489,3387,2823,-564
2019,8,25,3,2490,3330,2815,-515
2019,8,25,4,2591,3358,2780,-578
2019,8,25,5,2501,3293,2773,-520
2019,8,25,6,2560,3126,2799,-327
2019,8,25,7,2568,2919,2794,-125
2019,8,25,8,2270,2754,2669,-85
2019,8,25,9,2022,2583,2553,-30
2019,8,25,10,2027,2532,2521,-11
2019,8,25,11,1959,2497,2528,0
2019,8,25,12,1975,2477,2497,0
2019,8,25,13,1970,2515,2506,-9
2019,8,25,14,1937,2572,2476,-96
2019,8,25,15,1935,2693,2400,-293
2019,8,25,16,1938,2865,2401,-464
2019,8,25,17,2173,3020,2464,-556
2019,8,25,18,2230,3159,2495,-664
2019,8,25,19,2369,3216,2533,-683
2019,8,25,20,2465,3243,2682,-561
2019,8,25,21,2496,3264,2764,-500
2019,8,25,22,2539,3315,2839,-476
2019,8,25,23,2656,3347,2961,-386
2019,8,26,0,2715,3564,3077,-487
2019,8,26,1,2768,3501,3022,-479
2019,8,26,2,2764,3530,3003,-527
2019,8,26,3,2752,3484,3000,-484
2019,8,26,4,2807,3494,2909,-585
2019,8,26,5,2688,3364,2879,-485
2019,8,26,6,2613,3124,2796,-328
2019,8,26,7,2464,2878,2744,-134
2019,8,26,8,2464,2650,2563,-87
2019,8,26,9,2401,2562,2515,-47
2019,8,26,10,2329,2519,2503,-16
2019,8,26,11,2317,2483,2408,-75
2019,8,26,12,2345,2559,2416,-143
2019,8,26,13,2585,2739,2464,-275
2019,8,26,14,2415,2977,2511,-466
2019,8,26,15,2441,3151,2550,-601
2019,8,26,16,2460,3286,2650,-636
2019,8,26,17,2528,3379,2664,-715
2019,8,26,18,2597,3395,2640,-755
2019,8,26,19,2640,3436,2662,-774
2019,8,26,20,2671,3478,2751,-727
2019,8,26,21,2691,3508,2704,-804
2019,8,26,22,2711,3554,2756,-798
2019,8,26,23,2688,3595,2751,-844
2019,8,27,0,2688,3644,2751,-893
2019,8,27,1,2721,3724,2800,-924
2019,8,27,2,2699,3685,2814,-871
2019,8,27,3,2665,3610,2858,-752
2019,8,27,4,2710,3676,2824,-852
2019,8,27,5,2626,3520,2781,-739
2019,8,27,6,2809,3261,2807,-454
2019,8,27,7,2694,3009,2804,-205
2019,8,27,8,2368,2843,2661,-182
2019,8,27,9,2338,2733,2611,-122
2019,8,27,10,2337,2650,2611,-39
2019,8,27,11,2334,2647,2596,-51
2019,8,27,12,2270,2706,2557,-149
2019,8,27,13,2391,2824,2571,-253
2019,8,27,14,2279,3037,2577,-460
2019,8,27,15,2264,3209,2557,-652
2019,8,27,16,2302,3298,2446,-852
2019,8,27,17,2389,3402,2561,-841
2019,8,27,18,2467,3488,2622,-866
2019,8,27,19,2528,3610,2747,-863
2019,8,27,20,2537,3661,2762,-899
2019,8,27,21,2588,3735,2822,-913
2019,8,27,22,2635,3812,2833,-979
2019,8,27,23,2675,3893,2830,-1063
2019,8,28,0,2623,3961,2828,-1133
2019,8,28,1,2646,4047,2819,-1228
2019,8,28,2,2624,4004,2848,-1156
2019,8,28,3,2569,3901,2851,-1050
2019,8,28,4,2599,3882,2928,-954
2019,8,28,5,2436,3700,2816,-884
2019,8,28,6,2656,3397,2868,-529
2019,8,28,7,2559,3114,2807,-307
2019,8,28,8,2504,2927,2779,-148
2019,8,28,9,2319,2825,2808,-17
2019,8,28,10,2268,2751,2796,0
2019,8,28,11,2245,2720,2774,0
2019,8,28,12,2280,2785,2780,-5
2019,8,28,13,2442,2939,2657,-282
2019,8,28,14,2231,3144,2737,-407
2019,8,28,15,2224,3313,2604,-709
2019,8,28,16,2305,3434,2607,-827
2019,8,28,17,2420,3556,2621,-935
2019,8,28,18,2518,3656,2662,-994
2019,8,28,19,2587,3745,2699,-1046
2019,8,28,20,2657,3864,2775,-1089
2019,8,28,21,2725,3950,2769,-1181
2019,8,28,22,2687,4040,2813,-1227
2019,8,28,23,2632,4115,2821,-1294
2019,8,29,0,2648,4171,2799,-1372
2019,8,29,1,2620,4206,2810,-1396
2019,8,29,2,2556,4165,2820,-1345
2019,8,29,3,2547,4048,2619,-1429
2019,8,29,4,2649,4047,2844,-1203
2019,8,29,5,2565,3833,2872,-961
2019,8,29,6,2679,3508,2913,-595
2019,8,29,7,2663,3216,2974,-242
2019,8,29,8,2310,3004,2690,-314
2019,8,29,9,2149,2865,2618,-247
2019,8,29,10,1973,2625,2447,-178
2019,8,29,11,1955,2578,2412,-166
2019,8,29,12,2296,2757,2537,-220
2019,8,29,13,2227,2900,2540,-360
2019,8,29,14,2124,3097,2535,-562
2019,8,29,15,2260,3286,2596,-690
2019,8,29,16,2390,3405,2651,-754
2019,8,29,17,2277,3476,2690,-786
2019,8,29,18,2299,3560,2709,-851
2019,8,29,19,2364,3594,2812,-782
2019,8,29,20,2556,3657,2813,-844
2019,8,29,21,2598,3697,2773,-924
2019,8,29,22,2628,3713,2704,-1009
2019,8,29,23,2588,3775,2762,-1013
2019,8,30,0,2600,3804,2859,-945
2019,8,30,1,2584,3777,2883,-894
2019,8,30,2,2592,3738,2951,-787
2019,8,30,3,2590,3696,2920,-776
2019,8,30,4,2632,3703,2975,-728
2019,8,30,5,2576,3519,2949,-570
2019,8,30,6,2569,3304,2945,-359
2019,8,30,7,2562,3080,3000,-80
2019,8,30,8,2466,2891,2804,-87
2019,8,30,9,2273,2813,2713,-100
2019,8,30,10,2186,2678,2597,-81
2019,8,30,11,2130,2654,2583,-71
2019,8,30,12,2232,2679,2669,-10
2019,8,30,13,2292,2841,2696,-145
2019,8,30,14,2205,3059,2653,-406
2019,8,30,15,2301,3208,2463,-745
2019,8,30,16,2429,3398,2431,-967
2019,8,30,17,2543,3486,2611,-875
2019,8,30,18,2545,3560,2598,-962
2019,8,30,19,2550,3564,2649,-915
2019,8,30,20,2584,3577,2684,-893
2019,8,30,21,2724,3482,2597,-885
2019,8,30,22,2740,3413,2559,-854
2019,8,30,23,2664,3450,2610,-840
2019,8,31,0,2692,3468,2602,-866
2019,8,31,1,2698,3469,2592,-877
2019,8,31,2,2649,3432,2671,-761
2019,8,31,3,2592,3345,2606,-739
2019,8,31,4,2736,3423,2656,-767
2019,8,31,5,2718,3275,2598,-677
2019,8,31,6,2722,3053,2613,-440
2019,8,31,7,2733,2842,2567,-275
2019,8,31,8,2232,2655,2428,-227
2019,8,31,9,2347,2505,2327,-178
2019,8,31,10,2261,2434,2263,-171
2019,8,31,11,2173,2405,2207,-198
2019,8,31,12,2164,2427,2184,-243
2019,8,31,13,2232,2477,2194,-283
2019,8,31,14,2036,2537,2127,-410
2019,8,31,15,2153,2652,2137,-515
2019,8,31,16,2322,2863,2200,-663
2019,8,31,17,2295,2978,2432,-546
2019,8,31,18,2275,3069,2472,-597
2019,8,31,19,2334,3137,2545,-592
2019,8,31,20,2416,3229,2682,-547
2019,8,31,21,2468,3259,2684,-575
2019,8,31,22,2461,3266,2712,-554
2019,8,31,23,2485,3283,2713,-570
2019,9,1,0,2493,3311,2720,-591
2019,9,1,1,2493,3340,2719,-621
2019,9,1,2,2506,3335,2718,-617
2019,9,1,3,2442,3199,2561,-638
2019,9,1,4,2348,3227,2495,-732
2019,9,1,5,2546,3128,2491,-637
2019,9,1,6,2526,2932,2506,-426
2019,9,1,7,2657,2724,2517,-207
2019,9,1,8,2302,2558,2453,-105
2019,9,1,9,2204,2478,2450,-28
2019,9,1,10,2242,2415,2319,-96
2019,9,1,11,2094,2385,2280,-105
2019,9,1,12,2091,2385,2359,-26
2019,9,1,13,2165,2391,2265,-126
2019,9,1,14,2028,2482,2244,-238
2019,9,1,15,2069,2614,2148,-466
2019,9,1,16,2218,2844,2348,-496
2019,9,1,17,2397,2993,2364,-629
2019,9,1,18,2388,3120,2440,-680
2019,9,1,19,2450,3169,2484,-685
2019,9,1,20,2402,3230,2556,-674
2019,9,1,21,2593,3250,2589,-661
2019,9,1,22,2481,3304,2557,-747
2019,9,1,23,2509,3325,2565,-760
2019,9,2,0,2597,3332,2595,-737
2019,9,2,1,2624,3350,2649,-701
2019,9,2,2,2699,3351,2744,-607
2019,9,2,3,2674,3252,2720,-532
2019,9,2,4,2702,3257,2656,-601
2019,9,2,5,2808,3126,2627,-499
2019,9,2,6,2806,2969,2826,-143
2019,9,2,7,2454,2773,2732,-41
2019,9,2,8,2325,2685,2550,-135
2019,9,2,9,2150,2624,2369,-255
2019,9,2,10,2052,2578,2328,-250
2019,9,2,11,2057,2584,2337,-247
2019,9,2,12,2086,2603,2320,-283
2019,9,2,13,2065,2657,2300,-357
2019,9,2,14,2105,2656,2305,-351
2019,9,2,15,2113,2743,2212,-531
2019,9,2,16,2229,2921,2215,-706
2019,9,2,17,2564,3093,2472,-621
2019,9,2,18,2607,3235,2412,-823
2019,9,2,19,2552,3339,2472,-867
2019,9,2,20,2542,3396,2607,-789
2019,9,2,21,2559,3470,2698,-772
2019,9,2,22,2524,3525,2732,-793
2019,9,2,23,2571,3579,2728,-851
2019,9,3,0,2574,3697,2786,-911
2019,9,3,1,2576,3766,2781,-985
2019,9,3,2,2567,3745,2774,-971
2019,9,3,3,2587,3655,2789,-866
2019,9,3,4,2653,3684,2781,-903
2019,9,3,5,2691,3449,2707,-742
2019,9,3,6,2703,3142,2671,-471
2019,9,3,7,2564,2898,2591,-307
2019,9,3,8,2390,2738,2609,-129
2019,9,3,9,2362,2605,2530,-75
2019,9,3,10,2399,2552,2511,-41
2019,9,3,11,2361,2536,2500,-36
2019,9,3,12,2388,2609,2428,-181
2019,9,3,13,2391,2789,2453,-336
2019,9,3,14,2228,3028,2406,-622
2019,9,3,15,2288,3210,2498,-712
2019,9,3,16,2432,3294,2462,-832
2019,9,3,17,2581,3413,2460,-953
2019,9,3,18,2590,3506,2348,-1158
2019,9,3,19,2594,3567,2349,-1218
2019,9,3,20,2620,3627,2389,-1238
2019,9,3,21,2676,3702,2460,-1242
2019,9,3,22,2547,3757,2503,-1254
2019,9,3,23,2579,3811,2577,-1234
2019,9,4,0,2536,3866,2641,-1225
2019,9,4,1,2503,3879,2651,-1228
2019,9,4,2,2494,3832,2768,-1064
2019,9,4,3,2606,3755,2803,-952
2019,9,4,4,2597,3751,2815,-936
2019,9,4,5,2629,3510,2766,-744
2019,9,4,6,2770,3197,2806,-391
2019,9,4,7,2727,2987,2881,-106
2019,9,4,8,2290,2802,2718,-84
2019,9,4,9,2080,2685,2537,-148
2019,9,4,10,2005,2624,2478,-146
2019,9,4,11,2086,2632,2541,-91
2019,9,4,12,2181,2716,2558,-158
2019,9,4,13,2249,2896,2650,-246
2019,9,4,14,2211,3181,2589,-592
2019,9,4,15,2233,3312,2558,-754
2019,9,4,16,2195,3352,2493,-859
2019,9,4,17,2232,3376,2429,-947
2019,9,4,18,2240,3423,2424,-999
2019,9,4,19,2405,3531,2519,-1012
2019,9,4,20,2418,3515,2530,-985
2019,9,4,21,2467,3504,2504,-1000
2019,9,4,22,2494,3546,2500,-1046
2019,9,4,23,2492,3639,2622,-1017
2019,9,5,0,2543,3673,2626,-1047
2019,9,5,1,2545,3758,2684,-1074
2019,9,5,2,2573,3755,2707,-1048
2019,9,5,3,2581,3660,2645,-1015
2019,9,5,4,2684,3641,2666,-975
2019,9,5,5,2550,3472,2699,-773
2019,9,5,6,2555,3195,2753,-442
2019,9,5,7,2369,2927,2752,-175
2019,9,5,8,2290,2762,2647,-115
2019,9,5,9,2248,2629,2571,-58
2019,9,5,10,2360,2574,2487,-87
2019,9,5,11,2353,2580,2489,-91
2019,9,5,12,2339,2640,2425,-215
2019,9,5,13,2552,2811,2644,-167
2019,9,5,14,2551,3068,2624,-444
2019,9,5,15,2672,3248,2706,-542
2019,9,5,16,2625,3315,2632,-683
2019,9,5,17,2623,3362,2577,-785
2019,9,5,18,2683,3404,2522,-882
2019,9,5,19,2609,3460,2508,-952
2019,9,5,20,2548,3512,2521,-991
2019,9,5,21,2586,3601,2701,-900
2019,9,5,22,2512,3596,2610,-986
2019,9,5,23,2587,3608,2620,-988
2019,9,6,0,2674,3676,2688,-988
2019,9,6,1,2564,3704,2701,-1003
2019,9,6,2,2529,3711,2732,-979
2019,9,6,3,2549,3690,2748,-942
2019,9,6,4,2716,3702,2757,-945
2019,9,6,5,2506,3473,2715,-758
2019,9,6,6,2488,3240,2727,-513
2019,9,6,7,2518,2994,2628,-366
2019,9,6,8,2331,2800,2584,-216
2019,9,6,9,2373,2713,2624,-89
2019,9,6,10,2419,2658,2633,-25
2019,9,6,11,2421,2613,2565,-48
2019,9,6,12,2466,2656,2558,-98
2019,9,6,13,2566,2827,2609,-218
2019,9,6,14,2423,3086,2619,-467
2019,9,6,15,2554,3227,2631,-596
2019,9,6,16,2623,3345,2668,-677
2019,9,6,17,2664,3422,2659,-763
2019,9,6,18,2692,3475,2659,-816
2019,9,6,19,2736,3528,2668,-860
2019,9,6,20,2518,3566,2660,-906
2019,9,6,21,2564,3622,2686,-936
2019,9,6,22,2580,3697,2716,-981
2019,9,6,23,2614,3736,2783,-953
2019,9,7,0,2574,3785,2795,-990
2019,9,7,1,2593,3776,2802,-974
2019,9,7,2,2533,3669,2811,-858
2019,9,7,3,2528,3616,2809,-807
2019,9,7,4,2706,3610,2788,-822
2019,9,7,5,2573,3466,2761,-705
2019,9,7,6,2884,3261,2814,-447
2019,9,7,7,2940,3047,2879,-168
2019,9,7,8,2254,2826,2584,-242
2019,9,7,9,2206,2687,2348,-339
2019,9,7,10,2138,2623,2320,-303
2019,9,7,11,2114,2591,2312,-279
2019,9,7,12,2109,2601,2318,-283
2019,9,7,13,2131,2655,2321,-334
2019,9,7,14,2096,2759,2304,-455
2019,9,7,15,2107,2852,2302,-550
2019,9,7,16,2296,3021,2428,-593
2019,9,7,17,2424,3146,2465,-681
2019,9,7,18,2494,3225,2509,-716
2019,9,7,19,2513,3242,2587,-655
2019,9,7,20,2409,3226,2572,-654
2019,9,7,21,2401,3209,2578,-631
2019,9,7,22,2386,3186,2537,-649
2019,9,7,23,2389,3175,2557,-618
2019,9,8,0,2427,3205,2502,-703
2019,9,8,1,2593,3229,2568,-661
2019,9,8,2,2669,3226,2638,-588
2019,9,8,3,2669,3275,2684,-591
2019,9,8,4,2630,3181,2694,-487
2019,9,8,5,2555,3029,2604,-425
2019,9,8,6,2561,2861,2437,-424
2019,9,8,7,2572,2734,2380,-354
2019,9,8,8,2230,2554,2290,-264
2019,9,8,9,2024,2477,2209,-268
2019,9,8,10,2071,2433,2096,-337
2019,9,8,11,1850,2385,2076,-309
2019,9,8,12,1937,2449,1998,-451
2019,9,8,13,1898,2512,1962,-550
2019,9,8,14,1866,2566,2009,-557
2019,9,8,15,1859,2639,2019,-620
2019,9,8,16,1992,2829,2067,-762
2019,9,8,17,2155,3027,2193,-834
2019,9,8,18,2239,3119,2258,-861
2019,9,8,19,2290,3139,2302,-837
2019,9,8,20,2335,3209,2380,-829
2019,9,8,21,2382,3219,2442,-777
2019,9,8,22,2423,3201,2451,-750
2019,9,8,23,2486,3222,2530,-692
2019,9,9,0,2549,3251,2569,-682
2019,9,9,1,2604,3368,2632,-736
2019,9,9,2,2590,3423,2688,-735
2019,9,9,3,2568,3432,2712,-720
2019,9,9,4,2442,3406,2608,-798
2019,9,9,5,2342,3206,2425,-781
2019,9,9,6,2249,2958,2380,-578
2019,9,9,7,2168,2709,2202,-507
2019,9,9,8,1965,2570,2141,-429
2019,9,9,9,2024,2482,2126,-356
2019,9,9,10,1964,2441,2139,-302
2019,9,9,11,2017,2442,2167,-275
2019,9,9,12,2103,2527,2224,-303
2019,9,9,13,2085,2738,2243,-495
2019,9,9,14,2112,3027,2299,-728
2019,9,9,15,2246,3188,2458,-730
2019,9,9,16,2187,3225,2334,-891
2019,9,9,17,2212,3287,2356,-931
2019,9,9,18,2215,3295,2312,-983
2019,9,9,19,2231,3155,2162,-993
2019,9,9,20,2198,3126,2120,-1006
2019,9,9,21,2206,3110,2110,-1000
2019,9,9,22,2204,3072,2093,-979
2019,9,9,23,2361,3070,2094,-976
2019,9,10,0,2387,3115,2179,-936
2019,9,10,1,2464,3256,2369,-887
2019,9,10,2,2478,3257,2417,-840
2019,9,10,3,2538,3262,2464,-798
2019,9,10,4,2336,3262,2430,-832
2019,9,10,5,2472,3078,2359,-719
2019,9,10,6,2600,2799,2334,-465
2019,9,10,7,2355,2561,2061,-500
2019,9,10,8,1810,2365,1940,-425
2019,9,10,9,1931,2359,1950,-409
2019,9,10,10,1836,2311,1936,-375
2019,9,10,11,1863,2500,2116,-384
2019,9,10,12,1948,2634,2174,-460
2019,9,10,13,2126,2832,2262,-570
2019,9,10,14,1988,3092,2185,-907
2019,9,10,15,2144,3236,2245,-991
2019,9,10,16,2141,3292,2289,-1003
2019,9,10,17,2192,3280,2190,-1090
2019,9,10,18,2188,3308,2340,-968
2019,9,10,19,2224,3295,2326,-969
2019,9,10,20,2213,3308,2324,-984
2019,9,10,21,2221,3323,2323,-1000
2019,9,10,22,2221,3319,2418,-901
2019,9,10,23,2306,3341,2500,-841
2019,9,11,0,2328,3394,2565,-829
2019,9,11,1,2381,3462,2562,-900
2019,9,11,2,2432,3442,2580,-862
2019,9,11,3,2477,3466,2644,-822
2019,9,11,4,2494,3450,2635,-815
2019,9,11,5,2342,3237,2633,-604
2019,9,11,6,2421,2982,2618,-364
2019,9,11,7,2309,2724,2312,-412
2019,9,11,8,2105,2626,2166,-460
2019,9,11,9,2022,2534,2151,-383
2019,9,11,10,2023,2496,2152,-344
2019,9,11,11,2010,2496,2152,-344
2019,9,11,12,2007,2573,2158,-415
2019,9,11,13,2145,2761,2198,-563
2019,9,11,14,2030,3066,2203,-863
2019,9,11,15,2234,3234,2264,-970
2019,9,11,16,2266,3261,2224,-1037
2019,9,11,17,2288,3264,2200,-1064
2019,9,11,18,2306,3329,2228,-1101
2019,9,11,19,2345,3354,2223,-1131
2019,9,11,20,2314,3376,2280,-1096
2019,9,11,21,2366,3424,2459,-965
2019,9,11,22,2364,3454,2565,-889
2019,9,11,23,2387,3445,2487,-958
2019,9,12,0,2374,3476,2495,-981
2019,9,12,1,2403,3525,2583,-942
2019,9,12,2,2397,3516,2602,-914
2019,9,12,3,2445,3542,2665,-877
2019,9,12,4,2603,3551,2773,-778
2019,9,12,5,2421,3238,2547,-691
2019,9,12,6,2405,2969,2546,-423
2019,9,12,7,2294,2724,2328,-396
2019,9,12,8,2292,2567,2232,-335
2019,9,12,9,2215,2498,2242,-256
2019,9,12,10,2144,2503,2274,-229
2019,9,12,11,2238,2516,2280,-236
2019,9,12,12,2187,2579,2291,-288
2019,9,12,13,2184,2785,2196,-589
2019,9,12,14,2206,3055,2320,-735
2019,9,12,15,2367,3187,2271,-916
2019,9,12,16,2389,3238,2272,-966
2019,9,12,17,2444,3283,2279,-1004
2019,9,12,18,2587,3349,2285,-1064
2019,9,12,19,2623,3381,2346,-1035
2019,9,12,20,2498,3434,2365,-1069
2019,9,12,21,2468,3477,2412,-1065
2019,9,12,22,2556,3524,2415,-1109
2019,9,12,23,2575,3576,2492,-1084
2019,9,13,0,2509,3611,2591,-1020
2019,9,13,1,2516,3598,2672,-926
2019,9,13,2,2494,3561,2694,-867
2019,9,13,3,2536,3586,2666,-920
2019,9,13,4,2609,3546,2696,-850
2019,9,13,5,2443,3334,2743,-591
2019,9,13,6,2505,3081,2835,-246
2019,9,13,7,2363,2866,2665,-201
2019,9,13,8,2327,2713,2561,-152
2019,9,13,9,2214,2627,2477,-150
2019,9,13,10,2362,2545,2562,0
2019,9,13,11,2350,2536,2523,-13
2019,9,13,12,2305,2605,2533,-72
2019,9,13,13,2311,2770,2540,-230
2019,9,13,14,2276,3016,2515,-501
2019,9,13,15,2380,3147,2438,-709
2019,9,13,16,2502,3224,2553,-671
2019,9,13,17,2587,3270,2609,-661
2019,9,13,18,2615,3350,2732,-618
2019,9,13,19,2627,3367,2728,-639
2019,9,13,20,2571,3406,2782,-624
2019,9,13,21,2543,3408,2797,-611
2019,9,13,22,2544,3410,2842,-568
2019,9,13,23,2597,3426,2884,-542
2019,9,14,0,2612,3439,2852,-587
2019,9,14,1,2647,3445,2838,-607
2019,9,14,2,2656,3391,2841,-550
2019,9,14,3,2695,3415,2864,-551
2019,9,14,4,2677,3376,2881,-495
2019,9,14,5,2451,3217,2870,-347
2019,9,14,6,2469,3053,2933,-120
2019,9,14,7,2580,2838,2745,-93
2019,9,14,8,2514,2652,2535,-117
2019,9,14,9,2392,2582,2578,-4
2019,9,14,10,2378,2524,2585,0
2019,9,14,11,2392,2512,2583,0
2019,9,14,12,2449,2510,2565,0
2019,9,14,13,2551,2534,2473,-61
2019,9,14,14,2169,2646,2459,-187
2019,9,14,15,2210,2785,2412,-373
2019,9,14,16,2457,2961,2353,-608
2019,9,14,17,2398,3092,2500,-592
2019,9,14,18,2331,3160,2512,-648
2019,9,14,19,2566,3199,2533,-666
2019,9,14,20,2481,3186,2555,-631
2019,9,14,21,2488,3142,2498,-644
2019,9,14,22,2406,3129,2493,-636
2019,9,14,23,2389,3110,2488,-622
2019,9,15,0,2396,3180,2539,-641
2019,9,15,1,2357,3216,2610,-606
2019,9,15,2,2413,3219,2601,-618
2019,9,15,3,2576,3294,2676,-618
2019,9,15,4,2433,3246,2651,-595
2019,9,15,5,2305,3150,2651,-499
2019,9,15,6,2500,2985,2672,-313
2019,9,15,7,2427,2821,2484,-337
2019,9,15,8,2266,2641,2303,-338
2019,9,15,9,2148,2565,2321,-244
2019,9,15,10,2170,2451,2198,-253
2019,9,15,11,2108,2470,2253,-217
2019,9,15,12,2070,2415,2201,-214
2019,9,15,13,2070,2436,2186,-250
2019,9,15,14,2065,2487,2161,-326
2019,9,15,15,2084,2643,2293,-350
2019,9,15,16,2102,2870,2332,-538
2019,9,15,17,2290,3054,2401,-653
2019,9,15,18,2388,3117,2272,-845
2019,9,15,19,2414,3149,2233,-916
2019,9,15,20,2406,3175,2380,-795
2019,9,15,21,2363,3150,2430,-720
2019,9,15,22,2304,3107,2372,-735
2019,9,15,23,2354,3170,2503,-667
2019,9,16,0,2472,3184,2744,-440
2019,9,16,1,2436,3256,2709,-547
2019,9,16,2,2471,3263,2628,-635
2019,9,16,3,2590,3393,2651,-742
2019,9,16,4,2599,3422,2693,-729
2019,9,16,5,2426,3244,2498,-746
2019,9,16,6,2454,2991,2439,-552
2019,9,16,7,2487,2776,2437,-339
2019,9,16,8,2187,2630,2379,-251
2019,9,16,9,1954,2546,2444,-102
2019,9,16,10,2100,2501,2470,-31
2019,9,16,11,2232,2523,2474,-49
2019,9,16,12,2366,2622,2530,-92
2019,9,16,13,2265,2826,2596,-230
2019,9,16,14,2255,3151,2547,-604
2019,9,16,15,2319,3332,2600,-732
2019,9,16,16,2340,3368,2599,-769
2019,9,16,17,2324,3362,2678,-684
2019,9,16,18,2325,3361,2667,-694
2019,9,16,19,2319,3374,2674,-700
2019,9,16,20,2435,3386,2720,-666
2019,9,16,21,2435,3377,2718,-659
2019,9,16,22,2416,3372,2743,-629
2019,9,16,23,2646,3345,2677,-668
2019,9,17,0,2651,3382,2682,-700
2019,9,17,1,2658,3432,2684,-748
2019,9,17,2,2768,3435,2709,-726
2019,9,17,3,2778,3463,2808,-655
2019,9,17,4,2787,3443,2766,-677
2019,9,17,5,2569,3245,2831,-414
2019,9,17,6,2638,2988,2896,-92
2019,9,17,7,2407,2740,2490,-250
2019,9,17,8,2217,2597,2385,-212
2019,9,17,9,2040,2515,2292,-223
2019,9,17,10,2110,2471,2253,-218
2019,9,17,11,2043,2481,2204,-277
2019,9,17,12,2042,2560,2196,-364
2019,9,17,13,2193,2752,2240,-512
2019,9,17,14,2267,3071,2243,-828
2019,9,17,15,2495,3208,2235,-973
2019,9,17,16,2676,3246,2410,-836
2019,9,17,17,2718,3303,2512,-791
2019,9,17,18,2758,3364,2607,-757
2019,9,17,19,2639,3356,2525,-831
2019,9,17,20,2659,3356,2495,-861
2019,9,17,21,2666,3335,2558,-777
2019,9,17,22,2666,3329,2742,-587
2019,9,17,23,2691,3315,2557,-758
2019,9,18,0,2492,3345,2473,-872
2019,9,18,1,2537,3422,2405,-1017
2019,9,18,2,2572,3456,2415,-1041
2019,9,18,3,2599,3542,2509,-1033
2019,9,18,4,2523,3488,2556,-932
2019,9,18,5,2437,3257,2470,-787
2019,9,18,6,2459,2999,2468,-531
2019,9,18,7,2446,2821,2404,-417
2019,9,18,8,1954,2705,2323,-382
2019,9,18,9,1929,2650,2342,-308
2019,9,18,10,1992,2599,2320,-279
2019,9,18,11,1998,2583,2273,-310
2019,9,18,12,2082,2669,2277,-392
2019,9,18,13,2151,2852,2276,-576
2019,9,18,14,2128,3156,2280,-876
2019,9,18,15,2298,3346,2366,-980
2019,9,18,16,2319,3386,2425,-961
2019,9,18,17,2421,3345,2467,-878
2019,9,18,18,2420,3368,2530,-838
2019,9,18,19,2367,3352,2478,-874
2019,9,18,20,2505,3372,2525,-847
2019,9,18,21,2519,3351,2506,-845
2019,9,18,22,2509,3328,2465,-863
2019,9,18,23,2528,3310,2452,-858
2019,9,19,0,2603,3351,2505,-846
2019,9,19,1,2589,3409,2565,-844
2019,9,19,2,2496,3435,2654,-781
2019,9,19,3,2736,3550,2840,-710
2019,9,19,4,2610,3505,2823,-682
2019,9,19,5,2521,3285,2648,-637
2019,9,19,6,2364,3077,2705,-372
2019,9,19,7,2371,2761,2430,-331
2019,9,19,8,2241,2623,2345,-278
2019,9,19,9,2188,2540,2314,-226
2019,9,19,10,2025,2285,2124,-161
2019,9,19,11,2162,2275,2083,-192
2019,9,19,12,2198,2364,2100,-264
2019,9,19,13,2229,2623,2132,-491
2019,9,19,14,2186,3005,2216,-789
2019,9,19,15,2342,3209,2278,-931
2019,9,19,16,2361,3305,2328,-977
2019,9,19,17,2347,3295,2351,-944
2019,9,19,18,2459,3291,2410,-881
2019,9,19,19,2561,3284,2513,-771
2019,9,19,20,2552,3277,2471,-806
2019,9,19,21,2436,3268,2509,-759
2019,9,19,22,2544,3264,2517,-747
2019,9,19,23,2549,3290,2527,-763
2019,9,20,0,2560,3306,2615,-691
2019,9,20,1,2566,3326,2735,-591
2019,9,20,2,2576,3357,2746,-611
2019,9,20,3,2657,3449,2685,-764
2019,9,20,4,2618,3428,2663,-765
2019,9,20,5,2426,3225,2601,-624
2019,9,20,6,2688,3006,2712,-294
2019,9,20,7,2508,2756,2599,-157
2019,9,20,8,2192,2560,2274,-286
2019,9,20,9,2144,2480,2210,-270
2019,9,20,10,2148,2435,2093,-342
2019,9,20,11,2119,2442,2104,-338
2019,9,20,12,2103,2503,2086,-417
2019,9,20,13,2099,2696,2175,-521
2019,9,20,14,2087,2990,2184,-806
2019,9,20,15,2205,3237,2273,-964
2019,9,20,16,2278,3290,2259,-1031
2019,9,20,17,2401,3305,2299,-1006
2019,9,20,18,2412,3310,2268,-1042
2019,9,20,19,2463,3315,2328,-987
2019,9,20,20,2487,3371,2475,-896
2019,9,20,21,2497,3322,2473,-849
2019,9,20,22,2499,3261,2474,-787
2019,9,20,23,2398,3259,2549,-710
2019,9,21,0,2420,3304,2728,-576
2019,9,21,1,2583,3344,2776,-568
2019,9,21,2,2584,3334,2791,-543
2019,9,21,3,2630,3371,2723,-648
2019,9,21,4,2561,3290,2517,-773
2019,9,21,5,2396,3156,2406,-750
2019,9,21,6,2529,3044,2724,-320
2019,9,21,7,2410,2825,2607,-218
2019,9,21,8,1941,2616,2218,-398
2019,9,21,9,1928,2529,2198,-331
2019,9,21,10,1830,2455,2176,-279
2019,9,21,11,1739,2444,2152,-292
2019,9,21,12,1686,2464,2151,-313
2019,9,21,13,1884,2533,2176,-357
2019,9,21,14,1949,2647,2151,-496
2019,9,21,15,2085,2805,2203,-602
2019,9,21,16,2228,2991,2199,-792
2019,9,21,17,2355,3163,2362,-801
2019,9,21,18,2383,3230,2398,-832
2019,9,21,19,2266,3217,2410,-807
2019,9,21,20,2217,3202,2427,-775
2019,9,21,21,2250,3106,2224,-882
2019,9,21,22,2354,3099,2348,-751
2019,9,21,23,2375,3083,2340,-743
2019,9,22,0,2427,3096,2345,-751
2019,9,22,1,2446,3129,2486,-643
2019,9,22,2,2435,3167,2556,-611
2019,9,22,3,2550,3277,2698,-579
2019,9,22,4,2518,3222,2623,-599
2019,9,22,5,2378,3119,2484,-635
2019,9,22,6,2546,2948,2701,-247
2019,9,22,7,2459,2790,2719,-71
2019,9,22,8,2171,2622,2251,-371
2019,9,22,9,2204,2528,2186,-342
2019,9,22,10,2174,2455,2168,-287
2019,9,22,11,2140,2430,2081,-349
2019,9,22,12,2132,2475,2096,-379
2019,9,22,13,2081,2520,2102,-418
2019,9,22,14,1957,2629,2114,-515
2019,9,22,15,1973,2725,2112,-613
2019,9,22,16,2109,2928,2088,-840
2019,9,22,17,2104,3113,2103,-1010
2019,9,22,18,2160,3198,2145,-1053
2019,9,22,19,2273,3248,2252,-996
2019,9,22,20,2249,3291,2350,-941
2019,9,22,21,2197,3276,2320,-956
2019,9,22,22,2130,3239,2309,-930
2019,9,22,23,2121,3252,2397,-855
2019,9,23,0,2201,3280,2386,-894
2019,9,23,1,2368,3321,2384,-937
2019,9,23,2,2383,3422,2488,-934
2019,9,23,3,2473,3461,2643,-818
2019,9,23,4,2426,3385,2771,-614
2019,9,23,5,2236,3190,2702,-488
2019,9,23,6,2527,3002,2806,-196
2019,9,23,7,2305,2690,2588,-102
2019,9,23,8,2151,2540,2351,-189
2019,9,23,9,2067,2486,2293,-193
2019,9,23,10,2039,2451,2261,-190
2019,9,23,11,1694,2467,2271,-196
2019,9,23,12,1697,2614,2352,-262
2019,9,23,13,2021,2812,2413,-399
2019,9,23,14,1835,3106,2387,-719
2019,9,23,15,1975,3264,2323,-941
2019,9,23,16,2020,3379,2532,-847
2019,9,23,17,2037,3415,2491,-924
2019,9,23,18,2193,3450,2556,-894
2019,9,23,19,2198,3457,2551,-906
2019,9,23,20,2294,3475,2669,-806
2019,9,23,21,2292,3395,2589,-806
2019,9,23,22,2294,3364,2502,-862
2019,9,23,23,2301,3364,2489,-875
2019,9,24,0,2310,3409,2605,-804
2019,9,24,1,2316,3527,2673,-854
2019,9,24,2,2322,3582,2747,-835
2019,9,24,3,2340,3606,2745,-861
2019,9,24,4,2343,3547,2771,-776
2019,9,24,5,2222,3241,2489,-752
2019,9,24,6,2277,2986,2483,-503
2019,9,24,7,2279,2772,2437,-335
2019,9,24,8,2302,2636,2408,-228
2019,9,24,9,2101,2549,2232,-317
2019,9,24,10,2095,2510,2177,-333
2019,9,24,11,2099,2525,2057,-468
2019,9,24,12,2129,2599,2159,-440
2019,9,24,13,2278,2847,2210,-637
2019,9,24,14,1991,3164,2178,-986
2019,9,24,15,2157,3326,2111,-1215
2019,9,24,16,2219,3345,2068,-1277
2019,9,24,17,2275,3365,2124,-1241
2019,9,24,18,2283,3376,2142,-1234
2019,9,24,19,2382,3353,2265,-1088
2019,9,24,20,2373,3354,2291,-1063
2019,9,24,21,2380,3346,2308,-1038
2019,9,24,22,2375,3344,2470,-874
2019,9,24,23,2383,3324,2492,-832
2019,9,25,0,2420,3365,2494,-871
2019,9,25,1,2481,3422,2513,-909
2019,9,25,2,2558,3439,2569,-870
2019,9,25,3,2649,3517,2558,-959
2019,9,25,4,2698,3470,2545,-925
2019,9,25,5,2524,3238,2530,-708
2019,9,25,6,2649,3034,2571,-463
2019,9,25,7,2673,2800,2519,-281
2019,9,25,8,2172,2670,2418,-252
2019,9,25,9,2088,2591,2389,-202
2019,9,25,10,2059,2552,2372,-180
2019,9,25,11,2058,2566,2345,-221
2019,9,25,12,2124,2629,2377,-252
2019,9,25,13,2233,2843,2445,-398
2019,9,25,14,2167,3146,2379,-767
2019,9,25,15,2385,3348,2471,-877
2019,9,25,16,2377,3368,2423,-945
2019,9,25,17,2436,3372,2340,-1032
2019,9,25,18,2511,3341,2331,-1010
2019,9,25,19,2420,3344,2433,-911
2019,9,25,20,2498,3358,2498,-860
2019,9,25,21,2448,3364,2500,-864
2019,9,25,22,2419,3376,2564,-812
2019,9,25,23,2422,3358,2577,-781
2019,9,26,0,2541,3390,2668,-722
2019,9,26,1,2571,3428,2735,-693
2019,9,26,2,2509,3505,2852,-653
2019,9,26,3,2649,3608,2904,-704
2019,9,26,4,2531,3506,2824,-682
2019,9,26,5,2405,3345,2789,-556
2019,9,26,6,2621,3050,2784,-266
2019,9,26,7,2373,2771,2669,-102
2019,9,26,8,2250,2660,2506,-154
2019,9,26,9,1836,2539,2430,-109
2019,9,26,10,1959,2488,2372,-116
2019,9,26,11,1870,2504,2272,-232
2019,9,26,12,1981,2608,2332,-276
2019,9,26,13,2076,2809,2402,-407
2019,9,26,14,2053,3119,2383,-736
2019,9,26,15,2134,3322,2413,-909
2019,9,26,16,2109,3350,2411,-939
2019,9,26,17,2116,3364,2439,-925
2019,9,26,18,2131,3367,2488,-879
2019,9,26,19,2129,3336,2500,-836
2019,9,26,20,2257,3347,2604,-743
2019,9,26,21,2269,3313,2603,-710
2019,9,26,22,2285,3288,2608,-680
2019,9,26,23,2324,3293,2623,-670
2019,9,27,0,2277,3321,2619,-702
2019,9,27,1,2366,3386,2702,-684
2019,9,27,2,2409,3386,2706,-680
2019,9,27,3,2524,3473,2693,-780
2019,9,27,4,2448,3415,2672,-743
2019,9,27,5,2174,3248,2561,-687
2019,9,27,6,2303,3000,2734,-266
2019,9,27,7,2086,2789,2380,-409
2019,9,27,8,2109,2643,2268,-375
2019,9,27,9,2033,2568,2361,-207
2019,9,27,10,2030,2522,2315,-207
2019,9,27,11,2021,2529,2226,-303
2019,9,27,12,2057,2615,2226,-389
2019,9,27,13,2094,2853,2315,-538
2019,9,27,14,2044,3118,2197,-921
2019,9,27,15,2205,3333,2362,-971
2019,9,27,16,2293,3391,2348,-1043
2019,9,27,17,2272,3393,2287,-1106
2019,9,27,18,2234,3377,2287,-1090
2019,9,27,19,2308,3376,2464,-912
2019,9,27,20,2275,3300,2590,-710
2019,9,27,21,2239,3265,2605,-660
2019,9,27,22,2204,3219,2531,-688
2019,9,27,23,2295,3218,2510,-708
2019,9,28,0,2354,3247,2558,-689
2019,9,28,1,2391,3296,2583,-713
2019,9,28,2,2449,3342,2580,-762
2019,9,28,3,2489,3440,2586,-854
2019,9,28,4,2515,3362,2568,-794
2019,9,28,5,2493,3233,2422,-811
2019,9,28,6,2524,3058,2345,-713
2019,9,28,7,2344,2874,2326,-548
2019,9,28,8,2071,2761,2240,-521
2019,9,28,9,1961,2629,2156,-473
2019,9,28,10,1928,2530,2102,-428
2019,9,28,11,1931,2513,2074,-439
2019,9,28,12,1892,2573,2065,-508
2019,9,28,13,2004,2701,2061,-640
2019,9,28,14,1877,2870,2019,-851
2019,9,28,15,1892,3034,2103,-931
2019,9,28,16,2163,3306,2318,-988
2019,9,28,17,2112,3331,2336,-995
2019,9,28,18,2262,3320,2348,-972
2019,9,28,19,2192,3304,2351,-953
2019,9,28,20,2133,3224,2256,-968
2019,9,28,21,2169,3114,2193,-921
2019,9,28,22,2158,3051,2277,-774
2019,9,28,23,2168,3063,2269,-794
2019,9,29,0,2136,3070,2221,-849
2019,9,29,1,2135,3164,2432,-732
2019,9,29,2,2211,3213,2494,-719
2019,9,29,3,2337,3393,2462,-931
2019,9,29,4,2338,3362,2483,-879
2019,9,29,5,2157,3253,2454,-799
2019,9,29,6,2463,3072,2498,-574
2019,9,29,7,2323,2881,2476,-405
2019,9,29,8,2128,2746,2372,-374
2019,9,29,9,2006,2660,2344,-316
2019,9,29,10,1961,2609,2363,-246
2019,9,29,11,1976,2558,2254,-304
2019,9,29,12,1990,2594,2259,-335
2019,9,29,13,1998,2758,2365,-393
2019,9,29,14,1929,2933,2404,-529
2019,9,29,15,2071,3100,2430,-670
2019,9,29,16,2348,3247,2464,-783
2019,9,29,17,2476,3345,2476,-869
2019,9,29,18,2492,3235,2511,-724
2019,9,29,19,2465,3083,2347,-736
2019,9,29,20,2424,3060,2298,-762
2019,9,29,21,2303,3018,2307,-711
2019,9,29,22,2340,3000,2407,-593
2019,9,29,23,2325,2955,2365,-590
2019,9,30,0,2368,2997,2292,-705
2019,9,30,1,2449,3115,2432,-683
2019,9,30,2,2408,3226,2483,-743
2019,9,30,3,2598,3332,2409,-923
2019,9,30,4,2582,3280,2367,-913
2019,9,30,5,2510,3105,2411,-694
2019,9,30,6,2560,2860,2376,-484
2019,9,30,7,2470,2657,2336,-321
2019,9,30,8,2204,2546,2320,-226
2019,9,30,9,2163,2491,2285,-206
2019,9,30,10,2165,2485,2253,-232
2019,9,30,11,2198,2539,2274,-265
2019,9,30,12,2213,2682,2269,-413
2019,9,30,13,2326,3000,2271,-729
2019,9,30,14,2293,3404,2270,-1134
2019,9,30,15,2272,3658,2367,-1291
2019,9,30,16,2349,3648,2291,-1357
2019,9,30,17,2483,3527,2253,-1274
2019,9,30,18,2481,3458,2337,-1121
2019,9,30,19,2297,3352,2298,-1054
2019,9,30,20,2209,3286,2284,-1002
2019,9,30,21,2168,3219,2301,-918
2019,9,30,22,2121,3169,2274,-895
2019,9,30,23,2132,3121,2252,-869
2019,10,1,0,2256,3155,2241,-914
2019,10,1,1,2293,3263,2293,-970
2019,10,1,2,2412,3341,2321,-1020
2019,10,1,3,2484,3499,2319,-1180
2019,10,1,4,2472,3417,2247,-1170
2019,10,1,5,2289,3244,2189,-1055
2019,10,1,6,2372,2972,2181,-791
2019,10,1,7,2347,2745,2244,-501
2019,10,1,8,1931,2602,1994,-608
2019,10,1,9,1934,2559,1967,-592
2019,10,1,10,1936,2561,1951,-610
2019,10,1,11,1931,2604,1932,-672
2019,10,1,12,2045,2795,2023,-772
2019,10,1,13,2206,3117,2146,-971
2019,10,1,14,2153,3552,2178,-1374
2019,10,1,15,2212,3759,2196,-1563
2019,10,1,16,2240,3698,2210,-1488
2019,10,1,17,2324,3547,2205,-1342
2019,10,1,18,2278,3415,2198,-1217
2019,10,1,19,2059,3305,2096,-1209
2019,10,1,20,1963,3247,2097,-1150
2019,10,1,21,1908,3179,2110,-1069
2019,10,1,22,1853,3143,2045,-1098
2019,10,1,23,1841,3130,2027,-1103
2019,10,2,0,1840,3180,1952,-1228
2019,10,2,1,1912,3262,2001,-1261
2019,10,2,2,2028,3339,1981,-1358
2019,10,2,3,2247,3467,1992,-1475
2019,10,2,4,2201,3387,1924,-1463
2019,10,2,5,1929,3191,1881,-1310
2019,10,2,6,2145,2942,1937,-1005
2019,10,2,7,2064,2672,1827,-845
2019,10,2,8,1808,2566,1840,-726
2019,10,2,9,1841,2546,1956,-590
2019,10,2,10,1842,2515,1900,-615
2019,10,2,11,1817,2561,1734,-827
2019,10,2,12,1890,2727,1792,-935
2019,10,2,13,1887,3050,1966,-1084
2019,10,2,14,1936,3424,1931,-1493
2019,10,2,15,2116,3561,2067,-1494
2019,10,2,16,2158,3506,2053,-1453
2019,10,2,17,2111,3398,2093,-1305
2019,10,2,18,2291,3338,2152,-1186
2019,10,2,19,2206,3193,2085,-1108
2019,10,2,20,2177,3150,1871,-1279
2019,10,2,21,2164,3131,1805,-1326
2019,10,2,22,2127,3142,1761,-1381
2019,10,2,23,2115,3157,1774,-1383
2019,10,3,0,2145,3199,1778,-1421
2019,10,3,1,2144,3277,1880,-1397
2019,10,3,2,2197,3361,1919,-1442
2019,10,3,3,2447,3372,1937,-1435
2019,10,3,4,2358,3265,1906,-1359
2019,10,3,5,2045,3071,1811,-1260
2019,10,3,6,2139,2850,1855,-995
2019,10,3,7,2188,2655,1849,-806
2019,10,3,8,1844,2614,1816,-798
2019,10,3,9,1851,2658,1852,-806
2019,10,3,10,1814,2619,1796,-823
2019,10,3,11,1836,2646,1773,-873
2019,10,3,12,1928,2758,1880,-878
2019,10,3,13,2265,3042,2153,-889
2019,10,3,14,2065,3369,2101,-1268
2019,10,3,15,2262,3548,2133,-1415
2019,10,3,16,2234,3548,2165,-1383
2019,10,3,17,2117,3517,2089,-1428
2019,10,3,18,2202,3480,2069,-1411
2019,10,3,19,2156,3455,2057,-1398
2019,10,3,20,2162,3430,2015,-1415
2019,10,3,21,2146,3388,1988,-1400
2019,10,3,22,2118,3338,1982,-1356
2019,10,3,23,2112,3354,1966,-1388
2019,10,4,0,2036,3417,1990,-1427
2019,10,4,1,2096,3500,2094,-1406
2019,10,4,2,2293,3561,2198,-1363
2019,10,4,3,2378,3596,2087,-1509
2019,10,4,4,2313,3494,2023,-1471
2019,10,4,5,2142,3379,2074,-1305
2019,10,4,6,2486,3111,2091,-1020
2019,10,4,7,2213,2649,1712,-937
2019,10,4,8,1668,2787,1621,-1166
2019,10,4,9,1619,2704,1540,-1164
2019,10,4,10,1582,2606,1456,-1150
2019,10,4,11,1510,2624,1464,-1160
2019,10,4,12,1548,2741,1502,-1239
2019,10,4,13,1848,3018,1885,-1133
2019,10,4,14,1902,3352,1891,-1461
2019,10,4,15,1948,3598,2066,-1532
2019,10,4,16,1956,3585,1956,-1629
2019,10,4,17,1963,3505,1876,-1629
2019,10,4,18,1883,3460,1768,-1692
2019,10,4,19,1819,3443,1841,-1602
2019,10,4,20,1784,3391,1867,-1524
2019,10,4,21,1762,3348,1877,-1471
2019,10,4,22,1628,3296,1777,-1519
2019,10,4,23,1594,3291,1769,-1522
2019,10,5,0,1662,3275,1813,-1462
2019,10,5,1,1833,3345,1900,-1445
2019,10,5,2,1923,3424,1916,-1508
2019,10,5,3,2004,3385,1908,-1477
2019,10,5,4,1832,3299,1965,-1334
2019,10,5,5,1690,3154,1873,-1281
2019,10,5,6,1833,2984,1873,-1111
2019,10,5,7,1845,2825,1840,-985
2019,10,5,8,1532,2679,1776,-903
2019,10,5,9,1476,2583,1737,-846
2019,10,5,10,1478,2539,1733,-806
2019,10,5,11,1481,2508,1670,-838
2019,10,5,12,1484,2556,1695,-861
2019,10,5,13,1480,2664,1722,-942
2019,10,5,14,1437,2835,1728,-1107
2019,10,5,15,1529,3007,1750,-1257
2019,10,5,16,1604,3165,1827,-1338
2019,10,5,17,1766,3239,1906,-1333
2019,10,5,18,1794,3236,1846,-1390
2019,10,5,19,1783,3190,1901,-1289
2019,10,5,20,1855,3118,1856,-1262
2019,10,5,21,1858,3058,1886,-1172
2019,10,5,22,1844,2995,1822,-1173
2019,10,5,23,1859,2988,1815,-1173
2019,10,6,0,1883,3026,1891,-1135
2019,10,6,1,1965,3118,2033,-1085
2019,10,6,2,1922,3209,2069,-1140
2019,10,6,3,2002,3264,2032,-1232
2019,10,6,4,1920,3237,2003,-1234
2019,10,6,5,1805,3151,1918,-1233
2019,10,6,6,1981,2995,1981,-1014
2019,10,6,7,1861,2902,1946,-956
2019,10,6,8,1562,2777,1623,-1154
2019,10,6,9,1701,2707,1669,-1038
2019,10,6,10,1519,2671,1591,-1080
2019,10,6,11,1452,2666,1638,-1028
2019,10,6,12,1496,2725,1621,-1104
2019,10,6,13,1628,2835,1598,-1237
2019,10,6,14,1604,3027,1613,-1414
2019,10,6,15,1600,3232,1721,-1511
2019,10,6,16,1888,3438,1831,-1607
2019,10,6,17,1951,3495,1831,-1664
2019,10,6,18,1944,3452,1830,-1622
2019,10,6,19,1897,3313,1806,-1507
2019,10,6,20,1833,3252,1799,-1453
2019,10,6,21,1684,3212,1710,-1502
2019,10,6,22,1634,3167,1724,-1443
2019,10,6,23,1617,3178,1685,-1493
2019,10,7,0,1670,3199,1703,-1496
2019,10,7,1,1747,3386,1886,-1500
2019,10,7,2,1945,3485,1966,-1519
2019,10,7,3,1946,3579,1941,-1638
2019,10,7,4,1948,3502,1918,-1584
2019,10,7,5,1803,3321,1801,-1520
2019,10,7,6,1630,3032,1638,-1394
2019,10,7,7,1464,2823,1577,-1246
2019,10,7,8,1446,2710,1564,-1146
2019,10,7,9,1411,2650,1535,-1115
2019,10,7,10,1507,2631,1561,-1070
2019,10,7,11,1529,2655,1555,-1100
2019,10,7,12,1602,2778,1633,-1145
2019,10,7,13,1705,3052,1953,-1099
2019,10,7,14,1937,3449,2138,-1311
2019,10,7,15,2082,3647,2124,-1523
2019,10,7,16,2089,3634,2082,-1552
2019,10,7,17,2091,3635,2260,-1375
2019,10,7,18,2038,3606,2158,-1448
2019,10,7,19,1946,3574,2103,-1471
2019,10,7,20,1833,3492,1962,-1530
2019,10,7,21,1762,3462,1868,-1594
2019,10,7,22,1774,3435,1700,-1735
2019,10,7,23,1684,3422,1662,-1760
2019,10,8,0,1703,3498,1678,-1820
2019,10,8,1,1731,3624,1865,-1759
2019,10,8,2,1805,3683,2049,-1634
2019,10,8,3,1873,3686,2070,-1616
2019,10,8,4,1766,3519,1967,-1552
2019,10,8,5,1651,3294,1728,-1566
2019,10,8,6,1498,3043,1718,-1325
2019,10,8,7,1497,2816,1704,-1112
2019,10,8,8,1522,2620,1776,-844
2019,10,8,9,1549,2513,1694,-819
2019,10,8,10,1503,2506,1702,-804
2019,10,8,11,1509,2544,1734,-810
2019,10,8,12,1737,2713,1809,-904
2019,10,8,13,1976,2982,1911,-1071
2019,10,8,14,1930,3363,1914,-1449
2019,10,8,15,2098,3565,2029,-1536
2019,10,8,16,2119,3570,2065,-1505
2019,10,8,17,2079,3543,2000,-1543
2019,10,8,18,1914,3424,1887,-1537
2019,10,8,19,1875,3518,2054,-1464
2019,10,8,20,1852,3504,1976,-1528
2019,10,8,21,1823,3509,1983,-1526
2019,10,8,22,1845,3501,2029,-1472
2019,10,8,23,1990,3511,2071,-1440
2019,10,9,0,1873,3535,2037,-1498
2019,10,9,1,2087,3669,2268,-1401
2019,10,9,2,2191,3843,2198,-1645
2019,10,9,3,2156,3983,2235,-1748
2019,10,9,4,2116,3827,2050,-1777
2019,10,9,5,1854,3629,2045,-1584
2019,10,9,6,2232,3396,2133,-1263
2019,10,9,7,1902,3155,2077,-1078
2019,10,9,8,1230,3040,1458,-1582
2019,10,9,9,1174,2948,1323,-1625
2019,10,9,10,1207,2916,1321,-1595
2019,10,9,11,1210,2951,1266,-1685
2019,10,9,12,1271,3098,1350,-1748
2019,10,9,13,1561,3467,1642,-1825
2019,10,9,14,1560,3896,1658,-2238
2019,10,9,15,1635,4109,1689,-2420
2019,10,9,16,1717,4083,1710,-2373
2019,10,9,17,1687,3943,1623,-2320
2019,10,9,18,1706,3828,1544,-2284
2019,10,9,19,1595,3715,1569,-2146
2019,10,9,20,1608,3628,1508,-2120
2019,10,9,21,1527,3557,1498,-2059
2019,10,9,22,1468,3456,1428,-2028
2019,10,9,23,1439,3446,1470,-1976
2019,10,10,0,1466,3483,1479,-2004
2019,10,10,1,1509,3611,1472,-2139
2019,10,10,2,1621,3787,1486,-2301
2019,10,10,3,1780,3937,1478,-2459
2019,10,10,4,1780,3919,1568,-2351
2019,10,10,5,1642,3674,1480,-2194
2019,10,10,6,1743,3408,1499,-1909
2019,10,10,7,1538,3188,1494,-1694
2019,10,10,8,1403,3063,1462,-1601
2019,10,10,9,1417,3023,1494,-1529
2019,10,10,10,1399,3052,1528,-1524
2019,10,10,11,1477,3121,1488,-1633
2019,10,10,12,1658,3309,1677,-1632
2019,10,10,13,1802,3673,1838,-1835
2019,10,10,14,1808,4072,1826,-2246
2019,10,10,15,1925,4320,1857,-2463
2019,10,10,16,1986,4240,1884,-2356
2019,10,10,17,1986,4078,1882,-2196
2019,10,10,18,1934,3748,1518,-2230
2019,10,10,19,1871,3776,1722,-2054
2019,10,10,20,1814,3639,1754,-1885
2019,10,10,21,1604,3541,1666,-1875
2019,10,10,22,1599,3459,1611,-1848
2019,10,10,23,1509,3440,1561,-1879
2019,10,11,0,1530,3495,1650,-1845
2019,10,11,1,1625,3596,1711,-1885
2019,10,11,2,1878,3751,1859,-1892
2019,10,11,3,1899,3880,1903,-1977
2019,10,11,4,1857,3833,1868,-1965
2019,10,11,5,1834,3662,1758,-1904
2019,10,11,6,1651,3439,1832,-1607
2019,10,11,7,1490,3220,1767,-1453
2019,10,11,8,1538,3051,1433,-1618
2019,10,11,9,1519,3010,1381,-1629
2019,10,11,10,1488,3008,1455,-1553
2019,10,11,11,1541,3031,1419,-1612
2019,10,11,12,1769,3208,1608,-1600
2019,10,11,13,1740,3482,1877,-1605
2019,10,11,14,1853,3867,1899,-1968
2019,10,11,15,1826,4132,1969,-2163
2019,10,11,16,1831,4118,1996,-2122
2019,10,11,17,1914,4057,2093,-1964
2019,10,11,18,1879,3814,1728,-2086
2019,10,11,19,1894,3660,1450,-2210
2019,10,11,20,1741,3554,1425,-2129
2019,10,11,21,1672,3454,1391,-2063
2019,10,11,22,1671,3365,1435,-1930
2019,10,11,23,1602,3395,1608,-1787
2019,10,12,0,1638,3448,1642,-1806
2019,10,12,1,1822,3508,1678,-1830
2019,10,12,2,1859,3606,1736,-1870
2019,10,12,3,1859,3625,1648,-1977
2019,10,12,4,1858,3579,1673,-1906
2019,10,12,5,1657,3456,1674,-1782
2019,10,12,6,1857,3296,1857,-1439
2019,10,12,7,1573,3084,1680,-1404
2019,10,12,8,1590,2946,1536,-1410
2019,10,12,9,1551,2872,1477,-1395
2019,10,12,10,1536,2853,1422,-1431
2019,10,12,11,1540,2872,1396,-1476
2019,10,12,12,1589,2947,1435,-1512
2019,10,12,13,1512,3084,1472,-1612
2019,10,12,14,1454,3293,1557,-1736
2019,10,12,15,1766,3524,1808,-1716
2019,10,12,16,1768,3654,1671,-1983
2019,10,12,17,1767,3739,1724,-2015
2019,10,12,18,1766,3707,1663,-2044
2019,10,12,19,1766,3630,1677,-1953
2019,10,12,20,1703,3537,1672,-1865
2019,10,12,21,1633,3418,1645,-1773
2019,10,12,22,1571,3279,1599,-1680
2019,10,12,23,1551,3172,1542,-1630
2019,10,13,0,1596,3103,1617,-1486
2019,10,13,1,1607,3087,1540,-1547
2019,10,13,2,1631,3087,1457,-1630
2019,10,13,3,1631,3086,1511,-1575
2019,10,13,4,1627,3031,1557,-1474
2019,10,13,5,1630,2875,1504,-1371
2019,10,13,6,1632,2733,1552,-1181
2019,10,13,7,1282,2518,1404,-1114
2019,10,13,8,1047,2379,1085,-1294
2019,10,13,9,1079,2294,1026,-1268
2019,10,13,10,993,2251,1013,-1238
2019,10,13,11,1001,2226,990,-1236
2019,10,13,12,888,2193,952,-1241
2019,10,13,13,971,2176,863,-1313
2019,10,13,14,787,2313,859,-1454
2019,10,13,15,949,2528,1084,-1444
2019,10,13,16,1101,2722,1090,-1632
2019,10,13,17,1142,2830,1123,-1707
2019,10,13,18,1144,2859,1187,-1672
2019,10,13,19,1108,2793,1055,-1738
2019,10,13,20,1130,2697,1018,-1679
2019,10,13,21,1136,2655,1026,-1629
2019,10,13,22,1087,2583,919,-1664
2019,10,13,23,1079,2552,945,-1607
2019,10,14,0,1129,2631,1165,-1466
2019,10,14,1,1206,2719,1179,-1540
2019,10,14,2,1306,2868,1223,-1645
2019,10,14,3,1327,2968,1194,-1774
2019,10,14,4,1333,2852,1161,-1691
2019,10,14,5,1166,2674,1117,-1557
2019,10,14,6,1257,2488,1307,-1181
2019,10,14,7,1019,2240,1057,-1183
2019,10,14,8,1037,2125,1027,-1098
2019,10,14,9,776,2070,867,-1203
2019,10,14,10,918,1891,637,-1254
2019,10,14,11,868,2106,830,-1276
2019,10,14,12,939,2248,831,-1417
2019,10,14,13,982,2549,1046,-1503
2019,10,14,14,985,2976,1173,-1803
2019,10,14,15,1242,3234,1249,-1985
2019,10,14,16,1225,3218,1226,-1992
2019,10,14,17,1219,3137,1182,-1955
2019,10,14,18,1145,3056,984,-2072
2019,10,14,19,1119,2941,894,-2047
2019,10,14,20,1092,2878,936,-1942
2019,10,14,21,1055,2813,955,-1858
2019,10,14,22,910,2772,982,-1790
2019,10,14,23,1033,2751,979,-1772
2019,10,15,0,1089,2805,1020,-1785
2019,10,15,1,1158,2926,1090,-1836
2019,10,15,2,1276,3082,1146,-1936
2019,10,15,3,1328,3144,1223,-1921
2019,10,15,4,1284,3021,1228,-1793
2019,10,15,5,995,2839,1179,-1660
2019,10,15,6,1112,2593,1198,-1395
2019,10,15,7,943,2363,1176,-1187
2019,10,15,8,998,2219,1105,-1114
2019,10,15,9,972,2195,1066,-1129
2019,10,15,10,1012,2170,1112,-1058
2019,10,15,11,1069,2217,1141,-1076
2019,10,15,12,968,2380,1062,-1318
2019,10,15,13,1003,2663,1176,-1487
2019,10,15,14,1135,3038,1248,-1790
2019,10,15,15,1079,3258,1287,-1971
2019,10,15,16,1079,3210,1260,-1950
2019,10,15,17,1095,3122,1258,-1864
2019,10,15,18,1115,3079,1237,-1842
2019,10,15,19,1053,3011,1226,-1785
2019,10,15,20,916,2969,1221,-1748
2019,10,15,21,1050,2934,1229,-1705
2019,10,15,22,1017,2948,1280,-1668
2019,10,15,23,1012,2948,1284,-1664
2019,10,16,0,1052,2971,1250,-1721
2019,10,16,1,1125,3080,1268,-1812
2019,10,16,2,1126,3218,1283,-1935
2019,10,16,3,1131,3233,1283,-1950
2019,10,16,4,1009,3071,1262,-1809
2019,10,16,5,900,2820,1092,-1728
2019,10,16,6,1104,2552,1178,-1374
2019,10,16,7,930,2309,1133,-1176
2019,10,16,8,1074,2177,1140,-1037
2019,10,16,9,1105,2103,1106,-997
2019,10,16,10,1124,2061,1080,-981
2019,10,16,11,1047,2090,1058,-1032
2019,10,16,12,1094,2197,1112,-1085
2019,10,16,13,1121,2427,1147,-1280
2019,10,16,14,1067,2808,1089,-1719
2019,10,16,15,1133,3056,1140,-1916
2019,10,16,16,1133,2996,1032,-1964
2019,10,16,17,1133,2999,1051,-1948
2019,10,16,18,1096,2987,1005,-1982
2019,10,16,19,1014,2983,1100,-1883
2019,10,16,20,1102,2937,1152,-1785
2019,10,16,21,1073,2930,1207,-1723
2019,10,16,22,1047,2927,1282,-1645
2019,10,16,23,1039,2910,1310,-1600
2019,10,17,0,1074,2957,1282,-1675
2019,10,17,1,1145,2971,1150,-1821
2019,10,17,2,1251,3202,1289,-1913
2019,10,17,3,1107,3141,1397,-1744
2019,10,17,4,1062,3022,1425,-1597
2019,10,17,5,1064,2797,1401,-1396
2019,10,17,6,1219,2553,1467,-1086
2019,10,17,7,1058,2313,1372,-941
2019,10,17,8,1133,2163,1246,-917
2019,10,17,9,1155,2097,1321,-776
2019,10,17,10,1079,2053,1407,-646
2019,10,17,11,1203,2057,1453,-604
2019,10,17,12,1173,2171,1340,-831
2019,10,17,13,1283,2431,1410,-1021
2019,10,17,14,1239,2807,1412,-1395
2019,10,17,15,1349,3038,1422,-1616
2019,10,17,16,1219,3031,1270,-1761
2019,10,17,17,1333,2988,1260,-1728
2019,10,17,18,1260,2951,1200,-1751
2019,10,17,19,1205,2914,1140,-1774
2019,10,17,20,1164,2872,1277,-1595
2019,10,17,21,1132,2838,1235,-1603
2019,10,17,22,1133,2816,1254,-1562
2019,10,17,23,1145,2834,1224,-1610
2019,10,18,0,1073,2925,1278,-1647
2019,10,18,1,1190,3111,1388,-1723
2019,10,18,2,1207,3253,1396,-1857
2019,10,18,3,1256,3210,1345,-1865
2019,10,18,4,1287,3085,1475,-1610
2019,10,18,5,1096,2924,1404,-1520
2019,10,18,6,1484,2660,1521,-1139
2019,10,18,7,1315,2405,1388,-1017
2019,10,18,8,1154,2250,1281,-969
2019,10,18,9,1160,2151,1263,-888
2019,10,18,10,1106,2108,1258,-850
2019,10,18,11,1110,2138,1286,-852
2019,10,18,12,1182,2258,1318,-940
2019,10,18,13,1464,2569,1582,-987
2019,10,18,14,1351,2908,1656,-1252
2019,10,18,15,1483,3179,1671,-1508
2019,10,18,16,1383,3183,1516,-1667
2019,10,18,17,1293,3143,1439,-1704
2019,10,18,18,1293,3178,1451,-1727
2019,10,18,19,1318,3157,1366,-1791
2019,10,18,20,1347,3084,1270,-1814
2019,10,18,21,1349,3021,1305,-1716
2019,10,18,22,1381,3026,1337,-1689
2019,10,18,23,1411,3070,1473,-1597
2019,10,19,0,1343,3082,1492,-1590
2019,10,19,1,1463,3282,1587,-1695
2019,10,19,2,1411,3394,1711,-1683
2019,10,19,3,1542,3309,1657,-1652
2019,10,19,4,1503,3197,1692,-1505
2019,10,19,5,1342,3048,1746,-1302
2019,10,19,6,1525,2837,1724,-1113
2019,10,19,7,1456,2614,1566,-1048
2019,10,19,8,1403,2460,1531,-929
2019,10,19,9,1327,2317,1401,-916
2019,10,19,10,1321,2271,1383,-888
2019,10,19,11,1395,2310,1466,-844
2019,10,19,12,1349,2324,1385,-939
2019,10,19,13,1274,2475,1495,-980
2019,10,19,14,1329,2663,1520,-1143
2019,10,19,15,1340,2882,1403,-1479
2019,10,19,16,1478,3053,1371,-1682
2019,10,19,17,1399,3158,1412,-1746
2019,10,19,18,1457,3191,1697,-1494
2019,10,19,19,1532,3167,1659,-1508
2019,10,19,20,1524,3118,1610,-1508
2019,10,19,21,1435,3029,1616,-1413
2019,10,19,22,1381,2969,1608,-1361
2019,10,19,23,1408,2951,1724,-1227
2019,10,20,0,1320,2990,1735,-1255
2019,10,20,1,1530,3050,1786,-1264
2019,10,20,2,1494,3158,1738,-1420
2019,10,20,3,1491,3163,1734,-1429
2019,10,20,4,1389,3122,1753,-1369
2019,10,20,5,1366,3022,1758,-1264
2019,10,20,6,1429,2923,1861,-1062
2019,10,20,7,1471,2727,1819,-908
2019,10,20,8,1721,2607,1821,-786
2019,10,20,9,1706,2597,1864,-733
2019,10,20,10,1675,2495,1797,-698
2019,10,20,11,1680,2485,1805,-680
2019,10,20,12,1649,2532,1801,-731
2019,10,20,13,1803,2642,1865,-777
2019,10,20,14,1618,2828,1879,-949
2019,10,20,15,1734,2950,1860,-1090
2019,10,20,16,1606,3140,1808,-1332
2019,10,20,17,1581,3239,1745,-1494
2019,10,20,18,1699,3304,1814,-1490
2019,10,20,19,1572,3291,1714,-1577
2019,10,20,20,1680,3296,1727,-1569
2019,10,20,21,1686,3249,1712,-1537
2019,10,20,22,1570,3267,1762,-1505
2019,10,20,23,1704,3311,1866,-1445
2019,10,21,0,1762,3401,1999,-1402
2019,10,21,1,1802,3529,2113,-1416
2019,10,21,2,1840,3545,2073,-1472
2019,10,21,3,1804,3597,1983,-1614
2019,10,21,4,1750,3552,2034,-1518
2019,10,21,5,1739,3320,2052,-1268
2019,10,21,6,1795,3036,2041,-995
2019,10,21,7,1628,2782,1957,-825
2019,10,21,8,1564,2710,1677,-1033
2019,10,21,9,1558,2643,1616,-1027
2019,10,21,10,1426,2598,1573,-1025
2019,10,21,11,1539,2642,1665,-977
2019,10,21,12,1532,2508,1406,-1102
2019,10,21,13,1631,3040,1826,-1214
2019,10,21,14,1725,3426,1804,-1622
2019,10,21,15,1905,3641,1918,-1723
2019,10,21,16,1898,3620,1873,-1747
2019,10,21,17,1829,3585,1780,-1805
2019,10,21,18,1763,3575,1605,-1970
2019,10,21,19,1727,3427,1457,-1970
2019,10,21,20,1658,3545,1616,-1929
2019,10,21,21,1642,3530,1604,-1926
2019,10,21,22,1625,3506,1543,-1963
2019,10,21,23,1794,3510,1516,-1994
2019,10,22,0,1842,3614,1631,-1983
2019,10,22,1,1846,3766,1587,-2179
2019,10,22,2,1854,3825,1553,-2272
2019,10,22,3,1868,3732,1569,-2163
2019,10,22,4,1878,3570,1555,-2015
2019,10,22,5,1652,3328,1478,-1850
2019,10,22,6,1760,3038,1357,-1681
2019,10,22,7,1694,2788,1301,-1487
2019,10,22,8,1388,2708,1436,-1272
2019,10,22,9,1327,2552,1435,-1117
2019,10,22,10,1384,2498,1402,-1096
2019,10,22,11,1401,2477,1364,-1113
2019,10,22,12,1531,2574,1383,-1191
2019,10,22,13,1614,2817,1533,-1284
2019,10,22,14,1627,3201,1608,-1593
2019,10,22,15,1830,3459,1656,-1803
2019,10,22,16,1804,3399,1789,-1610
2019,10,22,17,1782,3365,1700,-1665
2019,10,22,18,1658,3265,1563,-1702
2019,10,22,19,1645,3228,1596,-1632
2019,10,22,20,1631,3237,1508,-1729
2019,10,22,21,1630,3271,1581,-1690
2019,10,22,22,1625,3261,1593,-1668
2019,10,22,23,1683,3258,1590,-1668
2019,10,23,0,1866,3329,1686,-1643
2019,10,23,1,1889,3448,1697,-1751
2019,10,23,2,1945,3610,1779,-1831
2019,10,23,3,1942,3635,1838,-1797
2019,10,23,4,1928,3495,1739,-1756
2019,10,23,5,1849,3326,1799,-1527
2019,10,23,6,1888,3064,1796,-1268
2019,10,23,7,1865,2872,1757,-1115
2019,10,23,8,1445,2721,1440,-1281
2019,10,23,9,1433,2636,1443,-1193
2019,10,23,10,1447,2612,1447,-1165
2019,10,23,11,1506,2662,1432,-1230
2019,10,23,12,1472,2813,1468,-1345
2019,10,23,13,1677,3190,1649,-1541
2019,10,23,14,1522,3619,1607,-2012
2019,10,23,15,1691,3945,1762,-2183
2019,10,23,16,1690,3868,1588,-2280
2019,10,23,17,1603,3807,1586,-2221
2019,10,23,18,1541,3709,1657,-2052
2019,10,23,19,1389,3598,1601,-1997
2019,10,23,20,1380,3531,1626,-1905
2019,10,23,21,1382,3478,1633,-1845
2019,10,23,22,1395,3424,1590,-1834
2019,10,23,23,1422,3377,1549,-1828
2019,10,24,0,1364,3506,1628,-1878
2019,10,24,1,1483,3650,1729,-1921
2019,10,24,2,1558,3869,1742,-2127
2019,10,24,3,1616,3873,1773,-2100
2019,10,24,4,1608,3812,1808,-2004
2019,10,24,5,1450,3628,1799,-1829
2019,10,24,6,1663,3409,1893,-1516
2019,10,24,7,1585,3157,1812,-1345
2019,10,24,8,1531,2986,1644,-1342
2019,10,24,9,1510,2925,1667,-1258
2019,10,24,10,1474,2852,1644,-1208
2019,10,24,11,1558,2891,1730,-1161
2019,10,24,12,1452,3070,1746,-1324
2019,10,24,13,1759,3398,2027,-1371
2019,10,24,14,1620,3785,2110,-1675
2019,10,24,15,1843,3970,2123,-1847
2019,10,24,16,1803,3796,1872,-1924
2019,10,24,17,1825,3849,1983,-1866
2019,10,24,18,1603,3765,1781,-1984
2019,10,24,19,1546,3658,1691,-1967
2019,10,24,20,1446,3561,1652,-1909
2019,10,24,21,1346,3501,1639,-1862
2019,10,24,22,1349,3448,1591,-1857
2019,10,24,23,1353,3449,1604,-1845
2019,10,25,0,1357,3482,1566,-1916
2019,10,25,1,1585,3636,1768,-1868
2019,10,25,2,1702,3721,1700,-2021
2019,10,25,3,1693,3758,1735,-2023
2019,10,25,4,1644,3677,1764,-1913
2019,10,25,5,1372,3484,1665,-1819
2019,10,25,6,1716,3244,1662,-1582
2019,10,25,7,1396,3009,1581,-1428
2019,10,25,8,1445,2856,1584,-1272
2019,10,25,9,1426,2789,1616,-1173
2019,10,25,10,1394,2727,1628,-1099
2019,10,25,11,1448,2741,1672,-1069
2019,10,25,12,1504,2847,1699,-1148
2019,10,25,13,1550,3120,1781,-1339
2019,10,25,14,1600,3481,1827,-1654
2019,10,25,15,1762,3733,1876,-1857
2019,10,25,16,1861,3721,1928,-1793
2019,10,25,17,1734,3699,1891,-1808
2019,10,25,18,1577,3679,1833,-1846
2019,10,25,19,1523,3655,1877,-1778
2019,10,25,20,1533,3628,1840,-1788
2019,10,25,21,1272,3555,1566,-1989
2019,10,25,22,1198,3502,1448,-2054
2019,10,25,23,1200,3536,1340,-2196
2019,10,26,0,1219,3542,1392,-2150
2019,10,26,1,1445,3582,1524,-2058
2019,10,26,2,1464,3694,1593,-2101
2019,10,26,3,1569,3690,1645,-2045
2019,10,26,4,1550,3648,1620,-2028
2019,10,26,5,1322,3482,1445,-2037
2019,10,26,6,1451,3304,1375,-1929
2019,10,26,7,1350,3111,1296,-1815
2019,10,26,8,1153,2917,1203,-1714
2019,10,26,9,1107,2835,1201,-1634
2019,10,26,10,1084,2790,1221,-1569
2019,10,26,11,1122,2801,1209,-1592
2019,10,26,12,1059,2849,1188,-1661
2019,10,26,13,1136,2987,1266,-1721
2019,10,26,14,1047,3191,1261,-1930
2019,10,26,15,1233,3436,1376,-2060
2019,10,26,16,1477,3622,1593,-2029
2019,10,26,17,1615,3692,1713,-1979
2019,10,26,18,1711,3702,1674,-2028
2019,10,26,19,1582,3616,1708,-1908
2019,10,26,20,1536,3528,1684,-1844
2019,10,26,21,1477,3424,1707,-1717
2019,10,26,22,1427,3345,1711,-1634
2019,10,26,23,1413,3324,1568,-1756
2019,10,27,0,1394,3398,1689,-1709
2019,10,27,1,1640,3488,1789,-1699
2019,10,27,2,1772,3679,1914,-1765
2019,10,27,3,1784,3655,1834,-1821
2019,10,27,4,1590,3602,1813,-1789
2019,10,27,5,1565,3540,1813,-1727
2019,10,27,6,1808,3212,1751,-1461
2019,10,27,7,1633,3213,1912,-1301
2019,10,27,8,1573,3069,1729,-1340
2019,10,27,9,1539,3008,1725,-1283
2019,10,27,10,1445,2966,1680,-1286
2019,10,27,11,1461,2987,1588,-1399
2019,10,27,12,1497,3065,1561,-1504
2019,10,27,13,1625,3219,1654,-1565
2019,10,27,14,1503,3433,1687,-1746
2019,10,27,15,1639,3702,1840,-1862
2019,10,27,16,1833,3874,1867,-2007
2019,10,27,17,1871,3920,1859,-2061
2019,10,27,18,1802,3821,1828,-1993
2019,10,27,19,1702,3704,1809,-1895
2019,10,27,20,1598,3573,1756,-1817
2019,10,27,21,1542,3483,1718,-1765
2019,10,27,22,1535,3384,1732,-1652
2019,10,27,23,1530,3373,1788,-1585
2019,10,28,0,1548,3455,1755,-1700
2019,10,28,1,1652,3663,1858,-1805
2019,10,28,2,1888,3931,1917,-2014
2019,10,28,3,1925,3953,1867,-2086
2019,10,28,4,1971,3895,1969,-1926
2019,10,28,5,1734,3695,1898,-1797
2019,10,28,6,1845,3441,1936,-1505
2019,10,28,7,1603,3251,1827,-1424
2019,10,28,8,1647,3151,1705,-1446
2019,10,28,9,1633,3105,1724,-1381
2019,10,28,10,1711,3109,1696,-1413
2019,10,28,11,1671,3143,1697,-1446
2019,10,28,12,1695,3378,1788,-1590
2019,10,28,13,2076,3742,2147,-1595
2019,10,28,14,1958,4198,2141,-2057
2019,10,28,15,2020,4473,2233,-2240
2019,10,28,16,1994,4476,2176,-2300
2019,10,28,17,1840,4320,2053,-2267
2019,10,28,18,2007,4161,2001,-2160
2019,10,28,19,1679,3985,1846,-2139
2019,10,28,20,1604,3871,1847,-2024
2019,10,28,21,1570,3767,1913,-1854
2019,10,28,22,1658,3675,1896,-1779
2019,10,28,23,1668,3664,1925,-1739
2019,10,29,0,1639,3760,2130,-1630
2019,10,29,1,1875,3933,2291,-1642
2019,10,29,2,2049,4179,2360,-1819
2019,10,29,3,2009,4132,2268,-1864
2019,10,29,4,1772,4060,2187,-1873
2019,10,29,5,1740,3786,2016,-1770
2019,10,29,6,1994,3497,2096,-1401
2019,10,29,7,1695,3234,1852,-1382
2019,10,29,8,1621,3114,1793,-1321
2019,10,29,9,1616,3121,1738,-1383
2019,10,29,10,1665,3134,1825,-1309
2019,10,29,11,1696,3219,1929,-1290
2019,10,29,12,1832,3416,1890,-1526
2019,10,29,13,2001,3739,2100,-1639
2019,10,29,14,1854,4232,2099,-2133
2019,10,29,15,2164,4531,2227,-2304
2019,10,29,16,2099,4510,2125,-2385
2019,10,29,17,1960,4344,1943,-2401
2019,10,29,18,1903,4160,1800,-2360
2019,10,29,19,1799,4017,1745,-2272
2019,10,29,20,1722,3918,1753,-2165
2019,10,29,21,1767,3900,1811,-2089
2019,10,29,22,1621,3826,1816,-2010
2019,10,29,23,1637,3778,1809,-1969
2019,10,30,0,1731,3887,1870,-2017
2019,10,30,1,1842,4101,1976,-2125
2019,10,30,2,2105,4345,2117,-2228
2019,10,30,3,2211,4353,2097,-2256
2019,10,30,4,2146,4269,2085,-2184
2019,10,30,5,1809,4050,1935,-2115
2019,10,30,6,2152,3818,2182,-1636
2019,10,30,7,2078,3546,2141,-1405
2019,10,30,8,1680,3445,1885,-1560
2019,10,30,9,1678,3349,1794,-1555
2019,10,30,10,1698,3344,1761,-1583
2019,10,30,11,1731,3474,1849,-1625
2019,10,30,12,1906,3618,1966,-1652
2019,10,30,13,1954,3992,2051,-1941
2019,10,30,14,1969,4441,2075,-2366
2019,10,30,15,1950,4746,2171,-2575
2019,10,30,16,1949,4698,2145,-2553
2019,10,30,17,1955,4483,1982,-2501
2019,10,30,18,1972,4313,2047,-2266
2019,10,30,19,1971,4129,2008,-2121
2019,10,30,20,1863,4001,2001,-2000
2019,10,30,21,1693,3861,1846,-2015
2019,10,30,22,1677,3739,1760,-1979
2019,10,30,23,1678,3716,1644,-2072
2019,10,31,0,1743,3777,1682,-2095
2019,10,31,1,1821,3969,1879,-2090
2019,10,31,2,2108,4229,2019,-2210
2019,10,31,3,2123,4246,2020,-2226
2019,10,31,4,2092,4190,2037,-2153
2019,10,31,5,1893,3977,1974,-2003
2019,10,31,6,2054,3733,2016,-1717
2019,10,31,7,1790,3457,1906,-1551
2019,10,31,8,1844,3324,1883,-1441
2019,10,31,9,1780,3278,1818,-1460
2019,10,31,10,1740,3248,1771,-1477
2019,10,31,11,1824,3313,1788,-1525
2019,10,31,12,1802,3496,1812,-1684
2019,10,31,13,1994,3907,2067,-1840
2019,10,31,14,1969,4299,2049,-2250
2019,10,31,15,1954,4521,2130,-2391
2019,10,31,16,1993,4451,2004,-2447
2019,10,31,17,1950,4346,2014,-2332
2019,10,31,18,1951,4176,1964,-2212
2019,10,31,19,1950,4011,1804,-2207
2019,10,31,20,1847,3868,1796,-2072
2019,10,31,21,1774,3749,1840,-1909
2019,10,31,22,1793,3675,1776,-1899
2019,10,31,23,1774,3640,1757,-1883
2019,11,1,0,1834,3784,1859,-1925
2019,11,1,1,1872,3896,1923,-1973
2019,11,1,2,1976,4022,2047,-1975
2019,11,1,3,1992,3989,1985,-2004
2019,11,1,4,2012,3988,1938,-2050
2019,11,1,5,1916,3899,2076,-1823
2019,11,1,6,2109,3642,2049,-1593
2019,11,1,7,1962,3398,1897,-1501
2019,11,1,8,2109,3318,2136,-1182
2019,11,1,9,2047,3250,2014,-1236
2019,11,1,10,2052,3242,2050,-1192
2019,11,1,11,2124,3315,2087,-1228
2019,11,1,12,2196,3532,2317,-1215
2019,11,1,13,2292,3824,2390,-1434
2019,11,1,14,2251,4234,2387,-1847
2019,11,1,15,2307,4495,2425,-2070
2019,11,1,16,2312,4534,2533,-2001
2019,11,1,17,2323,4357,2380,-1977
2019,11,1,18,2308,4185,2355,-1830
2019,11,1,19,2166,4000,2248,-1752
2019,11,1,20,2177,3848,2110,-1738
2019,11,1,21,2219,3728,2120,-1608
2019,11,1,22,2154,3625,2109,-1516
2019,11,1,23,2149,3645,2094,-1551
2019,11,2,0,2140,3715,2132,-1583
2019,11,2,1,2177,3877,2357,-1520
2019,11,2,2,2387,4047,2519,-1528
2019,11,2,3,2377,4040,2543,-1497
2019,11,2,4,2401,3934,2475,-1459
2019,11,2,5,2161,3797,2408,-1389
2019,11,2,6,2353,3602,2441,-1161
2019,11,2,7,2151,3324,2341,-983
2019,11,2,8,2060,3088,2125,-963
2019,11,2,9,2005,3020,2091,-929
2019,11,2,10,1985,3019,2119,-900
2019,11,2,11,2005,3022,2106,-916
2019,11,2,12,2075,3168,2167,-1001
2019,11,2,13,2113,3389,2154,-1235
2019,11,2,14,1979,3632,2170,-1462
2019,11,2,15,2112,3915,2379,-1536
2019,11,2,16,2339,4092,2377,-1715
2019,11,2,17,2360,4101,2261,-1840
2019,11,2,18,2312,4011,2265,-1746
2019,11,2,19,2285,3824,2118,-1706
2019,11,2,20,2195,3663,2123,-1540
2019,11,2,21,2052,3541,2049,-1492
2019,11,2,22,1972,3435,2085,-1350
2019,11,2,23,1972,3408,2093,-1315
2019,11,3,0,1994,3447,2143,-1304
2019,11,3,1,2122,3608,2276,-1332
2019,11,3,2,2382,3718,2313,-1405
2019,11,3,3,2350,3746,2376,-1370
2019,11,3,4,2152,3696,2404,-1292
2019,11,3,5,2134,3638,2438,-1200
2019,11,3,6,2505,3428,2333,-1095
2019,11,3,7,2154,3244,2149,-1095
2019,11,3,8,1603,3069,1747,-1322
2019,11,3,9,1498,3017,1668,-1349
2019,11,3,10,1418,2991,1672,-1319
2019,11,3,11,1480,2984,1640,-1344
2019,11,3,12,1492,3023,1638,-1385
2019,11,3,13,1579,3128,1643,-1485
2019,11,3,14,1647,3412,1833,-1579
2019,11,3,15,1413,3484,1670,-1814
2019,11,3,16,1649,3838,1729,-2109
2019,11,3,17,1789,3959,1782,-2177
2019,11,3,18,1786,3907,1685,-2222
2019,11,3,19,1742,3856,1785,-2071
2019,11,3,20,1739,3744,1756,-1988
2019,11,3,21,1632,3669,1785,-1884
2019,11,3,22,1602,3556,1703,-1853
2019,11,3,23,1537,3462,1615,-1847
2019,11,4,0,1455,3532,1745,-1787
2019,11,4,1,1652,3661,1761,-1900
2019,11,4,2,1907,3978,1881,-2097
2019,11,4,3,1925,4016,1961,-2055
2019,11,4,4,1882,3998,2053,-1945
2019,11,4,5,1737,3884,1919,-1965
2019,11,4,6,1591,3685,1897,-1788
2019,11,4,7,1763,3436,1942,-1494
2019,11,4,8,1430,3251,1898,-1353
2019,11,4,9,1626,3120,1811,-1309
2019,11,4,10,1526,3089,1871,-1218
2019,11,4,11,1577,3132,1872,-1260
2019,11,4,12,1603,3201,1837,-1364
2019,11,4,13,1595,3396,1863,-1533
2019,11,4,14,2027,3706,2181,-1525
2019,11,4,15,1980,4100,2157,-1943
2019,11,4,16,1999,4285,2060,-2225
2019,11,4,17,1997,4222,2049,-2173
2019,11,4,18,1892,4082,1960,-2122
2019,11,4,19,1651,3973,1860,-2113
2019,11,4,20,1591,3840,1873,-1967
2019,11,4,21,1593,3752,1885,-1867
2019,11,4,22,1481,3693,1886,-1807
2019,11,4,23,1482,3651,1877,-1774
2019,11,5,0,1483,3672,1875,-1797
2019,11,5,1,1648,3833,1894,-1939
2019,11,5,2,1883,4135,2113,-2022
2019,11,5,3,1922,4166,2156,-2010
2019,11,5,4,1838,4074,2180,-1894
2019,11,5,5,1708,3958,2070,-1888
2019,11,5,6,1489,3712,2000,-1712
2019,11,5,7,1724,3451,2070,-1381
2019,11,5,8,1494,3223,2041,-1182
2019,11,5,9,1710,3078,1969,-1109
2019,11,5,10,1743,3020,1988,-1032
2019,11,5,11,1748,3025,2035,-990
2019,11,5,12,1910,3082,2182,-900
2019,11,5,13,1991,3315,2263,-1052
2019,11,5,14,2266,3669,2415,-1254
2019,11,5,15,2256,4059,2425,-1634
2019,11,5,16,2274,4231,2350,-1881
2019,11,5,17,2276,4127,2136,-1991
2019,11,5,18,2179,4023,2095,-1928
2019,11,5,19,2125,3962,2206,-1756
2019,11,5,20,2091,3848,2142,-1706
2019,11,5,21,2038,3730,2029,-1701
2019,11,5,22,1870,3664,1969,-1695
2019,11,5,23,1930,3618,1916,-1702
2019,11,6,0,1877,3671,2038,-1633
2019,11,6,1,2113,3846,2154,-1692
2019,11,6,2,2280,4153,2364,-1789
2019,11,6,3,2309,4185,2374,-1811
2019,11,6,4,2297,4126,2333,-1793
2019,11,6,5,2264,4001,2332,-1669
2019,11,6,6,2003,3810,2368,-1442
2019,11,6,7,2177,3549,2401,-1148
2019,11,6,8,1955,3325,2390,-935
2019,11,6,9,2165,3208,2439,-769
2019,11,6,10,2082,3150,2420,-730
2019,11,6,11,2086,3150,2354,-796
2019,11,6,12,2089,3210,2311,-899
2019,11,6,13,2163,3384,2273,-1111
2019,11,6,14,2267,3700,2399,-1301
2019,11,6,15,2259,4067,2466,-1601
2019,11,6,16,2233,4211,2405,-1806
2019,11,6,17,2265,4126,2274,-1852
2019,11,6,18,2234,4033,2341,-1692
2019,11,6,19,2028,3975,2258,-1717
2019,11,6,20,1959,3854,2161,-1693
2019,11,6,21,1951,3770,2085,-1685
2019,11,6,22,1939,3686,2043,-1643
2019,11,6,23,1931,3636,1927,-1709
2019,11,7,0,1926,3709,2137,-1572
2019,11,7,1,2056,3934,2244,-1690
2019,11,7,2,2242,4253,2397,-1856
2019,11,7,3,2226,4256,2399,-1857
2019,11,7,4,2161,4205,2385,-1820
2019,11,7,5,2119,4094,2291,-1803
2019,11,7,6,2051,3894,2323,-1571
2019,11,7,7,2103,3632,2343,-1289
2019,11,7,8,2022,3392,2295,-1097
2019,11,7,9,2001,3273,2207,-1066
2019,11,7,10,1987,3224,2170,-1054
2019,11,7,11,2015,3208,2147,-1061
2019,11,7,12,2031,3322,2195,-1127
2019,11,7,13,2020,3501,2182,-1319
2019,11,7,14,2091,3821,2294,-1527
2019,11,7,15,2147,4222,2266,-1956
2019,11,7,16,2117,4368,2241,-2127
2019,11,7,17,2061,4277,2162,-2115
2019,11,7,18,2111,4142,2063,-2079
2019,11,7,19,1940,4077,2026,-2051
2019,11,7,20,1806,3979,2040,-1939
2019,11,7,21,1623,3856,2011,-1845
2019,11,7,22,1613,3765,1937,-1828
2019,11,7,23,1554,3725,1779,-1946
2019,11,8,0,1569,3746,2016,-1730
2019,11,8,1,1765,3919,2082,-1837
2019,11,8,2,2027,4201,2151,-2050
2019,11,8,3,2007,4224,2258,-1966
2019,11,8,4,1976,4166,2248,-1918
2019,11,8,5,1844,4059,2085,-1974
2019,11,8,6,1759,3865,2060,-1805
2019,11,8,7,1898,3606,2178,-1428
2019,11,8,8,1784,3400,2087,-1313
2019,11,8,9,1776,3277,2079,-1198
2019,11,8,10,1761,3227,2065,-1162
2019,11,8,11,1754,3229,2045,-1184
2019,11,8,12,1785,3294,2063,-1231
2019,11,8,13,1965,3487,2109,-1378
2019,11,8,14,2072,3803,2234,-1569
2019,11,8,15,2064,4183,2247,-1936
2019,11,8,16,2154,4412,2169,-2243
2019,11,8,17,2151,4369,2111,-2258
2019,11,8,18,2146,4231,2102,-2129
2019,11,8,19,1910,4070,1880,-2190
2019,11,8,20,1804,3929,1846,-2083
2019,11,8,21,1732,3822,1850,-1972
2019,11,8,22,1765,3757,1839,-1918
2019,11,8,23,1716,3688,1853,-1835
2019,11,9,0,1742,3667,1836,-1831
2019,11,9,1,1895,3835,1859,-1976
2019,11,9,2,2051,4076,1986,-2090
2019,11,9,3,1998,4033,2016,-2017
2019,11,9,4,1892,3916,1928,-1988
2019,11,9,5,1776,3832,1937,-1895
2019,11,9,6,1582,3660,1864,-1796
2019,11,9,7,1820,3458,1889,-1569
2019,11,9,8,1599,3238,1908,-1330
2019,11,9,9,1568,3090,1838,-1252
2019,11,9,10,1575,2992,1790,-1202
2019,11,9,11,1538,2939,1803,-1136
2019,11,9,12,1564,2957,1832,-1125
2019,11,9,13,1583,3032,1836,-1196
2019,11,9,14,1574,3141,1808,-1333
2019,11,9,15,1373,3304,1730,-1574
2019,11,9,16,1501,3522,1716,-1806
2019,11,9,17,1534,3697,1789,-1908
2019,11,9,18,1571,3817,1842,-1975
2019,11,9,19,1556,3828,1774,-2054
2019,11,9,20,1592,3803,1835,-1968
2019,11,9,21,1490,3749,1820,-1929
2019,11,9,22,1471,3691,1845,-1846
2019,11,9,23,1416,3650,1893,-1757
2019,11,10,0,1434,3670,1921,-1749
2019,11,10,1,1572,3799,1937,-1862
2019,11,10,2,1643,3899,1914,-1985
2019,11,10,3,1665,3845,1909,-1936
2019,11,10,4,1707,3748,1972,-1776
2019,11,10,5,1571,3644,1954,-1690
2019,11,10,6,1561,3485,1957,-1528
2019,11,10,7,1687,3307,1978,-1329
2019,11,10,8,1560,3140,1980,-1160
2019,11,10,9,1676,2970,1976,-994
2019,11,10,10,1653,2825,1958,-867
2019,11,10,11,1693,2730,1942,-788
2019,11,10,12,1637,2703,1899,-804
2019,11,10,13,1722,2736,1858,-878
2019,11,10,14,1433,2823,1820,-1003
2019,11,10,15,1366,2971,1695,-1276
2019,11,10,16,1364,3228,1685,-1543
2019,11,10,17,1380,3438,1683,-1755
2019,11,10,18,1481,3539,1650,-1889
2019,11,10,19,1488,3603,1702,-1901
2019,11,10,20,1458,3582,1716,-1866
2019,11,10,21,1453,3589,1727,-1862
2019,11,10,22,1431,3578,1751,-1827
2019,11,10,23,1441,3550,1776,-1774
2019,11,11,0,1469,3605,1873,-1732
2019,11,11,1,1601,3757,1951,-1806
2019,11,11,2,1839,3930,1975,-1955
2019,11,11,3,1849,3900,1976,-1924
2019,11,11,4,1788,3775,1992,-1783
2019,11,11,5,1713,3652,2030,-1622
2019,11,11,6,1719,3499,2059,-1440
2019,11,11,7,1856,3288,2163,-1125
2019,11,11,8,1796,3082,2101,-981
2019,11,11,9,1773,2948,2015,-933
2019,11,11,10,1852,2909,2054,-855
2019,11,11,11,1810,2857,2005,-852
2019,11,11,12,1812,2889,2121,-768
2019,11,11,13,1990,3027,2172,-855
2019,11,11,14,2044,3299,2232,-1067
2019,11,11,15,1823,3583,2197,-1386
2019,11,11,16,2057,3795,2171,-1624
2019,11,11,17,2001,3912,2178,-1734
2019,11,11,18,1982,3968,2156,-1812
2019,11,11,19,1999,3913,2116,-1797
2019,11,11,20,1940,3809,2072,-1737
2019,11,11,21,1943,3741,2122,-1619
2019,11,11,22,1863,3695,2123,-1572
2019,11,11,23,1843,3673,2105,-1568
2019,11,12,0,1886,3718,2082,-1636
2019,11,12,1,2055,3898,2114,-1784
2019,11,12,2,2072,4090,2215,-1875
2019,11,12,3,2063,4051,2185,-1866
2019,11,12,4,2001,4000,2182,-1818
2019,11,12,5,1969,3846,2144,-1702
2019,11,12,6,1819,3703,2097,-1606
2019,11,12,7,1965,3423,2070,-1353
2019,11,12,8,1911,3168,2038,-1130
2019,11,12,9,1929,3016,1977,-1039
2019,11,12,10,1890,2940,2000,-940
2019,11,12,11,1874,2910,1993,-917
2019,11,12,12,1873,2976,2109,-867
2019,11,12,13,1987,3119,2117,-1002
2019,11,12,14,2111,3409,2232,-1177
2019,11,12,15,2089,3787,2253,-1534
2019,11,12,16,2107,3987,2156,-1831
2019,11,12,17,2106,3985,2138,-1847
2019,11,12,18,2104,3956,2143,-1813
2019,11,12,19,1957,3917,2127,-1790
2019,11,12,20,1939,3877,2223,-1654
2019,11,12,21,1987,3831,2277,-1554
2019,11,12,22,1926,3802,2200,-1602
2019,11,12,23,1907,3782,2195,-1587
2019,11,13,0,1896,3803,2214,-1589
2019,11,13,1,1856,3979,2222,-1757
2019,11,13,2,2066,4139,2318,-1821
2019,11,13,3,2095,4099,2358,-1741
2019,11,13,4,2104,3998,2324,-1674
2019,11,13,5,1988,3843,2196,-1647
2019,11,13,6,1976,3596,2075,-1521
2019,11,13,7,2017,3329,2041,-1288
2019,11,13,8,1829,3091,1945,-1146
2019,11,13,9,1845,2963,1901,-1062
2019,11,13,10,1785,2884,1857,-1027
2019,11,13,11,1772,2851,1870,-981
2019,11,13,12,1792,2871,1912,-959
2019,11,13,13,1813,3002,1977,-1025
2019,11,13,14,1873,3308,2096,-1212
2019,11,13,15,1904,3685,2043,-1642
2019,11,13,16,1852,3882,2181,-1701
2019,11,13,17,1842,3845,2129,-1716
2019,11,13,18,1980,3809,2147,-1662
2019,11,13,19,1623,3763,2005,-1758
2019,11,13,20,1622,3677,1965,-1712
2019,11,13,21,1626,3665,1941,-1724
2019,11,13,22,1649,3643,1913,-1730
2019,11,13,23,1651,3644,1995,-1649
2019,11,14,0,1652,3660,1951,-1709
2019,11,14,1,1758,3828,1960,-1868
2019,11,14,2,1862,4028,2093,-1935
2019,11,14,3,1809,4007,2058,-1949
2019,11,14,4,1818,3897,2046,-1851
2019,11,14,5,1715,3787,1986,-1801
2019,11,14,6,1718,3570,1955,-1615
2019,11,14,7,1827,3284,1951,-1333
2019,11,14,8,1749,3074,1949,-1125
2019,11,14,9,1716,2944,1888,-1056
2019,11,14,10,1627,2864,1884,-980
2019,11,14,11,1568,2804,1807,-997
2019,11,14,12,1642,2871,1871,-1000
2019,11,14,13,1617,3027,1879,-1148
2019,11,14,14,1817,3395,2005,-1390
2019,11,14,15,1753,3783,1975,-1808
2019,11,14,16,1929,3978,2013,-1965
2019,11,14,17,1888,3874,1950,-1924
2019,11,14,18,1823,3814,1974,-1840
2019,11,14,19,1729,3748,1876,-1872
2019,11,14,20,1735,3672,1838,-1834
2019,11,14,21,1708,3649,1870,-1779
2019,11,14,22,1617,3624,1798,-1826
2019,11,14,23,1531,3616,1804,-1812
2019,11,15,0,1638,3669,1822,-1847
2019,11,15,1,1737,3852,1959,-1893
2019,11,15,2,1970,4094,2033,-2061
2019,11,15,3,1982,4105,2049,-2056
2019,11,15,4,1889,3975,2034,-1941
2019,11,15,5,1784,3838,1907,-1931
2019,11,15,6,1573,3642,1902,-1740
2019,11,15,7,1931,3390,1976,-1414
2019,11,15,8,1802,3140,1872,-1268
2019,11,15,9,1800,2995,1947,-1048
2019,11,15,10,1742,2923,1926,-997
2019,11,15,11,1676,2885,1897,-988
2019,11,15,12,1704,2908,1885,-1023
2019,11,15,13,1782,3038,1838,-1200
2019,11,15,14,2085,3319,1941,-1378
2019,11,15,15,1943,3680,2006,-1674
2019,11,15,16,2038,3927,2279,-1648
2019,11,15,17,1997,3972,2285,-1687
2019,11,15,18,1911,3889,2193,-1696
2019,11,15,19,1832,3825,2082,-1743
2019,11,15,20,1722,3779,1760,-2019
2019,11,15,21,1633,3723,1706,-2017
2019,11,15,22,1630,3676,1880,-1796
2019,11,15,23,1622,3632,2009,-1623
2019,11,16,0,1646,3650,2053,-1597
2019,11,16,1,1683,3791,2018,-1773
2019,11,16,2,1728,3968,2057,-1911
2019,11,16,3,1729,3910,2021,-1889
2019,11,16,4,1698,3801,1960,-1841
2019,11,16,5,1695,3694,1781,-1913
2019,11,16,6,1689,3574,1862,-1712
2019,11,16,7,1758,3395,1859,-1536
2019,11,16,8,1683,3165,1885,-1280
2019,11,16,9,1584,3010,1892,-1118
2019,11,16,10,1588,2911,1885,-1026
2019,11,16,11,1620,2867,1968,-899
2019,11,16,12,1704,2870,1936,-934
2019,11,16,13,1695,2924,1792,-1132
2019,11,16,14,1490,3046,1705,-1341
2019,11,16,15,1381,3270,1730,-1540
2019,11,16,16,1489,3472,1742,-1730
2019,11,16,17,1546,3630,1719,-1911
2019,11,16,18,1642,3708,1801,-1907
2019,11,16,19,1647,3735,1809,-1926
2019,11,16,20,1629,3707,1809,-1898
2019,11,16,21,1586,3669,1728,-1941
2019,11,16,22,1521,3632,1725,-1907
2019,11,16,23,1503,3611,1712,-1899
2019,11,17,0,1526,3653,1726,-1927
2019,11,17,1,1651,3795,1826,-1969
2019,11,17,2,1650,3865,1760,-2105
2019,11,17,3,1668,3823,1798,-2025
2019,11,17,4,1687,3709,1832,-1877
2019,11,17,5,1721,3595,1822,-1773
2019,11,17,6,1576,3457,1750,-1707
2019,11,17,7,1733,3274,1927,-1347
2019,11,17,8,1715,3069,1937,-1132
2019,11,17,9,1522,2852,1826,-1026
2019,11,17,10,1498,2751,1791,-960
2019,11,17,11,1447,2691,1756,-935
2019,11,17,12,1537,2752,1796,-956
2019,11,17,13,1527,2821,1903,-918
2019,11,17,14,1582,2936,1873,-1063
2019,11,17,15,1561,3115,1888,-1227
2019,11,17,16,1704,3294,1900,-1394
2019,11,17,17,1826,3448,1905,-1543
2019,11,17,18,1869,3582,2003,-1579
2019,11,17,19,1809,3680,2029,-1651
2019,11,17,20,1724,3685,2047,-1638
2019,11,17,21,1646,3681,2066,-1615
2019,11,17,22,1618,3641,1968,-1673
2019,11,17,23,1570,3615,2007,-1608
2019,11,18,0,1624,3624,2033,-1591
2019,11,18,1,1775,3734,2102,-1632
2019,11,18,2,1858,3911,2172,-1739
2019,11,18,3,1824,3871,2167,-1704
2019,11,18,4,1818,3792,2138,-1654
2019,11,18,5,1809,3668,2093,-1575
2019,11,18,6,1635,3453,1976,-1477
2019,11,18,7,1642,3227,2000,-1227
2019,11,18,8,1534,3000,1946,-1054
2019,11,18,9,1338,2857,1898,-959
2019,11,18,10,1499,2789,1861,-928
2019,11,18,11,1532,2762,1886,-876
2019,11,18,12,1736,2805,1871,-934
2019,11,18,13,1815,2949,1863,-1086
2019,11,18,14,2027,3282,2057,-1225
2019,11,18,15,1898,3663,2049,-1614
2019,11,18,16,1988,3909,2107,-1802
2019,11,18,17,1975,3927,2096,-1831
2019,11,18,18,1958,3878,2033,-1845
2019,11,18,19,1926,3911,2021,-1890
2019,11,18,20,1844,3934,2053,-1881
2019,11,18,21,1851,3954,2053,-1901
2019,11,18,22,1830,3880,1966,-1914
2019,11,18,23,1809,3894,2009,-1885
2019,11,19,0,1831,3946,2051,-1895
2019,11,19,1,2007,4131,2162,-1969
2019,11,19,2,2194,4254,2235,-2019
2019,11,19,3,1988,4173,2119,-2054
2019,11,19,4,1928,4069,2150,-1919
2019,11,19,5,1932,3918,2148,-1770
2019,11,19,6,1833,3678,1968,-1710
2019,11,19,7,2010,3386,2104,-1282
2019,11,19,8,1852,3143,2053,-1090
2019,11,19,9,1609,2992,1889,-1103
2019,11,19,10,1439,2903,1890,-1013
2019,11,19,11,1464,2873,1874,-999
2019,11,19,12,1333,2907,1863,-1044
2019,11,19,13,1464,3040,1906,-1134
2019,11,19,14,1780,3336,2064,-1272
2019,11,19,15,1549,3681,1980,-1701
2019,11,19,16,1808,3892,2065,-1827
2019,11,19,17,1752,3883,1977,-1906
2019,11,19,18,1725,3853,1959,-1894
2019,11,19,19,1664,3846,1799,-2047
2019,11,19,20,1651,3824,1713,-2111
2019,11,19,21,1630,3765,1697,-2068
2019,11,19,22,1622,3724,1661,-2063
2019,11,19,23,1616,3721,1680,-2041
2019,11,20,0,1648,3785,1694,-2091
2019,11,20,1,1744,3971,1791,-2180
2019,11,20,2,1789,4242,1920,-2322
2019,11,20,3,1792,4236,1912,-2324
2019,11,20,4,1796,4154,1876,-2278
2019,11,20,5,1801,4036,1841,-2195
2019,11,20,6,1666,3842,1800,-2042
2019,11,20,7,1822,3590,1895,-1695
2019,11,20,8,1926,3380,1906,-1474
2019,11,20,9,1533,3248,1709,-1539
2019,11,20,10,1575,3192,1664,-1528
2019,11,20,11,1601,3181,1654,-1527
2019,11,20,12,1687,3244,1804,-1440
2019,11,20,13,1848,3425,2077,-1348
2019,11,20,14,2066,3776,2302,-1474
2019,11,20,15,2153,4171,2347,-1824
2019,11,20,16,2379,4346,2515,-1831
2019,11,20,17,2325,4296,2498,-1798
2019,11,20,18,2243,4165,2479,-1686
2019,11,20,19,2137,4051,2346,-1705
2019,11,20,20,1947,3928,2025,-1903
2019,11,20,21,1876,3854,1974,-1880
2019,11,20,22,1825,3811,2005,-1806
2019,11,20,23,1910,3780,2069,-1711
2019,11,21,0,2014,3862,2196,-1666
2019,11,21,1,2085,4107,2262,-1845
2019,11,21,2,2270,4382,2381,-2001
2019,11,21,3,2295,4402,2357,-2045
2019,11,21,4,2263,4358,2383,-1975
2019,11,21,5,2159,4266,2369,-1897
2019,11,21,6,2149,4063,2339,-1724
2019,11,21,7,2142,3788,2257,-1531
2019,11,21,8,2042,3544,2219,-1325
2019,11,21,9,1892,3365,2060,-1305
2019,11,21,10,1787,3303,1924,-1379
2019,11,21,11,1816,3312,1933,-1379
2019,11,21,12,1868,3395,1950,-1445
2019,11,21,13,2045,3667,2174,-1493
2019,11,21,14,2204,4020,2341,-1679
2019,11,21,15,2153,4431,2272,-2159
2019,11,21,16,2166,4667,2334,-2333
2019,11,21,17,2177,4571,2289,-2282
2019,11,21,18,2134,4416,2196,-2220
2019,11,21,19,2051,4284,2141,-2143
2019,11,21,20,1937,4183,2114,-2069
2019,11,21,21,1846,4090,2130,-1960
2019,11,21,22,1813,4017,2050,-1967
2019,11,21,23,1727,3964,2073,-1891
2019,11,22,0,1774,4031,2099,-1932
2019,11,22,1,2000,4297,2184,-2113
2019,11,22,2,2211,4547,2293,-2254
2019,11,22,3,2213,4538,2275,-2263
2019,11,22,4,2179,4464,2262,-2202
2019,11,22,5,2063,4339,2119,-2220
2019,11,22,6,1910,4148,2156,-1992
2019,11,22,7,2015,3863,2165,-1698
2019,11,22,8,2039,3616,2112,-1504
2019,11,22,9,1795,3488,1909,-1579
2019,11,22,10,1798,3430,1906,-1524
2019,11,22,11,1807,3429,1911,-1518
2019,11,22,12,1805,3492,1946,-1546
2019,11,22,13,2002,3666,2008,-1658
2019,11,22,14,2104,3985,2096,-1889
2019,11,22,15,2073,4385,2138,-2247
2019,11,22,16,2084,4614,2212,-2402
2019,11,22,17,1981,4572,2083,-2489
2019,11,22,18,2029,4445,1944,-2501
2019,11,22,19,1985,4340,1927,-2413
2019,11,22,20,1878,4268,1875,-2393
2019,11,22,21,1848,4153,1835,-2318
2019,11,22,22,1808,4073,1750,-2323
2019,11,22,23,1810,4059,1805,-2254
2019,11,23,0,1813,4125,1807,-2318
2019,11,23,1,1912,4326,1968,-2358
2019,11,23,2,2066,4498,1977,-2521
2019,11,23,3,2064,4407,1920,-2487
2019,11,23,4,2011,4308,1874,-2434
2019,11,23,5,1886,4186,1874,-2312
2019,11,23,6,1848,3985,1884,-2101
2019,11,23,7,1948,3735,1828,-1907
2019,11,23,8,1843,3530,1738,-1792
2019,11,23,9,1213,3343,1413,-1930
2019,11,23,10,1204,3290,1401,-1889
2019,11,23,11,1212,3258,1380,-1878
2019,11,23,12,1190,3279,1390,-1889
2019,11,23,13,1189,3351,1427,-1924
2019,11,23,14,1305,3516,1482,-2034
2019,11,23,15,1190,3741,1477,-2264
2019,11,23,16,1178,3987,1510,-2477
2019,11,23,17,1366,4148,1482,-2666
2019,11,23,18,1526,4218,1573,-2645
2019,11,23,19,1466,4220,1557,-2663
2019,11,23,20,1227,4145,1289,-2856
2019,11,23,21,1161,4007,1266,-2741
2019,11,23,22,1082,3900,1268,-2632
2019,11,23,23,1106,3827,1282,-2545
2019,11,24,0,1133,3844,1355,-2489
2019,11,24,1,1258,4005,1369,-2636
2019,11,24,2,1406,4076,1431,-2645
2019,11,24,3,1357,3992,1429,-2563
2019,11,24,4,1298,3870,1378,-2492
2019,11,24,5,1211,3706,1276,-2430
2019,11,24,6,1210,3545,1236,-2309
2019,11,24,7,1217,3314,1267,-2047
2019,11,24,8,1219,3123,1283,-1840
2019,11,24,9,1063,2959,1362,-1597
2019,11,24,10,1000,2851,1374,-1477
2019,11,24,11,1008,2801,1377,-1424
2019,11,24,12,1000,2789,1380,-1409
2019,11,24,13,972,2836,1381,-1455
2019,11,24,14,967,2958,1381,-1577
2019,11,24,15,956,3155,1392,-1763
2019,11,24,16,949,3434,1317,-2117
2019,11,24,17,1049,3648,1403,-2245
2019,11,24,18,1080,3713,1339,-2374
2019,11,24,19,1099,3666,1386,-2280
2019,11,24,20,1162,3619,1357,-2262
2019,11,24,21,1173,3573,1369,-2204
2019,11,24,22,1168,3512,1250,-2262
2019,11,24,23,1171,3527,1341,-2186
2019,11,25,0,1161,3620,1467,-2153
2019,11,25,1,1132,3868,1436,-2432
2019,11,25,2,1266,4096,1505,-2591
2019,11,25,3,1182,4046,1479,-2567
2019,11,25,4,1134,3976,1444,-2532
2019,11,25,5,1130,3860,1485,-2375
2019,11,25,6,1050,3662,1495,-2167
2019,11,25,7,1146,3386,1484,-1902
2019,11,25,8,1086,3168,1351,-1817
2019,11,25,9,956,3045,1382,-1663
2019,11,25,10,950,2927,1247,-1680
2019,11,25,11,908,2927,1296,-1631
2019,11,25,12,905,2978,1160,-1818
2019,11,25,13,1078,3172,1160,-2012
2019,11,25,14,1174,3478,1220,-2258
2019,11,25,15,1181,3884,1201,-2683
2019,11,25,16,1168,4181,1233,-2948
2019,11,25,17,1152,4172,1224,-2948
2019,11,25,18,1144,4109,1323,-2786
2019,11,25,19,1004,4024,1222,-2802
2019,11,25,20,1020,3974,1234,-2740
2019,11,25,21,990,3933,1298,-2635
2019,11,25,22,980,3884,1332,-2552
2019,11,25,23,981,3885,1270,-2615
2019,11,26,0,973,3989,1390,-2599
2019,11,26,1,1000,4255,1370,-2885
2019,11,26,2,1142,4446,1483,-2963
2019,11,26,3,1022,4420,1465,-2955
2019,11,26,4,906,4354,1458,-2896
2019,11,26,5,890,4233,1545,-2688
2019,11,26,6,913,4000,1522,-2478
2019,11,26,7,882,3713,1534,-2179
2019,11,26,8,867,3471,1485,-1986
2019,11,26,9,1313,3317,1468,-1849
2019,11,26,10,1249,3252,1414,-1838
2019,11,26,11,1148,3261,1514,-1747
2019,11,26,12,1248,3342,1600,-1742
2019,11,26,13,1463,3501,1690,-1811
2019,11,26,14,1640,3819,1725,-2094
2019,11,26,15,1620,4172,1760,-2412
2019,11,26,16,1672,4459,1847,-2612
2019,11,26,17,1593,4396,1835,-2561
2019,11,26,18,1600,4339,1870,-2469
2019,11,26,19,1580,4241,1822,-2419
2019,11,26,20,1497,4180,1759,-2421
2019,11,26,21,1430,4117,1756,-2361
2019,11,26,22,1385,4086,1794,-2292
2019,11,26,23,1429,4079,1839,-2240
2019,11,27,0,1471,4161,1923,-2238
2019,11,27,1,1523,4403,1903,-2500
2019,11,27,2,1734,4605,1973,-2632
2019,11,27,3,1720,4583,1932,-2651
2019,11,27,4,1618,4510,1941,-2569
2019,11,27,5,1677,4348,1916,-2432
2019,11,27,6,1556,4060,1806,-2254
2019,11,27,7,1687,3847,1962,-1885
2019,11,27,8,1639,3539,1876,-1663
2019,11,27,9,1478,3381,1826,-1555
2019,11,27,10,1274,3314,1735,-1579
2019,11,27,11,1496,3302,1628,-1674
2019,11,27,12,1402,3348,1632,-1716
2019,11,27,13,1373,3511,1650,-1861
2019,11,27,14,1550,3808,1712,-2096
2019,11,27,15,1225,4182,1674,-2508
2019,11,27,16,1540,4393,1772,-2621
2019,11,27,17,1497,4412,1813,-2599
2019,11,27,18,1418,4318,1770,-2548
2019,11,27,19,1258,4193,1734,-2459
2019,11,27,20,1384,4096,1633,-2463
2019,11,27,21,1339,4040,1727,-2313
2019,11,27,22,1319,4011,1742,-2269
2019,11,27,23,1333,4043,1844,-2199
2019,11,28,0,1425,4132,1861,-2271
2019,11,28,1,1541,4422,1934,-2488
2019,11,28,2,1756,4600,1925,-2675
2019,11,28,3,1763,4588,1874,-2714
2019,11,28,4,1682,4581,2001,-2580
2019,11,28,5,1567,4487,2024,-2463
2019,11,28,6,1433,4308,1960,-2348
2019,11,28,7,1623,4059,2062,-1997
2019,11,28,8,1455,3834,1920,-1914
2019,11,28,9,1489,3639,1900,-1739
2019,11,28,10,1495,3567,1913,-1654
2019,11,28,11,1526,3560,1965,-1595
2019,11,28,12,1566,3595,2012,-1583
2019,11,28,13,1722,3707,1939,-1768
2019,11,28,14,1893,3892,2018,-1874
2019,11,28,15,1893,4097,1995,-2102
2019,11,28,16,1837,4335,1960,-2375
2019,11,28,17,1975,4549,2200,-2349
2019,11,28,18,1855,4652,2183,-2469
2019,11,28,19,1871,4634,2049,-2585
2019,11,28,20,1955,4559,2058,-2501
2019,11,28,21,1834,4429,2063,-2366
2019,11,28,22,1745,4268,2009,-2259
2019,11,28,23,1862,4135,1902,-2233
2019,11,29,0,1851,4083,1906,-2177
2019,11,29,1,1900,4142,1855,-2287
2019,11,29,2,1800,4125,1840,-2285
2019,11,29,3,1856,4084,1846,-2238
2019,11,29,4,1731,4092,1890,-2202
2019,11,29,5,1727,4167,2031,-2136
2019,11,29,6,1770,4077,1987,-2090
2019,11,29,7,1761,3920,1940,-1980
2019,11,29,8,1800,3783,1936,-1847
2019,11,29,9,1681,3688,1918,-1770
2019,11,29,10,1669,3677,1907,-1770
2019,11,29,11,1677,3685,1906,-1779
2019,11,29,12,1733,3737,1891,-1846
2019,11,29,13,1782,3925,1947,-1978
2019,11,29,14,1810,4129,1927,-2202
2019,11,29,15,1643,4371,1889,-2482
2019,11,29,16,1702,4516,1811,-2705
2019,11,29,17,1701,4607,1762,-2845
2019,11,29,18,1923,4529,1718,-2811
2019,11,29,19,1836,4256,1568,-2688
2019,11,29,20,1728,4041,1488,-2553
2019,11,29,21,1621,3917,1397,-2520
2019,11,29,22,1531,3821,1381,-2440
2019,11,29,23,1448,3785,1454,-2331
2019,11,30,0,1516,3872,1535,-2337
2019,11,30,1,1714,4145,1663,-2482
2019,11,30,2,1842,4321,1692,-2629
2019,11,30,3,1846,4304,1662,-2642
2019,11,30,4,1787,4285,1661,-2624
2019,11,30,5,1742,4216,1650,-2566
2019,11,30,6,1623,4103,1669,-2434
2019,11,30,7,1941,3901,1666,-2235
2019,11,30,8,1773,3773,1718,-2055
2019,11,30,9,1620,3638,1716,-1922
2019,11,30,10,1624,3594,1733,-1861
2019,11,30,11,1727,3608,1768,-1840
2019,11,30,12,1794,3648,1808,-1840
2019,11,30,13,1759,3735,1856,-1879
2019,11,30,14,1747,3898,1863,-2035
2019,11,30,15,1547,4119,1901,-2218
2019,11,30,16,1729,4345,1907,-2438
2019,11,30,17,1733,4532,1907,-2625
2019,11,30,18,1676,4547,1902,-2645
2019,11,30,19,1645,4437,1919,-2518
2019,11,30,20,1630,4283,1838,-2445
2019,11,30,21,1631,4115,1870,-2245
2019,11,30,22,1533,3991,1892,-2099
2019,11,30,23,1540,3927,1858,-2069
2019,12,1,0,1554,3975,1883,-2092
2019,12,1,1,1569,4224,1905,-2319
2019,12,1,2,1587,4404,1939,-2465
2019,12,1,3,1608,4380,1990,-2390
2019,12,1,4,1630,4329,1983,-2346
2019,12,1,5,1651,4252,2052,-2200
2019,12,1,6,1669,4103,2068,-2035
2019,12,1,7,1734,3886,2060,-1826
2019,12,1,8,1825,3615,1967,-1648
2019,12,1,9,1967,3453,1969,-1484
2019,12,1,10,1910,3358,1900,-1458
2019,12,1,11,1931,3301,1894,-1407
2019,12,1,12,1905,3279,1830,-1449
2019,12,1,13,1919,3329,1818,-1511
2019,12,1,14,1905,3437,1813,-1624
2019,12,1,15,1822,3598,1721,-1877
2019,12,1,16,1795,3793,1802,-1991
2019,12,1,17,1884,3979,1890,-2089
2019,12,1,18,1971,4080,1874,-2206
2019,12,1,19,1925,4104,1741,-2363
2019,12,1,20,1892,4087,1704,-2383
2019,12,1,21,1876,4046,1624,-2422
2019,12,1,22,1836,4003,1749,-2254
2019,12,1,23,1763,3981,1732,-2249
2019,12,2,0,1858,4030,1791,-2239
2019,12,2,1,2092,4202,1784,-2418
2019,12,2,2,2121,4336,1804,-2532
2019,12,2,3,2111,4279,1816,-2463
2019,12,2,4,2035,4191,1906,-2285
2019,12,2,5,1924,4015,1764,-2251
2019,12,2,6,1726,3828,1688,-2140
2019,12,2,7,1941,3505,1660,-1845
2019,12,2,8,1822,3261,1654,-1607
2019,12,2,9,1761,3120,1721,-1399
2019,12,2,10,1728,3062,1685,-1377
2019,12,2,11,1743,3057,1637,-1420
2019,12,2,12,1714,3131,1674,-1457
2019,12,2,13,1854,3316,1727,-1589
2019,12,2,14,1864,3654,1885,-1769
2019,12,2,15,1735,4062,1995,-2067
2019,12,2,16,1905,4296,1980,-2316
2019,12,2,17,1911,4224,1839,-2385
2019,12,2,18,1871,4124,1824,-2300
2019,12,2,19,1854,4020,1742,-2278
2019,12,2,20,1776,3902,1693,-2209
2019,12,2,21,1713,3830,1771,-2059
2019,12,2,22,1657,3775,1785,-1990
2019,12,2,23,1613,3762,1832,-1930
2019,12,3,0,1709,3830,1880,-1950
2019,12,3,1,1985,4062,2113,-1949
2019,12,3,2,2136,4236,2189,-2047
2019,12,3,3,2151,4191,2172,-2019
2019,12,3,4,2134,4075,2163,-1912
2019,12,3,5,1990,3954,2090,-1864
2019,12,3,6,1856,3776,2126,-1650
2019,12,3,7,1972,3445,2099,-1346
2019,12,3,8,1676,3175,2108,-1067
2019,12,3,9,2070,2950,2011,-939
2019,12,3,10,2005,2821,2002,-819
2019,12,3,11,1995,2790,2026,-764
2019,12,3,12,2033,2857,2001,-856
2019,12,3,13,2150,3151,2149,-1002
2019,12,3,14,2263,3457,2300,-1157
2019,12,3,15,2163,3819,2243,-1576
2019,12,3,16,2279,4028,2325,-1703
2019,12,3,17,2239,3980,2330,-1650
2019,12,3,18,2129,3905,2203,-1702
2019,12,3,19,2053,3834,2185,-1649
2019,12,3,20,1969,3776,2196,-1580
2019,12,3,21,1902,3761,2213,-1548
2019,12,3,22,1891,3733,2228,-1505
2019,12,3,23,1888,3721,2222,-1499
2019,12,4,0,1942,3763,2212,-1551
2019,12,4,1,2165,3972,2271,-1701
2019,12,4,2,2209,4126,2301,-1825
2019,12,4,3,2246,4086,2300,-1786
2019,12,4,4,2255,3944,2233,-1711
2019,12,4,5,2048,3771,2086,-1685
2019,12,4,6,1906,3515,1985,-1530
2019,12,4,7,2169,3202,1989,-1213
2019,12,4,8,2106,2945,1964,-981
2019,12,4,9,1889,2777,1977,-800
2019,12,4,10,1916,2689,1928,-761
2019,12,4,11,1858,2652,1905,-747
2019,12,4,12,1889,2695,1878,-817
2019,12,4,13,1967,2828,1945,-883
2019,12,4,14,2037,3148,2110,-1038
2019,12,4,15,2042,3515,2162,-1353
2019,12,4,16,2036,3743,2187,-1556
2019,12,4,17,2025,3720,2239,-1481
2019,12,4,18,2086,3684,2239,-1445
2019,12,4,19,1921,3640,2157,-1483
2019,12,4,20,1945,3646,2155,-1491
2019,12,4,21,1961,3763,2198,-1565
2019,12,4,22,2148,3789,2336,-1453
2019,12,4,23,2224,3802,2324,-1478
2019,12,5,0,2180,3888,2342,-1546
2019,12,5,1,2336,4141,2398,-1743
2019,12,5,2,2433,4274,2440,-1834
2019,12,5,3,2415,4265,2410,-1855
2019,12,5,4,2388,4188,2395,-1793
2019,12,5,5,2283,4084,2415,-1669
2019,12,5,6,2088,3891,2425,-1466
2019,12,5,7,2348,3576,2422,-1154
2019,12,5,8,2133,3324,2450,-874
2019,12,5,9,2037,3161,2343,-818
2019,12,5,10,2097,3068,2335,-733
2019,12,5,11,1855,2902,2160,-742
2019,12,5,12,1964,2908,2151,-757
2019,12,5,13,1982,3047,2092,-955
2019,12,5,14,2224,3340,2163,-1177
2019,12,5,15,2256,3689,2124,-1565
2019,12,5,16,2398,3897,2210,-1687
2019,12,5,17,2401,3843,2231,-1612
2019,12,5,18,2397,3724,2083,-1641
2019,12,5,19,2326,3704,2074,-1630
2019,12,5,20,2265,3662,2085,-1577
2019,12,5,21,2233,3633,2135,-1498
2019,12,5,22,2212,3683,2249,-1434
2019,12,5,23,2150,3695,2282,-1413
2019,12,6,0,2213,3729,2287,-1442
2019,12,6,1,2318,3970,2345,-1625
2019,12,6,2,2417,4147,2488,-1659
2019,12,6,3,2425,4134,2441,-1693
2019,12,6,4,2458,4074,2503,-1571
2019,12,6,5,2337,3935,2386,-1549
2019,12,6,6,2142,3705,2290,-1415
2019,12,6,7,2300,3419,2265,-1154
2019,12,6,8,2038,3146,1922,-1224
2019,12,6,9,1614,2975,1894,-1081
2019,12,6,10,1589,2876,1877,-999
2019,12,6,11,1574,2847,1751,-1096
2019,12,6,12,1594,2873,1701,-1172
2019,12,6,13,1736,3066,1814,-1252
2019,12,6,14,1821,3357,1955,-1402
2019,12,6,15,1810,3732,1945,-1787
2019,12,6,16,1898,3969,1995,-1974
2019,12,6,17,1868,3951,1916,-2035
2019,12,6,18,1863,3898,1891,-2007
2019,12,6,19,1834,3840,1850,-1990
2019,12,6,20,1764,3741,1860,-1881
2019,12,6,21,1694,3691,1916,-1775
2019,12,6,22,1692,3672,1932,-1740
2019,12,6,23,1594,3674,1903,-1771
2019,12,7,0,1692,3744,1857,-1887
2019,12,7,1,1905,3936,2052,-1884
2019,12,7,2,2064,4015,1991,-2024
2019,12,7,3,1996,3945,1936,-2009
2019,12,7,4,1888,3871,2015,-1856
2019,12,7,5,1778,3741,1986,-1755
2019,12,7,6,1671,3587,1990,-1597
2019,12,7,7,1937,3349,1986,-1363
2019,12,7,8,1732,3133,1893,-1240
2019,12,7,9,1571,2961,1787,-1174
2019,12,7,10,1605,2851,1715,-1136
2019,12,7,11,1562,2803,1701,-1102
2019,12,7,12,1528,2801,1599,-1202
2019,12,7,13,1589,2845,1652,-1193
2019,12,7,14,1625,2956,1610,-1346
2019,12,7,15,1321,3146,1692,-1454
2019,12,7,16,1488,3363,1788,-1575
2019,12,7,17,1692,3573,1913,-1660
2019,12,7,18,1766,3688,1844,-1844
2019,12,7,19,1785,3735,1802,-1933
2019,12,7,20,1761,3694,1792,-1902
2019,12,7,21,1727,3658,1788,-1870
2019,12,7,22,1711,3624,1736,-1888
2019,12,7,23,1649,3580,1717,-1863
2019,12,8,0,1707,3617,1713,-1904
2019,12,8,1,1831,3749,1742,-2007
2019,12,8,2,1844,3828,1714,-2114
2019,12,8,3,1809,3767,1786,-1981
2019,12,8,4,1777,3686,1841,-1845
2019,12,8,5,1672,3613,1854,-1759
2019,12,8,6,1594,3472,1883,-1589
2019,12,8,7,1883,3276,1950,-1326
2019,12,8,8,1653,3076,1933,-1143
2019,12,8,9,1791,2912,1922,-990
2019,12,8,10,1626,2775,1783,-992
2019,12,8,11,1607,2696,1761,-935
2019,12,8,12,1421,2683,1723,-960
2019,12,8,13,1587,2730,1701,-1029
2019,12,8,14,1643,2849,1621,-1228
2019,12,8,15,1494,3038,1541,-1497
2019,12,8,16,1594,3241,1602,-1639
2019,12,8,17,1797,3441,1691,-1750
2019,12,8,18,1922,3551,1724,-1827
2019,12,8,19,1938,3591,1777,-1814
2019,12,8,20,1910,3552,1941,-1611
2019,12,8,21,1987,3527,2003,-1524
2019,12,8,22,1866,3487,2114,-1373
2019,12,8,23,1845,3513,2163,-1350
2019,12,9,0,1995,3591,2197,-1394
2019,12,9,1,2102,3821,2277,-1544
2019,12,9,2,2236,3948,2278,-1670
2019,12,9,3,2246,3931,2331,-1600
2019,12,9,4,2185,3901,2362,-1539
2019,12,9,5,2176,3810,2355,-1455
2019,12,9,6,2055,3625,2343,-1282
2019,12,9,7,2224,3345,2327,-1018
2019,12,9,8,1965,3085,2259,-826
2019,12,9,9,2068,2955,2254,-701
2019,12,9,10,2031,2880,2183,-697
2019,12,9,11,2026,2824,2051,-773
2019,12,9,12,2069,2884,2053,-831
2019,12,9,13,2161,3086,2155,-931
2019,12,9,14,2332,3398,2334,-1064
2019,12,9,15,2211,3799,2315,-1484
2019,12,9,16,2309,4052,2425,-1627
2019,12,9,17,2308,4062,2428,-1634
2019,12,9,18,2279,4008,2415,-1593
2019,12,9,19,2206,3956,2316,-1640
2019,12,9,20,2252,3910,2232,-1678
2019,12,9,21,2232,3893,2245,-1648
2019,12,9,22,2200,3869,2227,-1642
2019,12,9,23,2154,3883,2247,-1636
2019,12,10,0,2236,3975,2315,-1660
2019,12,10,1,2318,4238,2494,-1744
2019,12,10,2,2384,4410,2518,-1892
2019,12,10,3,2387,4395,2543,-1852
2019,12,10,4,2388,4288,2515,-1773
2019,12,10,5,2387,4150,2436,-1714
2019,12,10,6,2215,3909,2389,-1520
2019,12,10,7,2332,3591,2341,-1250
2019,12,10,8,2236,3329,2328,-1001
2019,12,10,9,2155,3137,2333,-804
2019,12,10,10,2084,3060,2252,-808
2019,12,10,11,2070,3046,2242,-804
2019,12,10,12,2112,3028,2169,-859
2019,12,10,13,2266,3193,2156,-1037
2019,12,10,14,2326,3550,2344,-1206
2019,12,10,15,2276,3949,2376,-1573
2019,12,10,16,2300,4197,2433,-1764
2019,12,10,17,2305,4169,2415,-1754
2019,12,10,18,2302,4105,2452,-1653
2019,12,10,19,2229,4059,2385,-1674
2019,12,10,20,2260,4031,2292,-1739
2019,12,10,21,2225,4051,2350,-1701
2019,12,10,22,2225,4054,2370,-1684
2019,12,10,23,2227,4061,2416,-1645
2019,12,11,0,2213,4187,2453,-1734
2019,12,11,1,2339,4406,2540,-1866
2019,12,11,2,2355,4563,2593,-1970
2019,12,11,3,2347,4510,2597,-1913
2019,12,11,4,2428,4413,2567,-1846
2019,12,11,5,2435,4293,2508,-1785
2019,12,11,6,2371,4039,2477,-1562
2019,12,11,7,2466,3729,2470,-1259
2019,12,11,8,2365,3447,2317,-1130
2019,12,11,9,2231,3248,2393,-855
2019,12,11,10,2193,3152,2378,-774
2019,12,11,11,2214,3126,2387,-739
2019,12,11,12,2249,3184,2435,-749
2019,12,11,13,2272,3333,2440,-893
2019,12,11,14,2386,3627,2532,-1095
2019,12,11,15,2366,3995,2550,-1445
2019,12,11,16,2459,4219,2555,-1664
2019,12,11,17,2407,4202,2525,-1677
2019,12,11,18,2387,4143,2417,-1726
2019,12,11,19,2365,4121,2370,-1751
2019,12,11,20,2276,4078,2406,-1672
2019,12,11,21,2316,4104,2411,-1693
2019,12,11,22,2297,4104,2411,-1693
2019,12,11,23,2191,4106,2439,-1667
2019,12,12,0,2265,4170,2433,-1737
2019,12,12,1,2502,4346,2494,-1852
2019,12,12,2,2701,4394,2474,-1920
2019,12,12,3,2659,4346,2462,-1884
2019,12,12,4,2549,4299,2536,-1763
2019,12,12,5,2408,4184,2537,-1647
2019,12,12,6,2200,3969,2503,-1466
2019,12,12,7,2507,3716,2593,-1123
2019,12,12,8,2333,3445,2537,-908
2019,12,12,9,2428,3254,2527,-727
2019,12,12,10,2392,3125,2557,-568
2019,12,12,11,2356,3073,2497,-576
2019,12,12,12,2395,3061,2483,-578
2019,12,12,13,2326,3216,2535,-681
2019,12,12,14,2365,3541,2594,-947
2019,12,12,15,2396,3934,2639,-1295
2019,12,12,16,2623,4173,2680,-1493
2019,12,12,17,2583,4147,2576,-1571
2019,12,12,18,2531,4093,2511,-1582
2019,12,12,19,2501,4092,2414,-1678
2019,12,12,20,2479,4065,2353,-1712
2019,12,12,21,2484,4054,2499,-1555
2019,12,12,22,2490,4041,2550,-1491
2019,12,12,23,2529,4076,2491,-1585
2019,12,13,0,2602,4176,2612,-1564
2019,12,13,1,2629,4379,2581,-1798
2019,12,13,2,2790,4511,2623,-1888
2019,12,13,3,2725,4453,2714,-1739
2019,12,13,4,2624,4378,2758,-1620
2019,12,13,5,2559,4267,2748,-1519
2019,12,13,6,2341,4049,2652,-1397
2019,12,13,7,2590,3754,2710,-1044
2019,12,13,8,2317,3465,2621,-844
2019,12,13,9,2112,3298,2529,-769
2019,12,13,10,2188,3209,2501,-708
2019,12,13,11,2262,3178,2500,-678
2019,12,13,12,2297,3239,2547,-692
2019,12,13,13,2387,3375,2614,-761
2019,12,13,14,2452,3672,2639,-1033
2019,12,13,15,2473,4028,2491,-1537
2019,12,13,16,2304,4271,2477,-1794
2019,12,13,17,2376,4239,2325,-1914
2019,12,13,18,2251,4179,2443,-1736
2019,12,13,19,2330,4100,2468,-1632
2019,12,13,20,2220,4007,2370,-1637
2019,12,13,21,2277,3990,2425,-1565
2019,12,13,22,2290,3962,2543,-1419
2019,12,13,23,2363,3930,2540,-1390
2019,12,14,0,2347,3997,2541,-1456
2019,12,14,1,2622,4257,2584,-1673
2019,12,14,2,2711,4395,2538,-1857
2019,12,14,3,2624,4330,2500,-1830
2019,12,14,4,2600,4229,2545,-1684
2019,12,14,5,2477,4127,2539,-1588
2019,12,14,6,2303,3969,2496,-1473
2019,12,14,7,2537,3709,2463,-1246
2019,12,14,8,2386,3478,2419,-1059
2019,12,14,9,2241,3295,2416,-879
2019,12,14,10,2129,3187,2385,-802
2019,12,14,11,2150,3140,2397,-743
2019,12,14,12,2072,3137,2389,-748
2019,12,14,13,2137,3199,2329,-870
2019,12,14,14,2264,3341,2307,-1034
2019,12,14,15,1825,3551,2246,-1305
2019,12,14,16,2048,3818,2284,-1534
2019,12,14,17,2104,4043,2380,-1663
2019,12,14,18,2201,4163,2344,-1819
2019,12,14,19,2224,4186,2277,-1909
2019,12,14,20,2196,4167,2341,-1826
2019,12,14,21,2172,4134,2359,-1775
2019,12,14,22,2148,4083,2299,-1784
2019,12,14,23,2159,4062,2301,-1761
2019,12,15,0,2170,4099,2417,-1682
2019,12,15,1,2361,4278,2516,-1762
2019,12,15,2,2470,4339,2520,-1819
2019,12,15,3,2421,4278,2491,-1787
2019,12,15,4,2344,4113,2458,-1655
2019,12,15,5,2249,4025,2478,-1547
2019,12,15,6,2115,3884,2432,-1452
2019,12,15,7,2479,3713,2463,-1250
2019,12,15,8,2333,3486,2420,-1066
2019,12,15,9,2105,3257,2318,-939
2019,12,15,10,2084,3163,2272,-891
2019,12,15,11,2006,3115,2201,-914
2019,12,15,12,1907,3149,2205,-944
2019,12,15,13,2104,3274,2285,-989
2019,12,15,14,2070,3409,2400,-1009
2019,12,15,15,1954,3625,2489,-1136
2019,12,15,16,2084,3834,2520,-1314
2019,12,15,17,2200,4059,2469,-1590
2019,12,15,18,2312,4187,2398,-1789
2019,12,15,19,2323,4191,2407,-1784
2019,12,15,20,2295,4163,2398,-1765
2019,12,15,21,2276,4109,2385,-1724
2019,12,15,22,2239,4023,2308,-1715
2019,12,15,23,2183,3991,2314,-1677
2019,12,16,0,2189,4055,2438,-1617
2019,12,16,1,2310,4356,2611,-1745
2019,12,16,2,2494,4552,2641,-1911
2019,12,16,3,2453,4546,2678,-1868
2019,12,16,4,2389,4490,2644,-1846
2019,12,16,5,2332,4384,2658,-1726
2019,12,16,6,2189,4175,2603,-1572
2019,12,16,7,2243,3869,2498,-1371
2019,12,16,8,2183,3575,2429,-1146
2019,12,16,9,2029,3422,2499,-923
2019,12,16,10,1947,3359,2460,-899
2019,12,16,11,2033,3345,2260,-1085
2019,12,16,12,2129,3402,2257,-1145
2019,12,16,13,2191,3587,2194,-1393
2019,12,16,14,2301,3925,2281,-1644
2019,12,16,15,2177,4323,2302,-2021
2019,12,16,16,2338,4561,2412,-2149
2019,12,16,17,2326,4573,2360,-2213
2019,12,16,18,2249,4498,2289,-2209
2019,12,16,19,2151,4441,2275,-2166
2019,12,16,20,2149,4390,2238,-2152
2019,12,16,21,1995,4355,2203,-2152
2019,12,16,22,1967,4254,2129,-2125
2019,12,16,23,1962,4193,2177,-2016
2019,12,17,0,1960,4230,2327,-1903
2019,12,17,1,2198,4548,2551,-1997
2019,12,17,2,2424,4730,2571,-2159
2019,12,17,3,2427,4720,2569,-2151
2019,12,17,4,2351,4632,2572,-2060
2019,12,17,5,2215,4500,2562,-1938
2019,12,17,6,1986,4268,2520,-1748
2019,12,17,7,2454,3958,2551,-1407
2019,12,17,8,2312,3681,2504,-1177
2019,12,17,9,2252,3531,2429,-1102
2019,12,17,10,2145,3434,2407,-1027
2019,12,17,11,2187,3397,2244,-1153
2019,12,17,12,2203,3473,2247,-1226
2019,12,17,13,2313,3650,2327,-1323
2019,12,17,14,2482,4000,2569,-1431
2019,12,17,15,2323,4402,2561,-1841
2019,12,17,16,2563,4634,2621,-2013
2019,12,17,17,2495,4588,2582,-2006
2019,12,17,18,2370,4497,2530,-1967
2019,12,17,19,2359,4371,2436,-1935
2019,12,17,20,2256,4023,2176,-1847
2019,12,17,21,2129,3986,2080,-1906
2019,12,17,22,2120,3958,2190,-1768
2019,12,17,23,2110,3946,2247,-1699
2019,12,18,0,2116,4008,2351,-1657
2019,12,18,1,2375,4235,2451,-1784
2019,12,18,2,2580,4502,2559,-1943
2019,12,18,3,2579,4503,2621,-1882
2019,12,18,4,2496,4465,2658,-1807
2019,12,18,5,2468,4372,2631,-1741
2019,12,18,6,2241,4178,2545,-1633
2019,12,18,7,2421,3848,2509,-1339
2019,12,18,8,2305,3575,2508,-1067
2019,12,18,9,2225,3408,2476,-932
2019,12,18,10,2195,3338,2479,-859
2019,12,18,11,2301,3322,2481,-841
2019,12,18,12,2316,3332,2420,-912
2019,12,18,13,2375,3509,2417,-1092
2019,12,18,14,2445,3816,2473,-1343
2019,12,18,15,2412,4212,2454,-1758
2019,12,18,16,2440,4451,2431,-2020
2019,12,18,17,2509,4425,2492,-1933
2019,12,18,18,2437,4362,2361,-2001
2019,12,18,19,2391,4328,2404,-1924
2019,12,18,20,2364,4248,2443,-1805
2019,12,18,21,2343,4216,2405,-1811
2019,12,18,22,2291,4202,2451,-1751
2019,12,18,23,2318,4218,2464,-1754
2019,12,19,0,2362,4294,2436,-1858
2019,12,19,1,2576,4521,2628,-1893
2019,12,19,2,2777,4657,2608,-2049
2019,12,19,3,2755,4621,2608,-2013
2019,12,19,4,2646,4528,2456,-2072
2019,12,19,5,2559,4426,2528,-1898
2019,12,19,6,2378,4211,2438,-1773
2019,12,19,7,2545,3906,2460,-1446
2019,12,19,8,2439,3611,2416,-1195
2019,12,19,9,2246,3415,2360,-1055
2019,12,19,10,2207,3310,2344,-966
2019,12,19,11,2256,3199,2285,-914
2019,12,19,12,2205,3226,2269,-957
2019,12,19,13,2282,3384,2385,-999
2019,12,19,14,2345,3709,2496,-1213
2019,12,19,15,2258,4075,2449,-1626
2019,12,19,16,2347,4349,2492,-1857
2019,12,19,17,2389,4322,2466,-1856
2019,12,19,18,2404,4288,2425,-1863
2019,12,19,19,2377,4232,2384,-1848
2019,12,19,20,2302,4201,2390,-1811
2019,12,19,21,2286,4203,2347,-1856
2019,12,19,22,2284,4235,2337,-1898
2019,12,19,23,2286,4265,2370,-1895
2019,12,20,0,2279,4362,2506,-1856
2019,12,20,1,2334,4547,2595,-1952
2019,12,20,2,2337,4624,2609,-2015
2019,12,20,3,2348,4525,2616,-1909
2019,12,20,4,2268,4375,2558,-1817
2019,12,20,5,2129,4229,2581,-1648
2019,12,20,6,1936,3998,2403,-1595
2019,12,20,7,2343,3704,2587,-1117
2019,12,20,8,2089,3421,2328,-1093
2019,12,20,9,1936,3174,2268,-906
2019,12,20,10,1807,3060,2261,-799
2019,12,20,11,1788,2981,2226,-755
2019,12,20,12,1847,3003,2215,-788
2019,12,20,13,1864,3114,2231,-883
2019,12,20,14,2092,3381,2305,-1076
2019,12,20,15,1819,3741,2358,-1383
2019,12,20,16,2011,3989,2349,-1640
2019,12,20,17,2125,4025,2252,-1773
2019,12,20,18,2182,4039,2229,-1810
2019,12,20,19,2213,4093,2306,-1787
2019,12,20,20,2213,4078,2290,-1788
2019,12,20,21,2199,4071,2271,-1800
2019,12,20,22,2198,4047,2392,-1655
2019,12,20,23,2205,4026,2414,-1612
2019,12,21,0,2280,4096,2426,-1670
2019,12,21,1,2482,4236,2599,-1637
2019,12,21,2,2392,4300,2585,-1715
2019,12,21,3,2385,4233,2606,-1627
2019,12,21,4,2342,4123,2656,-1467
2019,12,21,5,2317,4003,2594,-1409
2019,12,21,6,2185,3802,2470,-1332
2019,12,21,7,2317,3610,2513,-1097
2019,12,21,8,2337,3326,2391,-935
2019,12,21,9,2048,3138,2270,-868
2019,12,21,10,1901,3020,2080,-940
2019,12,21,11,1900,2978,2014,-964
2019,12,21,12,1863,2970,1981,-989
2019,12,21,13,1891,3030,2039,-991
2019,12,21,14,1936,3207,2200,-1007
2019,12,21,15,1907,3374,2130,-1244
2019,12,21,16,2088,3619,2213,-1406
2019,12,21,17,2136,3870,2340,-1530
2019,12,21,18,2229,4029,2398,-1631
2019,12,21,19,2298,4120,2519,-1601
2019,12,21,20,2312,4101,2443,-1658
2019,12,21,21,2328,4092,2432,-1660
2019,12,21,22,2205,4024,2313,-1711
2019,12,21,23,2249,4000,2396,-1604
2019,12,22,0,2299,4028,2459,-1569
2019,12,22,1,2444,4182,2651,-1531
2019,12,22,2,2518,4251,2726,-1525
2019,12,22,3,2394,4189,2680,-1509
2019,12,22,4,2400,4118,2722,-1396
2019,12,22,5,2339,4059,2661,-1398
2019,12,22,6,2341,3906,2646,-1260
2019,12,22,7,2439,3706,2564,-1142
2019,12,22,8,2518,3483,2496,-987
2019,12,22,9,2249,3231,2274,-957
2019,12,22,10,2183,3135,2230,-905
2019,12,22,11,2165,3097,2211,-886
2019,12,22,12,2145,3112,2233,-879
2019,12,22,13,2187,3237,2308,-929
2019,12,22,14,2302,3397,2437,-960
2019,12,22,15,2186,3603,2392,-1211
2019,12,22,16,2124,3850,2493,-1357
2019,12,22,17,2277,4025,2523,-1502
2019,12,22,18,2455,4111,2609,-1502
2019,12,22,19,2365,4132,2586,-1546
2019,12,22,20,2438,4111,2579,-1532
2019,12,22,21,2374,4091,2498,-1593
2019,12,22,22,2332,4072,2513,-1559
2019,12,22,23,2293,4061,2541,-1520
2019,12,23,0,2392,4071,2486,-1585
2019,12,23,1,2527,4233,2564,-1669
2019,12,23,2,2474,4362,2586,-1776
2019,12,23,3,2557,4317,2614,-1703
2019,12,23,4,2465,4246,2658,-1588
2019,12,23,5,2539,4154,2647,-1507
2019,12,23,6,2344,3977,2587,-1390
2019,12,23,7,2446,3753,2581,-1172
2019,12,23,8,2307,3286,2276,-1010
2019,12,23,9,2062,3021,2059,-962
2019,12,23,10,1963,2906,1955,-951
2019,12,23,11,1946,2876,1963,-913
2019,12,23,12,1993,2925,1965,-960
2019,12,23,13,1999,3090,2045,-1045
2019,12,23,14,2223,3383,2181,-1202
2019,12,23,15,2133,3699,2200,-1499
2019,12,23,16,2270,3917,2238,-1679
2019,12,23,17,2278,4024,2445,-1579
2019,12,23,18,2343,4073,2430,-1643
2019,12,23,19,2419,4060,2439,-1621
2019,12,23,20,2436,3992,2343,-1649
2019,12,23,21,2387,3947,2360,-1587
2019,12,23,22,2252,3905,2229,-1676
2019,12,23,23,2239,3881,2312,-1569
2019,12,24,0,2323,3913,2400,-1513
2019,12,24,1,2503,4113,2403,-1710
2019,12,24,2,2614,4265,2403,-1862
2019,12,24,3,2594,4165,2298,-1867
2019,12,24,4,2510,4073,2324,-1749
2019,12,24,5,2436,3997,2324,-1673
2019,12,24,6,2284,3831,2262,-1569
2019,12,24,7,2483,3554,2302,-1252
2019,12,24,8,2293,3322,2129,-1193
2019,12,24,9,1954,3169,2028,-1141
2019,12,24,10,1893,3084,2010,-1074
2019,12,24,11,1816,3067,1932,-1135
2019,12,24,12,1776,3135,1963,-1172
2019,12,24,13,1979,3307,2034,-1273
2019,12,24,14,2101,3591,2138,-1453
2019,12,24,15,1883,3876,2229,-1647
2019,12,24,16,2080,4224,2311,-1913
2019,12,24,17,2034,4397,2345,-2052
2019,12,24,18,2130,4480,2304,-2176
2019,12,24,19,2107,4532,2414,-2118
2019,12,24,20,2066,4450,2336,-2114
2019,12,24,21,1976,4379,2322,-2057
2019,12,24,22,1983,4318,2273,-2045
2019,12,24,23,1998,4294,2286,-2008
2019,12,25,0,1924,4325,2366,-1959
2019,12,25,1,2111,4492,2526,-1966
2019,12,25,2,2170,4500,2514,-1986
2019,12,25,3,2152,4365,2470,-1895
2019,12,25,4,1926,4241,2414,-1827
2019,12,25,5,1945,4149,2365,-1784
2019,12,25,6,1910,4066,2378,-1688
2019,12,25,7,2192,3873,2409,-1464
2019,12,25,8,2057,3698,2369,-1329
2019,12,25,9,2050,3465,2201,-1264
2019,12,25,10,2031,3376,2195,-1181
2019,12,25,11,2056,3343,2186,-1157
2019,12,25,12,2041,3356,2164,-1192
2019,12,25,13,2073,3432,2178,-1254
2019,12,25,14,2130,3580,2160,-1420
2019,12,25,15,1954,3793,2184,-1609
2019,12,25,16,2047,3995,2178,-1817
2019,12,25,17,2278,4153,2255,-1898
2019,12,25,18,2295,4217,2121,-2096
2019,12,25,19,2275,4195,2079,-2116
2019,12,25,20,2291,4130,2050,-2080
2019,12,25,21,2252,4050,2099,-1951
2019,12,25,22,2113,3978,2093,-1885
2019,12,25,23,2058,3930,2159,-1771
2019,12,26,0,2054,3946,2151,-1795
2019,12,26,1,2283,4117,2374,-1743
2019,12,26,2,2290,4210,2372,-1838
2019,12,26,3,2191,4209,2376,-1833
2019,12,26,4,2288,4195,2404,-1791
2019,12,26,5,2291,4180,2408,-1772
2019,12,26,6,2291,4077,2302,-1775
2019,12,26,7,2291,3902,2311,-1591
2019,12,26,8,2198,3719,2093,-1626
2019,12,26,9,1990,3605,2135,-1470
2019,12,26,10,1992,3543,2116,-1427
2019,12,26,11,1985,3548,2205,-1343
2019,12,26,12,2013,3615,2241,-1374
2019,12,26,13,2107,3778,2342,-1436
2019,12,26,14,2237,4026,2397,-1629
2019,12,26,15,1973,4309,2430,-1879
2019,12,26,16,2060,4518,2453,-2065
2019,12,26,17,2106,4636,2469,-2167
2019,12,26,18,2113,4699,2460,-2239
2019,12,26,19,2107,4731,2300,-2431
2019,12,26,20,2067,4688,2289,-2399
2019,12,26,21,2022,4616,2291,-2325
2019,12,26,22,1945,4525,2285,-2240
2019,12,26,23,1921,4492,2278,-2214
2019,12,27,0,1967,4525,2291,-2234
2019,12,27,1,2162,4739,2458,-2281
2019,12,27,2,2264,4863,2453,-2410
2019,12,27,3,2264,4789,2457,-2332
2019,12,27,4,2204,4667,2483,-2184
2019,12,27,5,2070,4503,2309,-2194
2019,12,27,6,1870,4279,2285,-1994
2019,12,27,7,2216,3993,2372,-1621
2019,12,27,8,2150,3745,2364,-1381
2019,12,27,9,2349,3554,2247,-1307
2019,12,27,10,2274,3468,2335,-1133
2019,12,27,11,2232,3447,2343,-1104
2019,12,27,12,2220,3490,2295,-1195
2019,12,27,13,2169,3574,2172,-1402
2019,12,27,14,2262,3806,2217,-1589
2019,12,27,15,2345,4070,2219,-1851
2019,12,27,16,2411,4310,2419,-1891
2019,12,27,17,2483,4384,2397,-1987
2019,12,27,18,2541,4440,2372,-2068
2019,12,27,19,2518,4444,2354,-2090
2019,12,27,20,2444,4444,2280,-2164
2019,12,27,21,2367,4397,2275,-2122
2019,12,27,22,2286,4319,2314,-2005
2019,12,27,23,2196,4274,2287,-1987
2019,12,28,0,2281,4303,2273,-2030
2019,12,28,1,2472,4474,2401,-2073
2019,12,28,2,2635,4520,2383,-2137
2019,12,28,3,2554,4428,2345,-2083
2019,12,28,4,2496,4313,2392,-1921
2019,12,28,5,2474,4189,2388,-1801
2019,12,28,6,2239,4016,2253,-1763
2019,12,28,7,2468,3804,2337,-1467
2019,12,28,8,2355,3574,2296,-1278
2019,12,28,9,2191,3389,2162,-1227
2019,12,28,10,2162,3270,2093,-1177
2019,12,28,11,2083,3218,2040,-1178
2019,12,28,12,2073,3218,2032,-1186
2019,12,28,13,2136,3278,2079,-1199
2019,12,28,14,2074,3477,2185,-1292
2019,12,28,15,2000,3617,2212,-1405
2019,12,28,16,2154,3847,2285,-1562
2019,12,28,17,2243,4014,2317,-1697
2019,12,28,18,2442,4083,2475,-1608
2019,12,28,19,2454,4062,2427,-1635
2019,12,28,20,2402,4030,2421,-1609
2019,12,28,21,2351,4001,2397,-1604
2019,12,28,22,2246,3974,2416,-1558
2019,12,28,23,2263,3962,2466,-1496
2019,12,29,0,2322,4034,2507,-1527
2019,12,29,1,2409,4189,2578,-1611
2019,12,29,2,2530,4279,2602,-1677
2019,12,29,3,2461,4210,2608,-1602
2019,12,29,4,2367,4124,2574,-1550
2019,12,29,5,2259,4015,2554,-1461
2019,12,29,6,2124,3862,2430,-1432
2019,12,29,7,2458,3658,2506,-1152
2019,12,29,8,2335,3442,2470,-972
2019,12,29,9,2223,3305,2282,-1023
2019,12,29,10,2162,3137,2243,-894
2019,12,29,11,2128,3116,2270,-846
2019,12,29,12,2103,3116,2155,-961
2019,12,29,13,2097,3169,2165,-1004
2019,12,29,14,2164,3276,2211,-1065
2019,12,29,15,1859,3488,2255,-1233
2019,12,29,16,2006,3663,2333,-1330
2019,12,29,17,2208,3825,2302,-1523
2019,12,29,18,2209,3914,2300,-1614
2019,12,29,19,2252,3924,2318,-1606
2019,12,29,20,2169,3868,2295,-1573
2019,12,29,21,2131,3792,2285,-1507
2019,12,29,22,2089,3739,2307,-1432
2019,12,29,23,2087,3732,2303,-1429
2019,12,30,0,2126,3789,2338,-1451
2019,12,30,1,2354,4014,2417,-1597
2019,12,30,2,2514,4160,2473,-1687
2019,12,30,3,2507,4085,2475,-1610
2019,12,30,4,2432,4018,2515,-1503
2019,12,30,5,2405,3896,2507,-1389
2019,12,30,6,2226,3798,2447,-1351
2019,12,30,7,2529,3551,2425,-1126
2019,12,30,8,2423,3315,2398,-917
2019,12,30,9,2199,3154,2231,-923
2019,12,30,10,2172,3070,2201,-869
2019,12,30,11,2109,3043,2103,-940
2019,12,30,12,2100,3080,2113,-967
2019,12,30,13,2172,3212,2160,-1052
2019,12,30,14,2329,3460,2281,-1179
2019,12,30,15,2040,3768,2422,-1346
2019,12,30,16,2089,3978,2458,-1520
2019,12,30,17,2170,4060,2451,-1609
2019,12,30,18,2240,4118,2456,-1662
2019,12,30,19,2264,4145,2374,-1771
2019,12,30,20,2143,4115,2312,-1803
2019,12,30,21,2110,4093,2338,-1755
2019,12,30,22,2107,4034,2350,-1684
2019,12,30,23,2200,4013,2434,-1579
2019,12,31,0,2233,4055,2481,-1574
2019,12,31,1,2310,4258,2631,-1627
2019,12,31,2,2406,4402,2637,-1765
2019,12,31,3,2367,4348,2639,-1709
2019,12,31,4,2281,4209,2619,-1590
2019,12,31,5,2259,4101,2615,-1486
2019,12,31,6,2205,3939,2583,-1356
2019,12,31,7,2492,3687,2500,-1187
2019,12,31,8,2311,3441,2282,-1159
2019,12,31,9,2300,3282,2225,-1057
2019,12,31,10,2166,3203,2283,-920
2019,12,31,11,2183,3132,2196,-936
2019,12,31,12,2109,3121,2094,-1027
2019,12,31,13,2194,3241,2147,-1094
2019,12,31,14,2344,3421,2200,-1221
2019,12,31,15,2301,3670,2158,-1512
2019,12,31,16,2211,3802,2278,-1524
2019,12,31,17,2208,3914,2306,-1608
2019,12,31,18,2239,3989,2329,-1660
2019,12,31,19,2233,4045,2329,-1716
2019,12,31,20,2186,4071,2237,-1834
2019,12,31,21,2110,4076,2283,-1793
2019,12,31,22,2039,4077,2265,-1812
2019,12,31,23,2012,4055,2273,-1782
2020,1,1,0,2062,4070,2369,-1701
2020,1,1,1,2273,4213,2497,-1716
2020,1,1,2,2407,4264,2531,-1733
2020,1,1,3,2345,4102,2424,-1678
2020,1,1,4,2201,3904,2370,-1534
2020,1,1,5,2058,3706,2331,-1375
2020,1,1,6,1860,3529,2207,-1322
2020,1,1,7,2185,3361,2227,-1134
2020,1,1,8,1967,3169,2070,-1099
2020,1,1,9,1904,2988,2035,-953
2020,1,1,10,1785,2891,1982,-909
2020,1,1,11,1737,2821,1982,-839
2020,1,1,12,1708,2790,1855,-935
2020,1,1,13,1647,2835,1839,-996
2020,1,1,14,1602,2936,1809,-1127
2020,1,1,15,1501,3057,1744,-1313
2020,1,1,16,1503,3167,1756,-1411
2020,1,1,17,1444,3267,1680,-1587
2020,1,1,18,1553,3391,1562,-1829
2020,1,1,19,1708,3504,1611,-1893
2020,1,1,20,1795,3554,1705,-1849
2020,1,1,21,1810,3542,1633,-1909
2020,1,1,22,1789,3491,1552,-1939
2020,1,1,23,1794,3487,1565,-1922
2020,1,2,0,1811,3563,1868,-1695
2020,1,2,1,1950,3867,2106,-1761
2020,1,2,2,2140,4048,2240,-1808
2020,1,2,3,2089,3993,2126,-1867
2020,1,2,4,1958,3901,2115,-1786
2020,1,2,5,1916,3807,2132,-1675
2020,1,2,6,1719,3648,2104,-1544
2020,1,2,7,1947,3449,2081,-1368
2020,1,2,8,1838,3249,2080,-1169
2020,1,2,9,1858,3121,1967,-1154
2020,1,2,10,1903,3051,1946,-1105
2020,1,2,11,1757,3006,1946,-1060
2020,1,2,12,1799,3037,2068,-969
2020,1,2,13,1918,3198,2199,-999
2020,1,2,14,2159,3471,2398,-1073
2020,1,2,15,2178,3765,2513,-1252
2020,1,2,16,2200,3964,2553,-1411
2020,1,2,17,2140,4010,2583,-1427
2020,1,2,18,2069,4067,2524,-1543
2020,1,2,19,2080,4055,2509,-1546
2020,1,2,20,2023,4067,2369,-1698
2020,1,2,21,2000,4084,2346,-1738
2020,1,2,22,1987,4093,2362,-1731
2020,1,2,23,2044,4099,2346,-1753
2020,1,3,0,2130,4157,2305,-1852
2020,1,3,1,2107,4312,2328,-1984
2020,1,3,2,2176,4438,2396,-2042
2020,1,3,3,2175,4378,2340,-2038
2020,1,3,4,2099,4288,2479,-1809
2020,1,3,5,1991,4124,2328,-1796
2020,1,3,6,1927,3896,2342,-1554
2020,1,3,7,2056,3604,2425,-1179
2020,1,3,8,1957,3344,2390,-954
2020,1,3,9,2217,3092,2257,-835
2020,1,3,10,2025,2974,2199,-775
2020,1,3,11,1925,2926,2121,-805
2020,1,3,12,2024,2928,2117,-811
2020,1,3,13,2069,3050,2208,-842
2020,1,3,14,2230,3280,2200,-1080
2020,1,3,15,2038,3487,2134,-1353
2020,1,3,16,2143,3761,2363,-1398
2020,1,3,17,2148,3842,2201,-1641
2020,1,3,18,1969,3850,2214,-1636
2020,1,3,19,1918,3830,2193,-1637
2020,1,3,20,1860,3708,2029,-1679
2020,1,3,21,1851,3687,1920,-1767
2020,1,3,22,1849,3663,1983,-1680
2020,1,3,23,1879,3649,2042,-1607
2020,1,4,0,1923,3705,2054,-1651
2020,1,4,1,1964,3965,2321,-1644
2020,1,4,2,2030,4050,2407,-1643
2020,1,4,3,2046,3943,2386,-1557
2020,1,4,4,2010,3877,2331,-1546
2020,1,4,5,1971,3795,2300,-1495
2020,1,4,6,1849,3660,2305,-1355
2020,1,4,7,2217,3455,2323,-1132
2020,1,4,8,2069,3252,2265,-987
2020,1,4,9,1670,2974,2084,-890
2020,1,4,10,1742,2927,2147,-780
2020,1,4,11,1683,2889,2158,-731
2020,1,4,12,1835,2903,2204,-699
2020,1,4,13,1828,2959,2219,-740
2020,1,4,14,1895,3039,2140,-899
2020,1,4,15,1696,3228,1961,-1267
2020,1,4,16,1686,3488,1886,-1602
2020,1,4,17,1730,3670,1893,-1777
2020,1,4,18,1728,3775,1852,-1923
2020,1,4,19,1783,3759,1795,-1964
2020,1,4,20,1800,3769,1787,-1982
2020,1,4,21,1777,3746,1850,-1896
2020,1,4,22,1709,3797,1883,-1914
2020,1,4,23,1726,3731,1891,-1840
2020,1,5,0,1842,3835,1977,-1858
2020,1,5,1,1849,3990,2098,-1892
2020,1,5,2,1990,4154,2134,-2020
2020,1,5,3,2024,4105,2076,-2029
2020,1,5,4,1997,3966,2028,-1938
2020,1,5,5,2031,3856,2049,-1807
2020,1,5,6,2022,3691,2095,-1596
2020,1,5,7,2046,3467,2276,-1191
2020,1,5,8,2123,3250,2184,-1066
2020,1,5,9,1922,3082,1986,-1096
2020,1,5,10,1923,2944,1906,-1038
2020,1,5,11,1871,2916,1985,-931
2020,1,5,12,1907,2911,1983,-928
2020,1,5,13,1872,2963,1915,-1048
2020,1,5,14,1890,3129,1992,-1137
2020,1,5,15,1722,3305,1953,-1352
2020,1,5,16,1934,3497,2099,-1398
2020,1,5,17,2107,3677,2092,-1585
2020,1,5,18,2140,3841,2194,-1647
2020,1,5,19,2134,3902,2143,-1759
2020,1,5,20,2057,3961,2192,-1769
2020,1,5,21,1993,3826,2008,-1818
2020,1,5,22,1872,3728,2013,-1715
2020,1,5,23,1778,3642,1932,-1710
2020,1,6,0,1774,3720,2166,-1554
2020,1,6,1,2039,3921,2368,-1553
2020,1,6,2,1991,4211,2390,-1821
2020,1,6,3,2090,4181,2359,-1822
2020,1,6,4,2075,4105,2411,-1694
2020,1,6,5,1883,3983,2317,-1666
2020,1,6,6,1814,3739,2277,-1462
2020,1,6,7,1905,3422,2216,-1206
2020,1,6,8,1692,3187,2163,-1024
2020,1,6,9,1662,3045,2127,-918
2020,1,6,10,1653,2970,2001,-969
2020,1,6,11,1633,2961,1850,-1111
2020,1,6,12,1558,2996,1765,-1231
2020,1,6,13,1686,3167,1762,-1405
2020,1,6,14,1799,3517,1920,-1597
2020,1,6,15,1768,3872,1828,-2044
2020,1,6,16,1673,4096,2028,-2068
2020,1,6,17,1695,4101,1945,-2156
2020,1,6,18,1719,4029,1971,-2058
2020,1,6,19,1637,3990,2035,-1955
2020,1,6,20,1640,3909,1984,-1925
2020,1,6,21,1651,3889,1971,-1918
2020,1,6,22,1660,3848,1766,-2082
2020,1,6,23,1667,3805,1722,-2083
2020,1,7,0,1671,3903,1945,-1958
2020,1,7,1,1850,4111,2026,-2085
2020,1,7,2,1887,4276,2153,-2123
2020,1,7,3,1886,4234,2156,-2078
2020,1,7,4,1849,4101,2122,-1979
2020,1,7,5,1840,3951,2083,-1868
2020,1,7,6,1822,3680,1786,-1894
2020,1,7,7,1803,3372,1857,-1515
2020,1,7,8,1512,3098,1789,-1309
2020,1,7,9,1513,2942,1587,-1355
2020,1,7,10,1451,2852,1602,-1250
2020,1,7,11,1398,2862,1623,-1239
2020,1,7,12,1433,2897,1604,-1293
2020,1,7,13,1505,3033,1769,-1264
2020,1,7,14,1605,3302,1800,-1502
2020,1,7,15,1602,3664,1743,-1921
2020,1,7,16,1638,3868,1771,-2097
2020,1,7,17,1616,3853,1764,-2089
2020,1,7,18,1627,3761,1709,-2052
2020,1,7,19,1669,3742,1875,-1867
2020,1,7,20,1714,3694,1900,-1794
2020,1,7,21,1771,3653,2021,-1632
2020,1,7,22,1814,3614,2055,-1559
2020,1,7,23,1871,3640,2154,-1486
2020,1,8,0,1972,3667,2163,-1504
2020,1,8,1,2033,3898,2354,-1544
2020,1,8,2,2087,3948,2360,-1588
2020,1,8,3,2107,3930,2352,-1578
2020,1,8,4,2097,3973,2501,-1472
2020,1,8,5,2051,3871,2321,-1550
2020,1,8,6,1753,3664,2206,-1458
2020,1,8,7,1957,3382,2230,-1152
2020,1,8,8,1688,3116,2014,-1102
2020,1,8,9,1455,2938,1744,-1194
2020,1,8,10,1415,2869,1733,-1136
2020,1,8,11,1540,2852,1709,-1143
2020,1,8,12,1545,2907,1721,-1186
2020,1,8,13,1564,3079,1707,-1372
2020,1,8,14,1771,3410,1789,-1621
2020,1,8,15,1782,3823,1820,-2003
2020,1,8,16,1794,4082,1855,-2227
2020,1,8,17,1788,4137,1992,-2145
2020,1,8,18,1792,4049,1826,-2223
2020,1,8,19,1654,3987,1686,-2301
2020,1,8,20,1654,3927,1787,-2140
2020,1,8,21,1657,3919,1825,-2094
2020,1,8,22,1654,3925,1827,-2098
2020,1,8,23,1678,3938,1843,-2095
2020,1,9,0,1752,4029,1896,-2133
2020,1,9,1,1881,4320,2054,-2266
2020,1,9,2,1860,4493,2108,-2385
2020,1,9,3,1830,4505,2137,-2368
2020,1,9,4,1805,4413,2060,-2353
2020,1,9,5,1772,4291,1965,-2326
2020,1,9,6,1709,4062,1853,-2209
2020,1,9,7,1735,3750,1756,-1994
2020,1,9,8,1641,3507,1642,-1865
2020,1,9,9,1383,3369,1405,-1964
2020,1,9,10,1441,3329,1415,-1914
2020,1,9,11,1438,3326,1460,-1866
2020,1,9,12,1477,3396,1502,-1894
2020,1,9,13,1510,3554,1546,-2008
2020,1,9,14,1651,3891,1691,-2200
2020,1,9,15,1668,4276,1735,-2541
2020,1,9,16,1781,4519,1926,-2593
2020,1,9,17,1996,4505,1976,-2529
2020,1,9,18,1870,4441,2009,-2432
2020,1,9,19,1748,4380,1929,-2451
2020,1,9,20,1662,4321,1790,-2531
2020,1,9,21,1569,4220,1713,-2507
2020,1,9,22,1499,4141,1685,-2456
2020,1,9,23,1539,4110,1677,-2433
2020,1,10,0,1641,4175,1751,-2424
2020,1,10,1,1754,4386,1828,-2558
2020,1,10,2,1782,4622,1804,-2818
2020,1,10,3,1837,4650,1878,-2772
2020,1,10,4,1891,4569,1921,-2648
2020,1,10,5,1892,4435,1938,-2497
2020,1,10,6,1685,4166,1854,-2312
2020,1,10,7,1874,3867,1910,-1957
2020,1,10,8,1679,3541,1791,-1750
2020,1,10,9,1755,3384,1817,-1567
2020,1,10,10,1653,3287,1834,-1453
2020,1,10,11,1735,3289,1856,-1433
2020,1,10,12,1772,3334,1828,-1506
2020,1,10,13,1700,3482,1789,-1693
2020,1,10,14,1847,3804,1846,-1958
2020,1,10,15,1691,4237,1925,-2312
2020,1,10,16,1814,4465,1997,-2468
2020,1,10,17,1787,4472,1932,-2540
2020,1,10,18,1801,4426,1938,-2488
2020,1,10,19,1683,4382,1895,-2487
2020,1,10,20,1578,4324,1866,-2458
2020,1,10,21,1624,4315,1830,-2485
2020,1,10,22,1644,4237,1791,-2446
2020,1,10,23,1632,4147,1782,-2365
2020,1,11,0,1630,4171,1731,-2440
2020,1,11,1,1592,4294,1837,-2457
2020,1,11,2,1676,4393,1804,-2589
2020,1,11,3,1638,4321,1745,-2576
2020,1,11,4,1401,4184,1680,-2504
2020,1,11,5,1305,4040,1663,-2377
2020,1,11,6,1138,3846,1653,-2193
2020,1,11,7,1723,3578,1664,-1914
2020,1,11,8,1500,3322,1591,-1731
2020,1,11,9,1634,3155,1646,-1509
2020,1,11,10,1472,3048,1581,-1467
2020,1,11,11,1371,3002,1538,-1464
2020,1,11,12,1331,2968,1551,-1417
2020,1,11,13,1511,3027,1550,-1477
2020,1,11,14,1502,3164,1588,-1576
2020,1,11,15,1251,3346,1536,-1810
2020,1,11,16,1475,3556,1573,-1983
2020,1,11,17,1631,3753,1593,-2160
2020,1,11,18,1735,3861,1725,-2136
2020,1,11,19,1787,3937,1712,-2225
2020,1,11,20,1786,3929,1740,-2189
2020,1,11,21,1781,3931,1703,-2228
2020,1,11,22,1776,3914,1767,-2147
2020,1,11,23,1743,3891,1807,-2084
2020,1,12,0,1785,3934,1884,-2050
2020,1,12,1,1772,4114,2124,-1990
2020,1,12,2,1928,4211,2187,-2024
2020,1,12,3,1945,4141,2093,-2048
2020,1,12,4,2012,4043,2125,-1918
2020,1,12,5,1891,3933,2088,-1845
2020,1,12,6,1728,3789,2102,-1687
2020,1,12,7,1975,3569,2132,-1437
2020,1,12,8,1869,3371,2081,-1290
2020,1,12,9,1830,3190,1945,-1245
2020,1,12,10,1798,3107,1859,-1248
2020,1,12,11,1764,3060,1793,-1267
2020,1,12,12,1658,3066,1800,-1266
2020,1,12,13,1759,3165,1940,-1225
2020,1,12,14,1837,3304,2048,-1256
2020,1,12,15,1607,3523,2086,-1437
2020,1,12,16,1660,3731,2145,-1586
2020,1,12,17,1835,3914,2067,-1847
2020,1,12,18,1933,4011,2269,-1742
2020,1,12,19,1950,4048,2237,-1811
2020,1,12,20,1927,4019,2273,-1746
2020,1,12,21,1985,4032,2266,-1766
2020,1,12,22,1987,4015,2326,-1689
2020,1,12,23,1858,4092,2351,-1741
2020,1,13,0,1894,4015,2158,-1857
2020,1,13,1,2168,4160,2244,-1916
2020,1,13,2,2186,4376,2528,-1848
2020,1,13,3,2166,4390,2479,-1911
2020,1,13,4,2069,4422,2480,-1942
2020,1,13,5,1992,4314,2453,-1861
2020,1,13,6,1911,4103,2437,-1666
2020,1,13,7,2108,3819,2447,-1372
2020,1,13,8,1901,3578,2298,-1280
2020,1,13,9,1637,3431,2165,-1266
2020,1,13,10,1656,3366,2141,-1225
2020,1,13,11,1627,3388,2081,-1307
2020,1,13,12,1694,3465,2082,-1383
2020,1,13,13,1835,3649,2237,-1412
2020,1,13,14,2102,3949,2316,-1633
2020,1,13,15,1525,4238,2182,-2056
2020,1,13,16,1695,4592,2178,-2414
2020,1,13,17,1712,4658,2117,-2541
2020,1,13,18,1667,4687,2130,-2557
2020,1,13,19,1655,4689,2165,-2524
2020,1,13,20,1640,4655,2146,-2509
2020,1,13,21,1647,4627,2153,-2474
2020,1,13,22,1635,4564,2141,-2423
2020,1,13,23,1674,4535,2151,-2384
2020,1,14,0,1787,4581,2138,-2443
2020,1,14,1,1924,4754,2202,-2552
2020,1,14,2,2045,4972,2243,-2729
2020,1,14,3,2021,4897,2235,-2662
2020,1,14,4,1952,4778,2284,-2494
2020,1,14,5,1855,4613,2296,-2317
2020,1,14,6,1644,4364,2292,-2072
2020,1,14,7,2107,4064,2362,-1702
2020,1,14,8,1932,3813,2282,-1531
2020,1,14,9,2182,3599,2261,-1338
2020,1,14,10,2020,3547,2026,-1521
2020,1,14,11,2018,3554,2014,-1540
2020,1,14,12,2065,3632,2122,-1510
2020,1,14,13,2238,3856,2235,-1621
2020,1,14,14,2384,3979,2264,-1715
2020,1,14,15,2056,4261,2286,-1975
2020,1,14,16,2201,4489,2358,-2131
2020,1,14,17,2140,4573,2234,-2339
2020,1,14,18,2133,4598,2248,-2350
2020,1,14,19,2184,4617,2222,-2395
2020,1,14,20,2091,4730,2267,-2463
2020,1,14,21,1992,4747,2383,-2364
2020,1,14,22,1908,4673,2461,-2212
2020,1,14,23,1928,4599,2486,-2113
2020,1,15,0,1922,4624,2565,-2059
2020,1,15,1,2071,4797,2611,-2186
2020,1,15,2,2116,5081,2560,-2521
2020,1,15,3,2224,5030,2513,-2517
2020,1,15,4,2224,4886,2522,-2364
2020,1,15,5,2102,4704,2489,-2215
2020,1,15,6,2082,4452,2447,-2005
2020,1,15,7,2223,4137,2446,-1691
2020,1,15,8,2137,3865,2404,-1461
2020,1,15,9,2299,3722,2362,-1360
2020,1,15,10,2213,3519,2053,-1466
2020,1,15,11,2161,3507,1999,-1508
2020,1,15,12,2220,3562,2009,-1553
2020,1,15,13,2181,3752,2097,-1655
2020,1,15,14,2262,4123,2504,-1619
2020,1,15,15,2204,4479,2474,-2005
2020,1,15,16,2289,4706,2507,-2199
2020,1,15,17,2273,4744,2441,-2303
2020,1,15,18,2281,4751,2455,-2296
2020,1,15,19,2142,4761,2418,-2343
2020,1,15,20,2184,4738,2366,-2372
2020,1,15,21,2195,4738,2425,-2313
2020,1,15,22,2133,4716,2370,-2346
2020,1,15,23,2115,4727,2401,-2326
2020,1,16,0,2155,4733,2445,-2288
2020,1,16,1,2264,4811,2529,-2282
2020,1,16,2,2298,4935,2561,-2374
2020,1,16,3,2257,4847,2545,-2302
2020,1,16,4,2196,4710,2461,-2249
2020,1,16,5,2284,4514,2429,-2085
2020,1,16,6,2088,4233,2309,-1924
2020,1,16,7,2182,3923,2197,-1726
2020,1,16,8,2198,3627,2133,-1494
2020,1,16,9,1800,3453,2119,-1334
2020,1,16,10,1788,3364,2101,-1263
2020,1,16,11,1855,3378,2159,-1219
2020,1,16,12,1920,3422,2188,-1234
2020,1,16,13,2116,3578,2248,-1330
2020,1,16,14,2204,3855,2333,-1522
2020,1,16,15,2203,4222,2333,-1889
2020,1,16,16,2203,4490,2443,-2047
2020,1,16,17,2245,4494,2429,-2065
2020,1,16,18,2197,4419,2397,-2022
2020,1,16,19,2112,4317,2351,-1966
2020,1,16,20,2085,4197,2365,-1832
2020,1,16,21,2072,4047,2249,-1798
2020,1,16,22,2068,3975,2209,-1766
2020,1,16,23,2066,3922,2215,-1707
2020,1,17,0,2070,3984,2288,-1696
2020,1,17,1,2241,4254,2549,-1705
2020,1,17,2,2465,4556,2666,-1890
2020,1,17,3,2449,4537,2671,-1866
2020,1,17,4,2426,4499,2648,-1851
2020,1,17,5,2343,4409,2665,-1744
2020,1,17,6,2268,4182,2576,-1606
2020,1,17,7,2371,3910,2556,-1354
2020,1,17,8,2293,3637,2334,-1303
2020,1,17,9,2056,3475,2164,-1311
2020,1,17,10,1891,3492,2463,-1029
2020,1,17,11,1955,3505,2552,-953
2020,1,17,12,2047,3505,2463,-1042
2020,1,17,13,2119,3747,2620,-1127
2020,1,17,14,2510,4051,2689,-1362
2020,1,17,15,2365,4428,2626,-1802
2020,1,17,16,2362,4663,2585,-2078
2020,1,17,17,2379,4708,2452,-2256
2020,1,17,18,2342,4650,2511,-2139
2020,1,17,19,2298,4570,2465,-2105
2020,1,17,20,2244,4467,2426,-2041
2020,1,17,21,2205,4396,2349,-2047
2020,1,17,22,2121,4310,2389,-1921
2020,1,17,23,2114,4245,2385,-1860
2020,1,18,0,2163,4300,2419,-1881
2020,1,18,1,2253,4407,2498,-1909
2020,1,18,2,2428,4569,2539,-2030
2020,1,18,3,2387,4508,2556,-1952
2020,1,18,4,2262,4358,2528,-1830
2020,1,18,5,2280,4230,2521,-1709
2020,1,18,6,2171,4019,2419,-1600
2020,1,18,7,2196,3761,2392,-1369
2020,1,18,8,2130,3520,2365,-1155
2020,1,18,9,2202,3355,2328,-1027
2020,1,18,10,2179,3274,2343,-931
2020,1,18,11,2119,3246,2336,-910
2020,1,18,12,2092,3250,2299,-951
2020,1,18,13,2123,3314,2297,-1017
2020,1,18,14,2076,3419,2101,-1318
2020,1,18,15,1859,3611,2079,-1532
2020,1,18,16,1984,3801,2039,-1762
2020,1,18,17,2154,4073,2290,-1783
2020,1,18,18,2248,4184,2287,-1897
2020,1,18,19,2232,4187,2303,-1884
2020,1,18,20,2168,4123,2294,-1829
2020,1,18,21,2114,4042,2307,-1735
2020,1,18,22,2038,3932,2273,-1659
2020,1,18,23,1963,3862,2264,-1598
2020,1,19,0,1985,3851,2327,-1524
2020,1,19,1,2117,3951,2351,-1600
2020,1,19,2,2316,4102,2366,-1736
2020,1,19,3,2281,4050,2361,-1689
2020,1,19,4,2152,3937,2346,-1591
2020,1,19,5,2030,3838,2320,-1518
2020,1,19,6,1871,3665,2294,-1371
2020,1,19,7,2279,3485,2348,-1137
2020,1,19,8,2078,3295,2208,-1087
2020,1,19,9,2062,3063,2092,-971
2020,1,19,10,1970,2997,2080,-917
2020,1,19,11,1943,2947,2062,-885
2020,1,19,12,1981,2945,2171,-774
2020,1,19,13,2022,2981,2166,-815
2020,1,19,14,2024,3097,2177,-920
2020,1,19,15,1803,3257,2209,-1048
2020,1,19,16,1843,3464,2202,-1262
2020,1,19,17,1998,3641,2292,-1349
2020,1,19,18,2033,3736,2298,-1438
2020,1,19,19,2044,3759,2257,-1502
2020,1,19,20,2052,3754,2225,-1529
2020,1,19,21,2025,3706,2234,-1472
2020,1,19,22,2079,3664,2259,-1405
2020,1,19,23,2017,3589,2246,-1343
2020,1,20,0,2061,3577,2254,-1323
2020,1,20,1,2124,3700,2431,-1269
2020,1,20,2,2341,3917,2497,-1420
2020,1,20,3,2331,3901,2543,-1358
2020,1,20,4,2255,3842,2544,-1298
2020,1,20,5,2216,3654,2439,-1215
2020,1,20,6,2016,3530,2488,-1042
2020,1,20,7,2171,3273,2483,-790
2020,1,20,8,1974,3126,2545,-581
2020,1,20,9,2060,3008,2306,-702
2020,1,20,10,2073,2924,2242,-682
2020,1,20,11,1992,2905,2262,-643
2020,1,20,12,1995,2933,2171,-762
2020,1,20,13,2134,3065,2134,-931
2020,1,20,14,2127,3285,2204,-1081
2020,1,20,15,1927,3550,2358,-1192
2020,1,20,16,2074,3768,2411,-1357
2020,1,20,17,2097,3874,2417,-1457
2020,1,20,18,2143,3936,2399,-1537
2020,1,20,19,2147,3969,2366,-1603
2020,1,20,20,2135,3931,2339,-1592
2020,1,20,21,2097,3885,2329,-1556
2020,1,20,22,2067,3841,2295,-1546
2020,1,20,23,2005,3823,2304,-1519
2020,1,21,0,2042,3807,2269,-1538
2020,1,21,1,2144,3942,2378,-1564
2020,1,21,2,2338,4141,2387,-1754
2020,1,21,3,2343,4130,2377,-1753
2020,1,21,4,2228,4067,2426,-1641
2020,1,21,5,2097,3884,2373,-1511
2020,1,21,6,1946,3621,2289,-1332
2020,1,21,7,2188,3417,2382,-1035
2020,1,21,8,1944,3093,2322,-771
2020,1,21,9,2117,2913,2288,-625
2020,1,21,10,2040,2783,2262,-521
2020,1,21,11,1977,2779,2282,-497
2020,1,21,12,1990,2926,2365,-561
2020,1,21,13,2029,3079,2262,-817
2020,1,21,14,2137,3408,2338,-1070
2020,1,21,15,1970,3797,2359,-1438
2020,1,21,16,2204,3998,2438,-1560
2020,1,21,17,2175,3984,2424,-1560
2020,1,21,18,2074,3869,2436,-1433
2020,1,21,19,2002,3812,2406,-1406
2020,1,21,20,1904,3808,2355,-1453
2020,1,21,21,1951,3807,2365,-1442
2020,1,21,22,1895,3807,2360,-1447
2020,1,21,23,1908,3780,2423,-1357
2020,1,22,0,1918,3867,2373,-1494
2020,1,22,1,1981,4085,2462,-1623
2020,1,22,2,2154,4282,2518,-1764
2020,1,22,3,2148,4274,2473,-1801
2020,1,22,4,2037,4182,2501,-1681
2020,1,22,5,2020,4043,2450,-1593
2020,1,22,6,1986,3813,2340,-1473
2020,1,22,7,2007,3501,2354,-1147
2020,1,22,8,2031,3248,2274,-974
2020,1,22,9,2175,3093,2560,-533
2020,1,22,10,2184,2933,2468,-465
2020,1,22,11,2200,2901,2459,-442
2020,1,22,12,2319,2949,2522,-427
2020,1,22,13,2352,3156,2547,-609
2020,1,22,14,2353,3435,2346,-1089
2020,1,22,15,2248,3843,2399,-1444
2020,1,22,16,2310,4070,2392,-1678
2020,1,22,17,2377,4036,2398,-1638
2020,1,22,18,2351,3958,2305,-1653
2020,1,22,19,2328,3966,2403,-1563
2020,1,22,20,2299,3934,2346,-1588
2020,1,22,21,2135,3916,2234,-1682
2020,1,22,22,2113,3899,2305,-1594
2020,1,22,23,2108,3880,2365,-1515
2020,1,23,0,2176,3933,2486,-1447
2020,1,23,1,2236,4050,2464,-1586
2020,1,23,2,2269,4241,2491,-1750
2020,1,23,3,2251,4225,2486,-1739
2020,1,23,4,2249,4127,2535,-1592
2020,1,23,5,2250,3954,2544,-1410
2020,1,23,6,1974,3725,2460,-1265
2020,1,23,7,2202,3450,2491,-959
2020,1,23,8,2080,3145,2422,-723
2020,1,23,9,1824,2931,2166,-765
2020,1,23,10,1720,2835,2098,-737
2020,1,23,11,1863,2802,2074,-728
2020,1,23,12,1807,2880,2011,-869
2020,1,23,13,1880,2991,2108,-883
2020,1,23,14,1973,3265,2152,-1113
2020,1,23,15,1975,3601,2206,-1395
2020,1,23,16,2043,3805,2179,-1626
2020,1,23,17,2057,3796,2209,-1587
2020,1,23,18,2122,3769,2212,-1557
2020,1,23,19,2090,3762,2333,-1429
2020,1,23,20,2046,3727,2249,-1478
2020,1,23,21,2002,3708,2248,-1460
2020,1,23,22,1955,3708,2272,-1436
2020,1,23,23,1991,3673,2260,-1413
2020,1,24,0,2062,3704,2279,-1425
2020,1,24,1,2010,3832,2343,-1489
2020,1,24,2,2131,3990,2303,-1687
2020,1,24,3,2122,3978,2291,-1687
2020,1,24,4,2012,3900,2299,-1601
2020,1,24,5,2080,3760,2259,-1501
2020,1,24,6,1925,3534,2168,-1366
2020,1,24,7,1977,3267,2192,-1075
2020,1,24,8,1870,2958,1988,-970
2020,1,24,9,1758,2770,1709,-1061
2020,1,24,10,1561,2681,1741,-940
2020,1,24,11,1520,2653,1714,-939
2020,1,24,12,1549,2666,1715,-951
2020,1,24,13,1638,2794,1729,-1065
2020,1,24,14,1697,3165,1865,-1300
2020,1,24,15,1751,3534,1967,-1567
2020,1,24,16,1809,3764,2089,-1675
2020,1,24,17,1785,3761,2098,-1663
2020,1,24,18,1785,3741,2062,-1679
2020,1,24,19,1704,3723,2002,-1721
2020,1,24,20,1616,3673,1758,-1915
2020,1,24,21,1574,3612,1722,-1890
2020,1,24,22,1558,3595,1705,-1890
2020,1,24,23,1570,3577,1679,-1898
2020,1,25,0,1612,3616,1660,-1956
2020,1,25,1,1658,3730,1657,-2073
2020,1,25,2,1854,3914,1683,-2231
2020,1,25,3,1829,3917,1618,-2299
2020,1,25,4,1733,3816,1692,-2124
2020,1,25,5,1634,3676,1908,-1768
2020,1,25,6,1536,3523,1934,-1589
2020,1,25,7,1772,3304,1987,-1317
2020,1,25,8,1608,3093,1973,-1120
2020,1,25,9,1710,2941,1941,-1000
2020,1,25,10,1737,2771,1823,-948
2020,1,25,11,1674,2746,1800,-946
2020,1,25,12,1657,2765,1871,-894
2020,1,25,13,1632,2828,1926,-902
2020,1,25,14,1631,2992,1879,-1113
2020,1,25,15,1406,3150,1694,-1456
2020,1,25,16,1526,3373,1847,-1526
2020,1,25,17,1628,3511,1753,-1758
2020,1,25,18,1676,3586,1720,-1866
2020,1,25,19,1662,3643,1708,-1935
2020,1,25,20,1642,3630,1761,-1869
2020,1,25,21,1627,3625,1771,-1854
2020,1,25,22,1571,3567,1731,-1836
2020,1,25,23,1531,3506,1866,-1640
2020,1,26,0,1590,3515,1885,-1630
2020,1,26,1,1624,3616,1887,-1729
2020,1,26,2,1620,3776,1872,-1904
2020,1,26,3,1620,3775,1868,-1907
2020,1,26,4,1624,3704,1846,-1858
2020,1,26,5,1621,3592,1858,-1734
2020,1,26,6,1467,3413,1825,-1588
2020,1,26,7,1597,3263,1908,-1355
2020,1,26,8,1630,3046,1899,-1147
2020,1,26,9,1671,2858,1845,-1013
2020,1,26,10,1669,2792,1870,-922
2020,1,26,11,1703,2742,1878,-864
2020,1,26,12,1698,2774,1886,-888
2020,1,26,13,1666,2804,1828,-976
2020,1,26,14,1646,2915,1742,-1173
2020,1,26,15,1647,3087,1827,-1260
2020,1,26,16,1666,3270,1815,-1455
2020,1,26,17,1639,3432,1844,-1588
2020,1,26,18,1642,3548,1856,-1692
2020,1,26,19,1676,3541,1718,-1823
2020,1,26,20,1829,3488,1643,-1845
2020,1,26,21,1808,3512,1729,-1783
2020,1,26,22,1793,3455,1716,-1739
2020,1,26,23,1795,3349,1815,-1534
2020,1,27,0,1884,3389,1907,-1482
2020,1,27,1,1954,3653,2115,-1538
2020,1,27,2,2069,3869,2202,-1667
2020,1,27,3,2065,3875,2194,-1681
2020,1,27,4,2023,3800,2195,-1605
2020,1,27,5,1931,3627,2135,-1492
2020,1,27,6,1826,3448,2094,-1354
2020,1,27,7,1966,3247,2167,-1080
2020,1,27,8,1870,3012,2206,-806
2020,1,27,9,1860,2836,2075,-761
2020,1,27,10,1835,2719,2000,-719
2020,1,27,11,1806,2715,1997,-718
2020,1,27,12,1769,2775,2041,-734
2020,1,27,13,1875,3091,2268,-823
2020,1,27,14,1926,3420,2380,-1040
2020,1,27,15,1873,3797,2280,-1517
2020,1,27,16,1846,4027,2379,-1648
2020,1,27,17,1822,4024,2325,-1699
2020,1,27,18,1796,3940,2036,-1904
2020,1,27,19,1777,3867,2197,-1670
2020,1,27,20,1753,3784,2127,-1657
2020,1,27,21,1707,3760,2177,-1583
2020,1,27,22,1691,3771,2122,-1649
2020,1,27,23,1767,3790,2170,-1620
2020,1,28,0,1918,3865,2193,-1672
2020,1,28,1,2004,4021,2329,-1692
2020,1,28,2,2211,4213,2427,-1786
2020,1,28,3,2201,4217,2439,-1778
2020,1,28,4,2096,4091,2322,-1769
2020,1,28,5,1931,3951,2312,-1639
2020,1,28,6,1748,3719,2249,-1470
2020,1,28,7,1962,3429,2225,-1204
2020,1,28,8,1924,3061,2111,-950
2020,1,28,9,1962,3018,2205,-813
2020,1,28,10,1845,2819,2034,-785
2020,1,28,11,1862,2790,2045,-745
2020,1,28,12,1729,2835,2001,-834
2020,1,28,13,1922,2988,2098,-890
2020,1,28,14,1937,3295,2062,-1233
2020,1,28,15,1908,3716,2167,-1549
2020,1,28,16,2011,3932,2119,-1813
2020,1,28,17,2053,3893,2065,-1828
2020,1,28,18,2094,3871,2092,-1779
2020,1,28,19,1995,3814,2100,-1714
2020,1,28,20,1976,3748,2124,-1624
2020,1,28,21,1915,3687,2004,-1683
2020,1,28,22,1889,3638,1988,-1650
2020,1,28,23,1919,3579,1771,-1808
2020,1,29,0,2010,3670,1947,-1723
2020,1,29,1,2031,3833,2268,-1565
2020,1,29,2,2086,4044,2337,-1707
2020,1,29,3,2101,4070,2415,-1655
2020,1,29,4,2121,3978,2379,-1599
2020,1,29,5,2105,3829,2414,-1415
2020,1,29,6,1882,3629,2349,-1280
2020,1,29,7,2066,3339,2277,-1062
2020,1,29,8,1829,3075,2268,-807
2020,1,29,9,2085,2932,2281,-651
2020,1,29,10,2096,2808,2187,-621
2020,1,29,11,2063,2782,2176,-606
2020,1,29,12,1976,2824,2181,-643
2020,1,29,13,2019,2979,2168,-811
2020,1,29,14,2004,3312,2184,-1128
2020,1,29,15,1851,3708,2223,-1485
2020,1,29,16,2028,3929,2251,-1678
2020,1,29,17,2084,3962,2244,-1718
2020,1,29,18,2043,3931,2303,-1628
2020,1,29,19,1991,3919,2348,-1571
2020,1,29,20,2069,3908,2385,-1523
2020,1,29,21,2045,3889,2322,-1567
2020,1,29,22,1996,3851,2230,-1621
2020,1,29,23,1876,3732,2181,-1551
2020,1,30,0,1893,3682,2131,-1551
2020,1,30,1,1906,3759,2289,-1470
2020,1,30,2,1937,3946,2320,-1626
2020,1,30,3,1924,3955,2299,-1656
2020,1,30,4,1920,3929,2314,-1615
2020,1,30,5,1873,3824,2230,-1594
2020,1,30,6,1858,3593,2111,-1482
2020,1,30,7,2109,3331,2207,-1124
2020,1,30,8,1936,3073,2160,-913
2020,1,30,9,2021,2951,2057,-894
2020,1,30,10,2015,2895,2023,-872
2020,1,30,11,1952,2881,2003,-878
2020,1,30,12,2035,2931,2086,-845
2020,1,30,13,2136,3178,2208,-970
2020,1,30,14,2035,3510,2202,-1308
2020,1,30,15,1921,3929,2324,-1605
2020,1,30,16,2081,4154,2313,-1841
2020,1,30,17,1972,4126,2300,-1826
2020,1,30,18,2048,4054,2297,-1757
2020,1,30,19,1980,3929,2221,-1708
2020,1,30,20,1919,3865,2140,-1725
2020,1,30,21,1749,3812,2068,-1744
2020,1,30,22,1698,3775,2026,-1749
2020,1,30,23,1686,3808,2106,-1702
2020,1,31,0,1732,3862,2233,-1629
2020,1,31,1,1760,3999,2303,-1696
2020,1,31,2,1920,4192,2324,-1868
2020,1,31,3,1999,4176,2323,-1853
2020,1,31,4,1946,4097,2361,-1736
2020,1,31,5,1843,3948,2283,-1665
2020,1,31,6,1749,3697,2285,-1412
2020,1,31,7,1903,3400,2290,-1110
2020,1,31,8,1877,3135,2332,-803
2020,1,31,9,1866,2956,2201,-755
2020,1,31,10,1953,2804,2163,-641
2020,1,31,11,1752,2746,1902,-844
2020,1,31,12,1801,2756,1818,-938
2020,1,31,13,1770,2880,1745,-1135
2020,1,31,14,1794,3162,1850,-1312
2020,1,31,15,1778,3506,1856,-1650
2020,1,31,16,1770,3722,1881,-1841
2020,1,31,17,1805,3708,1902,-1806
2020,1,31,18,1809,3703,1936,-1767
2020,1,31,19,1813,3683,1922,-1761
2020,1,31,20,1731,3659,1810,-1849
2020,1,31,21,1740,3568,1643,-1925
2020,1,31,22,1647,3516,1603,-1913
2020,1,31,23,1603,3496,1757,-1739
2020,2,1,0,1683,3511,1993,-1518
2020,2,1,1,1799,3613,2091,-1522
2020,2,1,2,1908,3763,2122,-1641
2020,2,1,3,1933,3694,2077,-1617
2020,2,1,4,1837,3539,2029,-1510
2020,2,1,5,1755,3419,1994,-1425
2020,2,1,6,1563,3257,1812,-1445
2020,2,1,7,1847,3060,2078,-982
2020,2,1,8,1616,2882,1991,-891
2020,2,1,9,1578,2694,1993,-701
2020,2,1,10,1422,2606,1901,-705
2020,2,1,11,1524,2566,1814,-752
2020,2,1,12,1482,2569,1717,-852
2020,2,1,13,1440,2634,1782,-852
2020,2,1,14,1578,2780,1864,-916
2020,2,1,15,1392,2947,1774,-1173
2020,2,1,16,1475,3160,1866,-1294
2020,2,1,17,1546,3333,1836,-1497
2020,2,1,18,1690,3499,1908,-1591
2020,2,1,19,1776,3589,2024,-1565
2020,2,1,20,1831,3643,2037,-1606
2020,2,1,21,1834,3585,1650,-1935
2020,2,1,22,1818,3552,1734,-1818
2020,2,1,23,1776,3548,1732,-1816
2020,2,2,0,1808,3587,1852,-1735
2020,2,2,1,1794,3711,1913,-1798
2020,2,2,2,1987,3896,1916,-1980
2020,2,2,3,1946,3962,1947,-2015
2020,2,2,4,1883,3911,1987,-1924
2020,2,2,5,1852,3831,1995,-1836
2020,2,2,6,1856,3707,1964,-1743
2020,2,2,7,2010,3498,1980,-1518
2020,2,2,8,1994,3320,2016,-1304
2020,2,2,9,1688,3171,1866,-1305
2020,2,2,10,1788,3134,1944,-1190
2020,2,2,11,1623,3131,1928,-1203
2020,2,2,12,1703,3160,1926,-1234
2020,2,2,13,1783,3255,2020,-1235
2020,2,2,14,1979,3439,2259,-1180
2020,2,2,15,1780,3651,2163,-1488
2020,2,2,16,2005,3867,2051,-1816
2020,2,2,17,2151,4077,2100,-1977
2020,2,2,18,2084,4143,2126,-2017
2020,2,2,19,2066,4089,2058,-2031
2020,2,2,20,2014,4002,1938,-2064
2020,2,2,21,1980,3921,1987,-1934
2020,2,2,22,1933,3859,1897,-1962
2020,2,2,23,1981,3786,2037,-1749
2020,2,3,0,2042,3768,2141,-1627
2020,2,3,1,2011,3797,2188,-1609
2020,2,3,2,2129,4020,2345,-1675
2020,2,3,3,2176,4110,2361,-1749
2020,2,3,4,2129,4152,2397,-1755
2020,2,3,5,2158,4193,2407,-1786
2020,2,3,6,2112,3979,2350,-1629
2020,2,3,7,2103,3643,2394,-1249
2020,2,3,8,2014,3368,2313,-1055
2020,2,3,9,2199,3233,2462,-771
2020,2,3,10,2181,3180,2422,-758
2020,2,3,11,2241,3166,2358,-808
2020,2,3,12,2380,3233,2416,-817
2020,2,3,13,2115,3414,2491,-923
2020,2,3,14,2344,3743,2625,-1118
2020,2,3,15,2254,4177,2547,-1630
2020,2,3,16,2404,4482,2702,-1780
2020,2,3,17,2405,4465,2718,-1747
2020,2,3,18,2341,4367,2571,-1796
2020,2,3,19,2408,4265,2591,-1674
2020,2,3,20,2345,4188,2456,-1732
2020,2,3,21,2370,4147,2601,-1546
2020,2,3,22,2363,4051,2562,-1489
2020,2,3,23,2199,3998,2557,-1441
2020,2,4,0,2365,4021,2539,-1482
2020,2,4,1,2218,4178,2500,-1678
2020,2,4,2,2400,4479,2776,-1703
2020,2,4,3,2385,4588,2706,-1882
2020,2,4,4,2332,4557,2657,-1900
2020,2,4,5,2328,4397,2604,-1793
2020,2,4,6,2315,4151,2605,-1546
2020,2,4,7,2313,3829,2571,-1258
2020,2,4,8,2210,3583,2521,-1062
2020,2,4,9,2097,3456,2497,-959
2020,2,4,10,2177,3409,2460,-949
2020,2,4,11,2128,3428,2482,-946
2020,2,4,12,2089,3504,2502,-1002
2020,2,4,13,2317,3699,2601,-1098
2020,2,4,14,2518,4020,2683,-1337
2020,2,4,15,2299,4425,2727,-1698
2020,2,4,16,2539,4638,2818,-1820
2020,2,4,17,2535,4587,2794,-1793
2020,2,4,18,2369,4544,2655,-1889
2020,2,4,19,2364,4522,2780,-1742
2020,2,4,20,2283,4507,2715,-1792
2020,2,4,21,2158,4516,2625,-1891
2020,2,4,22,2067,4505,2486,-2019
2020,2,4,23,2104,4495,2309,-2186
2020,2,5,0,2102,4509,2557,-1952
2020,2,5,1,2155,4600,2627,-1973
2020,2,5,2,2182,4764,2687,-2077
2020,2,5,3,2235,4721,2677,-2044
2020,2,5,4,2224,4597,2686,-1911
2020,2,5,5,2129,4287,2533,-1754
2020,2,5,6,1914,4084,2467,-1617
2020,2,5,7,1930,3755,2254,-1501
2020,2,5,8,1795,3489,1925,-1564
2020,2,5,9,1704,3344,1929,-1415
2020,2,5,10,1591,3245,1815,-1430
2020,2,5,11,1542,3238,1871,-1367
2020,2,5,12,1596,3301,1901,-1400
2020,2,5,13,1541,3445,1900,-1545
2020,2,5,14,1646,3736,2042,-1694
2020,2,5,15,1649,4097,2092,-2005
2020,2,5,16,1642,4271,2086,-2185
2020,2,5,17,1682,4243,2126,-2117
2020,2,5,18,1669,4182,2138,-2044
2020,2,5,19,1633,4144,2073,-2071
2020,2,5,20,1625,4144,1908,-2236
2020,2,5,21,1631,4113,1973,-2140
2020,2,5,22,1610,4082,1846,-2236
2020,2,5,23,1565,4053,1937,-2116
2020,2,6,0,1600,4042,2042,-2000
2020,2,6,1,1714,4131,2165,-1966
2020,2,6,2,1757,4269,2150,-2119
2020,2,6,3,1753,4264,1997,-2267
2020,2,6,4,1665,4167,1998,-2169
2020,2,6,5,1780,4020,2099,-1921
2020,2,6,6,1582,3772,1820,-1952
2020,2,6,7,1776,3466,1801,-1665
2020,2,6,8,1505,3203,1790,-1413
2020,2,6,9,1513,3040,1822,-1218
2020,2,6,10,1413,2934,1797,-1137
2020,2,6,11,1296,2905,1712,-1193
2020,2,6,12,1351,2906,1718,-1188
2020,2,6,13,1467,3062,1901,-1161
2020,2,6,14,1872,3364,2091,-1273
2020,2,6,15,1940,3725,2048,-1677
2020,2,6,16,1950,3942,2090,-1852
2020,2,6,17,1963,3927,2152,-1775
2020,2,6,18,1950,3810,1995,-1815
2020,2,6,19,1998,3881,2012,-1869
2020,2,6,20,2012,3891,2058,-1833
2020,2,6,21,1989,3914,2061,-1853
2020,2,6,22,1940,3884,1989,-1895
2020,2,6,23,1920,3871,2026,-1845
2020,2,7,0,1956,3907,2006,-1901
2020,2,7,1,1934,3987,2010,-1977
2020,2,7,2,2042,4141,2175,-1966
2020,2,7,3,2098,4149,2180,-1969
2020,2,7,4,2087,4085,2113,-1972
2020,2,7,5,1947,3939,2093,-1846
2020,2,7,6,1720,3713,2086,-1627
2020,2,7,7,1831,3407,2090,-1317
2020,2,7,8,1583,3145,1962,-1183
2020,2,7,9,1261,2960,1398,-1562
2020,2,7,10,1285,2892,1442,-1450
2020,2,7,11,1258,2861,1419,-1442
2020,2,7,12,1314,2910,1398,-1512
2020,2,7,13,1296,3102,1531,-1571
2020,2,7,14,1361,3391,1556,-1835
2020,2,7,15,1300,3730,1435,-2295
2020,2,7,16,1369,3967,1314,-2653
2020,2,7,17,1338,3975,1334,-2641
2020,2,7,18,1506,3971,1302,-2669
2020,2,7,19,1445,3950,1336,-2614
2020,2,7,20,1399,3887,1314,-2573
2020,2,7,21,1336,3831,1296,-2535
2020,2,7,22,1302,3746,1260,-2486
2020,2,7,23,1254,3714,1246,-2468
2020,2,8,0,1226,3740,1284,-2456
2020,2,8,1,1246,3851,1407,-2444
2020,2,8,2,1261,4039,1439,-2600
2020,2,8,3,1291,4009,1471,-2538
2020,2,8,4,1316,3905,1503,-2402
2020,2,8,5,1346,3753,1411,-2342
2020,2,8,6,1213,3607,1579,-2028
2020,2,8,7,1348,3393,1554,-1839
2020,2,8,8,1334,3193,1512,-1681
2020,2,8,9,1163,3047,1431,-1616
2020,2,8,10,1088,2950,1392,-1558
2020,2,8,11,1115,2906,1323,-1583
2020,2,8,12,1081,2876,1228,-1648
2020,2,8,13,1091,2940,1343,-1597
2020,2,8,14,1282,3089,1378,-1711
2020,2,8,15,1046,3293,1382,-1911
2020,2,8,16,1185,3486,1413,-2073
2020,2,8,17,1219,3638,1309,-2329
2020,2,8,18,1252,3733,1178,-2555
2020,2,8,19,1231,3746,1304,-2442
2020,2,8,20,1212,3721,1286,-2435
2020,2,8,21,1236,3676,1232,-2444
2020,2,8,22,1221,3607,1165,-2442
2020,2,8,23,1211,3547,1336,-2211
2020,2,9,0,1312,3536,1398,-2138
2020,2,9,1,1262,3700,1556,-2144
2020,2,9,2,1514,3949,1704,-2245
2020,2,9,3,1593,4025,1716,-2309
2020,2,9,4,1547,3948,1719,-2229
2020,2,9,5,1428,3868,1741,-2127
2020,2,9,6,1295,3734,1751,-1983
2020,2,9,7,1677,3535,1778,-1757
2020,2,9,8,1504,3344,1713,-1631
2020,2,9,9,1448,3209,1674,-1535
2020,2,9,10,1440,3144,1688,-1456
2020,2,9,11,1418,3152,1704,-1448
2020,2,9,12,1558,3173,1643,-1530
2020,2,9,13,1483,3260,1735,-1525
2020,2,9,14,1580,3428,1984,-1444
2020,2,9,15,1624,3651,2046,-1605
2020,2,9,16,1805,3869,2167,-1702
2020,2,9,17,1942,4067,2241,-1826
2020,2,9,18,1940,4106,2070,-2036
2020,2,9,19,1874,4029,2058,-1971
2020,2,9,20,1789,3873,2075,-1798
2020,2,9,21,1820,3787,2026,-1761
2020,2,9,22,1653,3653,1988,-1665
2020,2,9,23,1723,3531,2012,-1519
2020,2,10,0,1684,3510,2011,-1499
2020,2,10,1,1727,3630,2246,-1384
2020,2,10,2,1901,3954,2444,-1510
2020,2,10,3,1887,4170,2535,-1635
2020,2,10,4,1973,4190,2488,-1702
2020,2,10,5,1911,4088,2358,-1730
2020,2,10,6,1702,3901,2259,-1642
2020,2,10,7,1750,3612,2181,-1431
2020,2,10,8,1535,3374,2058,-1316
2020,2,10,9,1663,3232,2058,-1174
2020,2,10,10,1638,3161,2008,-1153
2020,2,10,11,1643,3158,2055,-1103
2020,2,10,12,1733,3247,2067,-1180
2020,2,10,13,1777,3444,2111,-1333
2020,2,10,14,1954,3775,2203,-1572
2020,2,10,15,1959,4189,2258,-1931
2020,2,10,16,2021,4385,2318,-2067
2020,2,10,17,1983,4357,2315,-2042
2020,2,10,18,1959,4240,2302,-1938
2020,2,10,19,2115,4118,2222,-1896
2020,2,10,20,2030,3991,2016,-1975
2020,2,10,21,1950,3892,1928,-1964
2020,2,10,22,1883,3810,2144,-1666
2020,2,10,23,1841,3742,2114,-1628
2020,2,11,0,1851,3742,2061,-1681
2020,2,11,1,1967,3837,2172,-1665
2020,2,11,2,2233,4103,2220,-1883
2020,2,11,3,2247,4278,2202,-2076
2020,2,11,4,2179,4245,2200,-2045
2020,2,11,5,2161,4138,2248,-1890
2020,2,11,6,2105,3871,2174,-1697
2020,2,11,7,2000,3602,2295,-1307
2020,2,11,8,1963,3382,2226,-1156
2020,2,11,9,1714,3230,2021,-1209
2020,2,11,10,1767,3181,2017,-1164
2020,2,11,11,1784,3194,2032,-1162
2020,2,11,12,1717,3293,2033,-1260
2020,2,11,13,1783,3471,2076,-1395
2020,2,11,14,1817,3808,2076,-1732
2020,2,11,15,1811,4201,2031,-2170
2020,2,11,16,1905,4425,2148,-2277
2020,2,11,17,1879,4371,2064,-2307
2020,2,11,18,1829,4301,2097,-2204
2020,2,11,19,1817,4218,1905,-2313
2020,2,11,20,1820,4141,1844,-2297
2020,2,11,21,1758,4056,1652,-2404
2020,2,11,22,1739,3946,1693,-2253
2020,2,11,23,1740,3822,1536,-2286
2020,2,12,0,1686,3951,1833,-2118
2020,2,12,1,1770,4055,2003,-2052
2020,2,12,2,1738,4245,2058,-2187
2020,2,12,3,1702,4301,2072,-2229
2020,2,12,4,1692,4207,2022,-2185
2020,2,12,5,1668,4064,1990,-2074
2020,2,12,6,1646,3799,1778,-2021
2020,2,12,7,1598,3476,1701,-1775
2020,2,12,8,1421,3207,1533,-1674
2020,2,12,9,1249,3000,1514,-1486
2020,2,12,10,1249,2916,1469,-1447
2020,2,12,11,1248,2875,1490,-1385
2020,2,12,12,1289,2941,1611,-1330
2020,2,12,13,1388,3164,1645,-1519
2020,2,12,14,1720,3440,2003,-1437
2020,2,12,15,1720,3764,1835,-1929
2020,2,12,16,1868,4042,2004,-2038
2020,2,12,17,1875,4063,2193,-1870
2020,2,12,18,1848,3965,2179,-1786
2020,2,12,19,1730,3907,2097,-1810
2020,2,12,20,1703,3775,2000,-1775
2020,2,12,21,1719,3713,2035,-1678
2020,2,12,22,1682,3681,1991,-1690
2020,2,12,23,1670,3678,1989,-1689
2020,2,13,0,1719,3724,2003,-1721
2020,2,13,1,1752,3843,2082,-1761
2020,2,13,2,1844,4078,2185,-1893
2020,2,13,3,1911,4162,2225,-1937
2020,2,13,4,1936,4069,2216,-1853
2020,2,13,5,1851,3920,2196,-1724
2020,2,13,6,1601,3731,2076,-1655
2020,2,13,7,1556,3461,2065,-1396
2020,2,13,8,1549,3196,1970,-1226
2020,2,13,9,1858,3062,1963,-1099
2020,2,13,10,1825,3012,1932,-1080
2020,2,13,11,1796,3030,1961,-1069
2020,2,13,12,1785,3098,1939,-1159
2020,2,13,13,1931,3303,2080,-1223
2020,2,13,14,1945,3624,2085,-1539
2020,2,13,15,1920,4031,2094,-1937
2020,2,13,16,1924,4239,2173,-2066
2020,2,13,17,1934,4231,2132,-2099
2020,2,13,18,1953,4170,2196,-1974
2020,2,13,19,1969,4135,2178,-1957
2020,2,13,20,1990,4064,2102,-1962
2020,2,13,21,1799,4008,2010,-1998
2020,2,13,22,1691,3954,2130,-1824
2020,2,13,23,1560,3925,2105,-1820
2020,2,14,0,1502,3950,2050,-1900
2020,2,14,1,1521,4036,1957,-2079
2020,2,14,2,1796,4206,2044,-2162
2020,2,14,3,1896,4287,2096,-2191
2020,2,14,4,1732,4216,2024,-2192
2020,2,14,5,1565,4090,1813,-2277
2020,2,14,6,1319,3776,1636,-2140
2020,2,14,7,1392,3601,1715,-1886
2020,2,14,8,1385,3345,1663,-1682
2020,2,14,9,1301,3229,1608,-1621
2020,2,14,10,1240,3149,1645,-1504
2020,2,14,11,1203,3127,1666,-1461
2020,2,14,12,1343,3084,1681,-1403
2020,2,14,13,1454,3271,1589,-1682
2020,2,14,14,1389,3604,1742,-1862
2020,2,14,15,1301,3956,1688,-2268
2020,2,14,16,1501,4176,1739,-2437
2020,2,14,17,1499,4176,1651,-2525
2020,2,14,18,1371,4102,1624,-2478
2020,2,14,19,1338,4007,1618,-2389
2020,2,14,20,1254,3887,1565,-2322
2020,2,14,21,1395,3820,1542,-2278
2020,2,14,22,1237,3701,1513,-2188
2020,2,14,23,1349,3688,1531,-2157
2020,2,15,0,1382,3738,1622,-2116
2020,2,15,1,1300,3794,1494,-2300
2020,2,15,2,1417,4062,1612,-2450
2020,2,15,3,1398,4110,1627,-2483
2020,2,15,4,1423,4006,1639,-2367
2020,2,15,5,1326,3887,1693,-2194
2020,2,15,6,1320,3724,1639,-2085
2020,2,15,7,1386,3506,1639,-1867
2020,2,15,8,1374,3308,1604,-1704
2020,2,15,9,1120,3130,1352,-1778
2020,2,15,10,982,3075,1345,-1730
2020,2,15,11,1071,3013,1326,-1687
2020,2,15,12,1073,3014,1325,-1689
2020,2,15,13,1095,3078,1301,-1777
2020,2,15,14,1140,3245,1371,-1874
2020,2,15,15,968,3416,1316,-2100
2020,2,15,16,1174,3611,1224,-2387
2020,2,15,17,1206,3811,1271,-2540
2020,2,15,18,1276,3928,1310,-2618
2020,2,15,19,1272,3964,1301,-2663
2020,2,15,20,1162,3955,1279,-2676
2020,2,15,21,1176,3900,1305,-2595
2020,2,15,22,1159,3847,1300,-2547
2020,2,15,23,1196,3823,1297,-2526
2020,2,16,0,1203,3836,1295,-2541
2020,2,16,1,1239,3908,1346,-2562
2020,2,16,2,1344,4016,1504,-2512
2020,2,16,3,1381,4023,1606,-2417
2020,2,16,4,1380,3922,1608,-2314
2020,2,16,5,1338,3808,1506,-2302
2020,2,16,6,1183,3652,1508,-2144
2020,2,16,7,1490,3456,1583,-1873
2020,2,16,8,1319,3263,1417,-1846
2020,2,16,9,1001,3134,1342,-1792
2020,2,16,10,1068,3018,1314,-1704
2020,2,16,11,1022,2980,1312,-1668
2020,2,16,12,1037,3000,1428,-1572
2020,2,16,13,1098,3048,1437,-1611
2020,2,16,14,1006,3184,1440,-1744
2020,2,16,15,865,3388,1434,-1954
2020,2,16,16,894,3620,1438,-2182
2020,2,16,17,1091,3737,1332,-2405
2020,2,16,18,1183,3840,1420,-2420
2020,2,16,19,1167,3819,1409,-2410
2020,2,16,20,1122,3649,1289,-2360
2020,2,16,21,1148,3593,1128,-2465
2020,2,16,22,1148,3574,1073,-2501
2020,2,16,23,1014,3550,1111,-2439
2020,2,17,0,1048,3629,1216,-2413
2020,2,17,1,960,3774,1430,-2344
2020,2,17,2,1264,3955,1535,-2420
2020,2,17,3,1328,4057,1519,-2538
2020,2,17,4,1313,4039,1530,-2509
2020,2,17,5,1257,3934,1571,-2363
2020,2,17,6,969,3785,1561,-2224
2020,2,17,7,1214,3549,1607,-1942
2020,2,17,8,1164,3360,1669,-1691
2020,2,17,9,1119,3233,1751,-1482
2020,2,17,10,1181,3182,1736,-1446
2020,2,17,11,1195,3171,1701,-1470
2020,2,17,12,1329,3240,1696,-1544
2020,2,17,13,1289,3398,1716,-1682
2020,2,17,14,1347,3655,1957,-1698
2020,2,17,15,1172,3960,1899,-2061
2020,2,17,16,1565,4184,2042,-2142
2020,2,17,17,1717,4261,1990,-2271
2020,2,17,18,1663,4248,2002,-2246
2020,2,17,19,1649,4149,1911,-2238
2020,2,17,20,1601,4040,1644,-2396
2020,2,17,21,1574,3952,1713,-2239
2020,2,17,22,1528,3851,1624,-2227
2020,2,17,23,1501,3779,1709,-2070
2020,2,18,0,1503,3785,1825,-1960
2020,2,18,1,1417,3872,1888,-1984
2020,2,18,2,1673,4104,2044,-2060
2020,2,18,3,1671,4244,1951,-2293
2020,2,18,4,1678,4191,1932,-2259
2020,2,18,5,1673,4065,1917,-2148
2020,2,18,6,1491,3890,1848,-2042
2020,2,18,7,1698,3600,1813,-1787
2020,2,18,8,1650,3374,1723,-1651
2020,2,18,9,1569,3270,1723,-1547
2020,2,18,10,1565,3282,1750,-1532
2020,2,18,11,1618,3321,1814,-1507
2020,2,18,12,1677,3431,1871,-1560
2020,2,18,13,1884,3632,2003,-1629
2020,2,18,14,2062,3963,2312,-1651
2020,2,18,15,2122,4363,2354,-2009
2020,2,18,16,2102,4578,2392,-2186
2020,2,18,17,2059,4490,2323,-2167
2020,2,18,18,2090,4370,2350,-2020
2020,2,18,19,2035,4181,2405,-1776
2020,2,18,20,2015,4017,2179,-1838
2020,2,18,21,1928,3911,2150,-1761
2020,2,18,22,1851,3810,2121,-1689
2020,2,18,23,1773,3737,2111,-1626
2020,2,19,0,1815,3739,2111,-1628
2020,2,19,1,1749,3856,2183,-1673
2020,2,19,2,2009,4112,2361,-1751
2020,2,19,3,2095,4343,2422,-1921
2020,2,19,4,2060,4321,2443,-1878
2020,2,19,5,1968,4236,2456,-1780
2020,2,19,6,1814,4028,2425,-1603
2020,2,19,7,1966,3769,2448,-1321
2020,2,19,8,1727,3546,2310,-1236
2020,2,19,9,2095,3437,2342,-1095
2020,2,19,10,2102,3404,2369,-1035
2020,2,19,11,2162,3396,2378,-1018
2020,2,19,12,2198,3503,2456,-1047
2020,2,19,13,2224,3695,2466,-1229
2020,2,19,14,2417,4032,2691,-1341
2020,2,19,15,2414,4443,2657,-1786
2020,2,19,16,2516,4633,2642,-1991
2020,2,19,17,2395,4517,2646,-1871
2020,2,19,18,2377,4315,2531,-1784
2020,2,19,19,2275,4057,2490,-1567
2020,2,19,20,2108,3861,2290,-1571
2020,2,19,21,2126,3722,2267,-1455
2020,2,19,22,2072,3610,2200,-1410
2020,2,19,23,2094,3520,2160,-1360
2020,2,20,0,2085,3501,2159,-1342
2020,2,20,1,2151,3598,2313,-1285
2020,2,20,2,2236,3914,2420,-1494
2020,2,20,3,2407,4146,2549,-1597
2020,2,20,4,2456,4131,2496,-1635
2020,2,20,5,2206,4039,2346,-1693
2020,2,20,6,2091,3841,2427,-1414
2020,2,20,7,2212,3579,2391,-1188
2020,2,20,8,2226,3362,2325,-1037
2020,2,20,9,2073,3250,2332,-918
2020,2,20,10,2060,3218,2359,-859
2020,2,20,11,2021,3276,2322,-954
2020,2,20,12,2031,3354,2340,-1014
2020,2,20,13,2114,3574,2398,-1176
2020,2,20,14,2391,3916,2580,-1336
2020,2,20,15,2305,4329,2611,-1718
2020,2,20,16,2345,4512,2583,-1929
2020,2,20,17,2318,4426,2471,-1955
2020,2,20,18,2309,4225,2542,-1683
2020,2,20,19,2199,4021,2385,-1636
2020,2,20,20,2061,3828,2251,-1577
2020,2,20,21,2036,3698,2247,-1451
2020,2,20,22,1935,3581,2209,-1372
2020,2,20,23,1962,3499,2253,-1246
2020,2,21,0,1915,3481,2318,-1163
2020,2,21,1,1989,3566,2324,-1242
2020,2,21,2,2163,3802,2429,-1373
2020,2,21,3,2306,4031,2543,-1488
2020,2,21,4,2300,4033,2536,-1497
2020,2,21,5,2198,3861,2338,-1523
2020,2,21,6,2113,3665,2298,-1367
2020,2,21,7,2116,3407,2247,-1160
2020,2,21,8,2024,3305,2330,-975
2020,2,21,9,2163,3211,2361,-850
2020,2,21,10,2156,3176,2363,-813
2020,2,21,11,2150,3189,2352,-837
2020,2,21,12,2187,3223,2294,-929
2020,2,21,13,2195,3431,2347,-1084
2020,2,21,14,2433,3820,2591,-1229
2020,2,21,15,2418,4236,2651,-1585
2020,2,21,16,2447,4444,2751,-1693
2020,2,21,17,2475,4365,2481,-1884
2020,2,21,18,2279,4151,2415,-1736
2020,2,21,19,2254,3953,2346,-1607
2020,2,21,20,2175,3768,2265,-1503
2020,2,21,21,2028,3627,2236,-1391
2020,2,21,22,1942,3549,2290,-1259
2020,2,21,23,1900,3455,2282,-1173
2020,2,22,0,1901,3449,2288,-1161
2020,2,22,1,1938,3529,2287,-1242
2020,2,22,2,2150,3702,2326,-1376
2020,2,22,3,2255,3879,2385,-1494
2020,2,22,4,2212,3853,2475,-1378
2020,2,22,5,2171,3774,2428,-1346
2020,2,22,6,2178,3628,2450,-1178
2020,2,22,7,2199,3439,2461,-978
2020,2,22,8,2108,3238,2356,-882
2020,2,22,9,2036,3033,2214,-819
2020,2,22,10,2090,2932,2203,-729
2020,2,22,11,1952,2906,2229,-677
2020,2,22,12,1852,2933,2150,-783
2020,2,22,13,1801,3034,2285,-749
2020,2,22,14,2143,3169,2366,-803
2020,2,22,15,1871,3444,2322,-1122
2020,2,22,16,1879,3684,2439,-1245
2020,2,22,17,1933,3857,2447,-1410
2020,2,22,18,1860,3940,2391,-1549
2020,2,22,19,1838,3952,2335,-1617
2020,2,22,20,1822,3893,2276,-1617
2020,2,22,21,1802,3825,2076,-1749
2020,2,22,22,1791,3680,2014,-1666
2020,2,22,23,1755,3572,1941,-1631
2020,2,23,0,1772,3543,2158,-1385
2020,2,23,1,1761,3609,2199,-1410
2020,2,23,2,1957,3791,2248,-1543
2020,2,23,3,2127,3909,2287,-1622
2020,2,23,4,2069,3863,2252,-1611
2020,2,23,5,1979,3765,2225,-1540
2020,2,23,6,1930,3622,2195,-1427
2020,2,23,7,2132,3388,2178,-1210
2020,2,23,8,2061,3169,2169,-1000
2020,2,23,9,1882,2992,1999,-993
2020,2,23,10,1896,2895,1898,-997
2020,2,23,11,1786,2878,1910,-968
2020,2,23,12,1715,2896,1904,-992
2020,2,23,13,1717,2964,1899,-1065
2020,2,23,14,1821,3093,1814,-1279
2020,2,23,15,1304,3334,1852,-1482
2020,2,23,16,1434,3530,1782,-1748
2020,2,23,17,1551,3683,1792,-1891
2020,2,23,18,1597,3793,1791,-2002
2020,2,23,19,1640,3808,1661,-2147
2020,2,23,20,1516,3826,1631,-2195
2020,2,23,21,1488,3842,1658,-2184
2020,2,23,22,1435,3766,1707,-2059
2020,2,23,23,1450,3698,1621,-2077
2020,2,24,0,1421,3697,1570,-2127
2020,2,24,1,1574,3801,1732,-2069
2020,2,24,2,1532,3992,1798,-2194
2020,2,24,3,1661,4176,1914,-2262
2020,2,24,4,1655,4147,1982,-2165
2020,2,24,5,1690,4022,2008,-2014
2020,2,24,6,1485,3825,2017,-1808
2020,2,24,7,1679,3537,1999,-1538
2020,2,24,8,1689,3306,2011,-1295
2020,2,24,9,1564,3175,1851,-1324
2020,2,24,10,1531,3106,1831,-1275
2020,2,24,11,1551,3094,1934,-1160
2020,2,24,12,1554,3111,1965,-1146
2020,2,24,13,1728,3352,2066,-1286
2020,2,24,14,1970,3657,2265,-1392
2020,2,24,15,1809,4074,2343,-1731
2020,2,24,16,2072,4277,2343,-1934
2020,2,24,17,2020,4204,2225,-1979
2020,2,24,18,1849,4103,2203,-1900
2020,2,24,19,1873,4021,2242,-1779
2020,2,24,20,1799,3897,2280,-1617
2020,2,24,21,1830,3809,2004,-1805
2020,2,24,22,1805,3780,1816,-1964
2020,2,24,23,1747,3739,1828,-1911
2020,2,25,0,1892,3741,2015,-1726
2020,2,25,1,1853,3845,2130,-1715
2020,2,25,2,1974,4063,2331,-1732
2020,2,25,3,2154,4250,2339,-1911
2020,2,25,4,2124,4196,2343,-1853
2020,2,25,5,2172,4074,2273,-1801
2020,2,25,6,1933,3846,2183,-1663
2020,2,25,7,1999,3545,2308,-1237
2020,2,25,8,2031,3304,2245,-1059
2020,2,25,9,1892,3180,2167,-1013
2020,2,25,10,1928,3135,2191,-944
2020,2,25,11,1906,3154,2224,-930
2020,2,25,12,2041,3231,2264,-967
2020,2,25,13,2096,3428,2286,-1142
2020,2,25,14,2314,3783,2530,-1253
2020,2,25,15,2270,4215,2547,-1668
2020,2,25,16,2406,4387,2500,-1887
2020,2,25,17,2272,4308,2484,-1824
2020,2,25,18,2120,4169,2439,-1730
2020,2,25,19,2136,4010,2399,-1611
2020,2,25,20,2014,3878,2306,-1572
2020,2,25,21,2012,3827,2265,-1562
2020,2,25,22,1934,3749,2114,-1635
2020,2,25,23,1900,3650,2086,-1564
2020,2,26,0,1911,3683,1986,-1697
2020,2,26,1,2018,3794,2233,-1561
2020,2,26,2,2088,3976,2406,-1570
2020,2,26,3,2269,4103,2477,-1626
2020,2,26,4,2256,4050,2480,-1570
2020,2,26,5,2130,3918,2393,-1525
2020,2,26,6,2000,3694,2295,-1399
2020,2,26,7,2103,3390,2310,-1080
2020,2,26,8,1906,3144,2271,-873
2020,2,26,9,2116,2997,2344,-653
2020,2,26,10,2095,2925,2308,-617
2020,2,26,11,2123,2904,2293,-611
2020,2,26,12,2078,2965,2345,-620
2020,2,26,13,2109,3113,2378,-735
2020,2,26,14,2270,3419,2535,-884
2020,2,26,15,2266,3806,2587,-1219
2020,2,26,16,2276,3998,2694,-1304
2020,2,26,17,2367,3923,2614,-1309
2020,2,26,18,2228,3844,2552,-1292
2020,2,26,19,2122,3789,2489,-1300
2020,2,26,20,2016,3724,2322,-1402
2020,2,26,21,1932,3631,2225,-1406
2020,2,26,22,1888,3406,2204,-1202
2020,2,26,23,1877,3383,2128,-1255
2020,2,27,0,1860,3346,2085,-1261
2020,2,27,1,1921,3522,2308,-1214
2020,2,27,2,1952,3691,2437,-1254
2020,2,27,3,2171,3943,2463,-1480
2020,2,27,4,2110,3897,2418,-1479
2020,2,27,5,2019,3855,2350,-1505
2020,2,27,6,1982,3657,2286,-1371
2020,2,27,7,1959,3383,2394,-989
2020,2,27,8,1894,3117,2242,-875
2020,2,27,9,2081,2992,2242,-750
2020,2,27,10,2002,2927,2250,-677
2020,2,27,11,1980,2900,2243,-657
2020,2,27,12,2047,2962,2262,-700
2020,2,27,13,2017,3193,2392,-801
2020,2,27,14,2232,3517,2556,-961
2020,2,27,15,2176,3934,2571,-1363
2020,2,27,16,2307,4140,2550,-1590
2020,2,27,17,2259,4060,2586,-1474
2020,2,27,18,2139,3890,2456,-1434
2020,2,27,19,2073,3732,2390,-1342
2020,2,27,20,2062,3597,2345,-1252
2020,2,27,21,1984,3495,2317,-1178
2020,2,27,22,1914,3408,2235,-1173
2020,2,27,23,1857,3352,2237,-1115
2020,2,28,0,1857,3352,2189,-1163
2020,2,28,1,1791,3423,2194,-1229
2020,2,28,2,1958,3585,2280,-1305
2020,2,28,3,2204,3816,2329,-1487
2020,2,28,4,2193,3832,2320,-1512
2020,2,28,5,2100,3767,2230,-1537
2020,2,28,6,1953,3569,2139,-1430
2020,2,28,7,1973,3321,2067,-1254
2020,2,28,8,1967,3085,1921,-1164
2020,2,28,9,1785,2956,1898,-1058
2020,2,28,10,1731,2928,1888,-1040
2020,2,28,11,1740,2941,1890,-1051
2020,2,28,12,1812,3040,2094,-946
2020,2,28,13,1922,3251,1991,-1260
2020,2,28,14,2001,3586,2053,-1533
2020,2,28,15,2008,3996,2083,-1913
2020,2,28,16,2055,4168,2095,-2073
2020,2,28,17,1998,4127,2081,-2046
2020,2,28,18,1952,4006,2060,-1946
2020,2,28,19,1843,3903,1940,-1963
2020,2,28,20,1736,3841,1939,-1902
2020,2,28,21,1822,3758,1864,-1894
2020,2,28,22,1725,3630,1922,-1708
2020,2,28,23,1706,3533,1976,-1557
2020,2,29,0,1709,3584,1957,-1627
2020,2,29,1,1677,3756,2076,-1680
2020,2,29,2,1784,3926,2210,-1716
2020,2,29,3,1850,4003,2230,-1773
2020,2,29,4,1685,3923,2174,-1749
2020,2,29,5,1507,3844,1981,-1863
2020,2,29,6,1374,3682,1990,-1692
2020,2,29,7,1640,3467,1980,-1487
2020,2,29,8,1430,3260,1945,-1315
2020,2,29,9,1506,3116,1856,-1260
2020,2,29,10,1419,3033,1917,-1116
2020,2,29,11,1316,2977,1871,-1106
2020,2,29,12,1439,2986,1963,-1023
2020,2,29,13,1504,3037,1986,-1051
2020,2,29,14,1538,3175,1919,-1256
2020,2,29,15,1241,3383,1920,-1463
2020,2,29,16,1555,3579,1967,-1612
2020,2,29,17,1580,3762,1918,-1844
2020,2,29,18,1645,3817,1718,-2099
2020,2,29,19,1655,3783,1654,-2129
2020,2,29,20,1619,3720,1629,-2091
2020,2,29,21,1522,3658,1549,-2109
2020,2,29,22,1440,3490,1444,-2046
2020,2,29,23,1414,3337,1328,-2009
2020,3,1,0,1441,3330,1323,-2007
2020,3,1,1,1518,3493,1582,-1911
2020,3,1,2,1638,3714,1975,-1739
2020,3,1,3,1636,3898,2093,-1805
2020,3,1,4,1601,3853,1930,-1923
2020,3,1,5,1554,3773,1853,-1920
2020,3,1,6,1612,3680,1807,-1873
2020,3,1,7,1602,3465,1741,-1724
2020,3,1,8,1640,3299,1747,-1552
2020,3,1,9,1530,3180,1716,-1464
2020,3,1,10,1577,3154,1798,-1356
2020,3,1,11,1520,3180,1818,-1362
2020,3,1,12,1618,3160,1892,-1268
2020,3,1,13,1703,3250,1907,-1343
2020,3,1,14,1817,3438,2076,-1362
2020,3,1,15,1765,3658,2127,-1531
2020,3,1,16,1958,3860,2137,-1723
2020,3,1,17,2024,4016,2244,-1772
2020,3,1,18,1965,4041,2233,-1808
2020,3,1,19,1965,3945,2244,-1701
2020,3,1,20,1959,3833,2190,-1643
2020,3,1,21,1922,3729,2236,-1493
2020,3,1,22,1820,3674,2188,-1486
2020,3,1,23,1703,3667,2229,-1438
2020,3,2,0,1682,3711,2257,-1454
2020,3,2,1,1758,3823,2328,-1495
2020,3,2,2,1943,4009,2408,-1601
2020,3,2,3,2141,4111,2388,-1723
2020,3,2,4,2133,4059,2389,-1670
2020,3,2,5,1948,3975,2387,-1588
2020,3,2,6,1804,3702,2337,-1365
2020,3,2,7,1902,3384,2309,-1075
2020,3,2,8,1665,3132,2207,-925
2020,3,2,9,1660,2992,2142,-850
2020,3,2,10,1620,2944,2077,-867
2020,3,2,11,1608,2869,2034,-835
2020,3,2,12,1623,2927,2054,-873
2020,3,2,13,1721,3099,2070,-1029
2020,3,2,14,2024,3534,2310,-1224
2020,3,2,15,1897,3941,2236,-1705
2020,3,2,16,2155,4167,2257,-1910
2020,3,2,17,2157,4157,2330,-1827
2020,3,2,18,2051,4122,2322,-1800
2020,3,2,19,1944,4084,2297,-1787
2020,3,2,20,1911,4053,2253,-1800
2020,3,2,21,1781,4026,2098,-1928
2020,3,2,22,1775,4001,2030,-1971
2020,3,2,23,1700,3980,2015,-1965
2020,3,3,0,1646,4010,2046,-1964
2020,3,3,1,1798,4100,2294,-1806
2020,3,3,2,1985,4230,2332,-1898
2020,3,3,3,2069,4297,2336,-1961
2020,3,3,4,2143,4178,2441,-1737
2020,3,3,5,1986,4011,2396,-1615
2020,3,3,6,1726,3692,2141,-1551
2020,3,3,7,1883,3352,2062,-1290
2020,3,3,8,1656,2926,1802,-1124
2020,3,3,9,1661,2653,1726,-927
2020,3,3,10,1564,2562,1792,-770
2020,3,3,11,1596,2535,1817,-718
2020,3,3,12,1628,2560,1811,-749
2020,3,3,13,1620,2721,1913,-808
2020,3,3,14,1600,3080,1951,-1129
2020,3,3,15,1597,3442,1918,-1524
2020,3,3,16,1619,3580,1856,-1724
2020,3,3,17,1686,3549,1912,-1637
2020,3,3,18,1682,3484,1921,-1563
2020,3,3,19,1663,3414,1759,-1655
2020,3,3,20,1753,3372,1723,-1649
2020,3,3,21,1725,3372,1765,-1607
2020,3,3,22,1558,3379,1793,-1586
2020,3,3,23,1579,3376,1841,-1535
2020,3,4,0,1568,3443,1913,-1530
2020,3,4,1,1560,3570,2130,-1440
2020,3,4,2,1775,3735,2140,-1595
2020,3,4,3,1780,3877,2148,-1729
2020,3,4,4,1624,3809,2158,-1651
2020,3,4,5,2065,3685,2149,-1536
2020,3,4,6,1871,3442,2193,-1249
2020,3,4,7,2069,3141,2226,-915
2020,3,4,8,2232,2887,2171,-716
2020,3,4,9,1712,2758,2171,-587
2020,3,4,10,1797,2692,2075,-617
2020,3,4,11,1686,2676,2189,-487
2020,3,4,12,1782,2744,2269,-475
2020,3,4,13,1882,2931,2312,-619
2020,3,4,14,1826,3244,2329,-915
2020,3,4,15,2140,3662,2368,-1294
2020,3,4,16,2125,3824,2241,-1583
2020,3,4,17,2156,3787,2227,-1560
2020,3,4,18,2158,3662,2211,-1451
2020,3,4,19,1941,3527,2244,-1283
2020,3,4,20,2112,3390,2222,-1168
2020,3,4,21,2023,3299,2106,-1193
2020,3,4,22,2024,3187,1980,-1207
2020,3,4,23,1982,3116,1999,-1117
2020,3,5,0,1951,3082,1986,-1096
2020,3,5,1,2033,3175,1991,-1184
2020,3,5,2,2162,3399,2142,-1257
2020,3,5,3,2155,3661,2133,-1528
2020,3,5,4,2157,3659,2150,-1509
2020,3,5,5,2167,3597,2222,-1375
2020,3,5,6,2168,3379,2157,-1222
2020,3,5,7,1820,3094,2227,-867
2020,3,5,8,1805,2834,2053,-781
2020,3,5,9,1812,2702,1960,-742
2020,3,5,10,1795,2667,1924,-743
2020,3,5,11,1768,2693,1942,-751
2020,3,5,12,1788,2765,1897,-868
2020,3,5,13,1946,3030,2118,-912
2020,3,5,14,2006,3359,2277,-1082
2020,3,5,15,2045,3745,2275,-1470
2020,3,5,16,2093,3915,2163,-1752
2020,3,5,17,2042,3845,2102,-1743
2020,3,5,18,1937,3741,2113,-1628
2020,3,5,19,2022,3614,2041,-1573
2020,3,5,20,1845,3511,2050,-1461
2020,3,5,21,1753,3431,2021,-1410
2020,3,5,22,1677,3343,2048,-1295
2020,3,5,23,1647,3313,2089,-1224
2020,3,6,0,1666,3344,2073,-1271
2020,3,6,1,1784,3446,2175,-1271
2020,3,6,2,1896,3608,2264,-1344
2020,3,6,3,2096,3745,2301,-1444
2020,3,6,4,2087,3690,2319,-1371
2020,3,6,5,1963,3559,2249,-1310
2020,3,6,6,1947,3312,2259,-1053
2020,3,6,7,1961,3010,2291,-719
2020,3,6,8,1929,2774,2211,-563
2020,3,6,9,1916,2623,2099,-524
2020,3,6,10,1882,2576,2112,-464
2020,3,6,11,1805,2550,2075,-475
2020,3,6,12,1793,2612,2064,-548
2020,3,6,13,1886,2801,2083,-718
2020,3,6,14,2087,3106,2171,-935
2020,3,6,15,1950,3499,2183,-1316
2020,3,6,16,2094,3726,2167,-1559
2020,3,6,17,2083,3765,2120,-1645
2020,3,6,18,2020,3727,2055,-1672
2020,3,6,19,2037,3705,1994,-1711
2020,3,6,20,2050,3656,2071,-1585
2020,3,6,21,2074,3624,2109,-1515
2020,3,6,22,2041,3614,2145,-1469
2020,3,6,23,2092,3694,2175,-1519
2020,3,7,0,2067,3656,2149,-1507
2020,3,7,1,2160,3778,2198,-1580
2020,3,7,2,2301,3894,2377,-1517
2020,3,7,3,2449,3953,2442,-1511
2020,3,7,4,2437,4000,2477,-1523
2020,3,7,5,2269,3803,2483,-1320
2020,3,7,6,2114,3656,2454,-1202
2020,3,7,7,2426,3467,2596,-871
2020,3,7,8,2269,3185,2400,-785
2020,3,7,9,2110,3067,2286,-781
2020,3,7,10,2061,2974,2274,-700
2020,3,7,11,1995,2912,2258,-654
2020,3,7,12,1942,2930,2239,-691
2020,3,7,13,1973,3033,2293,-740
2020,3,7,14,2183,3231,2365,-866
2020,3,7,15,2021,3440,2265,-1175
2020,3,7,16,2198,3668,2339,-1329
2020,3,7,17,2284,3821,2355,-1466
2020,3,7,18,2297,3881,2434,-1447
2020,3,7,19,2164,3853,2411,-1442
2020,3,7,20,2090,3841,2441,-1400
2020,3,7,21,1997,3833,2388,-1445
2020,3,7,22,1908,3728,2260,-1468
2020,3,7,23,1882,3646,2293,-1353
2020,3,8,0,1906,3635,2338,-1297
2020,3,8,1,1976,3663,2235,-1428
2020,3,8,2,2179,3782,2475,-1307
2020,3,8,3,2345,3963,2475,-1488
2020,3,8,4,2354,3940,2474,-1466
2020,3,8,5,2308,3852,2535,-1317
2020,3,8,6,2227,3743,2578,-1165
2020,3,8,7,2319,3538,2626,-912
2020,3,8,8,2124,3316,2588,-728
2020,3,8,9,2216,3155,2413,-742
2020,3,8,10,2051,3074,2340,-734
2020,3,8,11,2049,3026,2318,-708
2020,3,8,12,2100,3144,2333,-811
2020,3,8,13,2009,3251,2392,-859
2020,3,8,14,2269,3477,2319,-1158
2020,3,8,15,2248,3677,2467,-1210
2020,3,8,16,2286,3847,2379,-1468
2020,3,8,17,2267,3964,2473,-1491
2020,3,8,18,2220,3960,2526,-1434
2020,3,8,19,2167,3945,2562,-1383
2020,3,8,20,2096,3869,2483,-1386
2020,3,8,21,1961,3715,2389,-1326
2020,3,8,22,1909,3559,2341,-1218
2020,3,8,23,1925,3499,2354,-1145
2020,3,9,0,2030,3499,2248,-1251
2020,3,9,1,2144,3625,2308,-1317
2020,3,9,2,2314,3772,2431,-1341
2020,3,9,3,2321,3954,2461,-1493
2020,3,9,4,2251,3952,2428,-1524
2020,3,9,5,2332,3809,2359,-1450
2020,3,9,6,2143,3639,2530,-1109
2020,3,9,7,2016,3361,2394,-967
2020,3,9,8,2078,3196,2296,-900
2020,3,9,9,2025,3155,2168,-987
2020,3,9,10,2049,3193,2209,-984
2020,3,9,11,2084,3314,2247,-1067
2020,3,9,12,2286,3494,2296,-1198
2020,3,9,13,2402,3863,2476,-1387
2020,3,9,14,2380,4294,2584,-1710
2020,3,9,15,2509,4561,2630,-1931
2020,3,9,16,2483,4608,2623,-1985
2020,3,9,17,2424,4411,2463,-1948
2020,3,9,18,2476,4267,2392,-1875
2020,3,9,19,2387,4079,2453,-1626
2020,3,9,20,2274,3974,2470,-1504
2020,3,9,21,2202,3826,2467,-1359
2020,3,9,22,2096,3687,2453,-1234
2020,3,9,23,2043,3615,2464,-1151
2020,3,10,0,2027,3617,2462,-1155
2020,3,10,1,2157,3720,2501,-1219
2020,3,10,2,2241,3828,2574,-1254
2020,3,10,3,2464,3974,2563,-1411
2020,3,10,4,2403,3977,2475,-1502
2020,3,10,5,2204,3790,2341,-1449
2020,3,10,6,2434,3502,2284,-1218
2020,3,10,7,2188,3261,2280,-981
2020,3,10,8,2128,3142,2286,-856
2020,3,10,9,2164,3113,2252,-861
2020,3,10,10,2147,3142,2157,-985
2020,3,10,11,2102,3204,2166,-1038
2020,3,10,12,2207,3368,2178,-1190
2020,3,10,13,2271,3668,2377,-1291
2020,3,10,14,2233,4098,2338,-1760
2020,3,10,15,2384,4361,2466,-1895
2020,3,10,16,2322,4363,2475,-1888
2020,3,10,17,2349,4279,2489,-1790
2020,3,10,18,2383,4159,2447,-1712
2020,3,10,19,2352,4103,2496,-1607
2020,3,10,20,2242,3968,2382,-1586
2020,3,10,21,2212,3878,2438,-1440
2020,3,10,22,2105,3753,2256,-1497
2020,3,10,23,2098,3776,2349,-1427
2020,3,11,0,2123,3827,2315,-1512
2020,3,11,1,2180,3938,2500,-1438
2020,3,11,2,2304,3962,2587,-1375
2020,3,11,3,2413,4064,2655,-1409
2020,3,11,4,2425,3993,2669,-1324
2020,3,11,5,2137,3717,2436,-1281
2020,3,11,6,2160,3380,2313,-1067
2020,3,11,7,2119,3079,2264,-815
2020,3,11,8,2157,2898,2186,-712
2020,3,11,9,2037,2801,2050,-751
2020,3,11,10,1993,2763,1984,-779
2020,3,11,11,2035,2794,1981,-813
2020,3,11,12,2147,2929,2037,-892
2020,3,11,13,2298,3258,2204,-1054
2020,3,11,14,2229,3633,2239,-1394
2020,3,11,15,2469,3938,2408,-1530
2020,3,11,16,2444,3930,2384,-1546
2020,3,11,17,2439,3864,2268,-1596
2020,3,11,18,2365,3757,2117,-1640
2020,3,11,19,2312,3693,2138,-1555
2020,3,11,20,2275,3662,2266,-1396
2020,3,11,21,2222,3573,2119,-1454
2020,3,11,22,2187,3529,2006,-1523
2020,3,11,23,2199,3480,2042,-1438
2020,3,12,0,2271,3606,2163,-1443
2020,3,12,1,2350,3702,2496,-1206
2020,3,12,2,2423,3793,2600,-1193
2020,3,12,3,2648,3918,2633,-1285
2020,3,12,4,2692,3830,2478,-1352
2020,3,12,5,2550,3652,2265,-1387
2020,3,12,6,2722,3365,2095,-1270
2020,3,12,7,2613,3122,2011,-1111
2020,3,12,8,1863,3004,2019,-985
2020,3,12,9,1886,2932,1993,-939
2020,3,12,10,1847,2954,1911,-1043
2020,3,12,11,1805,3006,1855,-1151
2020,3,12,12,1920,3243,1937,-1306
2020,3,12,13,2212,3563,2057,-1506
2020,3,12,14,2211,3983,2163,-1820
2020,3,12,15,2362,4269,2488,-1781
2020,3,12,16,2330,4253,2423,-1830
2020,3,12,17,2282,4146,2377,-1769
2020,3,12,18,2177,4004,2130,-1874
2020,3,12,19,2136,3912,2261,-1651
2020,3,12,20,2076,3835,2298,-1537
2020,3,12,21,2017,3694,2222,-1472
2020,3,12,22,1949,3557,2100,-1457
2020,3,12,23,1917,3484,2177,-1307
2020,3,13,0,1904,3431,2134,-1297
2020,3,13,1,1974,3723,2382,-1341
2020,3,13,2,2072,3673,2253,-1420
2020,3,13,3,2272,3846,2220,-1626
2020,3,13,4,2315,3821,2182,-1639
2020,3,13,5,2091,3666,2226,-1440
2020,3,13,6,2355,3398,2255,-1143
2020,3,13,7,2122,3190,2202,-988
2020,3,13,8,2094,3061,2150,-911
2020,3,13,9,2148,2959,2039,-920
2020,3,13,10,2033,2915,1961,-954
2020,3,13,11,2070,2959,1937,-1022
2020,3,13,12,2019,3102,1956,-1146
2020,3,13,13,2142,3435,2242,-1193
2020,3,13,14,2214,3792,2266,-1526
2020,3,13,15,2285,4078,2456,-1622
2020,3,13,16,2182,4177,2448,-1729
2020,3,13,17,2310,4222,2440,-1782
2020,3,13,18,2434,4215,2365,-1850
2020,3,13,19,2454,4208,2408,-1800
2020,3,13,20,2383,4222,2468,-1754
2020,3,13,21,2319,4195,2509,-1686
2020,3,13,22,2283,4182,2517,-1665
2020,3,13,23,2209,4180,2472,-1708
2020,3,14,0,2248,4210,2426,-1784
2020,3,14,1,2170,4274,2535,-1739
2020,3,14,2,2183,4277,2607,-1670
2020,3,14,3,2300,4303,2646,-1657
2020,3,14,4,2382,4191,2591,-1600
2020,3,14,5,2199,3978,2578,-1400
2020,3,14,6,2403,3655,2551,-1104
2020,3,14,7,2320,3403,2410,-993
2020,3,14,8,2244,3196,2239,-957
2020,3,14,9,2132,3134,2349,-785
2020,3,14,10,2193,3128,2345,-783
2020,3,14,11,2187,3198,2370,-828
2020,3,14,12,2269,3288,2383,-905
2020,3,14,13,2398,3434,2481,-953
2020,3,14,14,2281,3635,2426,-1209
2020,3,14,15,2435,3877,2583,-1294
2020,3,14,16,2606,4074,2521,-1553
2020,3,14,17,2665,4200,2652,-1548
2020,3,14,18,2657,4239,2693,-1546
2020,3,14,19,2587,4188,2665,-1523
2020,3,14,20,2504,4057,2598,-1459
2020,3,14,21,2395,3858,2519,-1339
2020,3,14,22,2314,3724,2387,-1337
2020,3,14,23,2285,3700,2241,-1459
2020,3,15,0,2332,3748,2292,-1456
2020,3,15,1,2366,3889,2329,-1560
2020,3,15,2,2392,3957,2338,-1619
2020,3,15,3,2531,4067,2337,-1730
2020,3,15,4,2558,4039,2355,-1684
2020,3,15,5,2461,3903,2338,-1565
2020,3,15,6,2562,3707,2481,-1226
2020,3,15,7,2296,3457,2397,-1060
2020,3,15,8,2338,3313,2402,-911
2020,3,15,9,2290,3233,2248,-985
2020,3,15,10,2264,3218,2248,-970
2020,3,15,11,2245,3247,2299,-948
2020,3,15,12,2277,3336,2374,-962
2020,3,15,13,2426,3496,2466,-1030
2020,3,15,14,2269,3673,2394,-1279
2020,3,15,15,2532,3938,2554,-1384
2020,3,15,16,2579,4105,2528,-1577
2020,3,15,17,2616,4184,2790,-1394
2020,3,15,18,2575,4169,2819,-1350
2020,3,15,19,2561,4078,2735,-1343
2020,3,15,20,2505,3922,2522,-1400
2020,3,15,21,2349,3740,2424,-1316
2020,3,15,22,2309,3619,2384,-1235
2020,3,15,23,2243,3564,2368,-1196
2020,3,16,0,2225,3613,2497,-1116
2020,3,16,1,2366,3696,2369,-1327
2020,3,16,2,2401,3807,2420,-1387
2020,3,16,3,2605,3928,2430,-1498
2020,3,16,4,2611,3935,2424,-1511
2020,3,16,5,2430,3765,2368,-1397
2020,3,16,6,2556,3528,2356,-1172
2020,3,16,7,2332,3207,2294,-913
2020,3,16,8,2088,3081,2232,-849
2020,3,16,9,2150,3033,2277,-756
2020,3,16,10,2106,3035,2276,-759
2020,3,16,11,2264,3247,2439,-808
2020,3,16,12,2278,3412,2469,-943
2020,3,16,13,2374,3729,2610,-1119
2020,3,16,14,2237,4091,2539,-1552
2020,3,16,15,2488,4343,2636,-1707
2020,3,16,16,2481,4368,2770,-1598
2020,3,16,17,2384,4248,2789,-1459
2020,3,16,18,2418,4069,2700,-1369
2020,3,16,19,2318,3859,2521,-1338
2020,3,16,20,2199,3734,2504,-1230
2020,3,16,21,2079,3584,2376,-1208
2020,3,16,22,1970,3436,2164,-1272
2020,3,16,23,1927,3344,2023,-1321
2020,3,17,0,1944,3321,2031,-1290
2020,3,17,1,2042,3387,2003,-1384
2020,3,17,2,2148,3527,2246,-1281
2020,3,17,3,2384,3680,2314,-1366
2020,3,17,4,2313,3672,2280,-1392
2020,3,17,5,2135,3505,2180,-1325
2020,3,17,6,2462,3263,2354,-909
2020,3,17,7,2148,3148,2295,-853
2020,3,17,8,2072,2968,2096,-872
2020,3,17,9,2007,2927,2072,-855
2020,3,17,10,1994,2924,2045,-879
2020,3,17,11,2054,3012,2014,-998
2020,3,17,12,2228,3225,2084,-1141
2020,3,17,13,2486,3523,2216,-1307
2020,3,17,14,2388,3889,2228,-1661
2020,3,17,15,2489,4260,2489,-1771
2020,3,17,16,2478,4311,2473,-1838
2020,3,17,17,2352,4210,2469,-1741
2020,3,17,18,2375,4050,2434,-1616
2020,3,17,19,2290,3946,2404,-1542
2020,3,17,20,2244,3832,2276,-1556
2020,3,17,21,2220,3631,2046,-1585
2020,3,17,22,2187,3503,1938,-1565
2020,3,17,23,2024,3386,1917,-1469
2020,3,18,0,2106,3355,1896,-1459
2020,3,18,1,2074,3446,2097,-1349
2020,3,18,2,2110,3560,2404,-1156
2020,3,18,3,2404,3713,2450,-1263
2020,3,18,4,2437,3729,2449,-1280
2020,3,18,5,2151,3580,2401,-1179
2020,3,18,6,2433,3310,2449,-861
2020,3,18,7,2218,3115,2344,-771
2020,3,18,8,2167,2991,2307,-684
2020,3,18,9,2216,2948,2346,-602
2020,3,18,10,2203,2957,2322,-635
2020,3,18,11,2261,3024,2367,-657
2020,3,18,12,2348,3233,2460,-773
2020,3,18,13,2484,3592,2506,-1086
2020,3,18,14,2579,3941,2506,-1435
2020,3,18,15,2714,4191,2555,-1636
2020,3,18,16,2757,4224,2536,-1688
2020,3,18,17,2671,4120,2529,-1591
2020,3,18,18,2721,3954,2567,-1387
2020,3,18,19,2596,3823,2497,-1326
2020,3,18,20,2444,3702,2375,-1327
2020,3,18,21,2392,3543,2330,-1213
2020,3,18,22,2297,3425,2174,-1251
2020,3,18,23,2228,3298,2064,-1234
2020,3,19,0,2207,3286,1993,-1293
2020,3,19,1,2318,3399,2153,-1246
2020,3,19,2,2398,3518,2304,-1214
2020,3,19,3,2544,3542,2256,-1286
2020,3,19,4,2575,3554,2452,-1102
2020,3,19,5,2410,3419,2468,-951
2020,3,19,6,2505,3201,2284,-917
2020,3,19,7,2251,2959,2045,-914
2020,3,19,8,2114,2854,2124,-730
2020,3,19,9,2119,2811,2038,-773
2020,3,19,10,2149,2830,2155,-675
2020,3,19,11,2029,2934,2195,-739
2020,3,19,12,2137,3096,2213,-883
2020,3,19,13,2401,3408,2297,-1111
2020,3,19,14,2567,3771,2329,-1442
2020,3,19,15,2609,4101,2560,-1541
2020,3,19,16,2753,4179,2593,-1586
2020,3,19,17,2721,4084,2496,-1588
2020,3,19,18,2748,3954,2508,-1446
2020,3,19,19,2618,3815,2456,-1359
2020,3,19,20,2526,3680,2444,-1236
2020,3,19,21,2378,3522,2344,-1178
2020,3,19,22,2275,3362,2176,-1186
2020,3,19,23,2272,3271,2127,-1144
2020,3,20,0,2246,3215,2041,-1174
2020,3,20,1,2290,3297,2172,-1125
2020,3,20,2,2360,3347,2229,-1118
2020,3,20,3,2500,3429,2288,-1141
2020,3,20,4,2569,3457,2333,-1124
2020,3,20,5,2406,3325,2342,-983
2020,3,20,6,2489,3119,2355,-764
2020,3,20,7,2286,2940,2375,-565
2020,3,20,8,2106,2811,2298,-513
2020,3,20,9,2073,2755,2315,-440
2020,3,20,10,2082,2766,2288,-478
2020,3,20,11,2120,2833,2312,-521
2020,3,20,12,2153,3038,2348,-690
2020,3,20,13,2440,3304,2445,-859
2020,3,20,14,2480,3654,2434,-1220
2020,3,20,15,2478,3913,2439,-1474
2020,3,20,16,2434,3968,2442,-1526
2020,3,20,17,2435,3820,2325,-1495
2020,3,20,18,2433,3633,2347,-1286
2020,3,20,19,2401,3505,2318,-1187
2020,3,20,20,2300,3481,2267,-1214
2020,3,20,21,2207,3326,2221,-1105
2020,3,20,22,2048,3341,2329,-1012
2020,3,20,23,1998,3271,2440,-831
2020,3,21,0,2031,3249,2477,-772
2020,3,21,1,2059,3262,2544,-718
2020,3,21,2,2086,3327,2615,-712
2020,3,21,3,2181,3346,2567,-779
2020,3,21,4,2215,3350,2514,-836
2020,3,21,5,2093,3180,2507,-673
2020,3,21,6,2305,3041,2594,-447
2020,3,21,7,2087,2789,2390,-399
2020,3,21,8,1951,2720,2297,-423
2020,3,21,9,1903,2667,2272,-395
2020,3,21,10,1880,2654,2267,-387
2020,3,21,11,1865,2669,2188,-481
2020,3,21,12,1787,2773,2184,-589
2020,3,21,13,2018,2945,2133,-812
2020,3,21,14,1823,3169,2136,-1033
2020,3,21,15,2040,3363,2177,-1186
2020,3,21,16,2181,3502,2233,-1269
2020,3,21,17,2169,3585,2114,-1471
2020,3,21,18,2149,3608,2175,-1433
2020,3,21,19,2097,3575,2128,-1447
2020,3,21,20,2011,3446,2111,-1335
2020,3,21,21,1903,3396,2019,-1377
2020,3,21,22,1782,3264,2008,-1256
2020,3,21,23,1769,3175,2118,-1057
2020,3,22,0,1801,3095,2032,-1063
2020,3,22,1,1851,3214,2212,-1002
2020,3,22,2,1882,3329,2462,-867
2020,3,22,3,1978,3398,2437,-961
2020,3,22,4,2038,3433,2306,-1127
2020,3,22,5,1954,3283,2209,-1074
2020,3,22,6,2057,3097,2205,-892
2020,3,22,7,2010,2913,2196,-717
2020,3,22,8,2069,2775,2189,-586
2020,3,22,9,2033,2724,2077,-647
2020,3,22,10,1934,2723,2098,-625
2020,3,22,11,1880,2754,2068,-686
2020,3,22,12,1930,2872,2152,-720
2020,3,22,13,2047,3010,2196,-814
2020,3,22,14,1839,3248,2238,-1010
2020,3,22,15,1969,3452,2316,-1136
2020,3,22,16,2182,3588,2293,-1295
2020,3,22,17,2187,3680,2272,-1408
2020,3,22,18,2115,3576,2185,-1391
2020,3,22,19,1984,3500,2154,-1346
2020,3,22,20,1917,3288,1995,-1293
2020,3,22,21,1835,3172,1859,-1313
2020,3,22,22,1820,3107,1841,-1266
2020,3,22,23,1800,3102,1895,-1207
2020,3,23,0,1805,3354,2123,-1231
2020,3,23,1,1849,3491,2275,-1216
2020,3,23,2,1870,3527,2204,-1323
2020,3,23,3,2028,3541,2158,-1383
2020,3,23,4,2039,3521,2217,-1304
2020,3,23,5,1942,3362,2279,-1083
2020,3,23,6,2122,3157,2327,-830
2020,3,23,7,1980,2893,2233,-660
2020,3,23,8,1688,2748,2209,-539
2020,3,23,9,1685,2666,2151,-515
2020,3,23,10,1611,2659,2137,-522
2020,3,23,11,1580,2707,2072,-635
2020,3,23,12,1646,2846,2026,-820
2020,3,23,13,1917,3091,2134,-957
2020,3,23,14,1927,3405,2123,-1282
2020,3,23,15,2130,3705,2219,-1486
2020,3,23,16,2130,3830,2223,-1607
2020,3,23,17,2097,3841,2157,-1684
2020,3,23,18,2010,3870,2173,-1697
2020,3,23,19,1958,3765,2188,-1577
2020,3,23,20,1909,3735,2248,-1487
2020,3,23,21,1850,3606,2169,-1437
2020,3,23,22,1796,3421,1599,-1822
2020,3,23,23,1787,3394,1681,-1713
2020,3,24,0,1806,3466,1666,-1800
2020,3,24,1,1851,3615,2125,-1490
2020,3,24,2,1941,3695,2443,-1252
2020,3,24,3,2062,3781,2538,-1243
2020,3,24,4,2092,3742,2488,-1254
2020,3,24,5,1891,3544,2442,-1102
2020,3,24,6,2068,3308,2471,-837
2020,3,24,7,1854,3097,2274,-823
2020,3,24,8,1906,2978,2257,-721
2020,3,24,9,1895,2894,2306,-588
2020,3,24,10,1913,2908,2343,-565
2020,3,24,11,2152,2955,2307,-648
2020,3,24,12,2346,3096,2498,-598
2020,3,24,13,2352,3331,2588,-743
2020,3,24,14,2325,3635,2501,-1134
2020,3,24,15,2449,3786,2371,-1415
2020,3,24,16,2450,3856,2304,-1552
2020,3,24,17,2288,3858,2269,-1589
2020,3,24,18,2200,3848,2426,-1422
2020,3,24,19,2044,3807,2351,-1456
2020,3,24,20,2027,3761,2234,-1527
2020,3,24,21,2037,3671,2180,-1491
2020,3,24,22,1986,3633,2188,-1445
2020,3,24,23,2032,3610,2213,-1397
2020,3,25,0,1961,3645,2118,-1527
2020,3,25,1,2044,3761,2136,-1625
2020,3,25,2,2140,3782,2327,-1455
2020,3,25,3,2212,3812,2405,-1407
2020,3,25,4,2304,3756,2381,-1375
2020,3,25,5,2062,3555,2274,-1281
2020,3,25,6,2284,3299,2300,-999
2020,3,25,7,2074,3078,2204,-874
2020,3,25,8,1964,2948,2125,-823
2020,3,25,9,1840,2894,2164,-730
2020,3,25,10,1833,2854,2156,-698
2020,3,25,11,1872,2885,2149,-736
2020,3,25,12,1929,3021,2192,-829
2020,3,25,13,2187,3266,2343,-923
2020,3,25,14,2071,3550,2194,-1356
2020,3,25,15,2373,3797,2369,-1428
2020,3,25,16,2407,3853,2279,-1574
2020,3,25,17,2352,3907,2142,-1765
2020,3,25,18,2199,3894,2196,-1698
2020,3,25,19,2026,3871,2073,-1798
2020,3,25,20,1985,3836,2081,-1755
2020,3,25,21,1950,3633,2010,-1623
2020,3,25,22,1909,3507,2049,-1458
2020,3,25,23,1889,3421,2187,-1234
2020,3,26,0,1862,3369,2115,-1254
2020,3,26,1,2069,3466,2181,-1285
2020,3,26,2,2165,3453,2269,-1184
2020,3,26,3,2288,3523,2271,-1252
2020,3,26,4,2337,3555,2372,-1183
2020,3,26,5,2221,3487,2353,-1134
2020,3,26,6,2341,3222,2349,-873
2020,3,26,7,2099,3119,2273,-846
2020,3,26,8,1893,2879,2141,-738
2020,3,26,9,1934,2838,2107,-731
2020,3,26,10,1904,2827,2138,-689
2020,3,26,11,1900,2874,2226,-648
2020,3,26,12,1980,2974,2255,-719
2020,3,26,13,2188,3203,2272,-931
2020,3,26,14,2389,3504,2287,-1217
2020,3,26,15,2436,3691,2559,-1132
2020,3,26,16,2459,3853,2507,-1346
2020,3,26,17,2492,3909,2561,-1348
2020,3,26,18,2401,3919,2538,-1381
2020,3,26,19,2246,3919,2263,-1656
2020,3,26,20,2093,3923,2275,-1648
2020,3,26,21,2068,3753,2179,-1574
2020,3,26,22,1961,3724,2114,-1610
2020,3,26,23,1929,3698,2083,-1615
2020,3,27,0,1939,3712,2171,-1541
2020,3,27,1,2077,3677,2273,-1404
2020,3,27,2,2185,3694,2272,-1422
2020,3,27,3,2388,3789,2511,-1278
2020,3,27,4,2397,3737,2539,-1198
2020,3,27,5,2122,3504,2246,-1258
2020,3,27,6,2072,3239,2340,-899
2020,3,27,7,1862,2987,2128,-859
2020,3,27,8,1937,2864,2192,-672
2020,3,27,9,1896,2776,2154,-622
2020,3,27,10,1855,2746,2102,-644
2020,3,27,11,1856,2775,2091,-684
2020,3,27,12,1904,2902,2094,-808
2020,3,27,13,2190,3080,2140,-940
2020,3,27,14,2176,3304,2093,-1211
2020,3,27,15,2297,3567,2234,-1333
2020,3,27,16,2282,3673,2170,-1503
2020,3,27,17,2277,3747,2259,-1488
2020,3,27,18,2273,3744,2258,-1486
2020,3,27,19,2073,3730,2206,-1524
2020,3,27,20,2016,3692,2165,-1527
2020,3,27,21,1970,3618,2119,-1499
2020,3,27,22,2025,3549,2037,-1512
2020,3,27,23,2015,3500,2015,-1485
2020,3,28,0,2005,3598,2062,-1536
2020,3,28,1,2107,3694,2222,-1472
2020,3,28,2,2310,3686,2314,-1372
2020,3,28,3,2364,3658,2473,-1185
2020,3,28,4,2362,3531,2442,-1089
2020,3,28,5,2077,3357,2274,-1083
2020,3,28,6,2214,3148,2311,-837
2020,3,28,7,1989,2945,2276,-669
2020,3,28,8,2001,2811,2271,-540
2020,3,28,9,2084,2701,2178,-523
2020,3,28,10,1878,2630,2123,-507
2020,3,28,11,2001,2625,2118,-507
2020,3,28,12,1924,2719,2198,-521
2020,3,28,13,1889,2818,2142,-676
2020,3,28,14,1669,2965,2041,-924
2020,3,28,15,1768,3115,1981,-1134
2020,3,28,16,1838,3228,1954,-1274
2020,3,28,17,1917,3366,1974,-1392
2020,3,28,18,1905,3447,2048,-1399
2020,3,28,19,1869,3510,2092,-1418
2020,3,28,20,1801,3495,2151,-1344
2020,3,28,21,1733,3438,2141,-1297
2020,3,28,22,1698,3353,2083,-1270
2020,3,28,23,1668,3304,2047,-1257
2020,3,29,0,1672,3297,1932,-1365
2020,3,29,1,1768,3389,2040,-1349
2020,3,29,2,1857,3430,2081,-1349
2020,3,29,3,2037,3505,2191,-1314
2020,3,29,4,2085,3448,2255,-1193
2020,3,29,5,1999,3279,2161,-1118
2020,3,29,6,2226,3039,2137,-902
2020,3,29,7,2055,2856,2112,-744
2020,3,29,8,1870,2763,2143,-620
2020,3,29,9,1930,2550,2103,-447
2020,3,29,10,1852,2499,2090,-409
2020,3,29,11,1921,2504,2117,-387
2020,3,29,12,1786,2542,2129,-413
2020,3,29,13,2052,2682,2202,-480
2020,3,29,14,1706,2831,2210,-621
2020,3,29,15,1715,2969,2118,-851
2020,3,29,16,1991,3128,2065,-1063
2020,3,29,17,2042,3238,1957,-1281
2020,3,29,18,2019,3283,1952,-1331
2020,3,29,19,1964,3324,1915,-1409
2020,3,29,20,1866,3298,1817,-1481
2020,3,29,21,1770,3188,1635,-1553
2020,3,29,22,1682,3111,1559,-1552
2020,3,29,23,1617,3061,1434,-1627
2020,3,30,0,1702,3085,1575,-1510
2020,3,30,1,1654,3218,1824,-1394
2020,3,30,2,1714,3288,2000,-1288
2020,3,30,3,1800,3354,2047,-1307
2020,3,30,4,1889,3392,2221,-1171
2020,3,30,5,1760,3285,2324,-961
2020,3,30,6,2139,2967,2101,-866
2020,3,30,7,1940,2872,2102,-770
2020,3,30,8,1873,2731,2037,-694
2020,3,30,9,1949,2647,2155,-492
2020,3,30,10,1750,2533,2056,-477
2020,3,30,11,1841,2564,1997,-567
2020,3,30,12,1933,2781,2097,-684
2020,3,30,13,2173,3056,2307,-749
2020,3,30,14,2086,3328,2360,-968
2020,3,30,15,2178,3571,2365,-1206
2020,3,30,16,2161,3708,2226,-1482
2020,3,30,17,2031,3711,2168,-1543
2020,3,30,18,1990,3629,2214,-1415
2020,3,30,19,1902,3613,2089,-1524
2020,3,30,20,1803,3585,1983,-1602
2020,3,30,21,1770,3571,1844,-1727
2020,3,30,22,1722,3515,1804,-1711
2020,3,30,23,1739,3445,1721,-1724
2020,3,31,0,1746,3503,1760,-1743
2020,3,31,1,1823,3660,1930,-1730
2020,3,31,2,1962,3680,2215,-1465
2020,3,31,3,1969,3732,2370,-1362
2020,3,31,4,1972,3716,2342,-1374
2020,3,31,5,1809,3556,2178,-1378
2020,3,31,6,2051,3310,2268,-1042
2020,3,31,7,1847,3111,2159,-952
2020,3,31,8,1972,2970,2212,-758
2020,3,31,9,1927,2851,2104,-747
2020,3,31,10,1868,2833,2094,-739
2020,3,31,11,1950,2808,2041,-767
2020,3,31,12,2004,3025,2229,-796
2020,3,31,13,2339,3309,2627,-682
2020,3,31,14,2355,3612,2688,-924
2020,3,31,15,2471,3795,2648,-1147
2020,3,31,16,2407,3860,2725,-1135
2020,3,31,17,2276,3850,2673,-1177
2020,3,31,18,2257,3812,2702,-1110
2020,3,31,19,2265,3761,2529,-1232
2020,3,31,20,2114,3674,2348,-1326
2020,3,31,21,2137,3549,2078,-1471
2020,3,31,22,2100,3426,2072,-1354
2020,3,31,23,2067,3421,2201,-1220
2020,4,1,0,2139,3450,2165,-1285
2020,4,1,1,2114,3605,2360,-1245
2020,4,1,2,2195,3635,2447,-1188
2020,4,1,3,2294,3688,2572,-1116
2020,4,1,4,2421,3695,2606,-1089
2020,4,1,5,2324,3527,2558,-969
2020,4,1,6,2234,3263,2504,-759
2020,4,1,7,2094,3069,2464,-605
2020,4,1,8,2075,2914,2258,-656
2020,4,1,9,2067,2844,2085,-759
2020,4,1,10,2000,2816,2138,-678
2020,4,1,11,1985,2851,2117,-734
2020,4,1,12,1974,2964,2073,-891
2020,4,1,13,2211,3199,2054,-1145
2020,4,1,14,2049,3482,2028,-1454
2020,4,1,15,2158,3760,2180,-1580
2020,4,1,16,2253,3840,2214,-1626
2020,4,1,17,2241,3830,2112,-1718
2020,4,1,18,2022,3795,2184,-1611
2020,4,1,19,2053,3732,2244,-1488
2020,4,1,20,2068,3616,2178,-1438
2020,4,1,21,2025,3497,2026,-1471
2020,4,1,22,1978,3422,2107,-1315
2020,4,1,23,1986,3360,2079,-1281
2020,4,2,0,1968,3417,2095,-1322
2020,4,2,1,2082,3501,2257,-1244
2020,4,2,2,2203,3544,2343,-1201
2020,4,2,3,2312,3621,2507,-1114
2020,4,2,4,2348,3661,2485,-1176
2020,4,2,5,2214,3493,2356,-1137
2020,4,2,6,2269,3343,2536,-807
2020,4,2,7,2150,3057,2321,-736
2020,4,2,8,2027,3075,2322,-753
2020,4,2,9,1996,2847,2129,-718
2020,4,2,10,1900,2813,2018,-795
2020,4,2,11,1866,2856,2067,-789
2020,4,2,12,2004,2986,2059,-927
2020,4,2,13,2222,3325,2228,-1097
2020,4,2,14,2276,3644,2237,-1407
2020,4,2,15,2355,3856,2274,-1582
2020,4,2,16,2358,3924,2342,-1582
2020,4,2,17,2252,3933,2408,-1525
2020,4,2,18,2258,3935,2518,-1417
2020,4,2,19,1987,3797,2362,-1435
2020,4,2,20,1925,3710,2319,-1391
2020,4,2,21,1947,3587,2207,-1380
2020,4,2,22,1908,3481,2155,-1326
2020,4,2,23,1941,3407,2041,-1366
2020,4,3,0,1948,3337,2036,-1301
2020,4,3,1,2009,3423,2221,-1202
2020,4,3,2,2241,3453,2179,-1274
2020,4,3,3,2295,3496,2204,-1292
2020,4,3,4,2336,3506,2189,-1317
2020,4,3,5,2222,3390,2363,-1027
2020,4,3,6,2273,3175,2394,-781
2020,4,3,7,2080,2947,2220,-727
2020,4,3,8,2217,2835,2365,-470
2020,4,3,9,2081,2749,2302,-447
2020,4,3,10,1952,2740,2281,-459
2020,4,3,11,2017,2794,2239,-555
2020,4,3,12,2114,2881,2374,-507
2020,4,3,13,2380,3177,2456,-721
2020,4,3,14,2369,3571,2529,-1042
2020,4,3,15,2382,3768,2552,-1216
2020,4,3,16,2427,3827,2551,-1276
2020,4,3,17,2438,3870,2587,-1283
2020,4,3,18,2394,3829,2488,-1341
2020,4,3,19,2326,3793,2429,-1364
2020,4,3,20,2225,3732,2379,-1353
2020,4,3,21,2145,3625,2301,-1324
2020,4,3,22,2073,3544,2003,-1541
2020,4,3,23,2040,3510,2145,-1365
2020,4,4,0,2027,3547,2153,-1394
2020,4,4,1,2156,3653,2233,-1420
2020,4,4,2,2220,3686,2365,-1321
2020,4,4,3,2332,3718,2411,-1307
2020,4,4,4,2434,3698,2321,-1377
2020,4,4,5,2343,3560,2306,-1254
2020,4,4,6,2458,3340,2564,-776
2020,4,4,7,2278,3145,2527,-618
2020,4,4,8,2288,2957,2476,-481
2020,4,4,9,2277,2893,2438,-455
2020,4,4,10,2326,2883,2346,-537
2020,4,4,11,2313,2893,2251,-642
2020,4,4,12,2314,3064,2383,-681
2020,4,4,13,2447,3242,2620,-622
2020,4,4,14,2283,3390,2490,-900
2020,4,4,15,2573,3562,2618,-944
2020,4,4,16,2580,3691,2628,-1063
2020,4,4,17,2534,3693,2650,-1043
2020,4,4,18,2495,3644,2700,-944
2020,4,4,19,2402,3565,2662,-903
2020,4,4,20,2234,3462,2657,-805
2020,4,4,21,2208,3375,2538,-837
2020,4,4,22,2160,3267,2478,-789
2020,4,4,23,2118,3227,2468,-759
2020,4,5,0,2124,3200,2483,-717
2020,4,5,1,2168,3251,2389,-862
2020,4,5,2,2179,3338,2469,-869
2020,4,5,3,2224,3417,2542,-875
2020,4,5,4,2313,3426,2513,-913
2020,4,5,5,2234,3285,2388,-897
2020,4,5,6,2439,3105,2469,-636
2020,4,5,7,2240,2890,2259,-631
2020,4,5,8,1935,2785,2026,-759
2020,4,5,9,1940,2675,1981,-694
2020,4,5,10,1886,2630,2004,-626
2020,4,5,11,1863,2634,1964,-670
2020,4,5,12,1864,2669,1953,-716
2020,4,5,13,1854,2820,2058,-762
2020,4,5,14,1832,3036,2190,-846
2020,4,5,15,1972,3220,2262,-958
2020,4,5,16,2135,3390,2374,-1016
2020,4,5,17,2264,3445,2372,-1073
2020,4,5,18,2264,3408,2282,-1126
2020,4,5,19,2162,3353,2241,-1112
2020,4,5,20,2107,3326,2244,-1082
2020,4,5,21,1998,3191,2142,-1049
2020,4,5,22,1893,3106,2080,-1026
2020,4,5,23,1855,3108,2002,-1106
2020,4,6,0,1903,3112,1949,-1163
2020,4,6,1,2021,3286,2104,-1182
2020,4,6,2,2095,3251,2074,-1177
2020,4,6,3,2184,3336,2166,-1170
2020,4,6,4,2235,3361,2165,-1196
2020,4,6,5,2090,3202,2143,-1059
2020,4,6,6,2195,3020,2177,-843
2020,4,6,7,1973,2790,2089,-701
2020,4,6,8,1752,2659,2060,-599
2020,4,6,9,1763,2608,2096,-512
2020,4,6,10,1792,2603,2098,-505
2020,4,6,11,1809,2704,2124,-580
2020,4,6,12,2006,2849,2265,-584
2020,4,6,13,2243,3098,2356,-742
2020,4,6,14,2417,3418,2396,-1022
2020,4,6,15,2458,3682,2554,-1128
2020,4,6,16,2422,3789,2650,-1139
2020,4,6,17,2410,3645,2540,-1105
2020,4,6,18,2307,3465,2470,-995
2020,4,6,19,2199,3422,2600,-822
2020,4,6,20,2095,3352,2522,-830
2020,4,6,21,2020,3272,2408,-864
2020,4,6,22,1997,3105,2311,-794
2020,4,6,23,2039,3044,2303,-741
2020,4,7,0,2083,3041,2298,-743
2020,4,7,1,2127,3143,2345,-798
2020,4,7,2,2214,3177,2389,-788
2020,4,7,3,2247,3193,2367,-826
2020,4,7,4,2262,3329,2319,-1010
2020,4,7,5,2122,3175,2251,-924
2020,4,7,6,2086,2986,2286,-700
2020,4,7,7,2080,2753,2120,-633
2020,4,7,8,2055,2674,2279,-395
2020,4,7,9,2005,2628,2288,-340
2020,4,7,10,2007,2628,2297,-331
2020,4,7,11,1979,2690,2345,-345
2020,4,7,12,2063,2831,2396,-435
2020,4,7,13,2342,3090,2533,-557
2020,4,7,14,2313,3353,2537,-816
2020,4,7,15,2344,3563,2462,-1101
2020,4,7,16,2446,3626,2509,-1117
2020,4,7,17,2412,3640,2360,-1280
2020,4,7,18,2246,3586,2360,-1226
2020,4,7,19,2186,3513,2281,-1232
2020,4,7,20,2118,3439,2280,-1159
2020,4,7,21,2119,3313,2281,-1032
2020,4,7,22,2076,3200,2278,-922
2020,4,7,23,2095,3097,2249,-848
2020,4,8,0,2136,3097,2277,-820
2020,4,8,1,2235,3192,2491,-701
2020,4,8,2,2352,3306,2683,-623
2020,4,8,3,2199,3267,2583,-684
2020,4,8,4,2309,3335,2650,-685
2020,4,8,5,2207,3218,2655,-563
2020,4,8,6,2283,2966,2466,-500
2020,4,8,7,2083,2824,2463,-361
2020,4,8,8,2194,2708,2245,-463
2020,4,8,9,2120,2665,2227,-438
2020,4,8,10,2054,2667,2239,-428
2020,4,8,11,2063,2725,2253,-472
2020,4,8,12,2247,2883,2345,-538
2020,4,8,13,2389,3152,2525,-627
2020,4,8,14,2524,3454,2537,-917
2020,4,8,15,2601,3667,2581,-1086
2020,4,8,16,2600,3655,2639,-1016
2020,4,8,17,2618,3536,2497,-1039
2020,4,8,18,2455,3433,2457,-976
2020,4,8,19,2349,3301,2387,-914
2020,4,8,20,2247,3233,2360,-873
2020,4,8,21,2160,3131,2352,-779
2020,4,8,22,2087,3104,2306,-798
2020,4,8,23,2010,2985,2109,-876
2020,4,9,0,2155,2997,2110,-887
2020,4,9,1,2193,3106,2194,-912
2020,4,9,2,2242,3129,2375,-754
2020,4,9,3,2243,3166,2405,-761
2020,4,9,4,2340,3245,2399,-846
2020,4,9,5,2127,3105,2377,-728
2020,4,9,6,2172,2925,2290,-635
2020,4,9,7,2041,2738,2275,-463
2020,4,9,8,2110,2563,2222,-341
2020,4,9,9,2181,2523,2293,-230
2020,4,9,10,2242,2574,2383,-191
2020,4,9,11,2278,2593,2413,-180
2020,4,9,12,2247,2722,2243,-479
2020,4,9,13,2385,2942,2268,-674
2020,4,9,14,2502,3296,2465,-831
2020,4,9,15,2588,3486,2557,-929
2020,4,9,16,2593,3520,2576,-944
2020,4,9,17,2499,3436,2496,-940
2020,4,9,18,2442,3317,2462,-855
2020,4,9,19,2314,3196,2335,-861
2020,4,9,20,2157,3202,2376,-826
2020,4,9,21,2130,3128,2429,-699
2020,4,9,22,2058,2952,2225,-727
2020,4,9,23,2063,2883,2205,-678
2020,4,10,0,2071,2905,2173,-732
2020,4,10,1,2128,2985,2187,-798
2020,4,10,2,2190,3047,2421,-626
2020,4,10,3,2296,3036,2425,-611
2020,4,10,4,2347,3137,2446,-691
2020,4,10,5,2216,3008,2434,-574
2020,4,10,6,2267,2793,2332,-461
2020,4,10,7,2074,2593,2284,-309
2020,4,10,8,2107,2473,2204,-269
2020,4,10,9,2097,2406,2143,-263
2020,4,10,10,2038,2470,2207,-263
2020,4,10,11,2035,2501,2192,-309
2020,4,10,12,2101,2604,2254,-350
2020,4,10,13,2344,2751,2247,-504
2020,4,10,14,2437,3065,2370,-695
2020,4,10,15,2494,3248,2558,-690
2020,4,10,16,2490,3299,2560,-739
2020,4,10,17,2478,3269,2510,-759
2020,4,10,18,2247,3210,2326,-884
2020,4,10,19,2161,3177,2240,-937
2020,4,10,20,2097,3115,2262,-853
2020,4,10,21,2193,3037,2386,-651
2020,4,10,22,2160,2970,2444,-526
2020,4,10,23,2139,2929,2436,-493
2020,4,11,0,2148,2952,2425,-527
2020,4,11,1,2150,3043,2435,-608
2020,4,11,2,2122,3051,2429,-622
2020,4,11,3,2097,3017,2396,-621
2020,4,11,4,2176,3057,2390,-667
2020,4,11,5,2131,2881,2269,-612
2020,4,11,6,2245,2717,2247,-470
2020,4,11,7,2094,2529,2344,-185
2020,4,11,8,2090,2446,2379,-67
2020,4,11,9,1975,2384,2258,-126
2020,4,11,10,1883,2343,2120,-223
2020,4,11,11,1875,2362,2124,-238
2020,4,11,12,1850,2414,2224,-190
2020,4,11,13,1944,2494,2139,-355
2020,4,11,14,1793,2629,2047,-582
2020,4,11,15,2023,2771,2038,-733
2020,4,11,16,2119,2967,2143,-824
2020,4,11,17,2138,3108,2199,-909
2020,4,11,18,2080,3192,2211,-981
2020,4,11,19,2073,3177,2207,-970
2020,4,11,20,2029,3143,2113,-1030
2020,4,11,21,1983,3015,1942,-1073
2020,4,11,22,1922,2930,2003,-927
2020,4,11,23,1872,2859,2006,-853
2020,4,12,0,1917,2858,2025,-833
2020,4,12,1,1895,2985,2098,-887
2020,4,12,2,1977,3054,2310,-744
2020,4,12,3,2033,3091,2334,-757
2020,4,12,4,2184,3216,2399,-817
2020,4,12,5,2117,3134,2465,-669
2020,4,12,6,2251,2994,2593,-401
2020,4,12,7,2078,2795,2513,-282
2020,4,12,8,2141,2736,2445,-291
2020,4,12,9,2158,2617,2242,-375
2020,4,12,10,2143,2592,2176,-416
2020,4,12,11,2156,2625,2204,-421
2020,4,12,12,2153,2711,2323,-388
2020,4,12,13,2276,2824,2365,-459
2020,4,12,14,2204,3007,2341,-666
2020,4,12,15,2481,3243,2562,-681
2020,4,12,16,2599,3302,2583,-719
2020,4,12,17,2645,3319,2673,-646
2020,4,12,18,2535,3274,2648,-626
2020,4,12,19,2469,3190,2542,-648
2020,4,12,20,2293,3092,2380,-712
2020,4,12,21,2170,2994,2339,-655
2020,4,12,22,2117,2889,2310,-579
2020,4,12,23,2113,2866,2257,-609
2020,4,13,0,2112,2912,2252,-660
2020,4,13,1,2110,2977,2267,-710
2020,4,13,2,2220,3035,2448,-587
2020,4,13,3,2286,3071,2451,-620
2020,4,13,4,2492,3173,2467,-706
2020,4,13,5,2375,3080,2341,-739
2020,4,13,6,2463,2873,2334,-539
2020,4,13,7,2390,2667,2272,-395
2020,4,13,8,2218,2558,2266,-292
2020,4,13,9,2220,2533,2254,-279
2020,4,13,10,2168,2547,2334,-213
2020,4,13,11,2279,2619,2294,-325
2020,4,13,12,2424,2878,2466,-412
2020,4,13,13,2642,3105,2680,-425
2020,4,13,14,2556,3479,2589,-890
2020,4,13,15,2543,3645,2605,-1040
2020,4,13,16,2516,3686,2673,-1013
2020,4,13,17,2454,3577,2641,-936
2020,4,13,18,2517,3508,2687,-821
2020,4,13,19,2349,3417,2567,-850
2020,4,13,20,2269,3311,2515,-796
2020,4,13,21,2219,3190,2315,-875
2020,4,13,22,2184,3069,2274,-795
2020,4,13,23,2149,3044,2354,-690
2020,4,14,0,2159,3020,2294,-726
2020,4,14,1,2208,3119,2510,-609
2020,4,14,2,2229,3140,2596,-544
2020,4,14,3,2233,3132,2703,-429
2020,4,14,4,2316,3194,2531,-663
2020,4,14,5,2203,3026,2428,-598
2020,4,14,6,2391,2774,2365,-409
2020,4,14,7,2214,2582,2212,-370
2020,4,14,8,1939,2478,2146,-332
2020,4,14,9,1907,2394,2130,-264
2020,4,14,10,1910,2382,2077,-305
2020,4,14,11,1915,2428,2189,-239
2020,4,14,12,1983,2647,2311,-336
2020,4,14,13,2204,2887,2495,-392
2020,4,14,14,2384,3174,2371,-803
2020,4,14,15,2372,3398,2401,-997
2020,4,14,16,2389,3402,2403,-999
2020,4,14,17,2368,3351,2422,-929
2020,4,14,18,2318,3207,2340,-867
2020,4,14,19,2107,3196,2027,-1169
2020,4,14,20,2016,3201,2061,-1140
2020,4,14,21,1979,3129,2132,-997
2020,4,14,22,1987,3027,2189,-838
2020,4,14,23,2045,2952,1941,-1011
2020,4,15,0,2078,2969,2028,-941
2020,4,15,1,2080,3088,2335,-753
2020,4,15,2,2279,3099,2465,-634
2020,4,15,3,2289,3072,2318,-754
2020,4,15,4,2302,3118,2306,-812
2020,4,15,5,2171,3000,2338,-662
2020,4,15,6,2065,2784,2320,-464
2020,4,15,7,1955,2581,2218,-363
2020,4,15,8,1673,2496,2284,-212
2020,4,15,9,1614,2399,2146,-253
2020,4,15,10,1603,2315,1987,-328
2020,4,15,11,1646,2324,1915,-409
2020,4,15,12,1745,2462,2134,-328
2020,4,15,13,1914,2625,2142,-483
2020,4,15,14,1726,2840,2066,-774
2020,4,15,15,1911,3019,1929,-1090
2020,4,15,16,1980,3122,1888,-1234
2020,4,15,17,2006,3195,2038,-1157
2020,4,15,18,2029,3210,2123,-1087
2020,4,15,19,2013,3185,2214,-971
2020,4,15,20,1985,3128,2141,-987
2020,4,15,21,1949,3093,2199,-894
2020,4,15,22,1923,3020,1904,-1116
2020,4,15,23,1812,2985,1974,-1011
2020,4,16,0,1859,2998,2099,-899
2020,4,16,1,1927,3133,2401,-732
2020,4,16,2,2002,3135,2428,-707
2020,4,16,3,1945,3060,2388,-672
2020,4,16,4,2021,3047,2227,-820
2020,4,16,5,1892,2929,1976,-953
2020,4,16,6,2096,2720,1924,-796
2020,4,16,7,2004,2525,1887,-638
2020,4,16,8,1701,2428,1883,-545
2020,4,16,9,1714,2348,1852,-496
2020,4,16,10,1713,2326,1863,-463
2020,4,16,11,1770,2357,1860,-497
2020,4,16,12,1844,2490,1916,-574
2020,4,16,13,2019,2700,1904,-796
2020,4,16,14,2159,3075,2096,-979
2020,4,16,15,2122,3306,2342,-964
2020,4,16,16,2189,3352,2326,-1026
2020,4,16,17,2187,3304,2270,-1034
2020,4,16,18,1946,3253,2283,-970
2020,4,16,19,1873,3217,2300,-917
2020,4,16,20,1839,3187,2147,-1040
2020,4,16,21,1853,3132,2119,-1013
2020,4,16,22,1954,3058,2113,-945
2020,4,16,23,1818,3035,2103,-932
2020,4,17,0,1838,3022,2067,-955
2020,4,17,1,1935,3098,2062,-1036
2020,4,17,2,1896,3041,2051,-990
2020,4,17,3,2003,3006,2048,-958
2020,4,17,4,1984,3096,2090,-1006
2020,4,17,5,1872,2990,2147,-843
2020,4,17,6,1866,2800,2208,-592
2020,4,17,7,1864,2613,2150,-463
2020,4,17,8,1789,2499,2069,-430
2020,4,17,9,1777,2439,2043,-396
2020,4,17,10,1763,2427,2039,-388
2020,4,17,11,1832,2485,2054,-431
2020,4,17,12,2098,2620,2242,-378
2020,4,17,13,2143,2827,2307,-520
2020,4,17,14,2179,3067,2329,-738
2020,4,17,15,2082,3262,2425,-837
2020,4,17,16,2129,3311,2469,-842
2020,4,17,17,2052,3280,2376,-904
2020,4,17,18,1869,3206,2269,-937
2020,4,17,19,1903,3182,2224,-958
2020,4,17,20,1830,3148,2169,-979
2020,4,17,21,1837,3096,2172,-924
2020,4,17,22,1793,3051,1968,-1083
2020,4,17,23,1755,3043,2173,-870
2020,4,18,0,1779,3078,2209,-869
2020,4,18,1,1811,3166,2296,-870
2020,4,18,2,1820,3099,2269,-830
2020,4,18,3,1714,3031,2203,-828
2020,4,18,4,1783,3037,2193,-844
2020,4,18,5,1684,2821,2123,-698
2020,4,18,6,2027,2640,2152,-488
2020,4,18,7,1856,2491,2229,-262
2020,4,18,8,1778,2393,2147,-246
2020,4,18,9,1696,2299,2088,-211
2020,4,18,10,1634,2221,1931,-290
2020,4,18,11,1683,2234,1920,-314
2020,4,18,12,1667,2231,1845,-386
2020,4,18,13,1683,2451,2021,-430
2020,4,18,14,1343,2571,1974,-597
2020,4,18,15,1550,2662,1921,-741
2020,4,18,16,1615,2865,2055,-810
2020,4,18,17,1718,3030,2091,-939
2020,4,18,18,1834,3121,2116,-1005
2020,4,18,19,1815,3093,2047,-1046
2020,4,18,20,1772,3121,2077,-1044
2020,4,18,21,1732,3065,2032,-1033
2020,4,18,22,1620,2924,1766,-1158
2020,4,18,23,1582,2872,1758,-1114
2020,4,19,0,1767,2940,1922,-1018
2020,4,19,1,1619,3056,2122,-934
2020,4,19,2,1636,3063,2226,-837
2020,4,19,3,1643,3043,2292,-751
2020,4,19,4,1887,3064,2242,-822
2020,4,19,5,1659,2926,2113,-813
2020,4,19,6,1992,2783,2126,-657
2020,4,19,7,1823,2611,2026,-585
2020,4,19,8,1766,2498,2063,-435
2020,4,19,9,1712,2427,2119,-308
2020,4,19,10,1684,2424,2133,-291
2020,4,19,11,1705,2334,2107,-227
2020,4,19,12,1730,2355,2111,-244
2020,4,19,13,1741,2464,2133,-331
2020,4,19,14,1687,2515,1925,-590
2020,4,19,15,1746,2681,1777,-904
2020,4,19,16,1748,2861,1860,-1001
2020,4,19,17,1855,3029,2151,-878
2020,4,19,18,2008,3024,2173,-851
2020,4,19,19,1880,3081,2245,-836
2020,4,19,20,2013,3048,2269,-779
2020,4,19,21,1918,3023,2285,-738
2020,4,19,22,1895,2965,2273,-692
2020,4,19,23,1870,2949,2229,-720
2020,4,20,0,1939,2980,2158,-822
2020,4,20,1,1960,3064,2258,-806
2020,4,20,2,1992,3088,2258,-830
2020,4,20,3,2032,2978,2280,-698
2020,4,20,4,2125,3021,2281,-740
2020,4,20,5,2004,2935,2286,-649
2020,4,20,6,2128,2754,2277,-477
2020,4,20,7,1984,2574,2287,-287
2020,4,20,8,1975,2408,2190,-218
2020,4,20,9,2025,2344,2135,-209
2020,4,20,10,2000,2330,2112,-218
2020,4,20,11,2011,2366,2094,-272
2020,4,20,12,2089,2481,2116,-365
2020,4,20,13,2365,2688,2163,-525
2020,4,20,14,2302,2932,2117,-815
2020,4,20,15,2263,3231,2479,-752
2020,4,20,16,2520,3320,2656,-664
2020,4,20,17,2504,3299,2659,-640
2020,4,20,18,2322,3233,2506,-727
2020,4,20,19,2231,3201,2269,-932
2020,4,20,20,2179,3133,2228,-905
2020,4,20,21,2118,3140,2339,-801
2020,4,20,22,2063,3037,2324,-713
2020,4,20,23,2034,2981,2256,-725
2020,4,21,0,2083,2905,2028,-877
2020,4,21,1,2144,3015,2192,-823
2020,4,21,2,2156,3069,2348,-721
2020,4,21,3,2161,3025,2334,-691
2020,4,21,4,2238,3085,2451,-634
2020,4,21,5,2092,2964,2410,-554
2020,4,21,6,2214,2788,2443,-345
2020,4,21,7,1983,2591,2225,-366
2020,4,21,8,2194,2480,2408,-72
2020,4,21,9,2002,2403,2210,-193
2020,4,21,10,1966,2296,2127,-169
2020,4,21,11,1942,2333,2136,-197
2020,4,21,12,2041,2410,2242,-168
2020,4,21,13,2117,2635,2386,-249
2020,4,21,14,2126,2810,2317,-493
2020,4,21,15,2184,3079,2327,-752
2020,4,21,16,2205,3223,2321,-902
2020,4,21,17,2225,3261,2174,-1087
2020,4,21,18,2201,3281,2089,-1192
2020,4,21,19,2174,3287,2141,-1146
2020,4,21,20,2164,3271,2166,-1105
2020,4,21,21,2117,3219,2227,-992
2020,4,21,22,2092,3153,2145,-1008
2020,4,21,23,2079,3127,2091,-1036
2020,4,22,0,2107,3096,2120,-976
2020,4,22,1,2185,3256,2284,-972
2020,4,22,2,2097,3313,2412,-901
2020,4,22,3,2120,3245,2373,-872
2020,4,22,4,2217,3177,2330,-847
2020,4,22,5,2164,3089,2375,-714
2020,4,22,6,2293,2891,2393,-498
2020,4,22,7,2211,2748,2458,-290
2020,4,22,8,1962,2563,2137,-426
2020,4,22,9,1990,2473,2064,-409
2020,4,22,10,1971,2462,2170,-292
2020,4,22,11,1900,2463,2206,-257
2020,4,22,12,1968,2548,2255,-293
2020,4,22,13,2090,2729,2299,-430
2020,4,22,14,1865,2967,2246,-721
2020,4,22,15,1904,3156,2130,-1026
2020,4,22,16,1946,3296,2141,-1155
2020,4,22,17,2008,3393,2249,-1144
2020,4,22,18,1975,3457,2278,-1179
2020,4,22,19,1998,3455,2179,-1276
2020,4,22,20,1948,3466,2185,-1281
2020,4,22,21,1935,3459,2177,-1282
2020,4,22,22,1954,3417,2176,-1241
2020,4,22,23,1836,3407,2208,-1199
2020,4,23,0,1956,3419,2176,-1243
2020,4,23,1,1908,3494,2263,-1231
2020,4,23,2,1870,3446,2251,-1195
2020,4,23,3,1812,3383,2321,-1062
2020,4,23,4,1870,3358,2308,-1050
2020,4,23,5,1825,3208,2302,-906
2020,4,23,6,2192,2991,2358,-633
2020,4,23,7,1954,2782,2168,-614
2020,4,23,8,1242,2669,1637,-1032
2020,4,23,9,1185,2531,1626,-905
2020,4,23,10,1175,2495,1661,-834
2020,4,23,11,1357,2494,1652,-842
2020,4,23,12,1312,2592,1734,-858
2020,4,23,13,1475,2770,1737,-1033
2020,4,23,14,1346,2983,1698,-1285
2020,4,23,15,1526,3187,1670,-1517
2020,4,23,16,1510,3279,1644,-1635
2020,4,23,17,1514,3360,1559,-1801
2020,4,23,18,1461,3353,1545,-1808
2020,4,23,19,1458,3342,1538,-1804
2020,4,23,20,1431,3294,1615,-1679
2020,4,23,21,1254,3227,1639,-1588
2020,4,23,22,1413,3139,1697,-1442
2020,4,23,23,1230,3110,1656,-1454
2020,4,24,0,1461,3127,1647,-1480
2020,4,24,1,1243,3222,1662,-1560
2020,4,24,2,1306,3193,1657,-1536
2020,4,24,3,1471,3179,1705,-1474
2020,4,24,4,1442,3221,1707,-1514
2020,4,24,5,1411,3113,1743,-1370
2020,4,24,6,1356,2918,1821,-1097
2020,4,24,7,1266,2742,1911,-831
2020,4,24,8,1692,2506,1916,-590
2020,4,24,9,1806,2423,1843,-580
2020,4,24,10,1672,2393,1763,-630
2020,4,24,11,1826,2418,1886,-532
2020,4,24,12,1760,2495,1901,-594
2020,4,24,13,1971,2652,1837,-815
2020,4,24,14,1994,2865,1816,-1049
2020,4,24,15,2069,3169,2155,-1014
2020,4,24,16,2207,3289,2350,-939
2020,4,24,17,2182,3283,2310,-973
2020,4,24,18,2014,3259,2224,-1035
2020,4,24,19,1991,3241,2210,-1031
2020,4,24,20,1971,3245,2194,-1051
2020,4,24,21,2004,3195,2228,-967
2020,4,24,22,1949,3108,2186,-922
2020,4,24,23,2072,3081,2199,-882
2020,4,25,0,1934,3071,2181,-890
2020,4,25,1,1973,3125,2118,-1007
2020,4,25,2,1989,3136,2184,-952
2020,4,25,3,1992,3107,2167,-940
2020,4,25,4,2054,3138,2242,-896
2020,4,25,5,1992,3027,2143,-884
2020,4,25,6,2093,2817,2133,-684
2020,4,25,7,2012,2660,2125,-535
2020,4,25,8,1978,2484,2071,-413
2020,4,25,9,1894,2351,1980,-371
2020,4,25,10,1829,2283,1900,-383
2020,4,25,11,1778,2277,1885,-392
2020,4,25,12,1833,2292,1881,-411
2020,4,25,13,1876,2379,1863,-516
2020,4,25,14,1695,2521,1907,-614
2020,4,25,15,1860,2670,1868,-802
2020,4,25,16,1923,2867,2009,-858
2020,4,25,17,1987,3018,2019,-999
2020,4,25,18,2073,3101,2128,-973
2020,4,25,19,2085,3176,2306,-870
2020,4,25,20,2015,3127,2295,-832
2020,4,25,21,1976,3012,2166,-846
2020,4,25,22,1840,2888,2020,-868
2020,4,25,23,1848,2838,2092,-746
2020,4,26,0,1865,2843,2102,-741
2020,4,26,1,1859,2903,2093,-810
2020,4,26,2,1950,2906,2049,-857
2020,4,26,3,1906,2935,2140,-795
2020,4,26,4,1940,3008,2227,-781
2020,4,26,5,1924,2926,2211,-715
2020,4,26,6,1978,2835,2351,-484
2020,4,26,7,1944,2598,2083,-515
2020,4,26,8,1246,2235,1550,-685
2020,4,26,9,1313,2118,1435,-683
2020,4,26,10,1122,2111,1535,-576
2020,4,26,11,1124,2162,1593,-569
2020,4,26,12,1135,2225,1554,-671
2020,4,26,13,1165,2338,1522,-816
2020,4,26,14,833,2446,1413,-1033
2020,4,26,15,927,2526,1249,-1277
2020,4,26,16,1132,2620,1105,-1515
2020,4,26,17,1286,2669,1155,-1514
2020,4,26,18,1331,2732,1259,-1473
2020,4,26,19,1352,2752,1286,-1466
2020,4,26,20,1374,2734,1135,-1599
2020,4,26,21,1335,2693,1205,-1488
2020,4,26,22,1295,2656,1273,-1383
2020,4,26,23,1288,2675,1356,-1319
2020,4,27,0,1333,2760,1500,-1260
2020,4,27,1,1397,2833,1547,-1286
2020,4,27,2,1431,2907,1621,-1286
2020,4,27,3,1419,2927,1692,-1235
2020,4,27,4,1449,3134,1841,-1293
2020,4,27,5,1381,3019,1896,-1123
2020,4,27,6,1440,2833,1923,-910
2020,4,27,7,1428,2524,1874,-650
2020,4,27,8,1358,2272,1713,-559
2020,4,27,9,1400,2201,1695,-506
2020,4,27,10,1407,2159,1613,-546
2020,4,27,11,1385,2180,1590,-590
2020,4,27,12,1388,2256,1524,-732
2020,4,27,13,1376,2429,1573,-856
2020,4,27,14,1241,2640,1539,-1101
2020,4,27,15,1243,2823,1415,-1408
2020,4,27,16,1349,2908,1403,-1505
2020,4,27,17,1368,2964,1448,-1516
2020,4,27,18,1356,2950,1303,-1647
2020,4,27,19,1295,2948,1309,-1639
2020,4,27,20,1263,2949,1290,-1659
2020,4,27,21,1205,2899,1378,-1521
2020,4,27,22,1142,2840,1372,-1468
2020,4,27,23,1104,2777,1360,-1417
2020,4,28,0,1121,2810,1386,-1424
2020,4,28,1,1232,2867,1357,-1510
2020,4,28,2,1249,2880,1406,-1474
2020,4,28,3,1219,2893,1539,-1354
2020,4,28,4,1246,2912,1542,-1370
2020,4,28,5,1216,2774,1474,-1300
2020,4,28,6,1258,2698,1524,-1174
2020,4,28,7,1130,2455,1450,-1005
2020,4,28,8,1125,2216,1227,-989
2020,4,28,9,1116,2155,1224,-931
2020,4,28,10,1203,2229,1373,-856
2020,4,28,11,1210,2255,1392,-863
2020,4,28,12,1329,2457,1558,-899
2020,4,28,13,1469,2654,1644,-1010
2020,4,28,14,1471,2889,1673,-1216
2020,4,28,15,1655,3063,1578,-1485
2020,4,28,16,1601,3275,1735,-1540
2020,4,28,17,1633,3194,1574,-1620
2020,4,28,18,1478,3176,1585,-1591
2020,4,28,19,1446,3217,1635,-1582
2020,4,28,20,1436,3207,1694,-1513
2020,4,28,21,1397,3155,1725,-1430
2020,4,28,22,1336,3109,1759,-1350
2020,4,28,23,1308,3087,1754,-1333
2020,4,29,0,1359,3118,1760,-1358
2020,4,29,1,1528,3175,1852,-1323
2020,4,29,2,1595,3234,1887,-1347
2020,4,29,3,1515,3218,1877,-1341
2020,4,29,4,1525,3208,1881,-1327
2020,4,29,5,1351,3102,1792,-1310
2020,4,29,6,1618,2912,1877,-1035
2020,4,29,7,1318,2662,1756,-906
2020,4,29,8,1237,2526,1763,-763
2020,4,29,9,1178,2243,1530,-713
2020,4,29,10,1169,2193,1533,-660
2020,4,29,11,1180,2200,1543,-657
2020,4,29,12,1293,2380,1583,-797
2020,4,29,13,1472,2700,1749,-951
2020,4,29,14,1678,2912,1798,-1114
2020,4,29,15,1685,3052,1711,-1341
2020,4,29,16,1689,3148,1785,-1363
2020,4,29,17,1704,3163,1789,-1374
2020,4,29,18,1677,3177,1802,-1375
2020,4,29,19,1672,3178,1785,-1393
2020,4,29,20,1670,3170,1774,-1396
2020,4,29,21,1565,3116,1672,-1444
2020,4,29,22,1574,3007,1674,-1333
2020,4,29,23,1528,2827,1494,-1333
2020,4,30,0,1318,3110,1523,-1587
2020,4,30,1,1382,3138,1530,-1608
2020,4,30,2,1412,3173,1580,-1593
2020,4,30,3,1345,3134,1610,-1524
2020,4,30,4,1267,3136,1684,-1452
2020,4,30,5,1119,3016,1610,-1406
2020,4,30,6,1030,2643,1303,-1340
2020,4,30,7,838,2397,1263,-1134
2020,4,30,8,843,2248,1228,-1020
2020,4,30,9,779,2155,1161,-994
2020,4,30,10,735,2138,1187,-951
2020,4,30,11,773,2145,1190,-955
2020,4,30,12,842,2221,1290,-931
2020,4,30,13,869,2383,1285,-1098
2020,4,30,14,742,2566,1200,-1366
2020,4,30,15,917,2760,1265,-1495
2020,4,30,16,733,2853,1216,-1637
2020,4,30,17,913,2819,1090,-1729
2020,4,30,18,890,2875,1212,-1663
2020,4,30,19,895,2956,1368,-1588
2020,4,30,20,743,2938,1273,-1665
2020,4,30,21,865,2905,1268,-1637
2020,4,30,22,819,2846,1276,-1570
2020,4,30,23,802,2809,1267,-1542
2020,5,1,0,808,2830,1244,-1586
2020,5,1,1,885,2829,1120,-1709
2020,5,1,2,908,2919,1278,-1641
2020,5,1,3,892,2919,1325,-1594
2020,5,1,4,771,2951,1320,-1631
2020,5,1,5,842,2898,1341,-1557
2020,5,1,6,1049,2888,1600,-1288
2020,5,1,7,846,2677,1458,-1219
2020,5,1,8,966,2398,1260,-1138
2020,5,1,9,920,2264,1194,-1070
2020,5,1,10,844,2259,1190,-1069
2020,5,1,11,960,2298,1230,-1068
2020,5,1,12,1153,2550,1406,-1144
2020,5,1,13,1344,2850,1590,-1260
2020,5,1,14,1232,3105,1585,-1520
2020,5,1,15,1318,3264,1604,-1660
2020,5,1,16,1321,3276,1527,-1749
2020,5,1,17,1306,3161,1509,-1652
2020,5,1,18,1256,3092,1434,-1658
2020,5,1,19,1159,3040,1439,-1601
2020,5,1,20,1110,3014,1445,-1569
2020,5,1,21,1192,2944,1339,-1605
2020,5,1,22,1127,2899,1333,-1566
2020,5,1,23,1078,2842,1316,-1526
2020,5,2,0,1078,2841,1295,-1546
2020,5,2,1,1033,3076,1483,-1593
2020,5,2,2,1019,3083,1503,-1580
2020,5,2,3,956,3061,1516,-1545
2020,5,2,4,967,3079,1665,-1414
2020,5,2,5,931,3001,1631,-1370
2020,5,2,6,1223,2839,1604,-1235
2020,5,2,7,1214,2664,1527,-1137
2020,5,2,8,1255,2505,1463,-1042
2020,5,2,9,1116,2427,1444,-983
2020,5,2,10,1091,2384,1483,-901
2020,5,2,11,1082,2359,1440,-919
2020,5,2,12,1073,2317,1319,-998
2020,5,2,13,1122,2374,1269,-1105
2020,5,2,14,568,2255,1024,-1231
2020,5,2,15,740,2499,1081,-1418
2020,5,2,16,969,2810,1225,-1585
2020,5,2,17,1113,2950,1347,-1603
2020,5,2,18,1169,3063,1485,-1578
2020,5,2,19,1187,3154,1478,-1676
2020,5,2,20,1158,3177,1504,-1673
2020,5,2,21,1077,3148,1455,-1693
2020,5,2,22,996,3144,1427,-1717
2020,5,2,23,946,3158,1357,-1801
2020,5,3,0,938,3173,1384,-1789
2020,5,3,1,989,3177,1483,-1694
2020,5,3,2,871,3043,1616,-1427
2020,5,3,3,883,2940,1552,-1388
2020,5,3,4,896,2870,1266,-1604
2020,5,3,5,941,2884,1563,-1321
2020,5,3,6,1124,2709,1572,-1137
2020,5,3,7,966,2495,1506,-989
2020,5,3,8,859,2365,1252,-1113
2020,5,3,9,848,2282,1197,-1085
2020,5,3,10,820,2221,1152,-1069
2020,5,3,11,827,2264,1251,-1013
2020,5,3,12,839,2311,1235,-1076
2020,5,3,13,856,2408,1234,-1174
2020,5,3,14,604,2499,1145,-1354
2020,5,3,15,760,2530,919,-1611
2020,5,3,16,642,2605,682,-1923
2020,5,3,17,579,2699,723,-1976
2020,5,3,18,617,2711,745,-1966
2020,5,3,19,636,2697,779,-1918
2020,5,3,20,630,2677,793,-1884
2020,5,3,21,564,2752,915,-1837
2020,5,3,22,505,2711,1026,-1685
2020,5,3,23,478,2647,1036,-1611
2020,5,4,0,547,2703,1146,-1557
2020,5,4,1,683,2833,1245,-1588
2020,5,4,2,768,2856,1352,-1504
2020,5,4,3,831,2823,1356,-1467
2020,5,4,4,932,2904,1363,-1541
2020,5,4,5,959,2835,1341,-1494
2020,5,4,6,839,2695,1314,-1381
2020,5,4,7,818,2509,1287,-1222
2020,5,4,8,756,2393,1074,-1319
2020,5,4,9,638,2342,997,-1345
2020,5,4,10,700,2314,994,-1320
2020,5,4,11,693,2388,994,-1394
2020,5,4,12,729,2559,990,-1569
2020,5,4,13,1014,2791,1257,-1534
2020,5,4,14,974,3049,1219,-1830
2020,5,4,15,1020,3203,1217,-1986
2020,5,4,16,958,3206,1177,-2029
2020,5,4,17,989,3199,1033,-2166
2020,5,4,18,948,3151,1208,-1943
2020,5,4,19,870,3108,1154,-1954
2020,5,4,20,819,3068,1215,-1853
2020,5,4,21,809,2991,1235,-1756
2020,5,4,22,847,2911,1246,-1665
2020,5,4,23,862,2872,1259,-1613
2020,5,5,0,888,2891,1255,-1636
2020,5,5,1,866,2985,1260,-1725
2020,5,5,2,984,2987,1355,-1632
2020,5,5,3,943,2962,1356,-1606
2020,5,5,4,934,2949,1350,-1599
2020,5,5,5,852,2854,1247,-1607
2020,5,5,6,774,2650,1257,-1393
2020,5,5,7,574,2449,1259,-1190
2020,5,5,8,917,2307,1257,-1050
2020,5,5,9,921,2248,1271,-977
2020,5,5,10,913,2205,1268,-937
2020,5,5,11,916,2218,1266,-952
2020,5,5,12,1009,2309,1277,-1032
2020,5,5,13,990,2476,1277,-1199
2020,5,5,14,870,2684,1256,-1428
2020,5,5,15,1030,2867,1322,-1545
2020,5,5,16,1046,2952,1358,-1594
2020,5,5,17,964,2947,1357,-1590
2020,5,5,18,1019,2927,1353,-1574
2020,5,5,19,1039,2913,1347,-1566
2020,5,5,20,980,2908,1260,-1648
2020,5,5,21,989,2859,1251,-1608
2020,5,5,22,979,2816,1237,-1579
2020,5,5,23,970,2793,1214,-1579
2020,5,6,0,1032,2821,1220,-1601
2020,5,6,1,1045,2896,1255,-1641
2020,5,6,2,1146,2892,1328,-1564
2020,5,6,3,1122,2856,1347,-1509
2020,5,6,4,1092,2865,1349,-1516
2020,5,6,5,1022,2778,1353,-1425
2020,5,6,6,1054,2581,1376,-1205
2020,5,6,7,969,2379,1392,-987
2020,5,6,8,725,2197,1156,-1041
2020,5,6,9,803,2123,1059,-1064
2020,5,6,10,831,2115,1119,-996
2020,5,6,11,655,2056,1195,-861
2020,5,6,12,713,2123,1282,-841
2020,5,6,13,769,2286,1270,-1016
2020,5,6,14,646,2535,1271,-1264
2020,5,6,15,930,2704,1241,-1463
2020,5,6,16,874,2865,1274,-1591
2020,5,6,17,871,2887,1201,-1686
2020,5,6,18,910,2857,965,-1892
2020,5,6,19,933,2883,1165,-1718
2020,5,6,20,939,2883,1211,-1672
2020,5,6,21,930,2798,1150,-1648
2020,5,6,22,939,2754,1185,-1569
2020,5,6,23,908,2688,1143,-1545
2020,5,7,0,882,2783,1246,-1537
2020,5,7,1,864,2757,1152,-1605
2020,5,7,2,862,2859,1233,-1626
2020,5,7,3,834,2852,1262,-1590
2020,5,7,4,871,2895,1304,-1591
2020,5,7,5,952,2896,1334,-1562
2020,5,7,6,981,2699,1281,-1418
2020,5,7,7,901,2500,1211,-1289
2020,5,7,8,797,2367,1194,-1173
2020,5,7,9,770,2307,1124,-1183
2020,5,7,10,613,2292,1068,-1224
2020,5,7,11,660,2320,1077,-1243
2020,5,7,12,960,2398,1138,-1260
2020,5,7,13,1110,2543,1301,-1242
2020,5,7,14,1058,2745,1283,-1462
2020,5,7,15,1251,2954,1302,-1652
2020,5,7,16,1179,2984,1305,-1679
2020,5,7,17,1165,2947,1318,-1629
2020,5,7,18,1172,2906,1309,-1597
2020,5,7,19,1058,2865,1298,-1567
2020,5,7,20,1078,2823,1296,-1527
2020,5,7,21,1039,2762,1291,-1471
2020,5,7,22,974,2694,1291,-1403
2020,5,7,23,951,2680,1290,-1390
2020,5,8,0,1010,2706,1368,-1338
2020,5,8,1,1011,2757,1356,-1401
2020,5,8,2,1017,2777,1338,-1439
2020,5,8,3,982,2771,1298,-1473
2020,5,8,4,1035,2727,1258,-1469
2020,5,8,5,1039,2711,1253,-1458
2020,5,8,6,1020,2478,1257,-1221
2020,5,8,7,985,2345,1285,-1060
2020,5,8,8,870,2219,1236,-983
2020,5,8,9,881,2133,1233,-900
2020,5,8,10,883,2114,1241,-873
2020,5,8,11,945,2165,1241,-924
2020,5,8,12,992,2281,1285,-996
2020,5,8,13,1010,2437,1397,-1040
2020,5,8,14,906,2639,1356,-1283
2020,5,8,15,1077,2796,1431,-1365
2020,5,8,16,1136,2866,1503,-1363
2020,5,8,17,1153,2788,1410,-1378
2020,5,8,18,1171,2879,1510,-1369
2020,5,8,19,1194,2881,1504,-1377
2020,5,8,20,1211,2877,1378,-1499
2020,5,8,21,1187,2854,1375,-1479
2020,5,8,22,1164,2829,1361,-1468
2020,5,8,23,1152,2829,1351,-1478
2020,5,9,0,1178,2874,1351,-1523
2020,5,9,1,1239,2901,1370,-1531
2020,5,9,2,1209,2921,1381,-1540
2020,5,9,3,1124,2858,1366,-1492
2020,5,9,4,1056,2835,1440,-1395
2020,5,9,5,972,2778,1433,-1345
2020,5,9,6,1026,2567,1421,-1146
2020,5,9,7,892,2404,1397,-1007
2020,5,9,8,823,2207,1118,-1089
2020,5,9,9,712,2097,1084,-1013
2020,5,9,10,656,2037,1164,-873
2020,5,9,11,646,2009,1209,-800
2020,5,9,12,665,2016,1233,-783
2020,5,9,13,814,2051,1231,-820
2020,5,9,14,593,2106,1185,-921
2020,5,9,15,675,2161,1021,-1140
2020,5,9,16,829,2422,1152,-1270
2020,5,9,17,821,2567,1105,-1462
2020,5,9,18,815,2666,1092,-1574
2020,5,9,19,851,2724,1142,-1582
2020,5,9,20,884,2766,1134,-1632
2020,5,9,21,858,2781,1136,-1645
2020,5,9,22,748,2786,1134,-1652
2020,5,9,23,704,2825,1154,-1671
2020,5,10,0,681,2923,1207,-1716
2020,5,10,1,801,2976,1188,-1788
2020,5,10,2,766,2966,1133,-1833
2020,5,10,3,633,2892,1134,-1758
2020,5,10,4,627,2861,1197,-1664
2020,5,10,5,547,2825,1118,-1707
2020,5,10,6,735,2650,1173,-1477
2020,5,10,7,562,2434,1163,-1271
2020,5,10,8,751,2240,1089,-1151
2020,5,10,9,662,2125,1130,-995
2020,5,10,10,650,2051,1132,-919
2020,5,10,11,709,2017,1149,-868
2020,5,10,12,709,1995,1157,-838
2020,5,10,13,667,2012,1203,-809
2020,5,10,14,623,2049,1234,-815
2020,5,10,15,773,2122,1123,-999
2020,5,10,16,698,2227,968,-1259
2020,5,10,17,929,2430,1077,-1353
2020,5,10,18,907,2697,1222,-1475
2020,5,10,19,932,2791,1181,-1610
2020,5,10,20,887,2819,1166,-1653
2020,5,10,21,892,2872,1125,-1747
2020,5,10,22,1076,2896,1040,-1856
2020,5,10,23,1046,2909,1176,-1733
2020,5,11,0,1145,3018,1284,-1734
2020,5,11,1,1216,3095,1276,-1819
2020,5,11,2,1185,3100,1311,-1789
2020,5,11,3,1185,3221,1393,-1828
2020,5,11,4,1144,3215,1425,-1790
2020,5,11,5,1021,3225,1406,-1819
2020,5,11,6,1131,2977,1381,-1596
2020,5,11,7,1119,2534,1226,-1308
2020,5,11,8,778,2338,1229,-1109
2020,5,11,9,825,2224,1248,-976
2020,5,11,10,723,2156,1243,-913
2020,5,11,11,716,2131,1271,-860
2020,5,11,12,816,2175,1275,-900
2020,5,11,13,830,2246,1268,-978
2020,5,11,14,672,2314,1189,-1125
2020,5,11,15,722,2499,1230,-1269
2020,5,11,16,924,2662,1236,-1426
2020,5,11,17,973,2770,1227,-1543
2020,5,11,18,1084,2857,1313,-1544
2020,5,11,19,1088,2943,1313,-1630
2020,5,11,20,1084,3132,1400,-1732
2020,5,11,21,1069,3159,1412,-1747
2020,5,11,22,1145,3124,1395,-1729
2020,5,11,23,1085,3086,1393,-1693
2020,5,12,0,1028,3063,1313,-1750
2020,5,12,1,1015,3116,1262,-1854
2020,5,12,2,998,3086,1267,-1819
2020,5,12,3,977,2973,1226,-1747
2020,5,12,4,966,2924,1245,-1679
2020,5,12,5,888,2814,1221,-1593
2020,5,12,6,1168,2617,1216,-1401
2020,5,12,7,1152,2415,1201,-1214
2020,5,12,8,743,2192,1056,-1136
2020,5,12,9,670,2088,972,-1116
2020,5,12,10,653,2051,1003,-1048
2020,5,12,11,712,2042,1050,-992
2020,5,12,12,678,2098,991,-1107
2020,5,12,13,784,2215,1072,-1143
2020,5,12,14,484,2350,942,-1408
2020,5,12,15,649,2563,944,-1619
2020,5,12,16,807,2701,990,-1711
2020,5,12,17,765,2772,999,-1773
2020,5,12,18,838,2823,1037,-1786
2020,5,12,19,901,2932,1172,-1760
2020,5,12,20,913,2962,1170,-1792
2020,5,12,21,907,2947,1116,-1831
2020,5,12,22,868,2915,1235,-1680
2020,5,12,23,830,2896,1311,-1585
2020,5,13,0,779,2931,1305,-1626
2020,5,13,1,798,2996,1371,-1625
2020,5,13,2,763,2968,1411,-1557
2020,5,13,3,737,2924,1420,-1504
2020,5,13,4,760,2903,1381,-1522
2020,5,13,5,792,2731,1322,-1409
2020,5,13,6,830,2537,1380,-1157
2020,5,13,7,1044,2342,1362,-980
2020,5,13,8,837,2181,1257,-924
2020,5,13,9,814,2099,1283,-816
2020,5,13,10,794,2054,1285,-769
2020,5,13,11,797,2051,1274,-777
2020,5,13,12,847,2113,1288,-825
2020,5,13,13,886,2268,1296,-972
2020,5,13,14,772,2450,1265,-1185
2020,5,13,15,719,2603,1277,-1326
2020,5,13,16,658,2746,1293,-1453
2020,5,13,17,678,2806,1299,-1507
2020,5,13,18,658,2832,1294,-1538
2020,5,13,19,633,2867,1275,-1592
2020,5,13,20,619,2876,1168,-1708
2020,5,13,21,610,2842,1141,-1701
2020,5,13,22,573,2771,1161,-1610
2020,5,13,23,575,2742,1171,-1571
2020,5,14,0,703,2781,1149,-1632
2020,5,14,1,814,2860,1239,-1621
2020,5,14,2,826,2857,1198,-1659
2020,5,14,3,833,2811,1160,-1651
2020,5,14,4,832,2786,1158,-1628
2020,5,14,5,824,2754,1208,-1546
2020,5,14,6,855,2634,1236,-1398
2020,5,14,7,705,2381,1173,-1208
2020,5,14,8,752,2212,1104,-1108
2020,5,14,9,670,2134,1038,-1096
2020,5,14,10,620,2090,1025,-1065
2020,5,14,11,590,2096,1031,-1065
2020,5,14,12,702,2158,1042,-1116
2020,5,14,13,750,2282,1076,-1206
2020,5,14,14,565,2486,989,-1497
2020,5,14,15,621,2680,992,-1688
2020,5,14,16,592,2800,974,-1826
2020,5,14,17,672,2877,1088,-1789
2020,5,14,18,682,2951,1118,-1833
2020,5,14,19,695,2982,1132,-1850
2020,5,14,20,715,2987,1141,-1846
2020,5,14,21,683,2952,1131,-1821
2020,5,14,22,697,2896,1138,-1758
2020,5,14,23,680,2869,1151,-1718
2020,5,15,0,651,2894,1145,-1749
2020,5,15,1,704,2954,1139,-1815
2020,5,15,2,701,2865,1076,-1789
2020,5,15,3,653,2797,1073,-1724
2020,5,15,4,641,2908,1179,-1729
2020,5,15,5,583,2780,1034,-1746
2020,5,15,6,764,2606,1108,-1498
2020,5,15,7,639,2374,1017,-1357
2020,5,15,8,687,2217,1046,-1171
2020,5,15,9,649,2139,1179,-960
2020,5,15,10,630,2094,1183,-911
2020,5,15,11,681,2097,1144,-953
2020,5,15,12,625,2151,1121,-1030
2020,5,15,13,675,2242,1100,-1142
2020,5,15,14,573,2422,1057,-1365
2020,5,15,15,754,2654,1024,-1630
2020,5,15,16,809,2715,948,-1767
2020,5,15,17,872,2770,1007,-1763
2020,5,15,18,944,2785,946,-1839
2020,5,15,19,1012,2801,974,-1827
2020,5,15,20,1026,2948,1149,-1799
2020,5,15,21,1018,2945,1189,-1756
2020,5,15,22,984,2772,1058,-1714
2020,5,15,23,956,2755,1093,-1662
2020,5,16,0,970,2794,1112,-1682
2020,5,16,1,998,2835,1115,-1720
2020,5,16,2,970,2832,1126,-1706
2020,5,16,3,923,2904,1236,-1668
2020,5,16,4,905,2908,1254,-1654
2020,5,16,5,894,2989,1349,-1640
2020,5,16,6,970,2832,1393,-1439
2020,5,16,7,1009,2643,1380,-1263
2020,5,16,8,834,2389,1190,-1199
2020,5,16,9,767,2205,1077,-1128
2020,5,16,10,653,2112,1034,-1078
2020,5,16,11,655,2091,1034,-1057
2020,5,16,12,661,2102,1065,-1037
2020,5,16,13,728,2159,1072,-1087
2020,5,16,14,595,2227,1060,-1167
2020,5,16,15,595,2366,1056,-1310
2020,5,16,16,754,2536,1082,-1454
2020,5,16,17,871,2685,1083,-1602
2020,5,16,18,942,2776,1143,-1633
2020,5,16,19,977,2842,1147,-1695
2020,5,16,20,955,2956,1267,-1689
2020,5,16,21,892,2943,1342,-1601
2020,5,16,22,848,2957,1413,-1544
2020,5,16,23,827,2937,1334,-1603
2020,5,17,0,844,2961,1292,-1669
2020,5,17,1,896,2981,1269,-1712
2020,5,17,2,888,2919,1222,-1697
2020,5,17,3,817,2890,1217,-1673
2020,5,17,4,814,2889,1208,-1681
2020,5,17,5,798,2824,1267,-1557
2020,5,17,6,992,2786,1358,-1428
2020,5,17,7,923,2562,1282,-1280
2020,5,17,8,824,2309,1111,-1198
2020,5,17,9,843,2215,1107,-1108
2020,5,17,10,816,2155,1109,-1046
2020,5,17,11,662,2098,1083,-1015
2020,5,17,12,724,2110,1094,-1016
2020,5,17,13,708,2137,1100,-1037
2020,5,17,14,631,2211,1093,-1118
2020,5,17,15,752,2312,1052,-1260
2020,5,17,16,702,2373,965,-1408
2020,5,17,17,1004,2607,1109,-1498
2020,5,17,18,824,2710,1056,-1654
2020,5,17,19,831,2752,1109,-1643
2020,5,17,20,825,2752,1122,-1630
2020,5,17,21,805,2685,1096,-1589
2020,5,17,22,761,2646,1043,-1603
2020,5,17,23,699,2641,1080,-1561
2020,5,18,0,666,2677,1041,-1636
2020,5,18,1,727,2762,1112,-1650
2020,5,18,2,751,2784,1100,-1684
2020,5,18,3,743,2742,1093,-1649
2020,5,18,4,787,2718,1229,-1489
2020,5,18,5,759,2705,1287,-1418
2020,5,18,6,838,2532,1244,-1288
2020,5,18,7,813,2343,1202,-1141
2020,5,18,8,838,2178,1161,-1017
2020,5,18,9,734,2110,1064,-1046
2020,5,18,10,777,2075,1080,-995
2020,5,18,11,729,2085,1103,-982
2020,5,18,12,844,2164,1179,-985
2020,5,18,13,977,2313,1208,-1105
2020,5,18,14,973,2556,1274,-1282
2020,5,18,15,1096,2726,1385,-1341
2020,5,18,16,1089,2835,1390,-1445
2020,5,18,17,1094,2884,1395,-1489
2020,5,18,18,1141,2896,1387,-1509
2020,5,18,19,1208,2911,1452,-1459
2020,5,18,20,1126,2921,1433,-1488
2020,5,18,21,1108,2884,1424,-1460
2020,5,18,22,1233,2844,1435,-1409
2020,5,18,23,1215,2824,1428,-1396
2020,5,19,0,1201,2845,1466,-1379
2020,5,19,1,1258,2917,1449,-1468
2020,5,19,2,1254,2914,1518,-1396
2020,5,19,3,1177,2874,1570,-1304
2020,5,19,4,1128,2840,1535,-1305
2020,5,19,5,1065,2776,1429,-1347
2020,5,19,6,905,2585,1385,-1200
2020,5,19,7,655,2369,1230,-1139
2020,5,19,8,743,2214,1024,-1190
2020,5,19,9,718,2126,1045,-1081
2020,5,19,10,601,2088,1038,-1050
2020,5,19,11,567,2086,1030,-1056
2020,5,19,12,688,2135,1009,-1126
2020,5,19,13,732,2269,1032,-1237
2020,5,19,14,548,2445,981,-1464
2020,5,19,15,599,2634,989,-1645
2020,5,19,16,662,2767,1054,-1713
2020,5,19,17,737,2832,1060,-1772
2020,5,19,18,813,2857,1026,-1831
2020,5,19,19,893,2888,1035,-1853
2020,5,19,20,832,2910,1030,-1880
2020,5,19,21,802,2859,1011,-1848
2020,5,19,22,758,2812,998,-1814
2020,5,19,23,730,2768,903,-1865
2020,5,20,0,762,2758,794,-1964
2020,5,20,1,834,2840,863,-1977
2020,5,20,2,837,2867,1051,-1816
2020,5,20,3,765,2784,1157,-1627
2020,5,20,4,803,2722,1131,-1591
2020,5,20,5,733,2761,1180,-1581
2020,5,20,6,875,2571,1193,-1378
2020,5,20,7,732,2372,1223,-1149
2020,5,20,8,823,2215,1207,-1008
2020,5,20,9,784,2131,1149,-982
2020,5,20,10,693,2093,1173,-920
2020,5,20,11,742,2094,1217,-877
2020,5,20,12,759,2164,1225,-939
2020,5,20,13,923,2298,1245,-1053
2020,5,20,14,792,2493,1209,-1284
2020,5,20,15,919,2685,1223,-1462
2020,5,20,16,1003,2827,1168,-1659
2020,5,20,17,987,2886,1024,-1862
2020,5,20,18,1017,2918,1055,-1863
2020,5,20,19,1017,2958,1207,-1751
2020,5,20,20,1033,2982,1287,-1695
2020,5,20,21,1027,2951,1329,-1622
2020,5,20,22,1010,2914,1300,-1614
2020,5,20,23,1006,2850,1132,-1718
2020,5,21,0,1012,2907,1219,-1688
2020,5,21,1,1034,3003,1331,-1672
2020,5,21,2,993,2974,1357,-1617
2020,5,21,3,934,2915,1375,-1540
2020,5,21,4,895,2874,1372,-1502
2020,5,21,5,867,2826,1340,-1486
2020,5,21,6,979,2651,1349,-1302
2020,5,21,7,867,2445,1319,-1126
2020,5,21,8,869,2305,1307,-998
2020,5,21,9,866,2217,1304,-913
2020,5,21,10,782,2181,1260,-921
2020,5,21,11,797,2197,1292,-905
2020,5,21,12,901,2264,1294,-970
2020,5,21,13,966,2444,1292,-1152
2020,5,21,14,789,2650,1277,-1373
2020,5,21,15,907,2773,1171,-1602
2020,5,21,16,994,2874,1124,-1750
2020,5,21,17,1041,2935,1132,-1803
2020,5,21,18,1063,2955,1173,-1782
2020,5,21,19,1087,2930,1192,-1738
2020,5,21,20,1083,2942,1226,-1716
2020,5,21,21,1034,2919,1354,-1565
2020,5,21,22,957,2884,1403,-1481
2020,5,21,23,918,2844,1402,-1442
2020,5,22,0,877,2896,1411,-1485
2020,5,22,1,931,2983,1408,-1575
2020,5,22,2,949,2964,1404,-1560
2020,5,22,3,934,2921,1388,-1533
2020,5,22,4,931,2905,1380,-1525
2020,5,22,5,925,2866,1387,-1479
2020,5,22,6,1115,2687,1383,-1304
2020,5,22,7,908,2486,1374,-1112
2020,5,22,8,942,2344,1366,-978
2020,5,22,9,883,2272,1263,-1009
2020,5,22,10,848,2236,1243,-993
2020,5,22,11,852,2248,1326,-922
2020,5,22,12,956,2321,1318,-1003
2020,5,22,13,1066,2473,1313,-1160
2020,5,22,14,852,2689,1305,-1384
2020,5,22,15,943,2850,1303,-1547
2020,5,22,16,1040,2966,1378,-1588
2020,5,22,17,1072,3036,1422,-1614
2020,5,22,18,1071,3036,1431,-1605
2020,5,22,19,1049,3027,1432,-1595
2020,5,22,20,1038,2980,1413,-1567
2020,5,22,21,973,2878,1363,-1515
2020,5,22,22,927,2826,1367,-1459
2020,5,22,23,964,2797,1371,-1426
2020,5,23,0,944,2815,1386,-1429
2020,5,23,1,998,2869,1391,-1478
2020,5,23,2,1002,2854,1386,-1468
2020,5,23,3,944,2807,1354,-1453
2020,5,23,4,930,2767,1266,-1501
2020,5,23,5,934,2773,1383,-1390
2020,5,23,6,1069,2622,1388,-1234
2020,5,23,7,942,2437,1361,-1076
2020,5,23,8,894,2296,1317,-979
2020,5,23,9,870,2198,1257,-941
2020,5,23,10,826,2130,1111,-1019
2020,5,23,11,752,2122,1025,-1097
2020,5,23,12,759,2085,1054,-1031
2020,5,23,13,695,2236,1179,-1057
2020,5,23,14,718,2338,1071,-1267
2020,5,23,15,702,2463,1006,-1457
2020,5,23,16,650,2550,866,-1684
2020,5,23,17,679,2595,829,-1766
2020,5,23,18,672,2671,852,-1819
2020,5,23,19,669,2723,918,-1805
2020,5,23,20,717,2705,958,-1747
2020,5,23,21,735,2680,987,-1693
2020,5,23,22,704,2632,963,-1669
2020,5,23,23,689,2580,962,-1618
2020,5,24,0,687,2594,988,-1606
2020,5,24,1,736,2645,1031,-1614
2020,5,24,2,718,2659,1074,-1585
2020,5,24,3,720,2636,1089,-1547
2020,5,24,4,722,2634,1101,-1533
2020,5,24,5,720,2652,1086,-1566
2020,5,24,6,715,2533,1115,-1418
2020,5,24,7,725,2364,1091,-1273
2020,5,24,8,748,2226,1052,-1174
2020,5,24,9,712,2138,1088,-1050
2020,5,24,10,687,2091,1104,-987
2020,5,24,11,701,2080,1088,-992
2020,5,24,12,735,2099,1088,-1011
2020,5,24,13,712,2134,1067,-1067
2020,5,24,14,662,2225,1017,-1208
2020,5,24,15,607,2321,874,-1447
2020,5,24,16,660,2430,881,-1549
2020,5,24,17,658,2567,1010,-1557
2020,5,24,18,700,2613,1009,-1604
2020,5,24,19,728,2624,1029,-1595
2020,5,24,20,736,2621,1040,-1581
2020,5,24,21,689,2580,1032,-1548
2020,5,24,22,659,2555,1027,-1528
2020,5,24,23,662,2546,1080,-1466
2020,5,25,0,669,2583,1094,-1489
2020,5,25,1,683,2653,1104,-1549
2020,5,25,2,694,2671,1093,-1578
2020,5,25,3,659,2648,1106,-1542
2020,5,25,4,668,2632,1093,-1539
2020,5,25,5,675,2639,1100,-1539
2020,5,25,6,726,2569,1189,-1380
2020,5,25,7,727,2334,1110,-1224
2020,5,25,8,778,2168,1052,-1116
2020,5,25,9,750,2064,1076,-988
2020,5,25,10,717,2019,1079,-940
2020,5,25,11,686,1987,1096,-891
2020,5,25,12,706,2012,1094,-918
2020,5,25,13,708,2047,1098,-949
2020,5,25,14,694,2124,1114,-1010
2020,5,25,15,704,2247,1086,-1161
2020,5,25,16,671,2397,1066,-1331
2020,5,25,17,714,2534,955,-1579
2020,5,25,18,796,2670,1021,-1649
2020,5,25,19,852,2771,1078,-1693
2020,5,25,20,861,2810,1125,-1685
2020,5,25,21,869,2819,1145,-1674
2020,5,25,22,857,2790,1141,-1649
2020,5,25,23,837,2770,1192,-1578
2020,5,26,0,864,2792,1252,-1540
2020,5,26,1,843,2823,1294,-1529
2020,5,26,2,853,2862,1340,-1522
2020,5,26,3,894,2780,1319,-1461
2020,5,26,4,894,2746,1313,-1433
2020,5,26,5,887,2696,1306,-1390
2020,5,26,6,950,2523,1334,-1189
2020,5,26,7,861,2325,1325,-1000
2020,5,26,8,807,2160,1279,-881
2020,5,26,9,784,2045,1169,-876
2020,5,26,10,810,2012,1205,-807
2020,5,26,11,755,2059,1274,-785
2020,5,26,12,799,2128,1267,-861
2020,5,26,13,922,2270,1335,-935
2020,5,26,14,1036,2467,1326,-1141
2020,5,26,15,1112,2636,1335,-1301
2020,5,26,16,1124,2812,1361,-1451
2020,5,26,17,1217,2872,1350,-1522
2020,5,26,18,1051,2880,1360,-1520
2020,5,26,19,1094,2876,1376,-1500
2020,5,26,20,1125,2851,1325,-1526
2020,5,26,21,1110,2852,1439,-1413
2020,5,26,22,1018,2788,1336,-1452
2020,5,26,23,1225,2756,1327,-1429
2020,5,27,0,1304,2777,1297,-1480
2020,5,27,1,1392,2886,1398,-1488
2020,5,27,2,1425,2939,1393,-1546
2020,5,27,3,1411,2770,1226,-1544
2020,5,27,4,1358,2717,1275,-1442
2020,5,27,5,1331,2739,1450,-1289
2020,5,27,6,1322,2584,1415,-1169
2020,5,27,7,1182,2376,1343,-1033
2020,5,27,8,1143,2340,1527,-813
2020,5,27,9,1047,2241,1548,-693
2020,5,27,10,1000,2096,1495,-601
2020,5,27,11,1025,2119,1500,-619
2020,5,27,12,1374,2319,1729,-590
2020,5,27,13,1403,2469,1802,-667
2020,5,27,14,1213,2555,1655,-900
2020,5,27,15,1301,2698,1633,-1065
2020,5,27,16,1372,2778,1781,-997
2020,5,27,17,1378,2804,1811,-993
2020,5,27,18,1430,2807,1809,-998
2020,5,27,19,1472,2830,1822,-1008
2020,5,27,20,1523,2853,1828,-1025
2020,5,27,21,1517,2943,1931,-1012
2020,5,27,22,1495,2933,1922,-1011
2020,5,27,23,1494,2940,1872,-1068
2020,5,28,0,1499,2985,1911,-1074
2020,5,28,1,1549,3062,1893,-1169
2020,5,28,2,1540,3058,1823,-1235
2020,5,28,3,1488,3008,1701,-1307
2020,5,28,4,1408,2843,1532,-1311
2020,5,28,5,1366,2807,1575,-1232
2020,5,28,6,1618,2739,1864,-875
2020,5,28,7,1390,2507,1807,-700
2020,5,28,8,917,2215,1389,-826
2020,5,28,9,901,2107,1278,-829
2020,5,28,10,944,2048,1305,-743
2020,5,28,11,933,2041,1258,-783
2020,5,28,12,944,2102,1334,-768
2020,5,28,13,1125,2310,1493,-817
2020,5,28,14,1251,2500,1614,-886
2020,5,28,15,1405,2668,1592,-1076
2020,5,28,16,1533,2806,1663,-1143
2020,5,28,17,1708,2770,1640,-1130
2020,5,28,18,1712,2823,1760,-1063
2020,5,28,19,1783,2892,1859,-1033
2020,5,28,20,1827,3067,1995,-1072
2020,5,28,21,1834,3094,2001,-1093
2020,5,28,22,1832,3109,1991,-1118
2020,5,28,23,1918,3147,2081,-1066
2020,5,29,0,1946,3199,2109,-1090
2020,5,29,1,1998,3275,2109,-1166
2020,5,29,2,1965,3206,2087,-1119
2020,5,29,3,1899,3155,2109,-1046
2020,5,29,4,1840,3084,2042,-1042
2020,5,29,5,1802,3033,2041,-992
2020,5,29,6,1628,2835,1972,-863
2020,5,29,7,1381,2596,1793,-803
2020,5,29,8,1154,2331,1422,-909
2020,5,29,9,1061,2169,1369,-800
2020,5,29,10,999,2089,1369,-720
2020,5,29,11,981,2055,1317,-738
2020,5,29,12,997,2104,1373,-731
2020,5,29,13,1120,2272,1448,-824
2020,5,29,14,1230,2463,1577,-886
2020,5,29,15,1484,2646,1687,-959
2020,5,29,16,1546,2679,1729,-950
2020,5,29,17,1637,2763,1796,-967
2020,5,29,18,1714,2830,1866,-964
2020,5,29,19,1777,2946,1931,-1015
2020,5,29,20,1816,3087,2003,-1084
2020,5,29,21,1825,3115,1987,-1128
2020,5,29,22,1817,3123,1997,-1126
2020,5,29,23,1895,3150,2003,-1147
2020,5,30,0,1924,3176,2067,-1109
2020,5,30,1,1927,3166,2100,-1066
2020,5,30,2,1867,3112,1938,-1174
2020,5,30,3,1764,3008,1991,-1017
2020,5,30,4,1683,2918,1887,-1031
2020,5,30,5,1669,2890,1950,-940
2020,5,30,6,1583,2726,1996,-730
2020,5,30,7,1373,2513,1925,-588
2020,5,30,8,1100,2254,1433,-821
2020,5,30,9,982,2070,1237,-833
2020,5,30,10,820,2049,1094,-955
2020,5,30,11,825,2015,1129,-886
2020,5,30,12,795,2015,1162,-853
2020,5,30,13,815,2040,1206,-834
2020,5,30,14,820,2102,1149,-953
2020,5,30,15,762,2171,1190,-981
2020,5,30,16,815,2459,1263,-1196
2020,5,30,17,981,2633,1197,-1436
2020,5,30,18,1052,2728,1158,-1570
2020,5,30,19,1081,2916,1254,-1662
2020,5,30,20,1020,2860,1182,-1678
2020,5,30,21,950,2877,1177,-1700
2020,5,30,22,874,2828,1145,-1683
2020,5,30,23,817,2805,1147,-1658
2020,5,31,0,893,2994,1241,-1753
2020,5,31,1,846,3059,1267,-1792
2020,5,31,2,879,3041,1520,-1521
2020,5,31,3,882,2842,1383,-1459
2020,5,31,4,929,2782,1409,-1373
2020,5,31,5,951,2704,1397,-1307
2020,5,31,6,1023,2550,1402,-1148
2020,5,31,7,981,2374,1392,-982
2020,5,31,8,1028,2243,1404,-839
2020,5,31,9,1096,2151,1402,-749
2020,5,31,10,1058,2104,1359,-745
2020,5,31,11,1035,2086,1372,-714
2020,5,31,12,964,2114,1421,-693
2020,5,31,13,983,2160,1443,-717
2020,5,31,14,695,2244,1223,-1021
2020,5,31,15,703,2376,1317,-1059
2020,5,31,16,769,2456,1278,-1178
2020,5,31,17,953,2597,1276,-1321
2020,5,31,18,1014,2658,1340,-1318
2020,5,31,19,1028,2733,1372,-1361
2020,5,31,20,1021,2750,1391,-1359
2020,5,31,21,989,2689,1382,-1307
2020,5,31,22,970,2686,1439,-1247
2020,5,31,23,878,2662,1398,-1264
2020,6,1,0,844,2640,1382,-1258
2020,6,1,1,808,2702,1402,-1300
2020,6,1,2,850,2755,1423,-1332
2020,6,1,3,871,2725,1430,-1295
2020,6,1,4,870,2692,1371,-1321
2020,6,1,5,883,2716,1356,-1360
2020,6,1,6,891,2568,1315,-1253
2020,6,1,7,834,2369,1271,-1098
2020,6,1,8,896,2234,1207,-1027
2020,6,1,9,898,2151,1159,-992
2020,6,1,10,840,2121,1148,-973
2020,6,1,11,799,2140,1155,-985
2020,6,1,12,837,2231,1155,-1076
2020,6,1,13,820,2387,1157,-1230
2020,6,1,14,746,2544,1039,-1505
2020,6,1,15,823,2763,1148,-1615
2020,6,1,16,932,2821,1144,-1677
2020,6,1,17,983,2832,1113,-1719
2020,6,1,18,1020,2840,1120,-1720
2020,6,1,19,1048,2845,1141,-1704
2020,6,1,20,1070,2850,1190,-1660
2020,6,1,21,1043,2816,1273,-1543
2020,6,1,22,1055,2764,1279,-1485
2020,6,1,23,1084,2736,1276,-1460
2020,6,2,0,1104,2730,1261,-1469
2020,6,2,1,1126,2827,1335,-1492
2020,6,2,2,1118,2841,1382,-1459
2020,6,2,3,1106,2797,1404,-1393
2020,6,2,4,1041,2745,1389,-1356
2020,6,2,5,1042,2728,1375,-1353
2020,6,2,6,1041,2568,1368,-1200
2020,6,2,7,889,2346,1365,-981
2020,6,2,8,868,2200,1281,-919
2020,6,2,9,857,2110,1219,-891
2020,6,2,10,813,2067,1147,-920
2020,6,2,11,790,2081,1049,-1032
2020,6,2,12,823,2155,1101,-1054
2020,6,2,13,887,2292,1176,-1116
2020,6,2,14,832,2502,1143,-1359
2020,6,2,15,831,2681,1139,-1542
2020,6,2,16,794,2747,1131,-1616
2020,6,2,17,805,2785,1140,-1645
2020,6,2,18,841,2809,1156,-1653
2020,6,2,19,871,2825,1152,-1673
2020,6,2,20,876,2872,1145,-1727
2020,6,2,21,831,2853,1170,-1683
2020,6,2,22,926,2867,1226,-1641
2020,6,2,23,908,2836,1240,-1596
2020,6,3,0,1009,2962,1419,-1543
2020,6,3,1,1057,3009,1468,-1541
2020,6,3,2,1076,2860,1290,-1570
2020,6,3,3,987,2781,1343,-1438
2020,6,3,4,880,2743,1354,-1389
2020,6,3,5,882,2700,1297,-1403
2020,6,3,6,987,2566,1376,-1190
2020,6,3,7,932,2317,1271,-1046
2020,6,3,8,837,2214,1213,-1001
2020,6,3,9,811,2122,1175,-947
2020,6,3,10,818,2064,1113,-951
2020,6,3,11,811,2079,1008,-1071
2020,6,3,12,740,2161,961,-1200
2020,6,3,13,813,2299,971,-1328
2020,6,3,14,568,2478,840,-1638
2020,6,3,15,698,2676,970,-1706
2020,6,3,16,692,2896,1088,-1808
2020,6,3,17,668,2958,1095,-1863
2020,6,3,18,694,2974,1091,-1883
2020,6,3,19,722,2966,1089,-1877
2020,6,3,20,742,2963,1106,-1857
2020,6,3,21,712,2922,1116,-1806
2020,6,3,22,689,2857,1100,-1757
2020,6,3,23,824,2870,1166,-1704
2020,6,4,0,862,2902,1219,-1683
2020,6,4,1,984,2961,1249,-1712
2020,6,4,2,1027,2961,1396,-1565
2020,6,4,3,999,2922,1452,-1470
2020,6,4,4,972,2883,1454,-1429
2020,6,4,5,924,2735,1340,-1395
2020,6,4,6,968,2542,1350,-1192
2020,6,4,7,925,2330,1247,-1083
2020,6,4,8,902,2142,1225,-917
2020,6,4,9,916,2082,1269,-813
2020,6,4,10,910,2034,1156,-878
2020,6,4,11,911,2053,1283,-770
2020,6,4,12,909,2113,1276,-837
2020,6,4,13,971,2233,1290,-943
2020,6,4,14,865,2439,1325,-1114
2020,6,4,15,1017,2634,1338,-1296
2020,6,4,16,1169,2774,1412,-1362
2020,6,4,17,1193,2811,1350,-1461
2020,6,4,18,1289,2819,1378,-1441
2020,6,4,19,1362,2839,1322,-1517
2020,6,4,20,1414,2849,1465,-1384
2020,6,4,21,1422,2821,1510,-1311
2020,6,4,22,1465,2780,1624,-1156
2020,6,4,23,1501,2794,1645,-1149
2020,6,5,0,1645,2907,1627,-1280
2020,6,5,1,1677,2977,1727,-1250
2020,6,5,2,1639,2968,1750,-1218
2020,6,5,3,1626,2902,1810,-1092
2020,6,5,4,1611,2873,1856,-1017
2020,6,5,5,1589,2859,1827,-1032
2020,6,5,6,1366,2705,1745,-960
2020,6,5,7,1312,2497,1539,-958
2020,6,5,8,727,2220,1055,-1165
2020,6,5,9,653,2122,1015,-1107
2020,6,5,10,728,2082,1023,-1059
2020,6,5,11,647,2082,1008,-1074
2020,6,5,12,669,2136,998,-1138
2020,6,5,13,715,2255,1056,-1199
2020,6,5,14,715,2557,1158,-1399
2020,6,5,15,971,2741,1345,-1396
2020,6,5,16,1188,2844,1455,-1389
2020,6,5,17,1214,2902,1458,-1444
2020,6,5,18,1259,2925,1447,-1478
2020,6,5,19,1287,2939,1549,-1390
2020,6,5,20,1288,2953,1555,-1398
2020,6,5,21,1252,2921,1485,-1436
2020,6,5,22,1218,2891,1517,-1374
2020,6,5,23,1199,2876,1546,-1330
2020,6,6,0,1183,2884,1485,-1399
2020,6,6,1,1186,2909,1389,-1520
2020,6,6,2,1135,2887,1422,-1465
2020,6,6,3,1083,2701,1271,-1430
2020,6,6,4,1016,2606,1355,-1251
2020,6,6,5,1016,2643,1259,-1384
2020,6,6,6,877,2517,1249,-1268
2020,6,6,7,827,2339,1306,-1033
2020,6,6,8,843,2196,1294,-902
2020,6,6,9,879,2067,1169,-898
2020,6,6,10,772,1985,1088,-897
2020,6,6,11,764,1982,1139,-843
2020,6,6,12,745,2024,1182,-842
2020,6,6,13,875,2077,1210,-867
2020,6,6,14,650,2183,1241,-942
2020,6,6,15,711,2320,1207,-1113
2020,6,6,16,660,2471,1088,-1383
2020,6,6,17,657,2570,1007,-1563
2020,6,6,18,766,2617,959,-1658
2020,6,6,19,748,2678,1142,-1536
2020,6,6,20,769,2644,1007,-1637
2020,6,6,21,734,2616,899,-1717
2020,6,6,22,838,2597,1008,-1589
2020,6,6,23,867,2581,1154,-1427
2020,6,7,0,887,2597,1129,-1468
2020,6,7,1,932,2669,1198,-1471
2020,6,7,2,927,2694,1358,-1336
2020,6,7,3,860,2661,1364,-1297
2020,6,7,4,839,2633,1302,-1331
2020,6,7,5,844,2636,1360,-1276
2020,6,7,6,915,2532,1343,-1189
2020,6,7,7,903,2325,1171,-1154
2020,6,7,8,887,2177,1186,-991
2020,6,7,9,837,2088,1163,-925
2020,6,7,10,800,2029,1126,-903
2020,6,7,11,815,2024,1134,-890
2020,6,7,12,794,2038,1181,-857
2020,6,7,13,739,2080,1177,-903
2020,6,7,14,834,2161,1141,-1020
2020,6,7,15,829,2296,1011,-1285
2020,6,7,16,831,2455,957,-1498
2020,6,7,17,855,2593,1025,-1568
2020,6,7,18,912,2681,1096,-1585
2020,6,7,19,945,2707,1172,-1535
2020,6,7,20,945,2707,1163,-1544
2020,6,7,21,947,2664,1176,-1488
2020,6,7,22,889,2623,1136,-1487
2020,6,7,23,888,2609,1052,-1557
2020,6,8,0,888,2617,1212,-1405
2020,6,8,1,945,2700,1246,-1454
2020,6,8,2,962,2720,1325,-1395
2020,6,8,3,926,2712,1336,-1376
2020,6,8,4,893,2685,1313,-1372
2020,6,8,5,894,2694,1341,-1353
2020,6,8,6,910,2544,1320,-1224
2020,6,8,7,901,2305,1238,-1067
2020,6,8,8,882,2159,1182,-977
2020,6,8,9,903,2065,1181,-884
2020,6,8,10,856,2074,1275,-799
2020,6,8,11,906,2068,1246,-822
2020,6,8,12,917,2104,1167,-937
2020,6,8,13,967,2284,1253,-1031
2020,6,8,14,844,2485,1245,-1240
2020,6,8,15,832,2654,1189,-1465
2020,6,8,16,953,2749,1226,-1523
2020,6,8,17,1000,2800,1103,-1697
2020,6,8,18,932,2829,1191,-1638
2020,6,8,19,962,2846,1238,-1608
2020,6,8,20,984,2849,1245,-1604
2020,6,8,21,949,2811,1236,-1575
2020,6,8,22,900,2762,1237,-1525
2020,6,8,23,975,2731,1234,-1497
2020,6,9,0,993,2750,1233,-1517
2020,6,9,1,977,2838,1310,-1528
2020,6,9,2,1000,2864,1350,-1514
2020,6,9,3,966,2819,1345,-1474
2020,6,9,4,942,2754,1282,-1472
2020,6,9,5,954,2719,1264,-1455
2020,6,9,6,1033,2578,1321,-1257
2020,6,9,7,841,2372,1281,-1091
2020,6,9,8,875,2222,1190,-1032
2020,6,9,9,831,2141,1188,-953
2020,6,9,10,805,2093,1192,-901
2020,6,9,11,778,2108,1187,-921
2020,6,9,12,815,2177,1163,-1014
2020,6,9,13,880,2443,1254,-1189
2020,6,9,14,988,2663,1317,-1346
2020,6,9,15,1111,2866,1404,-1462
2020,6,9,16,1297,3003,1605,-1398
2020,6,9,17,1344,3085,1745,-1340
2020,6,9,18,1391,3118,1602,-1516
2020,6,9,19,1371,3132,1574,-1558
2020,6,9,20,1355,3134,1613,-1521
2020,6,9,21,1352,3085,1673,-1412
2020,6,9,22,1333,3043,1693,-1350
2020,6,9,23,1291,3025,1696,-1329
2020,6,10,0,1288,3042,1554,-1488
2020,6,10,1,1325,3107,1589,-1518
2020,6,10,2,1326,3088,1554,-1534
2020,6,10,3,1328,3023,1477,-1546
2020,6,10,4,1332,2958,1497,-1461
2020,6,10,5,1337,2894,1497,-1397
2020,6,10,6,1210,2719,1540,-1179
2020,6,10,7,963,2404,1295,-1109
2020,6,10,8,859,2219,1268,-951
2020,6,10,9,846,2139,1285,-854
2020,6,10,10,796,2096,1260,-836
2020,6,10,11,839,2096,1380,-716
2020,6,10,12,856,2158,1354,-804
2020,6,10,13,1080,2280,1420,-860
2020,6,10,14,1502,2482,1629,-853
2020,6,10,15,1569,2782,1917,-865
2020,6,10,16,1669,2890,2113,-777
2020,6,10,17,1730,2939,2143,-796
2020,6,10,18,1782,2975,2137,-838
2020,6,10,19,1856,3014,2140,-874
2020,6,10,20,1906,3059,2138,-921
2020,6,10,21,1917,3049,2146,-903
2020,6,10,22,1903,3029,2151,-878
2020,6,10,23,1896,3025,2099,-926
2020,6,11,0,1997,3057,2100,-957
2020,6,11,1,2040,3093,2121,-972
2020,6,11,2,2003,3074,1842,-1232
2020,6,11,3,1914,2986,1742,-1244
2020,6,11,4,1826,2941,1714,-1227
2020,6,11,5,1773,2792,1726,-1066
2020,6,11,6,1330,2619,1763,-856
2020,6,11,7,1105,2394,1440,-954
2020,6,11,8,895,2234,1365,-869
2020,6,11,9,836,2124,1261,-863
2020,6,11,10,821,2069,1182,-887
2020,6,11,11,823,2051,1270,-781
2020,6,11,12,875,2102,1354,-748
2020,6,11,13,966,2209,1392,-817
2020,6,11,14,1301,2376,1504,-872
2020,6,11,15,1415,2558,1633,-925
2020,6,11,16,1554,2706,1791,-915
2020,6,11,17,1676,2789,1850,-939
2020,6,11,18,1742,2868,2015,-853
2020,6,11,19,1798,2905,2034,-871
2020,6,11,20,1796,3041,2146,-895
2020,6,11,21,1849,3003,2153,-850
2020,6,11,22,1814,2960,1888,-1072
2020,6,11,23,1796,2964,1822,-1142
2020,6,12,0,1826,2992,2101,-891
2020,6,12,1,1896,3060,2103,-957
2020,6,12,2,1841,3053,1978,-1075
2020,6,12,3,1770,2998,2030,-968
2020,6,12,4,1731,2939,1886,-1053
2020,6,12,5,1706,2924,1655,-1269
2020,6,12,6,1323,2637,1623,-1014
2020,6,12,7,1021,2501,1348,-1153
2020,6,12,8,847,2238,1178,-1060
2020,6,12,9,783,2111,1260,-851
2020,6,12,10,823,2074,1129,-945
2020,6,12,11,896,2057,1156,-901
2020,6,12,12,779,2093,1103,-990
2020,6,12,13,760,2188,1181,-1007
2020,6,12,14,897,2473,1195,-1278
2020,6,12,15,950,2685,1210,-1475
2020,6,12,16,930,2854,1208,-1646
2020,6,12,17,918,2972,1224,-1748
2020,6,12,18,944,3038,1230,-1808
2020,6,12,19,983,3094,1368,-1726
2020,6,12,20,1058,3118,1395,-1723
2020,6,12,21,1153,3091,1395,-1696
2020,6,12,22,1227,3060,1333,-1727
2020,6,12,23,1258,3005,1386,-1619
2020,6,13,0,1296,2985,1497,-1488
2020,6,13,1,1268,2990,1542,-1448
2020,6,13,2,1161,2847,1414,-1433
2020,6,13,3,1090,2779,1335,-1444
2020,6,13,4,971,2756,1425,-1331
2020,6,13,5,999,2728,1402,-1326
2020,6,13,6,993,2592,1435,-1157
2020,6,13,7,932,2404,1242,-1162
2020,6,13,8,724,2244,1174,-1070
2020,6,13,9,646,2112,1175,-937
2020,6,13,10,712,2083,1120,-963
2020,6,13,11,651,2017,1157,-860
2020,6,13,12,581,2083,1280,-803
2020,6,13,13,704,2132,1287,-845
2020,6,13,14,669,2234,1266,-968
2020,6,13,15,604,2480,1341,-1139
2020,6,13,16,759,2610,1345,-1265
2020,6,13,17,771,2679,1099,-1580
2020,6,13,18,857,2734,1250,-1484
2020,6,13,19,847,2765,1315,-1450
2020,6,13,20,879,2756,1286,-1470
2020,6,13,21,870,2643,1237,-1406
2020,6,13,22,846,2604,1242,-1362
2020,6,13,23,827,2542,1214,-1328
2020,6,14,0,777,2587,1224,-1363
2020,6,14,1,807,2678,1311,-1367
2020,6,14,2,742,2668,1309,-1359
2020,6,14,3,718,2647,1330,-1317
2020,6,14,4,717,2636,1305,-1331
2020,6,14,5,738,2671,1350,-1321
2020,6,14,6,855,2554,1395,-1159
2020,6,14,7,983,2379,1350,-1029
2020,6,14,8,852,2186,1230,-956
2020,6,14,9,854,2061,1160,-901
2020,6,14,10,853,2031,1148,-883
2020,6,14,11,874,2090,1218,-872
2020,6,14,12,880,2116,1274,-842
2020,6,14,13,940,2139,1284,-855
2020,6,14,14,844,2152,1143,-1009
2020,6,14,15,754,2283,959,-1324
2020,6,14,16,853,2407,1008,-1399
2020,6,14,17,846,2521,1021,-1500
2020,6,14,18,852,2589,1061,-1528
2020,6,14,19,853,2704,1255,-1449
2020,6,14,20,850,2707,1271,-1436
2020,6,14,21,796,2641,1241,-1400
2020,6,14,22,792,2598,1261,-1337
2020,6,14,23,786,2626,1316,-1310
2020,6,15,0,836,2660,1341,-1319
2020,6,15,1,843,2725,1370,-1355
2020,6,15,2,822,2741,1317,-1424
2020,6,15,3,825,2710,1252,-1458
2020,6,15,4,781,2693,1215,-1478
2020,6,15,5,751,2695,1320,-1375
2020,6,15,6,662,2554,1252,-1302
2020,6,15,7,696,2342,1168,-1174
2020,6,15,8,889,2193,1144,-1049
2020,6,15,9,802,2109,1164,-945
2020,6,15,10,749,2069,1178,-891
2020,6,15,11,833,2067,1103,-964
2020,6,15,12,880,2139,1091,-1048
2020,6,15,13,924,2306,1214,-1092
2020,6,15,14,1024,2602,1304,-1298
2020,6,15,15,1066,2816,1466,-1350
2020,6,15,16,1040,2947,1442,-1505
2020,6,15,17,1308,3041,1500,-1541
2020,6,15,18,1373,3088,1534,-1554
2020,6,15,19,1396,3141,1554,-1587
2020,6,15,20,1398,3160,1487,-1673
2020,6,15,21,1407,3124,1524,-1600
2020,6,15,22,1410,3071,1402,-1669
2020,6,15,23,1343,3034,1384,-1650
2020,6,16,0,1339,3050,1459,-1591
2020,6,16,1,1397,3101,1624,-1477
2020,6,16,2,1401,3076,1622,-1454
2020,6,16,3,1326,2893,1461,-1432
2020,6,16,4,1257,2834,1347,-1487
2020,6,16,5,1222,2806,1288,-1518
2020,6,16,6,976,2626,1134,-1492
2020,6,16,7,755,2429,1183,-1246
2020,6,16,8,765,2251,1084,-1167
2020,6,16,9,725,2194,1201,-993
2020,6,16,10,791,2143,1205,-938
2020,6,16,11,771,2145,1171,-974
2020,6,16,12,763,2213,1216,-997
2020,6,16,13,842,2355,1174,-1181
2020,6,16,14,616,2469,1007,-1462
2020,6,16,15,775,2709,1038,-1671
2020,6,16,16,857,2843,1172,-1671
2020,6,16,17,932,2818,1100,-1718
2020,6,16,18,990,2840,1068,-1772
2020,6,16,19,1066,2846,1122,-1724
2020,6,16,20,1116,2920,1261,-1659
2020,6,16,21,1114,2874,1294,-1580
2020,6,16,22,1076,2837,1299,-1538
2020,6,16,23,1059,2816,1244,-1572
2020,6,17,0,1092,2834,1247,-1587
2020,6,17,1,1164,2886,1295,-1591
2020,6,17,2,1140,2880,1352,-1528
2020,6,17,3,1071,2824,1414,-1410
2020,6,17,4,1002,2783,1442,-1341
2020,6,17,5,977,2755,1408,-1347
2020,6,17,6,1067,2627,1389,-1238
2020,6,17,7,968,2410,1282,-1128
2020,6,17,8,853,2293,1153,-1140
2020,6,17,9,723,2163,1123,-1040
2020,6,17,10,557,2120,1056,-1064
2020,6,17,11,567,2110,997,-1113
2020,6,17,12,608,2178,950,-1228
2020,6,17,13,611,2288,985,-1303
2020,6,17,14,548,2525,1100,-1425
2020,6,17,15,660,2636,1005,-1631
2020,6,17,16,649,2708,952,-1756
2020,6,17,17,646,2833,1030,-1803
2020,6,17,18,704,2856,1044,-1812
2020,6,17,19,638,2887,1052,-1835
2020,6,17,20,721,2860,953,-1907
2020,6,17,21,741,2853,986,-1867
2020,6,17,22,766,2848,1099,-1749
2020,6,17,23,785,2858,1148,-1710
2020,6,18,0,799,2893,1152,-1741
2020,6,18,1,817,2952,1076,-1876
2020,6,18,2,808,2912,1025,-1887
2020,6,18,3,816,2891,1134,-1757
2020,6,18,4,740,2820,1178,-1642
2020,6,18,5,705,2806,1077,-1729
2020,6,18,6,712,2648,1065,-1583
2020,6,18,7,684,2483,1146,-1337
2020,6,18,8,630,2239,1032,-1207
2020,6,18,9,677,2133,1011,-1122
2020,6,18,10,572,2083,959,-1124
2020,6,18,11,541,2077,957,-1120
2020,6,18,12,603,2121,998,-1123
2020,6,18,13,670,2226,1039,-1187
2020,6,18,14,620,2434,1020,-1414
2020,6,18,15,756,2626,1083,-1543
2020,6,18,16,810,2730,1149,-1581
2020,6,18,17,818,2811,1235,-1576
2020,6,18,18,915,2845,1228,-1617
2020,6,18,19,996,2889,1230,-1659
2020,6,18,20,1047,2924,1233,-1691
2020,6,18,21,1050,2945,1259,-1686
2020,6,18,22,1048,3005,1327,-1678
2020,6,18,23,1058,3045,1344,-1701
2020,6,19,0,1083,3117,1373,-1744
2020,6,19,1,1133,3177,1369,-1808
2020,6,19,2,1110,3187,1376,-1811
2020,6,19,3,1026,3107,1371,-1736
2020,6,19,4,951,2909,1258,-1651
2020,6,19,5,901,2870,1249,-1621
2020,6,19,6,894,2822,1402,-1420
2020,6,19,7,692,2574,1392,-1182
2020,6,19,8,767,2327,1188,-1139
2020,6,19,9,733,2154,1133,-1021
2020,6,19,10,749,2088,1066,-1022
2020,6,19,11,720,2065,1041,-1024
2020,6,19,12,738,2101,1084,-1017
2020,6,19,13,856,2174,1236,-938
2020,6,19,14,1182,2353,1451,-902
2020,6,19,15,1327,2546,1600,-946
2020,6,19,16,1523,2696,1831,-865
2020,6,19,17,1580,2810,1857,-953
2020,6,19,18,1656,2890,1858,-1032
2020,6,19,19,1747,3065,1963,-1102
2020,6,19,20,1808,3151,2020,-1131
2020,6,19,21,1816,3186,2022,-1164
2020,6,19,22,1819,3211,1984,-1227
2020,6,19,23,1833,3239,1979,-1260
2020,6,20,0,1863,3246,2032,-1214
2020,6,20,1,1882,3264,2061,-1203
2020,6,20,2,1805,3201,2049,-1152
2020,6,20,3,1776,3116,2048,-1068
2020,6,20,4,1645,3052,1921,-1131
2020,6,20,5,1537,2991,1914,-1077
2020,6,20,6,1060,2703,1667,-1036
2020,6,20,7,700,2469,1571,-898
2020,6,20,8,846,2316,1283,-1033
2020,6,20,9,923,2199,1206,-993
2020,6,20,10,816,2136,1218,-918
2020,6,20,11,870,2107,1212,-895
2020,6,20,12,850,2139,1139,-1000
2020,6,20,13,836,2144,1070,-1074
2020,6,20,14,776,2183,1058,-1125
2020,6,20,15,742,2306,1055,-1251
2020,6,20,16,724,2421,1005,-1416
2020,6,20,17,751,2631,1116,-1515
2020,6,20,18,850,2745,1082,-1663
2020,6,20,19,909,2808,1092,-1716
2020,6,20,20,911,2831,1106,-1725
2020,6,20,21,903,2822,1123,-1699
2020,6,20,22,965,2809,1131,-1678
2020,6,20,23,950,2819,1160,-1659
2020,6,21,0,991,2853,1175,-1678
2020,6,21,1,1052,2894,1177,-1717
2020,6,21,2,1070,2881,1246,-1635
2020,6,21,3,1012,2830,1366,-1464
2020,6,21,4,922,2770,1351,-1419
2020,6,21,5,667,2758,1301,-1457
2020,6,21,6,662,2639,1213,-1426
2020,6,21,7,653,2446,1206,-1240
2020,6,21,8,809,2281,1264,-1017
2020,6,21,9,796,2172,1299,-873
2020,6,21,10,830,2083,1238,-845
2020,6,21,11,882,2050,1224,-826
2020,6,21,12,880,2042,1231,-811
2020,6,21,13,845,2045,1244,-801
2020,6,21,14,826,2081,1204,-877
2020,6,21,15,845,2157,1104,-1053
2020,6,21,16,802,2395,1194,-1201
2020,6,21,17,825,2563,1100,-1463
2020,6,21,18,858,2626,1051,-1575
2020,6,21,19,847,2677,1061,-1616
2020,6,21,20,875,2701,1052,-1649
2020,6,21,21,894,2690,1065,-1625
2020,6,21,22,903,2661,1083,-1578
2020,6,21,23,945,2663,1183,-1480
2020,6,22,0,1029,2699,1256,-1443
2020,6,22,1,1067,2759,1313,-1446
2020,6,22,2,1041,2774,1332,-1442
2020,6,22,3,1014,2747,1338,-1409
2020,6,22,4,992,2719,1343,-1376
2020,6,22,5,1015,2705,1334,-1371
2020,6,22,6,958,2586,1322,-1264
2020,6,22,7,890,2362,1283,-1079
2020,6,22,8,930,2194,1117,-1077
2020,6,22,9,865,2101,1098,-1003
2020,6,22,10,718,2056,1071,-985
2020,6,22,11,724,2032,1081,-951
2020,6,22,12,761,2085,1067,-1018
2020,6,22,13,841,2200,1116,-1084
2020,6,22,14,871,2354,1178,-1176
2020,6,22,15,1073,2563,1356,-1207
2020,6,22,16,1275,2685,1444,-1241
2020,6,22,17,1322,2784,1536,-1248
2020,6,22,18,1420,2845,1526,-1319
2020,6,22,19,1499,2900,1517,-1383
2020,6,22,20,1534,3003,1646,-1357
2020,6,22,21,1541,3015,1660,-1355
2020,6,22,22,1540,3034,1659,-1375
2020,6,22,23,1548,3072,1715,-1357
2020,6,23,0,1582,3209,1798,-1411
2020,6,23,1,1640,3283,1797,-1486
2020,6,23,2,1625,3287,1796,-1491
2020,6,23,3,1553,3225,1833,-1392
2020,6,23,4,1465,3109,1763,-1346
2020,6,23,5,1409,3021,1650,-1371
2020,6,23,6,1293,2777,1595,-1182
2020,6,23,7,1048,2504,1342,-1162
2020,6,23,8,952,2264,1300,-964
2020,6,23,9,866,2142,1308,-834
2020,6,23,10,811,2063,1244,-819
2020,6,23,11,832,2047,1200,-847
2020,6,23,12,840,2085,1204,-881
2020,6,23,13,882,2174,1234,-940
2020,6,23,14,1034,2353,1276,-1077
2020,6,23,15,1293,2554,1444,-1110
2020,6,23,16,1497,2716,1548,-1168
2020,6,23,17,1561,2831,1703,-1128
2020,6,23,18,1661,2930,1848,-1082
2020,6,23,19,1741,3035,1864,-1171
2020,6,23,20,1808,3246,1965,-1281
2020,6,23,21,1837,3308,1955,-1353
2020,6,23,22,1852,3372,2036,-1336
2020,6,23,23,1874,3402,2091,-1311
2020,6,24,0,1816,3437,2124,-1313
2020,6,24,1,1864,3428,2217,-1211
2020,6,24,2,1802,3370,2241,-1129
2020,6,24,3,1701,3283,2138,-1145
2020,6,24,4,1603,3182,2051,-1131
2020,6,24,5,1545,3117,2007,-1110
2020,6,24,6,1276,2808,1769,-1039
2020,6,24,7,1017,2551,1551,-1000
2020,6,24,8,785,2349,1281,-1068
2020,6,24,9,798,2233,1085,-1148
2020,6,24,10,778,2150,1030,-1120
2020,6,24,11,780,2137,1052,-1085
2020,6,24,12,780,2159,1070,-1089
2020,6,24,13,779,2232,1136,-1096
2020,6,24,14,796,2335,992,-1343
2020,6,24,15,847,2522,1062,-1460
2020,6,24,16,827,2731,1157,-1574
2020,6,24,17,850,2862,1274,-1588
2020,6,24,18,896,2951,1277,-1674
2020,6,24,19,952,3010,1282,-1728
2020,6,24,20,993,3053,1299,-1754
2020,6,24,21,995,3137,1387,-1750
2020,6,24,22,978,3135,1386,-1749
2020,6,24,23,954,3174,1401,-1773
2020,6,25,0,910,3277,1449,-1828
2020,6,25,1,908,3242,1342,-1900
2020,6,25,2,892,3231,1341,-1890
2020,6,25,3,860,3126,1343,-1783
2020,6,25,4,815,3013,1343,-1670
2020,6,25,5,771,2940,1304,-1636
2020,6,25,6,860,2768,1172,-1596
2020,6,25,7,664,2509,1135,-1374
2020,6,25,8,712,2296,1057,-1239
2020,6,25,9,666,2178,970,-1208
2020,6,25,10,666,2097,939,-1158
2020,6,25,11,665,2075,948,-1127
2020,6,25,12,679,2113,988,-1125
2020,6,25,13,721,2201,1140,-1061
2020,6,25,14,880,2363,1170,-1193
2020,6,25,15,1104,2566,1426,-1140
2020,6,25,16,1421,2716,1504,-1212
2020,6,25,17,1611,2825,1564,-1261
2020,6,25,18,1692,2908,1865,-1043
2020,6,25,19,1817,3000,1891,-1109
2020,6,25,20,1903,3162,1989,-1173
2020,6,25,21,1932,3218,2002,-1216
2020,6,25,22,1954,3262,1982,-1280
2020,6,25,23,1952,3330,2002,-1328
2020,6,26,0,1917,3389,2120,-1269
2020,6,26,1,1916,3460,2176,-1284
2020,6,26,2,1940,3448,2187,-1261
2020,6,26,3,1853,3349,2158,-1191
2020,6,26,4,1749,3236,2170,-1066
2020,6,26,5,1675,3149,2131,-1018
2020,6,26,6,1311,2954,2132,-822
2020,6,26,7,1038,2581,1715,-866
2020,6,26,8,959,2346,1467,-879
2020,6,26,9,873,2216,1421,-795
2020,6,26,10,782,2114,1258,-856
2020,6,26,11,773,2094,1260,-834
2020,6,26,12,789,2123,1266,-857
2020,6,26,13,865,2157,1149,-1008
2020,6,26,14,1044,2343,1171,-1172
2020,6,26,15,1177,2553,1279,-1274
2020,6,26,16,1306,2718,1372,-1346
2020,6,26,17,1424,2960,1650,-1310
2020,6,26,18,1483,3010,1750,-1260
2020,6,26,19,1557,3042,1794,-1248
2020,6,26,20,1609,3121,1833,-1288
2020,6,26,21,1620,3278,1922,-1356
2020,6,26,22,1619,3324,1936,-1388
2020,6,26,23,1634,3338,1937,-1401
2020,6,27,0,1661,3350,1925,-1425
2020,6,27,1,1674,3315,1927,-1388
2020,6,27,2,1598,3215,1924,-1291
2020,6,27,3,1490,2990,1777,-1213
2020,6,27,4,1384,2887,1644,-1243
2020,6,27,5,1358,2826,1623,-1203
2020,6,27,6,1163,2683,1593,-1090
2020,6,27,7,984,2479,1296,-1183
2020,6,27,8,871,2294,1189,-1105
2020,6,27,9,742,2171,1154,-1017
2020,6,27,10,782,2093,1116,-977
2020,6,27,11,704,2012,1005,-1007
2020,6,27,12,662,2013,954,-1059
2020,6,27,13,682,2044,968,-1076
2020,6,27,14,676,2083,829,-1254
2020,6,27,15,675,2198,808,-1390
2020,6,27,16,736,2357,871,-1486
2020,6,27,17,748,2528,1046,-1482
2020,6,27,18,763,2602,1024,-1578
2020,6,27,19,816,2678,1099,-1579
2020,6,27,20,809,2667,1029,-1638
2020,6,27,21,800,2657,1032,-1625
2020,6,27,22,786,2651,1074,-1577
2020,6,27,23,787,2607,1035,-1572
2020,6,28,0,787,2679,1127,-1552
2020,6,28,1,730,2706,1101,-1605
2020,6,28,2,730,2676,1014,-1662
2020,6,28,3,730,2635,917,-1718
2020,6,28,4,731,2588,954,-1634
2020,6,28,5,730,2571,900,-1671
2020,6,28,6,729,2459,987,-1472
2020,6,28,7,726,2270,984,-1286
2020,6,28,8,754,2132,871,-1261
2020,6,28,9,633,2037,817,-1220
2020,6,28,10,599,1985,769,-1216
2020,6,28,11,572,1963,762,-1201
2020,6,28,12,567,1968,758,-1210
2020,6,28,13,608,1988,746,-1242
2020,6,28,14,502,2060,785,-1275
2020,6,28,15,596,2196,787,-1409
2020,6,28,16,497,2351,755,-1596
2020,6,28,17,770,2528,865,-1663
2020,6,28,18,505,2625,876,-1749
2020,6,28,19,606,2674,967,-1707
2020,6,28,20,630,2673,965,-1708
2020,6,28,21,618,2648,969,-1679
2020,6,28,22,587,2619,1005,-1614
2020,6,28,23,632,2608,958,-1650
2020,6,29,0,631,2662,895,-1767
2020,6,29,1,691,2745,920,-1825
2020,6,29,2,784,2769,998,-1771
2020,6,29,3,793,2743,1073,-1670
2020,6,29,4,711,2704,1064,-1640
2020,6,29,5,735,2685,1033,-1652
2020,6,29,6,603,2569,907,-1662
2020,6,29,7,549,2343,911,-1432
2020,6,29,8,591,2182,896,-1286
2020,6,29,9,569,2074,956,-1118
2020,6,29,10,604,2022,895,-1127
2020,6,29,11,642,2045,918,-1127
2020,6,29,12,641,2124,961,-1163
2020,6,29,13,735,2233,962,-1271
2020,6,29,14,726,2412,943,-1469
2020,6,29,15,984,2592,992,-1600
2020,6,29,16,893,2733,1185,-1548
2020,6,29,17,845,2823,1306,-1517
2020,6,29,18,888,2867,1328,-1539
2020,6,29,19,971,2902,1313,-1589
2020,6,29,20,1037,2924,1314,-1610
2020,6,29,21,1046,2922,1372,-1550
2020,6,29,22,1055,2912,1457,-1455
2020,6,29,23,1060,2916,1534,-1382
2020,6,30,0,1107,2967,1510,-1457
2020,6,30,1,1193,3023,1527,-1496
2020,6,30,2,1164,3017,1597,-1420
2020,6,30,3,1167,2930,1458,-1472
2020,6,30,4,1237,2835,1364,-1471
2020,6,30,5,1137,2834,1288,-1546
2020,6,30,6,835,2673,1302,-1371
2020,6,30,7,745,2464,1315,-1149
2020,6,30,8,966,2269,1291,-978
2020,6,30,9,885,2179,1283,-896
2020,6,30,10,737,2118,1182,-936
2020,6,30,11,739,2094,1132,-962
2020,6,30,12,797,2137,1138,-999
2020,6,30,13,772,2239,1134,-1105
2020,6,30,14,842,2408,1119,-1289
2020,6,30,15,850,2590,1151,-1439
2020,6,30,16,791,2728,1176,-1552
2020,6,30,17,822,2822,1172,-1650
2020,6,30,18,902,2890,1275,-1615
2020,6,30,19,932,2919,1277,-1642
2020,6,30,20,928,2935,1284,-1651
2020,6,30,21,927,2905,1286,-1619
2020,6,30,22,904,2871,1285,-1586
2020,6,30,23,904,2860,1296,-1564
2020,7,1,0,904,2878,1245,-1633
2020,7,1,1,903,2942,1268,-1674
2020,7,1,2,902,2933,1281,-1652
2020,7,1,3,903,2874,1253,-1621
2020,7,1,4,876,2785,1125,-1660
2020,7,1,5,876,2787,1269,-1518
2020,7,1,6,907,2623,1248,-1375
2020,7,1,7,768,2407,1145,-1262
2020,7,1,8,877,2253,1149,-1104
2020,7,1,9,836,2144,1102,-1042
2020,7,1,10,802,2086,1033,-1053
2020,7,1,11,805,2092,1055,-1037
2020,7,1,12,816,2157,1138,-1019
2020,7,1,13,912,2278,1146,-1132
2020,7,1,14,521,2448,1066,-1382
2020,7,1,15,773,2653,1155,-1498
2020,7,1,16,772,2806,1220,-1586
2020,7,1,17,779,2889,1240,-1649
2020,7,1,18,793,2935,1277,-1658
2020,7,1,19,808,2963,1328,-1635
2020,7,1,20,943,2955,1262,-1693
2020,7,1,21,895,2937,1233,-1704
2020,7,1,22,900,2896,1343,-1553
2020,7,1,23,955,2891,1286,-1605
2020,7,2,0,935,2907,1291,-1616
2020,7,2,1,905,2945,1304,-1641
2020,7,2,2,960,2935,1381,-1554
2020,7,2,3,928,2877,1373,-1504
2020,7,2,4,824,2836,1279,-1557
2020,7,2,5,810,2800,1283,-1517
2020,7,2,6,913,2645,1326,-1319
2020,7,2,7,804,2429,1310,-1119
2020,7,2,8,885,2285,1365,-920
2020,7,2,9,898,2188,1265,-923
2020,7,2,10,869,2133,1275,-858
2020,7,2,11,857,2129,1254,-875
2020,7,2,12,900,2177,1268,-909
2020,7,2,13,1014,2304,1374,-930
2020,7,2,14,916,2470,1344,-1126
2020,7,2,15,906,2656,1375,-1281
2020,7,2,16,882,2780,1333,-1447
2020,7,2,17,915,2867,1376,-1491
2020,7,2,18,859,2923,1371,-1552
2020,7,2,19,935,2948,1370,-1578
2020,7,2,20,722,2947,1337,-1610
2020,7,2,21,710,2911,1277,-1634
2020,7,2,22,741,2857,1279,-1578
2020,7,2,23,949,2829,1219,-1610
2020,7,3,0,1046,2836,1191,-1645
2020,7,3,1,1147,3036,1335,-1701
2020,7,3,2,1165,3125,1446,-1679
2020,7,3,3,1135,3072,1462,-1610
2020,7,3,4,1090,3036,1460,-1576
2020,7,3,5,1031,3017,1466,-1551
2020,7,3,6,1027,2877,1523,-1354
2020,7,3,7,1021,2469,1289,-1180
2020,7,3,8,898,2265,1144,-1121
2020,7,3,9,813,2147,1148,-999
2020,7,3,10,777,2100,1218,-882
2020,7,3,11,730,2076,1083,-993
2020,7,3,12,814,2109,1168,-941
2020,7,3,13,734,2164,1102,-1062
2020,7,3,14,644,2282,1157,-1125
2020,7,3,15,716,2446,1155,-1291
2020,7,3,16,838,2596,1147,-1449
2020,7,3,17,915,2764,1223,-1541
2020,7,3,18,940,2830,1226,-1604
2020,7,3,19,990,2846,1226,-1620
2020,7,3,20,991,2852,1245,-1607
2020,7,3,21,998,2826,1260,-1566
2020,7,3,22,965,2799,1231,-1568
2020,7,3,23,993,2784,1273,-1511
2020,7,4,0,1101,2938,1445,-1493
2020,7,4,1,1122,2980,1486,-1494
2020,7,4,2,1133,2781,1328,-1453
2020,7,4,3,1130,2721,1260,-1461
2020,7,4,4,884,2696,1325,-1371
2020,7,4,5,652,2696,1330,-1366
2020,7,4,6,839,2578,1331,-1247
2020,7,4,7,821,2412,1294,-1118
2020,7,4,8,833,2245,1203,-1042
2020,7,4,9,773,2148,1171,-977
2020,7,4,10,765,2096,1147,-949
2020,7,4,11,744,2068,1145,-923
2020,7,4,12,751,2084,1212,-872
2020,7,4,13,735,2094,1191,-903
2020,7,4,14,758,2162,1115,-1047
2020,7,4,15,780,2261,1067,-1194
2020,7,4,16,799,2386,1050,-1336
2020,7,4,17,884,2553,1134,-1419
2020,7,4,18,739,2655,1152,-1503
2020,7,4,19,776,2849,1319,-1530
2020,7,4,20,782,2972,1446,-1526
2020,7,4,21,754,2957,1459,-1498
2020,7,4,22,765,2931,1476,-1455
2020,7,4,23,776,2911,1550,-1361
2020,7,5,0,788,2914,1600,-1314
2020,7,5,1,847,2931,1553,-1378
2020,7,5,2,859,2764,1416,-1348
2020,7,5,3,819,2605,1298,-1307
2020,7,5,4,870,2533,1272,-1261
2020,7,5,5,868,2523,1284,-1239
2020,7,5,6,876,2462,1265,-1197
2020,7,5,7,699,2387,1129,-1258
2020,7,5,8,960,2315,1261,-1054
2020,7,5,9,962,2143,1195,-948
2020,7,5,10,918,2075,1201,-874
2020,7,5,11,813,2034,1091,-943
2020,7,5,12,816,2046,1082,-964
2020,7,5,13,732,2035,1074,-961
2020,7,5,14,747,2084,1069,-1015
2020,7,5,15,799,2162,1037,-1125
2020,7,5,16,994,2287,1090,-1197
2020,7,5,17,1086,2458,1244,-1214
2020,7,5,18,1038,2568,1381,-1187
2020,7,5,19,1128,2662,1390,-1272
2020,7,5,20,1184,2860,1536,-1324
2020,7,5,21,1190,2956,1630,-1326
2020,7,5,22,1176,2977,1611,-1366
2020,7,5,23,1155,2991,1648,-1343
2020,7,6,0,1163,3056,1645,-1411
2020,7,6,1,1179,3138,1652,-1486
2020,7,6,2,1157,3167,1647,-1520
2020,7,6,3,1147,3142,1657,-1485
2020,7,6,4,1190,2995,1564,-1431
2020,7,6,5,1111,2963,1597,-1366
2020,7,6,6,1175,2784,1610,-1174
2020,7,6,7,967,2420,1402,-1018
2020,7,6,8,1141,2243,1425,-818
2020,7,6,9,1060,2139,1370,-769
2020,7,6,10,986,2088,1310,-778
2020,7,6,11,915,2073,1310,-763
2020,7,6,12,914,2114,1295,-819
2020,7,6,13,886,2214,1262,-952
2020,7,6,14,790,2376,1260,-1116
2020,7,6,15,895,2549,1365,-1184
2020,7,6,16,944,2690,1330,-1360
2020,7,6,17,1110,2790,1438,-1352
2020,7,6,18,1206,2877,1502,-1375
2020,7,6,19,1286,2976,1615,-1361
2020,7,6,20,1344,3052,1579,-1473
2020,7,6,21,1344,3074,1560,-1514
2020,7,6,22,1321,3064,1560,-1504
2020,7,6,23,1434,3149,1651,-1498
2020,7,7,0,1577,3191,1728,-1463
2020,7,7,1,1635,3244,1849,-1395
2020,7,7,2,1605,3132,1788,-1344
2020,7,7,3,1496,2954,1579,-1375
2020,7,7,4,1332,2875,1573,-1302
2020,7,7,5,1093,2847,1516,-1331
2020,7,7,6,1255,2671,1645,-1026
2020,7,7,7,1041,2444,1270,-1174
2020,7,7,8,835,2232,1171,-1061
2020,7,7,9,879,2125,1160,-965
2020,7,7,10,859,2044,1128,-916
2020,7,7,11,858,2092,1263,-829
2020,7,7,12,869,2141,1249,-892
2020,7,7,13,1002,2332,1327,-1005
2020,7,7,14,955,2518,1337,-1181
2020,7,7,15,976,2690,1355,-1335
2020,7,7,16,1060,2860,1472,-1388
2020,7,7,17,1132,2952,1560,-1392
2020,7,7,18,1289,3023,1615,-1408
2020,7,7,19,1343,3061,1662,-1399
2020,7,7,20,1411,2980,1623,-1357
2020,7,7,21,1286,2946,1614,-1332
2020,7,7,22,1288,2915,1590,-1325
2020,7,7,23,1380,2906,1603,-1303
2020,7,8,0,1409,3045,1699,-1346
2020,7,8,1,1442,3015,1666,-1349
2020,7,8,2,1443,3085,1753,-1332
2020,7,8,3,1381,3029,1669,-1360
2020,7,8,4,1365,2933,1682,-1251
2020,7,8,5,1240,2835,1619,-1216
2020,7,8,6,1246,2794,1512,-1282
2020,7,8,7,1055,2504,1366,-1138
2020,7,8,8,920,2311,1280,-1031
2020,7,8,9,772,2162,1173,-989
2020,7,8,10,609,2074,1050,-1024
2020,7,8,11,599,2115,1088,-1027
2020,7,8,12,679,2161,1075,-1086
2020,7,8,13,778,2322,1235,-1087
2020,7,8,14,844,2515,1283,-1232
2020,7,8,15,1085,2725,1518,-1207
2020,7,8,16,1227,2840,1471,-1369
2020,7,8,17,1340,2943,1443,-1500
2020,7,8,18,1405,2997,1634,-1363
2020,7,8,19,1479,3051,1667,-1384
2020,7,8,20,1554,3208,1794,-1414
2020,7,8,21,1594,3216,1881,-1335
2020,7,8,22,1618,3212,1947,-1265
2020,7,8,23,1746,3221,1954,-1267
2020,7,9,0,1821,3256,1989,-1267
2020,7,9,1,1799,3329,1982,-1347
2020,7,9,2,1794,3327,1965,-1362
2020,7,9,3,1789,3250,2005,-1245
2020,7,9,4,1776,3182,1991,-1191
2020,7,9,5,1581,3145,1817,-1328
2020,7,9,6,1369,2971,1740,-1231
2020,7,9,7,917,2720,1411,-1309
2020,7,9,8,853,2315,1127,-1188
2020,7,9,9,835,2185,1086,-1099
2020,7,9,10,775,2142,1126,-1016
2020,7,9,11,822,2126,1122,-1004
2020,7,9,12,937,2166,1242,-924
2020,7,9,13,940,2282,1242,-1040
2020,7,9,14,1312,2675,1590,-1085
2020,7,9,15,1468,2874,1649,-1225
2020,7,9,16,1558,3006,1693,-1313
2020,7,9,17,1616,3107,1893,-1214
2020,7,9,18,1649,3163,1922,-1241
2020,7,9,19,1662,3221,1940,-1281
2020,7,9,20,1694,3248,1935,-1313
2020,7,9,21,1744,3250,1939,-1311
2020,7,9,22,1747,3239,1938,-1301
2020,7,9,23,1875,3236,2050,-1186
2020,7,10,0,1836,3238,2166,-1072
2020,7,10,1,1877,3297,2158,-1139
2020,7,10,2,1858,3291,2114,-1177
2020,7,10,3,1817,3228,2105,-1123
2020,7,10,4,1755,3153,2051,-1102
2020,7,10,5,1610,3116,1915,-1201
2020,7,10,6,1135,2725,1532,-1193
2020,7,10,7,864,2473,1334,-1139
2020,7,10,8,928,2300,1384,-916
2020,7,10,9,910,2192,1457,-735
2020,7,10,10,886,2129,1452,-677
2020,7,10,11,847,2109,1355,-754
2020,7,10,12,878,2149,1389,-760
2020,7,10,13,997,2250,1509,-741
2020,7,10,14,1221,2412,1592,-820
2020,7,10,15,1454,2598,1651,-947
2020,7,10,16,1612,2739,1760,-979
2020,7,10,17,1816,3047,2103,-944
2020,7,10,18,1895,3122,2156,-966
2020,7,10,19,1901,3165,2180,-985
2020,7,10,20,1886,3202,2176,-1026
2020,7,10,21,2015,3205,2146,-1059
2020,7,10,22,2044,3210,2248,-962
2020,7,10,23,2073,3224,2237,-987
2020,7,11,0,2067,3268,2309,-959
2020,7,11,1,2102,3329,2333,-996
2020,7,11,2,2055,3317,2317,-1000
2020,7,11,3,2077,3233,2312,-921
2020,7,11,4,2018,3153,2362,-791
2020,7,11,5,1990,3123,2207,-916
2020,7,11,6,1657,2977,2224,-753
2020,7,11,7,1342,2744,1885,-859
2020,7,11,8,1217,2319,1551,-768
2020,7,11,9,1192,2193,1543,-650
2020,7,11,10,1184,2122,1537,-585
2020,7,11,11,1153,2087,1541,-546
2020,7,11,12,1162,2096,1531,-565
2020,7,11,13,1178,2115,1533,-582
2020,7,11,14,1026,2193,1502,-691
2020,7,11,15,1085,2414,1385,-1029
2020,7,11,16,1238,2503,1530,-973
2020,7,11,17,1448,2718,1721,-997
2020,7,11,18,1498,2818,1732,-1086
2020,7,11,19,1510,2917,1783,-1134
2020,7,11,20,1484,3047,1906,-1141
2020,7,11,21,1533,3046,1950,-1096
2020,7,11,22,1567,3013,1881,-1132
2020,7,11,23,1574,2899,1722,-1177
2020,7,12,0,1532,2823,1776,-1047
2020,7,12,1,1493,2860,1818,-1042
2020,7,12,2,1408,2829,1752,-1077
2020,7,12,3,1325,2767,1599,-1168
2020,7,12,4,1337,2688,1542,-1146
2020,7,12,5,1368,2735,1659,-1076
2020,7,12,6,1306,2576,1631,-945
2020,7,12,7,1074,2396,1445,-951
2020,7,12,8,1183,2256,1389,-867
2020,7,12,9,1124,2159,1405,-754
2020,7,12,10,993,2095,1433,-662
2020,7,12,11,999,2064,1441,-623
2020,7,12,12,989,2061,1456,-605
2020,7,12,13,1025,2079,1481,-598
2020,7,12,14,1086,2119,1462,-657
2020,7,12,15,1237,2206,1345,-861
2020,7,12,16,1166,2377,1423,-954
2020,7,12,17,1309,2551,1560,-991
2020,7,12,18,1463,2657,1730,-927
2020,7,12,19,1395,2726,1746,-980
2020,7,12,20,1433,2750,1719,-1031
2020,7,12,21,1424,2729,1788,-941
2020,7,12,22,1519,2812,1812,-1000
2020,7,12,23,1501,2804,1559,-1245
2020,7,13,0,1543,2869,1639,-1230
2020,7,13,1,1455,2921,1738,-1183
2020,7,13,2,1487,2959,1778,-1181
2020,7,13,3,1430,2934,1844,-1090
2020,7,13,4,1404,2890,1884,-1006
2020,7,13,5,1464,2882,1897,-985
2020,7,13,6,1466,2646,1879,-767
2020,7,13,7,1330,2416,1745,-671
2020,7,13,8,1294,2241,1673,-568
2020,7,13,9,1225,2135,1504,-631
2020,7,13,10,1186,2082,1371,-711
2020,7,13,11,1087,2081,1325,-756
2020,7,13,12,1089,2146,1318,-828
2020,7,13,13,1291,2350,1584,-766
2020,7,13,14,1363,2586,1615,-971
2020,7,13,15,1371,2871,1642,-1229
2020,7,13,16,1502,3005,1833,-1172
2020,7,13,17,1600,3091,1990,-1101
2020,7,13,18,1661,3147,1985,-1162
2020,7,13,19,1811,3082,2028,-1054
2020,7,13,20,1954,2999,1970,-1029
2020,7,13,21,1979,3005,2053,-952
2020,7,13,22,1982,3018,2101,-917
2020,7,13,23,2003,3133,2246,-887
2020,7,14,0,2027,3312,2468,-844
2020,7,14,1,2076,3397,2427,-970
2020,7,14,2,2048,3396,2427,-969
2020,7,14,3,1980,3331,2472,-859
2020,7,14,4,1916,3228,2462,-766
2020,7,14,5,1883,3167,2219,-948
2020,7,14,6,1683,2980,2118,-862
2020,7,14,7,1468,2736,1880,-856
2020,7,14,8,1136,2437,1431,-1006
2020,7,14,9,1105,2312,1406,-906
2020,7,14,10,1077,2260,1392,-868
2020,7,14,11,1069,2245,1406,-839
2020,7,14,12,1114,2301,1379,-922
2020,7,14,13,1097,2404,1418,-986
2020,7,14,14,1464,2685,1853,-832
2020,7,14,15,1663,2765,1910,-855
2020,7,14,16,1787,2909,1949,-960
2020,7,14,17,1874,3088,2052,-1036
2020,7,14,18,1930,3157,2054,-1103
2020,7,14,19,1973,3218,2160,-1058
2020,7,14,20,1996,3277,2163,-1114
2020,7,14,21,2021,3301,2172,-1129
2020,7,14,22,2029,3336,2253,-1083
2020,7,14,23,2084,3393,2339,-1054
2020,7,15,0,2165,3450,2404,-1046
2020,7,15,1,2206,3529,2428,-1101
2020,7,15,2,2179,3527,2461,-1066
2020,7,15,3,2097,3432,2339,-1093
2020,7,15,4,2041,3329,2369,-960
2020,7,15,5,2085,3265,2279,-986
2020,7,15,6,1485,3055,1956,-1099
2020,7,15,7,1009,2749,1667,-1082
2020,7,15,8,1182,2540,1602,-938
2020,7,15,9,1234,2371,1471,-900
2020,7,15,10,1121,2287,1403,-884
2020,7,15,11,1096,2265,1419,-846
2020,7,15,12,1125,2323,1402,-921
2020,7,15,13,1112,2475,1474,-1001
2020,7,15,14,1448,2668,1776,-892
2020,7,15,15,1622,2850,1949,-901
2020,7,15,16,1773,2993,2097,-896
2020,7,15,17,1871,3110,2121,-989
2020,7,15,18,1976,3206,2217,-989
2020,7,15,19,1984,3276,2195,-1081
2020,7,15,20,2043,3380,2238,-1142
2020,7,15,21,2063,3434,2280,-1154
2020,7,15,22,2056,3473,2354,-1119
2020,7,15,23,2222,3532,2500,-1032
2020,7,16,0,2295,3431,2412,-1019
2020,7,16,1,2325,3494,2533,-961
2020,7,16,2,2291,3487,2552,-935
2020,7,16,3,2218,3385,2382,-1003
2020,7,16,4,2194,3345,2342,-1003
2020,7,16,5,2062,3305,2082,-1223
2020,7,16,6,1649,3124,1843,-1281
2020,7,16,7,1344,2903,1540,-1363
2020,7,16,8,1451,2643,1691,-952
2020,7,16,9,1161,2548,1506,-1042
2020,7,16,10,1164,2471,1482,-989
2020,7,16,11,1123,2438,1480,-958
2020,7,16,12,1153,2463,1446,-1017
2020,7,16,13,1172,2508,1424,-1084
2020,7,16,14,1467,2623,1693,-930
2020,7,16,15,1610,2798,1738,-1060
2020,7,16,16,1615,3036,1787,-1249
2020,7,16,17,1700,3163,1854,-1309
2020,7,16,18,1735,3240,1667,-1573
2020,7,16,19,1884,3321,1808,-1513
2020,7,16,20,2003,3411,2042,-1369
2020,7,16,21,2032,3449,2305,-1144
2020,7,16,22,2072,3480,2332,-1148
2020,7,16,23,2164,3520,2352,-1168
2020,7,17,0,2029,3555,2404,-1151
2020,7,17,1,1832,3585,2403,-1182
2020,7,17,2,1915,3554,2418,-1136
2020,7,17,3,1964,3456,2370,-1086
2020,7,17,4,1987,3363,2306,-1057
2020,7,17,5,1900,3294,2089,-1205
2020,7,17,6,1669,2995,1850,-1145
2020,7,17,7,1369,2735,1591,-1144
2020,7,17,8,1202,2418,1555,-863
2020,7,17,9,1067,2287,1449,-838
2020,7,17,10,1029,2221,1383,-838
2020,7,17,11,989,2185,1378,-807
2020,7,17,12,963,2183,1304,-879
2020,7,17,13,1012,2278,1301,-977
2020,7,17,14,1107,2401,1500,-901
2020,7,17,15,1165,2554,1463,-1091
2020,7,17,16,1420,2917,1681,-1236
2020,7,17,17,1453,3029,1776,-1253
2020,7,17,18,1554,2872,1642,-1230
2020,7,17,19,1600,2877,1641,-1236
2020,7,17,20,1618,2870,1614,-1256
2020,7,17,21,1634,2867,1632,-1235
2020,7,17,22,1652,2843,1678,-1165
2020,7,17,23,1711,3069,1943,-1126
2020,7,18,0,1854,3115,2064,-1051
2020,7,18,1,1938,3161,2068,-1093
2020,7,18,2,1890,3144,2058,-1086
2020,7,18,3,1827,3178,2276,-902
2020,7,18,4,1820,3090,2185,-905
2020,7,18,5,1707,2981,1895,-1086
2020,7,18,6,1498,2692,1709,-983
2020,7,18,7,1236,2474,1574,-900
2020,7,18,8,956,2296,1285,-1011
2020,7,18,9,969,2181,1248,-933
2020,7,18,10,915,2106,1233,-873
2020,7,18,11,800,2078,1241,-837
2020,7,18,12,823,2068,1236,-832
2020,7,18,13,940,2093,1230,-863
2020,7,18,14,886,2163,1225,-938
2020,7,18,15,1216,2306,1237,-1069
2020,7,18,16,1452,2476,1223,-1253
2020,7,18,17,1541,2706,1394,-1312
2020,7,18,18,1560,2824,1507,-1317
2020,7,18,19,1521,2979,1571,-1408
2020,7,18,20,1558,3061,1715,-1346
2020,7,18,21,1568,3091,1612,-1479
2020,7,18,22,1579,3120,1664,-1456
2020,7,18,23,1551,3156,1599,-1557
2020,7,19,0,1602,3236,1641,-1595
2020,7,19,1,1619,3322,1783,-1539
2020,7,19,2,1633,3333,1827,-1506
2020,7,19,3,1627,3270,1880,-1390
2020,7,19,4,1558,3208,1883,-1325
2020,7,19,5,1624,3169,1817,-1352
2020,7,19,6,1606,3010,1778,-1232
2020,7,19,7,1372,2689,1733,-956
2020,7,19,8,1464,2549,1755,-794
2020,7,19,9,1388,2413,1816,-597
2020,7,19,10,1309,2237,1660,-577
2020,7,19,11,1266,2188,1579,-609
2020,7,19,12,1244,2180,1589,-591
2020,7,19,13,1264,2174,1566,-608
2020,7,19,14,1179,2227,1523,-704
2020,7,19,15,1326,2305,1439,-866
2020,7,19,16,1532,2631,1567,-1064
2020,7,19,17,1717,2823,1561,-1262
2020,7,19,18,1834,2988,1735,-1253
2020,7,19,19,1849,3126,1869,-1257
2020,7,19,20,1910,3237,2025,-1212
2020,7,19,21,1939,3293,2079,-1214
2020,7,19,22,2033,3346,2058,-1288
2020,7,19,23,1991,3402,2128,-1274
2020,7,20,0,2017,3496,2188,-1308
2020,7,20,1,2032,3621,2245,-1376
2020,7,20,2,2050,3639,2237,-1402
2020,7,20,3,1991,3580,2321,-1259
2020,7,20,4,1958,3480,2289,-1191
2020,7,20,5,1970,3409,2117,-1292
2020,7,20,6,1952,3201,2062,-1139
2020,7,20,7,1745,2923,1915,-1008
2020,7,20,8,1686,2640,1806,-834
2020,7,20,9,1597,2412,1697,-715
2020,7,20,10,1490,2286,1658,-628
2020,7,20,11,1416,2208,1652,-556
2020,7,20,12,1404,2329,1747,-582
2020,7,20,13,1621,2430,1927,-503
2020,7,20,14,1534,2595,1895,-700
2020,7,20,15,1759,2801,2068,-733
2020,7,20,16,1950,3047,2161,-886
2020,7,20,17,2119,3200,2163,-1037
2020,7,20,18,2214,3438,2303,-1135
2020,7,20,19,2312,3580,2406,-1174
2020,7,20,20,2395,3688,2464,-1224
2020,7,20,21,2574,3777,2604,-1173
2020,7,20,22,2594,3828,2604,-1224
2020,7,20,23,2622,3901,2611,-1290
2020,7,21,0,2565,3968,2538,-1430
2020,7,21,1,2533,4034,2564,-1470
2020,7,21,2,2486,4015,2551,-1464
2020,7,21,3,2518,3932,2677,-1255
2020,7,21,4,2393,3800,2679,-1121
2020,7,21,5,2465,3686,2635,-1051
2020,7,21,6,2469,3429,2367,-1062
2020,7,21,7,2054,3102,1970,-1132
2020,7,21,8,1237,2635,1743,-892
2020,7,21,9,1195,2461,1697,-764
2020,7,21,10,1103,2369,1592,-777
2020,7,21,11,1032,2318,1612,-706
2020,7,21,12,1076,2343,1491,-852
2020,7,21,13,1249,2433,1615,-818
2020,7,21,14,1870,2806,2098,-708
2020,7,21,15,1986,3019,2248,-771
2020,7,21,16,2082,3198,2204,-994
2020,7,21,17,2185,3331,2261,-1070
2020,7,21,18,2261,3450,2388,-1062
2020,7,21,19,2318,3551,2498,-1053
2020,7,21,20,2262,3652,2585,-1067
2020,7,21,21,2437,3701,2616,-1085
2020,7,21,22,2487,3746,2611,-1135
2020,7,21,23,2491,3806,2592,-1214
2020,7,22,0,2497,3854,2579,-1275
2020,7,22,1,2522,3911,2649,-1262
2020,7,22,2,2543,3879,2680,-1199
2020,7,22,3,2513,3773,2650,-1123
2020,7,22,4,2625,3631,2707,-924
2020,7,22,5,2473,3532,2524,-1008
2020,7,22,6,1627,3229,2074,-1155
2020,7,22,7,1265,2743,1695,-1048
2020,7,22,8,1338,2515,1711,-804
2020,7,22,9,1084,2383,1654,-729
2020,7,22,10,1052,2300,1535,-765
2020,7,22,11,1027,2257,1443,-814
2020,7,22,12,1074,2290,1460,-830
2020,7,22,13,1175,2394,1559,-835
2020,7,22,14,1483,2676,1699,-977
2020,7,22,15,1679,2845,1864,-981
2020,7,22,16,1768,3019,2002,-1017
2020,7,22,17,1824,3104,1953,-1151
2020,7,22,18,1891,3166,2009,-1157
2020,7,22,19,2021,3218,2067,-1151
2020,7,22,20,2103,3203,2072,-1131
2020,7,22,21,2136,3199,2210,-989
2020,7,22,22,2174,3206,2203,-1003
2020,7,22,23,2230,3216,2309,-907
2020,7,23,0,2307,3362,2496,-866
2020,7,23,1,2323,3434,2635,-799
2020,7,23,2,2319,3450,2650,-800
2020,7,23,3,2350,3360,2628,-732
2020,7,23,4,2357,3298,2604,-694
2020,7,23,5,2299,3227,2344,-883
2020,7,23,6,1699,2813,1827,-986
2020,7,23,7,1164,2552,1435,-1117
2020,7,23,8,970,2372,1466,-906
2020,7,23,9,883,2260,1411,-849
2020,7,23,10,879,2190,1354,-836
2020,7,23,11,862,2163,1311,-852
2020,7,23,12,900,2207,1381,-826
2020,7,23,13,1054,2307,1448,-859
2020,7,23,14,1012,2455,1396,-1059
2020,7,23,15,1027,2603,1435,-1168
2020,7,23,16,1166,2820,1506,-1314
2020,7,23,17,1259,2927,1445,-1482
2020,7,23,18,1340,2988,1494,-1494
2020,7,23,19,1388,3045,1483,-1562
2020,7,23,20,1427,3231,1728,-1503
2020,7,23,21,1450,3231,1814,-1417
2020,7,23,22,1477,3173,1798,-1375
2020,7,23,23,1610,3193,1867,-1326
2020,7,24,0,1729,3190,1894,-1296
2020,7,24,1,1728,3257,1959,-1298
2020,7,24,2,1717,3260,1975,-1285
2020,7,24,3,1692,3199,1972,-1227
2020,7,24,4,1630,3174,1869,-1305
2020,7,24,5,1564,3123,1806,-1317
2020,7,24,6,1566,2934,1821,-1113
2020,7,24,7,1312,2478,1453,-1025
2020,7,24,8,1067,2292,1388,-904
2020,7,24,9,972,2185,1385,-800
2020,7,24,10,961,2123,1320,-803
2020,7,24,11,869,2101,1262,-839
2020,7,24,12,952,2149,1238,-911
2020,7,24,13,951,2261,1259,-1002
2020,7,24,14,1072,2407,1336,-1071
2020,7,24,15,1173,2595,1442,-1153
2020,7,24,16,1270,2743,1454,-1289
2020,7,24,17,1400,2837,1449,-1388
2020,7,24,18,1437,2842,1381,-1461
2020,7,24,19,1464,2992,1461,-1531
2020,7,24,20,1489,2945,1645,-1300
2020,7,24,21,1595,2971,1715,-1256
2020,7,24,22,1574,2907,1607,-1300
2020,7,24,23,1726,2874,1697,-1177
2020,7,25,0,1864,2881,1720,-1161
2020,7,25,1,1863,2938,1802,-1136
2020,7,25,2,1860,3130,1998,-1132
2020,7,25,3,1851,3087,2096,-991
2020,7,25,4,1839,3039,2094,-945
2020,7,25,5,1860,3029,2069,-960
2020,7,25,6,1689,2746,1858,-888
2020,7,25,7,1379,2438,1566,-872
2020,7,25,8,1205,2238,1389,-849
2020,7,25,9,1087,2087,1277,-810
2020,7,25,10,1057,2001,1092,-909
2020,7,25,11,1002,1984,1147,-837
2020,7,25,12,1018,2030,1261,-769
2020,7,25,13,1066,2085,1316,-769
2020,7,25,14,1238,2170,1264,-906
2020,7,25,15,1284,2281,1242,-1039
2020,7,25,16,1539,2532,1388,-1144
2020,7,25,17,1665,2834,1654,-1180
2020,7,25,18,1765,2940,1665,-1275
2020,7,25,19,1810,2982,1724,-1258
2020,7,25,20,1829,3034,1859,-1175
2020,7,25,21,1829,3049,1954,-1095
2020,7,25,22,1832,3085,1963,-1122
2020,7,25,23,1852,3118,2088,-1030
2020,7,26,0,1876,3186,2006,-1180
2020,7,26,1,1854,3262,2041,-1221
2020,7,26,2,1866,3284,2102,-1182
2020,7,26,3,1861,3217,2099,-1118
2020,7,26,4,1831,3137,2104,-1033
2020,7,26,5,1819,3109,2111,-998
2020,7,26,6,1779,2947,2008,-939
2020,7,26,7,1606,2733,1733,-1000
2020,7,26,8,1136,2422,1465,-957
2020,7,26,9,1063,2252,1412,-840
2020,7,26,10,1026,2164,1348,-816
2020,7,26,11,1144,2111,1288,-823
2020,7,26,12,1132,2105,1301,-804
2020,7,26,13,1052,2091,1378,-713
2020,7,26,14,1124,2165,1416,-749
2020,7,26,15,1256,2296,1365,-931
2020,7,26,16,1472,2614,1493,-1121
2020,7,26,17,1585,2807,1681,-1126
2020,7,26,18,1742,2968,1937,-1031
2020,7,26,19,1852,3080,2057,-1023
2020,7,26,20,1908,3171,2037,-1134
2020,7,26,21,2006,3242,2073,-1169
2020,7,26,22,1887,3333,2067,-1266
2020,7,26,23,1865,3425,2075,-1350
2020,7,27,0,1934,3547,2229,-1318
2020,7,27,1,1924,3683,2337,-1346
2020,7,27,2,1966,3715,2355,-1360
2020,7,27,3,2004,3690,2374,-1316
2020,7,27,4,1991,3594,2331,-1263
2020,7,27,5,1953,3506,2282,-1224
2020,7,27,6,1893,3267,2148,-1119
2020,7,27,7,1631,2976,1983,-993
2020,7,27,8,1650,2755,1783,-972
2020,7,27,9,1528,2603,1780,-823
2020,7,27,10,1417,2373,1677,-696
2020,7,27,11,1499,2334,1806,-528
2020,7,27,12,1510,2369,1832,-537
2020,7,27,13,1578,2460,1875,-585
2020,7,27,14,1817,2667,1941,-726
2020,7,27,15,1852,2878,2028,-850
2020,7,27,16,2022,3185,2260,-925
2020,7,27,17,2210,3388,2463,-925
2020,7,27,18,2330,3548,2539,-1009
2020,7,27,19,2411,3704,2548,-1156
2020,7,27,20,2401,3857,2591,-1266
2020,7,27,21,2393,3955,2598,-1357
2020,7,27,22,2424,4042,2621,-1421
2020,7,27,23,2432,4110,2507,-1603
2020,7,28,0,2375,4178,2543,-1635
2020,7,28,1,2382,4244,2552,-1692
2020,7,28,2,2362,4198,2601,-1597
2020,7,28,3,2241,4083,2613,-1470
2020,7,28,4,2354,3937,2662,-1275
2020,7,28,5,2385,3811,2608,-1203
2020,7,28,6,1957,3521,2458,-1063
2020,7,28,7,1850,3192,2094,-1098
2020,7,28,8,1151,2926,1874,-1052
2020,7,28,9,1006,2662,1613,-1049
2020,7,28,10,873,2487,1483,-1004
2020,7,28,11,852,2422,1477,-945
2020,7,28,12,1218,2460,1560,-900
2020,7,28,13,1192,2541,1384,-1157
2020,7,28,14,1830,2798,1830,-968
2020,7,28,15,2052,2979,2035,-944
2020,7,28,16,2181,3112,2286,-826
2020,7,28,17,2293,3229,2468,-761
2020,7,28,18,2386,3337,2607,-730
2020,7,28,19,2406,3419,2671,-748
2020,7,28,20,2333,3505,2608,-897
2020,7,28,21,2369,3585,2535,-1050
2020,7,28,22,2397,3636,2467,-1169
2020,7,28,23,2345,3700,2456,-1244
2020,7,29,0,2356,3780,2489,-1291
2020,7,29,1,2362,3867,2595,-1272
2020,7,29,2,2328,3837,2679,-1158
2020,7,29,3,2336,3726,2620,-1106
2020,7,29,4,2332,3583,2564,-1019
2020,7,29,5,2099,3466,2451,-1015
2020,7,29,6,1415,2986,1956,-1030
2020,7,29,7,1106,2693,1664,-1029
2020,7,29,8,1227,2468,1534,-934
2020,7,29,9,1088,2339,1374,-965
2020,7,29,10,1123,2235,1450,-785
2020,7,29,11,1091,2203,1422,-781
2020,7,29,12,996,2240,1492,-748
2020,7,29,13,1108,2347,1640,-707
2020,7,29,14,1468,2619,1880,-739
2020,7,29,15,1733,2808,1985,-823
2020,7,29,16,1878,2961,2054,-907
2020,7,29,17,2005,3142,2102,-1040
2020,7,29,18,2114,3254,2248,-1006
2020,7,29,19,2202,3384,2409,-975
2020,7,29,20,2341,3499,2525,-974
2020,7,29,21,2203,3575,2537,-1038
2020,7,29,22,2255,3654,2538,-1116
2020,7,29,23,2319,3743,2576,-1167
2020,7,30,0,2315,3830,2554,-1276
2020,7,30,1,2289,3913,2539,-1374
2020,7,30,2,2285,3901,2563,-1338
2020,7,30,3,2191,3788,2572,-1216
2020,7,30,4,2143,3643,2543,-1100
2020,7,30,5,2247,3550,2347,-1203
2020,7,30,6,1812,3272,1993,-1279
2020,7,30,7,1527,2981,1725,-1256
2020,7,30,8,1096,2548,1484,-1064
2020,7,30,9,964,2433,1474,-959
2020,7,30,10,998,2307,1401,-906
2020,7,30,11,939,2294,1429,-865
2020,7,30,12,946,2302,1391,-911
2020,7,30,13,1183,2430,1520,-910
2020,7,30,14,1526,2764,1851,-913
2020,7,30,15,1740,2923,1958,-965
2020,7,30,16,1923,3101,2154,-947
2020,7,30,17,2029,3256,2273,-983
2020,7,30,18,2125,3313,2423,-890
2020,7,30,19,2263,3362,2440,-922
2020,7,30,20,2201,3480,2415,-1065
2020,7,30,21,2194,3575,2434,-1141
2020,7,30,22,2173,3682,2414,-1268
2020,7,30,23,2252,3759,2371,-1388
2020,7,31,0,2168,3827,2335,-1492
2020,7,31,1,2165,3922,2348,-1574
2020,7,31,2,2143,3892,2277,-1615
2020,7,31,3,2154,3783,2337,-1446
2020,7,31,4,2138,3644,2369,-1275
2020,7,31,5,2247,3537,2343,-1194
2020,7,31,6,1559,3255,1937,-1318
2020,7,31,7,1204,2957,1575,-1382
2020,7,31,8,1043,2714,1590,-1124
2020,7,31,9,982,2471,1482,-989
2020,7,31,10,966,2372,1453,-919
2020,7,31,11,954,2322,1425,-897
2020,7,31,12,901,2345,1535,-810
2020,7,31,13,1122,2440,1623,-817
2020,7,31,14,1422,2641,1929,-712
2020,7,31,15,1639,2784,2093,-691
2020,7,31,16,1762,2945,2236,-709
2020,7,31,17,1841,3085,2231,-854
2020,7,31,18,1868,3198,2238,-960
2020,7,31,19,1883,3281,2167,-1114
2020,7,31,20,1905,3373,2166,-1207
2020,7,31,21,1975,3440,2242,-1198
2020,7,31,22,1985,3497,2351,-1146
2020,7,31,23,2035,3569,2489,-1080
2020,8,1,0,2112,3603,2541,-1062
2020,8,1,1,2125,3651,2501,-1150
2020,8,1,2,2099,3551,2512,-1039
2020,8,1,3,2121,3388,2592,-796
2020,8,1,4,1932,3254,2468,-786
2020,8,1,5,1820,3182,2280,-902
2020,8,1,6,1351,2887,1817,-1070
2020,8,1,7,1058,2650,1740,-910
2020,8,1,8,1187,2452,1645,-807
2020,8,1,9,1082,2310,1563,-747
2020,8,1,10,1031,2197,1495,-702
2020,8,1,11,951,2136,1472,-664
2020,8,1,12,937,2104,1385,-719
2020,8,1,13,1022,2138,1461,-677
2020,8,1,14,1081,2181,1521,-660
2020,8,1,15,1096,2281,1486,-795
2020,8,1,16,1247,2499,1356,-1143
2020,8,1,17,1464,2651,1553,-1098
2020,8,1,18,1666,2745,1928,-817
2020,8,1,19,1759,2833,2054,-779
2020,8,1,20,1912,2873,2132,-741
2020,8,1,21,1928,2924,2144,-780
2020,8,1,22,2051,2945,2244,-701
2020,8,1,23,2085,2998,2293,-705
2020,8,2,0,2040,3090,2341,-749
2020,8,2,1,2134,3187,2362,-825
2020,8,2,2,2123,3204,2368,-836
2020,8,2,3,2036,3146,2390,-756
2020,8,2,4,2003,3066,2406,-660
2020,8,2,5,1906,3028,2372,-656
2020,8,2,6,1805,2855,2203,-652
2020,8,2,7,1582,2618,1870,-748
2020,8,2,8,960,2316,1524,-792
2020,8,2,9,939,2153,1322,-831
2020,8,2,10,782,2028,1248,-780
2020,8,2,11,753,1974,1189,-785
2020,8,2,12,801,1964,1166,-798
2020,8,2,13,735,2039,1163,-876
2020,8,2,14,820,2056,1324,-732
2020,8,2,15,1042,2132,1288,-844
2020,8,2,16,1125,2289,1322,-967
2020,8,2,17,1309,2483,1449,-1034
2020,8,2,18,1430,2628,1515,-1113
2020,8,2,19,1519,2797,1628,-1169
2020,8,2,20,1396,3052,1769,-1283
2020,8,2,21,1548,3191,1933,-1258
2020,8,2,22,1484,3253,2062,-1191
2020,8,2,23,1523,3315,2072,-1243
2020,8,3,0,1588,3400,2144,-1256
2020,8,3,1,1684,3531,2207,-1324
2020,8,3,2,1690,3529,2254,-1275
2020,8,3,3,1588,3454,2183,-1271
2020,8,3,4,1654,3375,2190,-1185
2020,8,3,5,1611,3304,2149,-1155
2020,8,3,6,1371,3060,1946,-1114
2020,8,3,7,1081,2528,1536,-992
2020,8,3,8,1094,2324,1511,-813
2020,8,3,9,1043,2214,1546,-668
2020,8,3,10,1008,2165,1507,-658
2020,8,3,11,1049,2155,1398,-757
2020,8,3,12,1189,2210,1562,-648
2020,8,3,13,1113,2336,1558,-778
2020,8,3,14,1466,2479,1873,-606
2020,8,3,15,1661,2654,2026,-628
2020,8,3,16,1878,3020,2168,-852
2020,8,3,17,2006,3137,2218,-919
2020,8,3,18,2119,3238,2293,-945
2020,8,3,19,2102,3326,2266,-1060
2020,8,3,20,2098,3428,2308,-1120
2020,8,3,21,2119,3492,2500,-992
2020,8,3,22,2171,3535,2558,-977
2020,8,3,23,2284,3603,2619,-984
2020,8,4,0,2302,3680,2593,-1087
2020,8,4,1,2643,3771,2757,-1014
2020,8,4,2,2609,3777,2763,-1014
2020,8,4,3,2510,3655,2753,-902
2020,8,4,4,2452,3517,2462,-1055
2020,8,4,5,2371,3451,2420,-1031
2020,8,4,6,1844,3179,2246,-933
2020,8,4,7,1577,2731,1792,-939
2020,8,4,8,1356,2561,1773,-788
2020,8,4,9,1338,2318,1648,-670
2020,8,4,10,1235,2234,1575,-659
2020,8,4,11,1204,2206,1520,-686
2020,8,4,12,1204,2248,1505,-743
2020,8,4,13,1437,2379,1601,-778
2020,8,4,14,1642,2627,1823,-804
2020,8,4,15,1862,2899,2058,-841
2020,8,4,16,1974,3066,2129,-937
2020,8,4,17,2081,3199,2098,-1101
2020,8,4,18,2173,3300,2174,-1126
2020,8,4,19,2249,3419,2435,-984
2020,8,4,20,2317,3489,2353,-1136
2020,8,4,21,2376,3556,2517,-1039
2020,8,4,22,2424,3627,2594,-1033
2020,8,4,23,2425,3734,2688,-1046
2020,8,5,0,2408,3810,2637,-1173
2020,8,5,1,2424,3900,2701,-1199
2020,8,5,2,2390,3857,2651,-1206
2020,8,5,3,2330,3719,2594,-1125
2020,8,5,4,2278,3552,2550,-1002
2020,8,5,5,2192,3505,2436,-1069
2020,8,5,6,2107,3254,2280,-974
2020,8,5,7,1831,2956,2150,-806
2020,8,5,8,1682,2688,2078,-610
2020,8,5,9,1578,2458,1973,-485
2020,8,5,10,1509,2319,1797,-522
2020,8,5,11,1471,2273,1743,-530
2020,8,5,12,1501,2325,1782,-543
2020,8,5,13,1556,2516,1963,-553
2020,8,5,14,1744,2710,2052,-658
2020,8,5,15,1916,2883,2078,-805
2020,8,5,16,2059,3042,2171,-871
2020,8,5,17,2165,3179,2178,-1001
2020,8,5,18,2233,3272,2212,-1060
2020,8,5,19,2306,3343,2163,-1180
2020,8,5,20,2291,3450,2168,-1282
2020,8,5,21,2352,3528,2270,-1258
2020,8,5,22,2392,3583,2414,-1169
2020,8,5,23,2424,3649,2446,-1203
2020,8,6,0,2455,3715,2446,-1269
2020,8,6,1,2450,3830,2540,-1290
2020,8,6,2,2524,3807,2678,-1129
2020,8,6,3,2430,3654,2660,-994
2020,8,6,4,2430,3510,2321,-1189
2020,8,6,5,2301,3376,2201,-1175
2020,8,6,6,1901,2943,1911,-1032
2020,8,6,7,1532,2658,1713,-945
2020,8,6,8,685,2413,1055,-1358
2020,8,6,9,478,2301,988,-1313
2020,8,6,10,567,2241,964,-1277
2020,8,6,11,541,2207,955,-1252
2020,8,6,12,628,2176,884,-1292
2020,8,6,13,833,2259,944,-1315
2020,8,6,14,566,2508,970,-1538
2020,8,6,15,724,2674,1043,-1631
2020,8,6,16,834,2848,1146,-1702
2020,8,6,17,896,2964,1199,-1765
2020,8,6,18,964,2964,1149,-1815
2020,8,6,19,880,3003,1027,-1976
2020,8,6,20,798,3092,1031,-2061
2020,8,6,21,864,3175,1118,-2057
2020,8,6,22,876,3060,1029,-2031
2020,8,6,23,890,3028,1006,-2022
2020,8,7,0,991,2930,1006,-1924
2020,8,7,1,965,2965,1155,-1810
2020,8,7,2,941,2939,1181,-1758
2020,8,7,3,777,2962,1170,-1792
2020,8,7,4,799,2875,1115,-1760
2020,8,7,5,817,2833,1123,-1710
2020,8,7,6,845,2637,1145,-1492
2020,8,7,7,791,2412,1129,-1283
2020,8,7,8,758,2264,1146,-1118
2020,8,7,9,664,2165,1088,-1077
2020,8,7,10,616,2122,1061,-1061
2020,8,7,11,704,2121,1059,-1062
2020,8,7,12,793,2294,1129,-1165
2020,8,7,13,1016,2429,1402,-1027
2020,8,7,14,1284,2691,1662,-1029
2020,8,7,15,1521,2826,1795,-1031
2020,8,7,16,1674,2961,1745,-1216
2020,8,7,17,1802,3050,1847,-1203
2020,8,7,18,1890,3109,1836,-1273
2020,8,7,19,1949,3151,1961,-1190
2020,8,7,20,1999,3191,1963,-1228
2020,8,7,21,2004,3202,2046,-1156
2020,8,7,22,2087,3218,2117,-1101
2020,8,7,23,2101,3243,2158,-1085
2020,8,8,0,2170,3292,2243,-1049
2020,8,8,1,2123,3325,2288,-1037
2020,8,8,2,2062,3300,2414,-886
2020,8,8,3,1981,3180,2175,-1005
2020,8,8,4,1947,3141,2078,-1063
2020,8,8,5,1840,3005,1978,-1027
2020,8,8,6,1737,2800,1776,-1024
2020,8,8,7,1567,2604,1579,-1025
2020,8,8,8,1123,2314,1484,-830
2020,8,8,9,1078,2195,1479,-716
2020,8,8,10,1094,2133,1505,-628
2020,8,8,11,1117,2098,1495,-603
2020,8,8,12,1086,2100,1445,-655
2020,8,8,13,1059,2145,1444,-701
2020,8,8,14,948,2190,1400,-790
2020,8,8,15,1010,2284,1215,-1069
2020,8,8,16,992,2427,1135,-1292
2020,8,8,17,1025,2554,1150,-1404
2020,8,8,18,1121,2660,1362,-1298
2020,8,8,19,1144,2714,1530,-1184
2020,8,8,20,1268,2818,1609,-1209
2020,8,8,21,1382,2819,1651,-1168
2020,8,8,22,1450,2813,1724,-1089
2020,8,8,23,1470,2806,1541,-1265
2020,8,9,0,1516,2859,1504,-1355
2020,8,9,1,1605,2913,1703,-1210
2020,8,9,2,1579,2912,1759,-1153
2020,8,9,3,1571,2860,1785,-1075
2020,8,9,4,1545,2897,1923,-974
2020,8,9,5,1450,2781,1866,-915
2020,8,9,6,1526,2577,1786,-791
2020,8,9,7,1420,2391,1742,-649
2020,8,9,8,1458,2199,1625,-574
2020,8,9,9,1387,2071,1445,-626
2020,8,9,10,1325,2065,1472,-593
2020,8,9,11,1255,2032,1499,-533
2020,8,9,12,1300,2033,1475,-558
2020,8,9,13,1355,2070,1505,-565
2020,8,9,14,1150,2114,1444,-670
2020,8,9,15,1321,2134,1254,-880
2020,8,9,16,1407,2363,1210,-1153
2020,8,9,17,1723,2676,1493,-1183
2020,8,9,18,1799,2844,1900,-944
2020,8,9,19,1834,2916,2032,-884
2020,8,9,20,2054,2968,2191,-777
2020,8,9,21,2271,2993,2191,-802
2020,8,9,22,2254,3032,2330,-702
2020,8,9,23,2333,3027,2387,-640
2020,8,10,0,2395,3175,2472,-703
2020,8,10,1,2491,3239,2365,-874
2020,8,10,2,2525,3261,2482,-779
2020,8,10,3,2523,3263,2597,-666
2020,8,10,4,2478,3122,2562,-560
2020,8,10,5,2385,3058,2622,-436
2020,8,10,6,2341,2928,2492,-436
2020,8,10,7,2060,2686,2228,-458
2020,8,10,8,1839,2460,2168,-292
2020,8,10,9,1802,2355,2158,-197
2020,8,10,10,1687,2299,2104,-195
2020,8,10,11,1665,2287,2118,-169
2020,8,10,12,1784,2346,2176,-170
2020,8,10,13,1908,2474,2092,-382
2020,8,10,14,1826,2622,2139,-483
2020,8,10,15,1998,2805,2128,-677
2020,8,10,16,2060,2961,2141,-820
2020,8,10,17,2080,3090,2230,-860
2020,8,10,18,2313,3190,2416,-774
2020,8,10,19,2380,3287,2488,-799
2020,8,10,20,2448,3357,2566,-791
2020,8,10,21,2496,3420,2719,-701
2020,8,10,22,2522,3482,2727,-755
2020,8,10,23,2547,3539,2737,-802
2020,8,11,0,2591,3615,2723,-892
2020,8,11,1,2597,3704,2737,-967
2020,8,11,2,2540,3676,2783,-893
2020,8,11,3,2443,3539,2669,-870
2020,8,11,4,2381,3453,2664,-789
2020,8,11,5,2274,3284,2520,-764
2020,8,11,6,2230,3072,2413,-659
2020,8,11,7,2004,2814,2280,-534
2020,8,11,8,1349,2388,1761,-627
2020,8,11,9,1165,2250,1656,-594
2020,8,11,10,920,2194,1548,-646
2020,8,11,11,971,2158,1561,-597
2020,8,11,12,1056,2197,1561,-636
2020,8,11,13,1197,2322,1765,-557
2020,8,11,14,1460,2550,1873,-677
2020,8,11,15,1608,2820,1890,-930
2020,8,11,16,1612,2953,1851,-1102
2020,8,11,17,1813,3060,1793,-1267
2020,8,11,18,1820,3072,1692,-1380
2020,8,11,19,1815,3140,1739,-1401
2020,8,11,20,1817,3198,1809,-1389
2020,8,11,21,1842,3224,1866,-1358
2020,8,11,22,1891,3259,1930,-1329
2020,8,11,23,1885,3295,1923,-1372
2020,8,12,0,1983,3432,2101,-1331
2020,8,12,1,2036,3463,2186,-1277
2020,8,12,2,1995,3383,2187,-1196
2020,8,12,3,1984,3223,2122,-1101
2020,8,12,4,1898,3193,2110,-1083
2020,8,12,5,1894,3079,1999,-1080
2020,8,12,6,1446,2610,1531,-1079
2020,8,12,7,1245,2378,1453,-925
2020,8,12,8,1258,2208,1341,-867
2020,8,12,9,1127,2061,1242,-819
2020,8,12,10,1124,2004,1194,-810
2020,8,12,11,1119,1996,1338,-658
2020,8,12,12,1114,1991,1205,-786
2020,8,12,13,1214,2131,1243,-888
2020,8,12,14,1100,2287,1293,-994
2020,8,12,15,1311,2564,1337,-1227
2020,8,12,16,1329,2731,1255,-1476
2020,8,12,17,1497,2910,1272,-1638
2020,8,12,18,1437,2991,1465,-1526
2020,8,12,19,1598,3043,1495,-1548
2020,8,12,20,1567,3067,1567,-1500
2020,8,12,21,1632,3061,1648,-1413
2020,8,12,22,1592,3146,1822,-1324
2020,8,12,23,1618,3155,1797,-1358
2020,8,13,0,1597,3197,1741,-1456
2020,8,13,1,1750,3282,1961,-1321
2020,8,13,2,1746,3287,2069,-1218
2020,8,13,3,1670,3165,2037,-1128
2020,8,13,4,1767,3188,2129,-1059
2020,8,13,5,1689,3112,2144,-968
2020,8,13,6,1573,2895,2136,-759
2020,8,13,7,1557,2664,2066,-598
2020,8,13,8,1561,2401,1751,-650
2020,8,13,9,1426,2266,1747,-519
2020,8,13,10,1354,2160,1454,-706
2020,8,13,11,1262,2096,1369,-727
2020,8,13,12,1390,2163,1456,-707
2020,8,13,13,1462,2487,1755,-732
2020,8,13,14,1845,2663,1809,-854
2020,8,13,15,2006,2856,1998,-858
2020,8,13,16,2022,2944,1990,-954
2020,8,13,17,2034,3022,2010,-1012
2020,8,13,18,2050,3086,1998,-1088
2020,8,13,19,2045,3122,1967,-1155
2020,8,13,20,2118,3118,1949,-1169
2020,8,13,21,2140,3161,2096,-1065
2020,8,13,22,2205,3190,2374,-816
2020,8,13,23,2219,3216,2276,-940
2020,8,14,0,2306,3271,2487,-784
2020,8,14,1,2317,3347,2514,-833
2020,8,14,2,2342,3353,2471,-882
2020,8,14,3,2288,3272,2595,-677
2020,8,14,4,2189,3227,2616,-611
2020,8,14,5,2239,3149,2309,-840
2020,8,14,6,1975,2933,2251,-682
2020,8,14,7,1888,2704,2249,-455
2020,8,14,8,1792,2357,1984,-373
2020,8,14,9,1787,2281,1929,-352
2020,8,14,10,1720,2239,1991,-248
2020,8,14,11,1742,2289,2033,-256
2020,8,14,12,1713,2356,2086,-270
2020,8,14,13,1843,2388,2063,-325
2020,8,14,14,1915,2634,2092,-542
2020,8,14,15,2087,2822,2090,-732
2020,8,14,16,2213,2942,2117,-825
2020,8,14,17,2299,3052,2194,-858
2020,8,14,18,2352,3154,2332,-822
2020,8,14,19,2351,3221,2504,-717
2020,8,14,20,2461,3268,2450,-818
2020,8,14,21,2453,3307,2591,-716
2020,8,14,22,2445,3344,2616,-728
2020,8,14,23,2445,3380,2643,-737
2020,8,15,0,2443,3435,2621,-814
2020,8,15,1,2443,3505,2700,-805
2020,8,15,2,2471,3464,2839,-625
2020,8,15,3,2469,3348,2740,-608
2020,8,15,4,2477,3274,2775,-499
2020,8,15,5,2297,3184,2685,-499
2020,8,15,6,2276,2986,2600,-386
2020,8,15,7,2060,2752,2461,-291
2020,8,15,8,1871,2574,2295,-279
2020,8,15,9,1826,2326,2031,-295
2020,8,15,10,1908,2284,2007,-277
2020,8,15,11,1857,2243,1971,-272
2020,8,15,12,1718,2206,1854,-352
2020,8,15,13,1767,2282,1909,-373
2020,8,15,14,1730,2292,1572,-720
2020,8,15,15,1730,2509,1773,-736
2020,8,15,16,1805,2721,1893,-828
2020,8,15,17,1991,2957,2003,-954
2020,8,15,18,2175,3096,2163,-933
2020,8,15,19,2158,3199,2288,-911
2020,8,15,20,2179,3293,2311,-982
2020,8,15,21,2196,3364,2500,-864
2020,8,15,22,2200,3444,2549,-895
2020,8,15,23,2304,3525,2549,-976
2020,8,16,0,2409,3622,2596,-1026
2020,8,16,1,2401,3689,2652,-1037
2020,8,16,2,2416,3686,2679,-1007
2020,8,16,3,2428,3570,2613,-957
2020,8,16,4,2277,3481,2569,-912
2020,8,16,5,2259,3373,2432,-941
2020,8,16,6,2379,3171,2462,-709
2020,8,16,7,2156,2911,2349,-562
2020,8,16,8,1971,2694,2194,-500
2020,8,16,9,1853,2503,1996,-507
2020,8,16,10,1808,2417,1972,-445
2020,8,16,11,1740,2396,2081,-315
2020,8,16,12,1713,2380,2072,-308
2020,8,16,13,1729,2396,2030,-366
2020,8,16,14,1657,2350,1844,-506
2020,8,16,15,1776,2555,1966,-589
2020,8,16,16,1976,2780,2041,-739
2020,8,16,17,2101,3000,2110,-890
2020,8,16,18,2177,3164,2276,-888
2020,8,16,19,2309,3388,2395,-993
2020,8,16,20,2004,3519,2276,-1243
2020,8,16,21,2009,3673,2361,-1312
2020,8,16,22,2192,3786,2526,-1260
2020,8,16,23,2076,3871,2439,-1432
2020,8,17,0,2173,3955,2507,-1448
2020,8,17,1,2187,4035,2561,-1474
2020,8,17,2,2181,4006,2445,-1561
2020,8,17,3,2120,3932,2342,-1590
2020,8,17,4,2001,3865,2346,-1519
2020,8,17,5,2043,3769,2414,-1355
2020,8,17,6,2550,3483,2312,-1171
2020,8,17,7,2266,3151,2138,-1013
2020,8,17,8,1821,2934,1955,-979
2020,8,17,9,1705,2817,1949,-868
2020,8,17,10,1529,2726,2006,-720
2020,8,17,11,1704,2672,2129,-543
2020,8,17,12,1633,2693,2079,-614
2020,8,17,13,1828,2782,2068,-714
2020,8,17,14,1809,2872,1971,-901
2020,8,17,15,1970,2999,2046,-953
2020,8,17,16,2113,3199,2154,-1045
2020,8,17,17,2222,3362,2360,-1002
2020,8,17,18,2317,3538,2511,-1027
2020,8,17,19,2396,3678,2519,-1159
2020,8,17,20,2476,3802,2506,-1296
2020,8,17,21,2421,3901,2491,-1410
2020,8,17,22,2490,3973,2568,-1405
2020,8,17,23,2476,4060,2730,-1330
2020,8,18,0,2469,4135,2625,-1510
2020,8,18,1,2425,4175,2846,-1329
2020,8,18,2,2324,4112,2835,-1277
2020,8,18,3,2228,3974,2690,-1284
2020,8,18,4,2390,3878,2671,-1207
2020,8,18,5,2266,3700,2632,-1068
2020,8,18,6,2457,3389,2737,-652
2020,8,18,7,2277,3071,2527,-544
2020,8,18,8,1706,2844,2292,-552
2020,8,18,9,1694,2673,2169,-504
2020,8,18,10,1641,2581,2176,-405
2020,8,18,11,1576,2545,2240,-305
2020,8,18,12,1688,2589,2214,-375
2020,8,18,13,1785,2691,2204,-487
2020,8,18,14,1586,2825,2105,-720
2020,8,18,15,1747,2995,2164,-831
2020,8,18,16,1892,3115,2251,-864
2020,8,18,17,2006,3220,2285,-935
2020,8,18,18,2066,3328,2419,-909
2020,8,18,19,2129,3419,2456,-963
2020,8,18,20,2023,3514,2541,-973
2020,8,18,21,2169,3574,2731,-843
2020,8,18,22,2206,3655,2781,-874
2020,8,18,23,2252,3711,2774,-937
2020,8,19,0,2256,3791,2794,-997
2020,8,19,1,2272,3841,2734,-1107
2020,8,19,2,2208,3783,2545,-1238
2020,8,19,3,2097,3655,2554,-1101
2020,8,19,4,2074,3578,2608,-970
2020,8,19,5,1949,3428,2426,-1002
2020,8,19,6,2219,3157,2376,-781
2020,8,19,7,1958,2662,2056,-606
2020,8,19,8,1406,2445,1924,-521
2020,8,19,9,1333,2319,1628,-691
2020,8,19,10,1218,2246,1718,-528
2020,8,19,11,1147,2219,1793,-426
2020,8,19,12,1143,2252,1762,-490
2020,8,19,13,1298,2366,1856,-510
2020,8,19,14,1189,2520,1787,-733
2020,8,19,15,1672,2882,2198,-684
2020,8,19,16,1837,3046,2278,-768
2020,8,19,17,1993,3178,2314,-864
2020,8,19,18,2091,3244,2380,-864
2020,8,19,19,2188,3358,2424,-934
2020,8,19,20,2090,3455,2424,-1031
2020,8,19,21,2189,3545,2594,-951
2020,8,19,22,2250,3592,2665,-927
2020,8,19,23,2328,3706,2687,-1019
2020,8,20,0,2289,3783,2826,-957
2020,8,20,1,2368,3768,2684,-1084
2020,8,20,2,2410,3726,2655,-1071
2020,8,20,3,2225,3624,2616,-1008
2020,8,20,4,2184,3586,2577,-1009
2020,8,20,5,2045,3360,2424,-936
2020,8,20,6,2302,3071,2381,-690
2020,8,20,7,2045,2818,1960,-858
2020,8,20,8,1658,2622,1974,-648
2020,8,20,9,1361,2348,1719,-629
2020,8,20,10,1238,2238,1720,-518
2020,8,20,11,1325,2192,1777,-415
2020,8,20,12,1403,2229,1785,-444
2020,8,20,13,1415,2340,1861,-479
2020,8,20,14,1363,2437,1317,-1120
2020,8,20,15,1613,2713,1731,-982
2020,8,20,16,1753,2957,2123,-834
2020,8,20,17,1868,3189,2236,-953
2020,8,20,18,2013,3358,2307,-1051
2020,8,20,19,2091,3455,2296,-1159
2020,8,20,20,2215,3553,2288,-1265
2020,8,20,21,2263,3568,2406,-1162
2020,8,20,22,2313,3572,2414,-1158
2020,8,20,23,2357,3591,2563,-1028
2020,8,21,0,2398,3644,2442,-1202
2020,8,21,1,2434,3716,2461,-1255
2020,8,21,2,2378,3663,2464,-1199
2020,8,21,3,2302,3561,2417,-1144
2020,8,21,4,2318,3528,2323,-1205
2020,8,21,5,2202,3369,2292,-1077
2020,8,21,6,2202,3152,2341,-811
2020,8,21,7,1984,2911,2106,-805
2020,8,21,8,1648,2741,2059,-682
2020,8,21,9,1578,2632,2012,-620
2020,8,21,10,1532,2562,2001,-561
2020,8,21,11,1526,2543,1945,-598
2020,8,21,12,1606,2579,2027,-552
2020,8,21,13,1741,2677,2021,-656
2020,8,21,14,1529,2830,1953,-877
2020,8,21,15,1663,2990,1946,-1044
2020,8,21,16,1629,3141,1897,-1244
2020,8,21,17,1688,3246,2037,-1209
2020,8,21,18,1727,3316,2153,-1163
2020,8,21,19,1749,3373,2194,-1179
2020,8,21,20,1763,3381,2090,-1291
2020,8,21,21,1753,3351,2015,-1336
2020,8,21,22,1712,3298,1975,-1323
2020,8,21,23,1825,3273,2105,-1168
2020,8,22,0,1804,3265,2099,-1166
2020,8,22,1,1740,3285,1882,-1403
2020,8,22,2,1663,3260,1828,-1432
2020,8,22,3,1614,3182,1808,-1374
2020,8,22,4,1575,3184,1929,-1255
2020,8,22,5,1461,3089,1969,-1120
2020,8,22,6,1660,2814,2113,-701
2020,8,22,7,1439,2590,1953,-637
2020,8,22,8,1083,2331,1737,-594
2020,8,22,9,1069,2211,1705,-506
2020,8,22,10,1084,2148,1671,-477
2020,8,22,11,1064,2119,1613,-506
2020,8,22,12,1118,2115,1592,-523
2020,8,22,13,1238,2152,1685,-467
2020,8,22,14,1044,2152,1406,-746
2020,8,22,15,1053,2259,1448,-811
2020,8,22,16,1244,2426,1601,-825
2020,8,22,17,1422,2702,1813,-889
2020,8,22,18,1545,2799,1780,-1019
2020,8,22,19,1611,2955,1900,-1055
2020,8,22,20,1631,2990,1856,-1134
2020,8,22,21,1633,2987,1770,-1217
2020,8,22,22,1626,2997,1785,-1212
2020,8,22,23,1641,3024,1769,-1255
2020,8,23,0,1693,3082,1921,-1161
2020,8,23,1,1709,3201,2035,-1166
2020,8,23,2,1701,3173,2030,-1143
2020,8,23,3,1661,3107,2068,-1039
2020,8,23,4,1681,3090,2055,-1035
2020,8,23,5,1585,2998,2047,-951
2020,8,23,6,1821,2816,2090,-726
2020,8,23,7,1676,2632,1953,-679
2020,8,23,8,1697,2486,1963,-523
2020,8,23,9,1604,2380,1958,-422
2020,8,23,10,1613,2229,1797,-432
2020,8,23,11,1612,2180,1843,-337
2020,8,23,12,1740,2207,1927,-280
2020,8,23,13,1558,2232,1936,-296
2020,8,23,14,1588,2257,1849,-408
2020,8,23,15,1710,2379,1830,-549
2020,8,23,16,1701,2546,1852,-694
2020,8,23,17,1931,2721,1951,-770
2020,8,23,18,1892,2816,1991,-825
2020,8,23,19,1933,2879,2084,-795
2020,8,23,20,1963,2923,2113,-810
2020,8,23,21,1974,3003,2376,-627
2020,8,23,22,1983,3040,2412,-628
2020,8,23,23,2065,3081,2477,-604
2020,8,24,0,2128,3171,2603,-568
2020,8,24,1,2175,3267,2648,-619
2020,8,24,2,2164,3279,2688,-591
2020,8,24,3,2135,3175,2483,-692
2020,8,24,4,2122,3171,2424,-747
2020,8,24,5,1999,3063,2395,-668
2020,8,24,6,2034,2863,2245,-618
2020,8,24,7,1822,2597,2114,-483
2020,8,24,8,1803,2387,1986,-401
2020,8,24,9,1739,2283,1945,-338
2020,8,24,10,1733,2218,1860,-358
2020,8,24,11,1741,2196,1819,-377
2020,8,24,12,1810,2229,1768,-461
2020,8,24,13,1991,2431,2041,-390
2020,8,24,14,1828,2571,1943,-628
2020,8,24,15,1893,2730,1905,-825
2020,8,24,16,2027,3017,2240,-777
2020,8,24,17,2116,3040,2184,-856
2020,8,24,18,2156,3140,2233,-907
2020,8,24,19,2191,3236,2352,-884
2020,8,24,20,2233,3295,2411,-884
2020,8,24,21,2258,3230,2382,-848
2020,8,24,22,2264,3289,2458,-831
2020,8,24,23,2310,3329,2612,-717
2020,8,25,0,2334,3357,2629,-728
2020,8,25,1,2389,3390,2627,-763
2020,8,25,2,2422,3373,2695,-678
2020,8,25,3,2359,3273,2678,-595
2020,8,25,4,2344,3255,2646,-609
2020,8,25,5,2187,3097,2466,-631
2020,8,25,6,2114,2881,2359,-522
2020,8,25,7,1922,2661,2396,-265
2020,8,25,8,1761,2501,2238,-263
2020,8,25,9,1776,2344,2148,-196
2020,8,25,10,1839,2288,2052,-236
2020,8,25,11,1774,2254,1967,-287
2020,8,25,12,1701,2283,1895,-388
2020,8,25,13,1843,2431,1985,-446
2020,8,25,14,1870,2581,1837,-744
2020,8,25,15,1934,2741,1859,-882
2020,8,25,16,2015,2879,1911,-968
2020,8,25,17,2068,2962,1935,-1027
2020,8,25,18,2054,3048,2050,-998
2020,8,25,19,2260,3107,2238,-869
2020,8,25,20,2254,3197,2208,-989
2020,8,25,21,2383,3228,2395,-833
2020,8,25,22,2433,3268,2343,-925
2020,8,25,23,2418,3302,2383,-919
2020,8,26,0,2442,3395,2574,-821
2020,8,26,1,2436,3455,2570,-885
2020,8,26,2,2433,3432,2555,-877
2020,8,26,3,2469,3325,2460,-865
2020,8,26,4,2484,3298,2543,-755
2020,8,26,5,2089,3159,2433,-726
2020,8,26,6,2245,2925,2582,-343
2020,8,26,7,2041,2684,2386,-298
2020,8,26,8,1549,2361,2037,-324
2020,8,26,9,1605,2227,1915,-312
2020,8,26,10,1567,2043,1763,-280
2020,8,26,11,1249,2056,1719,-337
2020,8,26,12,1424,2097,1722,-375
2020,8,26,13,1498,2374,1799,-575
2020,8,26,14,1456,2565,1721,-844
2020,8,26,15,1744,2863,1856,-1007
2020,8,26,16,1882,3001,1977,-1024
2020,8,26,17,1916,3088,1999,-1089
2020,8,26,18,1899,3147,2059,-1088
2020,8,26,19,1901,3209,2101,-1108
2020,8,26,20,2177,3276,2195,-1081
2020,8,26,21,2210,3306,2224,-1082
2020,8,26,22,2214,3333,2292,-1041
2020,8,26,23,2219,3358,2412,-946
2020,8,27,0,2240,3400,2308,-1092
2020,8,27,1,2292,3449,2385,-1064
2020,8,27,2,2262,3405,2469,-936
2020,8,27,3,2182,3307,2418,-889
2020,8,27,4,2176,3291,2301,-990
2020,8,27,5,2017,3139,2102,-1037
2020,8,27,6,1948,2909,2302,-607
2020,8,27,7,1853,2667,2195,-472
2020,8,27,8,1515,2404,1888,-516
2020,8,27,9,1395,2170,1710,-460
2020,8,27,10,1297,2061,1663,-398
2020,8,27,11,1253,2069,1640,-429
2020,8,27,12,1358,2141,1562,-579
2020,8,27,13,1401,2381,1723,-658
2020,8,27,14,1541,2594,1762,-832
2020,8,27,15,1707,2835,1892,-943
2020,8,27,16,1761,3019,1951,-1068
2020,8,27,17,1785,3117,1977,-1140
2020,8,27,18,1811,3182,2016,-1166
2020,8,27,19,2044,3239,1960,-1279
2020,8,27,20,2012,3304,2103,-1201
2020,8,27,21,2053,3322,2040,-1282
2020,8,27,22,2117,3352,2024,-1328
2020,8,27,23,2170,3402,2074,-1328
2020,8,28,0,2148,3456,2237,-1219
2020,8,28,1,2154,3506,2336,-1170
2020,8,28,2,2166,3473,2466,-1007
2020,8,28,3,2117,3359,2372,-987
2020,8,28,4,2236,3334,2265,-1069
2020,8,28,5,1882,3192,2029,-1163
2020,8,28,6,1827,2960,2063,-897
2020,8,28,7,1635,2636,1871,-765
2020,8,28,8,1601,2445,1812,-633
2020,8,28,9,1355,2261,1673,-588
2020,8,28,10,1456,2178,1685,-493
2020,8,28,11,1366,2167,1681,-486
2020,8,28,12,1432,2206,1646,-560
2020,8,28,13,1547,2459,1738,-721
2020,8,28,14,1552,2632,1723,-909
2020,8,28,15,1639,2847,1802,-1045
2020,8,28,16,1712,2995,1834,-1161
2020,8,28,17,1798,3102,1825,-1277
2020,8,28,18,1758,3170,2000,-1170
2020,8,28,19,1874,3218,2018,-1200
2020,8,28,20,1922,3278,1918,-1360
2020,8,28,21,2034,3305,2053,-1252
2020,8,28,22,2027,3350,2230,-1120
2020,8,28,23,2137,3397,2205,-1192
2020,8,29,0,2187,3448,2191,-1257
2020,8,29,1,2194,3486,2331,-1155
2020,8,29,2,2120,3421,2005,-1416
2020,8,29,3,2083,3306,2150,-1156
2020,8,29,4,2015,3273,2288,-985
2020,8,29,5,1867,3127,2192,-935
2020,8,29,6,1869,2938,2243,-695
2020,8,29,7,1476,2717,2004,-713
2020,8,29,8,1287,2551,1592,-959
2020,8,29,9,1341,2265,1413,-852
2020,8,29,10,1269,2145,1321,-824
2020,8,29,11,1281,2070,1224,-846
2020,8,29,12,1239,2036,1192,-844
2020,8,29,13,1036,2087,1205,-882
2020,8,29,14,1285,2168,1246,-922
2020,8,29,15,1156,2464,1444,-1020
2020,8,29,16,1170,2633,1348,-1285
2020,8,29,17,1381,2787,1384,-1403
2020,8,29,18,1423,2875,1346,-1529
2020,8,29,19,1434,2907,1405,-1502
2020,8,29,20,1399,2923,1421,-1502
2020,8,29,21,1334,2925,1406,-1519
2020,8,29,22,1290,2938,1527,-1411
2020,8,29,23,1341,2998,1598,-1400
2020,8,30,0,1217,3030,1540,-1490
2020,8,30,1,1409,3083,1601,-1482
2020,8,30,2,1272,3070,1482,-1588
2020,8,30,3,1269,3001,1434,-1567
2020,8,30,4,1297,3002,1446,-1556
2020,8,30,5,1178,2880,1554,-1326
2020,8,30,6,1332,2626,1484,-1142
2020,8,30,7,1154,2366,1387,-979
2020,8,30,8,1556,2200,1588,-612
2020,8,30,9,1456,2104,1479,-625
2020,8,30,10,1400,1979,1258,-721
2020,8,30,11,1283,1958,1224,-734
2020,8,30,12,1332,2013,1279,-734
2020,8,30,13,1426,2119,1309,-810
2020,8,30,14,1224,2276,1452,-824
2020,8,30,15,1371,2295,1381,-914
2020,8,30,16,1577,2444,1412,-1032
2020,8,30,17,1654,2580,1478,-1102
2020,8,30,18,1790,2659,1597,-1062
2020,8,30,19,1796,2792,1791,-1001
2020,8,30,20,1854,2833,1814,-1019
2020,8,30,21,1891,2835,1792,-1043
2020,8,30,22,1927,2864,1789,-1075
2020,8,30,23,1864,2918,1829,-1089
2020,8,31,0,1932,2995,1882,-1113
2020,8,31,1,2011,3177,2198,-979
2020,8,31,2,2027,3179,2287,-892
2020,8,31,3,2108,3186,2346,-840
2020,8,31,4,2111,3168,2310,-858
2020,8,31,5,2002,2993,2270,-723
2020,8,31,6,2014,2735,2221,-514
2020,8,31,7,1871,2432,2072,-360
2020,8,31,8,1750,2242,1957,-285
2020,8,31,9,1618,1999,1804,-195
2020,8,31,10,1576,1905,1685,-220
2020,8,31,11,1656,1892,1505,-387
2020,8,31,12,1621,1961,1561,-400
2020,8,31,13,1912,2210,1802,-408
2020,8,31,14,1757,2399,1567,-832
2020,8,31,15,1735,2645,1696,-949
2020,8,31,16,1852,2806,1690,-1116
2020,8,31,17,1971,2940,1778,-1162
2020,8,31,18,2061,3001,1805,-1196
2020,8,31,19,2130,3092,2067,-1025
2020,8,31,20,2175,3186,2205,-981
2020,8,31,21,2241,3204,2288,-916
2020,8,31,22,2232,3173,2238,-935
2020,8,31,23,2273,3183,2237,-946
2020,9,1,0,2331,3199,2344,-855
2020,9,1,1,2353,3284,2488,-796
2020,9,1,2,2321,3272,2558,-714
2020,9,1,3,2323,3204,2382,-822
2020,9,1,4,2309,3218,2216,-1002
2020,9,1,5,2077,3052,2004,-1048
2020,9,1,6,2271,2836,2213,-623
2020,9,1,7,2106,2598,2241,-357
2020,9,1,8,1788,2442,2168,-274
2020,9,1,9,1897,2348,2081,-267
2020,9,1,10,1899,2307,2000,-307
2020,9,1,11,1811,2304,1952,-352
2020,9,1,12,2009,2297,1871,-426
2020,9,1,13,1843,2447,1951,-496
2020,9,1,14,1955,2663,1904,-759
2020,9,1,15,1838,2873,2044,-829
2020,9,1,16,1927,3002,2145,-857
2020,9,1,17,1938,3043,2010,-1033
2020,9,1,18,1959,3114,2003,-1111
2020,9,1,19,2187,3198,2143,-1055
2020,9,1,20,2045,3232,2139,-1093
2020,9,1,21,2056,3292,2225,-1067
2020,9,1,22,2090,3345,2258,-1087
2020,9,1,23,2138,3406,2456,-950
2020,9,2,0,2275,3497,2663,-834
2020,9,2,1,2420,3552,2679,-873
2020,9,2,2,2405,3486,2636,-850
2020,9,2,3,2405,3395,2601,-794
2020,9,2,4,2349,3328,2522,-806
2020,9,2,5,2056,3149,2343,-806
2020,9,2,6,2148,2913,2476,-437
2020,9,2,7,2087,2637,2317,-320
2020,9,2,8,1885,2414,2175,-239
2020,9,2,9,1934,2296,2160,-136
2020,9,2,10,1865,2205,2072,-133
2020,9,2,11,1906,2195,2026,-169
2020,9,2,12,1828,2242,1994,-248
2020,9,2,13,1933,2376,2040,-336
2020,9,2,14,1957,2609,2154,-455
2020,9,2,15,2121,2764,2055,-709
2020,9,2,16,2183,2934,2065,-869
2020,9,2,17,2154,3050,2158,-892
2020,9,2,18,2042,3169,2244,-925
2020,9,2,19,2088,3262,2437,-825
2020,9,2,20,2146,3376,2441,-935
2020,9,2,21,2121,3451,2503,-948
2020,9,2,22,2274,3500,2580,-920
2020,9,2,23,2248,3530,2549,-981
2020,9,3,0,2231,3548,2594,-954
2020,9,3,1,2290,3601,2654,-947
2020,9,3,2,2296,3563,2762,-801
2020,9,3,3,2337,3409,2610,-799
2020,9,3,4,2325,3350,2580,-770
2020,9,3,5,2309,3171,2528,-643
2020,9,3,6,1898,2936,2502,-434
2020,9,3,7,2020,2637,2166,-471
2020,9,3,8,1867,2441,2044,-397
2020,9,3,9,1747,2345,2083,-262
2020,9,3,10,1689,2297,1984,-313
2020,9,3,11,1727,2255,1987,-268
2020,9,3,12,1766,2253,1993,-260
2020,9,3,13,1959,2381,2085,-296
2020,9,3,14,1919,2570,2046,-524
2020,9,3,15,1809,2764,2044,-720
2020,9,3,16,1882,2918,2100,-818
2020,9,3,17,2019,3012,2093,-919
2020,9,3,18,2065,3097,2165,-932
2020,9,3,19,2074,3203,2142,-1061
2020,9,3,20,2139,3328,2232,-1096
2020,9,3,21,2187,3407,2297,-1110
2020,9,3,22,2219,3492,2349,-1143
2020,9,3,23,2313,3561,2388,-1173
2020,9,4,0,2354,3606,2350,-1256
2020,9,4,1,2351,3648,2387,-1261
2020,9,4,2,2303,3569,2414,-1155
2020,9,4,3,2272,3447,2405,-1042
2020,9,4,4,2210,3170,2338,-832
2020,9,4,5,2245,2834,2208,-626
2020,9,4,6,2134,2589,2111,-478
2020,9,4,7,2048,2313,2054,-259
2020,9,4,8,2000,2103,1974,-129
2020,9,4,9,1864,2006,1906,-100
2020,9,4,10,1851,1898,1783,-115
2020,9,4,11,1842,1858,1749,-109
2020,9,4,12,1866,1914,1768,-146
2020,9,4,13,1799,2072,1800,-272
2020,9,4,14,1664,2220,1685,-535
2020,9,4,15,1810,2417,1738,-679
2020,9,4,16,1814,2580,1709,-871
2020,9,4,17,1922,2691,1775,-916
2020,9,4,18,1926,2789,1789,-1000
2020,9,4,19,1918,2893,1804,-1089
2020,9,4,20,2141,2988,1948,-1040
2020,9,4,21,2185,3088,2066,-1022
2020,9,4,22,2207,3167,2230,-937
2020,9,4,23,2202,3225,2270,-955
2020,9,5,0,2188,3262,2199,-1063
2020,9,5,1,2193,3273,2282,-991
2020,9,5,2,2326,3199,2215,-984
2020,9,5,3,2217,2997,2096,-901
2020,9,5,4,2122,2934,1987,-947
2020,9,5,5,2236,2742,1995,-747
2020,9,5,6,2178,2472,2199,-273
2020,9,5,7,2189,2285,1934,-351
2020,9,5,8,1684,2203,1700,-503
2020,9,5,9,1514,2101,1847,-254
2020,9,5,10,1440,2000,1759,-241
2020,9,5,11,1429,1911,1645,-266
2020,9,5,12,1526,1885,1650,-235
2020,9,5,13,1710,1910,1702,-208
2020,9,5,14,1642,1982,1637,-345
2020,9,5,15,1643,2127,1657,-470
2020,9,5,16,1849,2410,1735,-675
2020,9,5,17,2013,2558,1711,-847
2020,9,5,18,2142,2649,1707,-942
2020,9,5,19,2164,2708,1784,-924
2020,9,5,20,2377,2726,1850,-876
2020,9,5,21,2135,2712,1831,-881
2020,9,5,22,2140,2738,1856,-882
2020,9,5,23,2253,2800,2062,-738
2020,9,6,0,2274,2828,2216,-612
2020,9,6,1,2401,2904,2478,-426
2020,9,6,2,2454,2898,2373,-525
2020,9,6,3,2356,2758,2192,-566
2020,9,6,4,2231,2803,2149,-654
2020,9,6,5,2093,2656,2000,-656
2020,9,6,6,1907,2479,1923,-556
2020,9,6,7,1977,2387,1972,-415
2020,9,6,8,1801,2279,2015,-264
2020,9,6,9,1802,2158,2019,-139
2020,9,6,10,1704,2151,1920,-231
2020,9,6,11,1691,2169,1942,-227
2020,9,6,12,1690,2219,2017,-202
2020,9,6,13,1566,2252,2065,-187
2020,9,6,14,1563,2213,1702,-511
2020,9,6,15,1704,2259,1676,-583
2020,9,6,16,1603,2431,1775,-656
2020,9,6,17,1733,2606,1937,-669
2020,9,6,18,1829,2721,2012,-709
2020,9,6,19,1890,2799,2018,-781
2020,9,6,20,1926,2829,1945,-884
2020,9,6,21,1918,2861,2064,-797
2020,9,6,22,1910,2940,2240,-700
2020,9,6,23,1968,2992,2380,-612
2020,9,7,0,2201,3093,2419,-674
2020,9,7,1,2122,3200,2232,-968
2020,9,7,2,2135,3174,2127,-1047
2020,9,7,3,2128,3090,1964,-1126
2020,9,7,4,2093,3123,2231,-892
2020,9,7,5,1860,2895,2058,-837
2020,9,7,6,1702,2692,2169,-523
2020,9,7,7,1639,2415,2029,-386
2020,9,7,8,1586,2256,1990,-266
2020,9,7,9,1423,2147,1824,-323
2020,9,7,10,1392,2064,1776,-288
2020,9,7,11,1467,2060,1767,-293
2020,9,7,12,1545,2199,1922,-277
2020,9,7,13,1480,2219,1941,-278
2020,9,7,14,1309,2299,1952,-347
2020,9,7,15,1385,2447,2036,-411
2020,9,7,16,1411,2638,2148,-490
2020,9,7,17,1638,2808,2279,-529
2020,9,7,18,1712,2943,2366,-577
2020,9,7,19,1773,3029,2360,-669
2020,9,7,20,2173,3070,2185,-885
2020,9,7,21,2160,3052,2084,-968
2020,9,7,22,2211,3107,1937,-1170
2020,9,7,23,2304,3142,1879,-1263
2020,9,8,0,2175,3211,1976,-1235
2020,9,8,1,2304,3278,2002,-1276
2020,9,8,2,2322,3208,1758,-1450
2020,9,8,3,2323,3150,1786,-1364
2020,9,8,4,2309,3077,1815,-1262
2020,9,8,5,1948,2840,1631,-1209
2020,9,8,6,1782,2561,1775,-786
2020,9,8,7,1647,2469,2089,-380
2020,9,8,8,1796,2222,1959,-263
2020,9,8,9,1758,2056,1829,-227
2020,9,8,10,1464,1908,1716,-192
2020,9,8,11,1276,1880,1582,-298
2020,9,8,12,1438,1992,1817,-175
2020,9,8,13,1612,2129,1760,-369
2020,9,8,14,1324,2349,1700,-649
2020,9,8,15,1425,2660,1887,-773
2020,9,8,16,1562,2811,2118,-693
2020,9,8,17,1678,2882,2044,-838
2020,9,8,18,2014,2967,1986,-981
2020,9,8,19,2135,3061,2024,-1037
2020,9,8,20,1978,3081,1913,-1168
2020,9,8,21,2023,3033,1778,-1255
2020,9,8,22,2191,3015,1818,-1197
2020,9,8,23,2179,3087,1887,-1200
2020,9,9,0,2079,3169,1890,-1279
2020,9,9,1,2049,3229,1947,-1282
2020,9,9,2,2011,3237,2014,-1223
2020,9,9,3,2300,3170,2015,-1155
2020,9,9,4,2231,3132,2103,-1029
2020,9,9,5,1824,2912,1884,-1028
2020,9,9,6,1733,2681,1906,-775
2020,9,9,7,1788,2445,1823,-622
2020,9,9,8,1863,2292,1904,-388
2020,9,9,9,1822,2158,1945,-213
2020,9,9,10,1713,2094,1992,-102
2020,9,9,11,1713,2079,1931,-148
2020,9,9,12,1769,2084,1770,-314
2020,9,9,13,1780,2162,1620,-542
2020,9,9,14,1426,2417,1670,-747
2020,9,9,15,1591,2620,1950,-670
2020,9,9,16,1706,2756,1910,-846
2020,9,9,17,1951,2856,1925,-931
2020,9,9,18,2140,2940,1981,-959
2020,9,9,19,2200,3094,2082,-1012
2020,9,9,20,2144,3197,2179,-1018
2020,9,9,21,2080,3263,2060,-1203
2020,9,9,22,2066,3344,2026,-1318
2020,9,9,23,1963,3420,2054,-1366
2020,9,10,0,1875,3494,2066,-1428
2020,9,10,1,1904,3529,2055,-1474
2020,9,10,2,1953,3553,2162,-1391
2020,9,10,3,1941,3451,2172,-1279
2020,9,10,4,2148,3377,2290,-1087
2020,9,10,5,1823,3137,2082,-1055
2020,9,10,6,2023,2875,2280,-595
2020,9,10,7,1829,2615,2049,-566
2020,9,10,8,1761,2424,1855,-569
2020,9,10,9,1622,2305,1840,-465
2020,9,10,10,1614,2166,1776,-390
2020,9,10,11,1640,2103,1746,-357
2020,9,10,12,1635,2134,1724,-410
2020,9,10,13,1709,2267,1725,-542
2020,9,10,14,1440,2460,1600,-860
2020,9,10,15,1442,2695,1861,-834
2020,9,10,16,1659,2863,1915,-948
2020,9,10,17,1688,2962,1919,-1043
2020,9,10,18,1778,3065,1888,-1177
2020,9,10,19,1828,3156,1829,-1327
2020,9,10,20,1874,3281,2057,-1224
2020,9,10,21,1980,3422,2169,-1253
2020,9,10,22,1865,3535,2206,-1329
2020,9,10,23,1856,3619,2178,-1441
2020,9,11,0,1855,3667,2191,-1476
2020,9,11,1,1856,3684,2203,-1481
2020,9,11,2,1872,3568,2174,-1394
2020,9,11,3,1892,3490,2189,-1301
2020,9,11,4,2067,3375,2175,-1200
2020,9,11,5,1576,3130,1909,-1221
2020,9,11,6,1617,2839,1871,-968
2020,9,11,7,1778,2656,1923,-733
2020,9,11,8,1703,2469,1851,-618
2020,9,11,9,1682,2322,1887,-435
2020,9,11,10,1594,2247,1978,-269
2020,9,11,11,1588,2159,1788,-371
2020,9,11,12,1598,2251,1950,-301
2020,9,11,13,1711,2307,1888,-419
2020,9,11,14,1478,2470,1717,-753
2020,9,11,15,1581,2624,1763,-861
2020,9,11,16,1713,2755,1726,-1029
2020,9,11,17,1743,2815,1729,-1086
2020,9,11,18,1769,2892,1818,-1074
2020,9,11,19,1835,2960,1903,-1057
2020,9,11,20,1955,3040,2050,-990
2020,9,11,21,2261,3079,2060,-1019
2020,9,11,22,2257,3106,2058,-1048
2020,9,11,23,2262,3133,2090,-1043
2020,9,12,0,2265,3162,2121,-1041
2020,9,12,1,2223,3190,2167,-1023
2020,9,12,2,2287,3124,2179,-945
2020,9,12,3,2331,3056,2292,-764
2020,9,12,4,2035,3017,2145,-872
2020,9,12,5,1750,2833,2116,-717
2020,9,12,6,1862,2621,2103,-518
2020,9,12,7,1961,2410,1938,-472
2020,9,12,8,1638,2253,1904,-349
2020,9,12,9,1595,2152,1868,-284
2020,9,12,10,1551,2096,1729,-367
2020,9,12,11,1550,2083,1741,-342
2020,9,12,12,1580,2062,1682,-380
2020,9,12,13,1484,2082,1630,-452
2020,9,12,14,1441,2142,1585,-557
2020,9,12,15,1426,2271,1658,-613
2020,9,12,16,1611,2472,1647,-825
2020,9,12,17,1533,2638,1673,-965
2020,9,12,18,1805,2735,1770,-965
2020,9,12,19,1618,2788,1823,-965
2020,9,12,20,1819,2790,1786,-1004
2020,9,12,21,1598,2777,1807,-970
2020,9,12,22,1592,2743,1834,-909
2020,9,12,23,1833,2753,1865,-888
2020,9,13,0,1739,2759,1907,-852
2020,9,13,1,1822,2812,1903,-909
2020,9,13,2,1930,2833,1978,-855
2020,9,13,3,1871,2819,2046,-773
2020,9,13,4,1809,2791,2020,-771
2020,9,13,5,1618,2649,1962,-687
2020,9,13,6,1859,2467,1958,-509
2020,9,13,7,1845,2282,1828,-454
2020,9,13,8,1745,2137,1794,-343
2020,9,13,9,1653,2017,1704,-313
2020,9,13,10,1566,1994,1631,-363
2020,9,13,11,1565,1966,1624,-342
2020,9,13,12,1565,1961,1603,-358
2020,9,13,13,1464,2021,1629,-392
2020,9,13,14,1445,2051,1491,-560
2020,9,13,15,1566,2208,1589,-619
2020,9,13,16,1562,2415,1658,-757
2020,9,13,17,1703,2582,1670,-912
2020,9,13,18,1776,2669,1715,-954
2020,9,13,19,1820,2706,1761,-945
2020,9,13,20,2039,2751,1851,-900
2020,9,13,21,2019,2751,1895,-856
2020,9,13,22,1984,2735,1918,-817
2020,9,13,23,1825,2763,1929,-834
2020,9,14,0,2051,2789,1921,-868
2020,9,14,1,1974,2852,1900,-952
2020,9,14,2,2057,2868,1905,-963
2020,9,14,3,2120,2903,1921,-982
2020,9,14,4,1955,2916,1965,-951
2020,9,14,5,1937,2667,1747,-920
2020,9,14,6,1894,2464,1710,-754
2020,9,14,7,1887,2261,1581,-680
2020,9,14,8,1549,2131,1601,-530
2020,9,14,9,1583,2090,1567,-523
2020,9,14,10,1502,2012,1494,-518
2020,9,14,11,1498,1991,1501,-490
2020,9,14,12,1551,2055,1489,-566
2020,9,14,13,1929,2215,1543,-672
2020,9,14,14,1980,2458,1707,-751
2020,9,14,15,1955,2644,1716,-928
2020,9,14,16,2006,2786,1753,-1033
2020,9,14,17,2122,2864,1824,-1040
2020,9,14,18,2114,2900,1786,-1114
2020,9,14,19,2161,2952,1988,-964
2020,9,14,20,2202,2975,2026,-949
2020,9,14,21,2313,2966,2136,-830
2020,9,14,22,2290,2951,2158,-793
2020,9,14,23,2307,2951,2156,-795
2020,9,15,0,2342,3028,2208,-820
2020,9,15,1,2362,3127,2193,-934
2020,9,15,2,2373,3118,1959,-1159
2020,9,15,3,2380,3098,1918,-1180
2020,9,15,4,2389,3040,2017,-1023
2020,9,15,5,2129,2870,2056,-814
2020,9,15,6,2165,2660,2100,-560
2020,9,15,7,2022,2445,1934,-511
2020,9,15,8,1649,2233,1696,-537
2020,9,15,9,1625,2077,1580,-497
2020,9,15,10,1591,2012,1556,-456
2020,9,15,11,1595,1992,1533,-459
2020,9,15,12,1595,2062,1558,-504
2020,9,15,13,1817,2229,1820,-409
2020,9,15,14,1733,2427,1927,-500
2020,9,15,15,1858,2613,1948,-665
2020,9,15,16,2011,2780,1970,-810
2020,9,15,17,1990,2898,1957,-941
2020,9,15,18,2071,2957,1951,-1006
2020,9,15,19,2148,3021,2003,-1018
2020,9,15,20,2131,3097,2072,-1025
2020,9,15,21,2260,3131,2298,-833
2020,9,15,22,2277,3179,2357,-822
2020,9,15,23,2304,3206,2452,-754
2020,9,16,0,2286,3223,2298,-925
2020,9,16,1,2338,3245,2294,-951
2020,9,16,2,2317,3234,2311,-923
2020,9,16,3,2352,3272,2353,-919
2020,9,16,4,2409,3166,2328,-838
2020,9,16,5,2073,2933,2251,-682
2020,9,16,6,1840,2745,2123,-622
2020,9,16,7,1686,2531,2006,-525
2020,9,16,8,1574,2302,1890,-412
2020,9,16,9,1548,2211,1816,-395
2020,9,16,10,1567,2178,1794,-384
2020,9,16,11,1549,2152,1770,-382
2020,9,16,12,1568,2209,1730,-479
2020,9,16,13,1634,2405,1787,-618
2020,9,16,14,1754,2543,1776,-767
2020,9,16,15,1796,2752,2002,-750
2020,9,16,16,1722,2873,1947,-926
2020,9,16,17,1877,2922,1934,-988
2020,9,16,18,1904,3005,2000,-1005
2020,9,16,19,1875,3060,2061,-999
2020,9,16,20,2013,3103,2148,-955
2020,9,16,21,2052,3174,2218,-956
2020,9,16,22,2029,3186,2215,-971
2020,9,16,23,2014,3190,2195,-995
2020,9,17,0,2078,3219,2251,-968
2020,9,17,1,2070,3246,2197,-1049
2020,9,17,2,2061,3155,2092,-1063
2020,9,17,3,2095,3125,2117,-1008
2020,9,17,4,2037,3017,2098,-919
2020,9,17,5,1859,2836,1936,-900
2020,9,17,6,1970,2610,2128,-482
2020,9,17,7,1773,2391,1868,-523
2020,9,17,8,1813,2231,1830,-401
2020,9,17,9,1705,2137,1817,-320
2020,9,17,10,1650,2078,1698,-380
2020,9,17,11,1644,2061,1665,-396
2020,9,17,12,1731,2107,1674,-433
2020,9,17,13,1835,2357,1911,-446
2020,9,17,14,1656,2497,1885,-612
2020,9,17,15,1880,2673,1888,-785
2020,9,17,16,1773,2869,1980,-889
2020,9,17,17,1935,2917,2057,-860
2020,9,17,18,1998,2958,2231,-727
2020,9,17,19,2003,3095,2374,-721
2020,9,17,20,2058,3131,2290,-841
2020,9,17,21,2088,3165,2354,-811
2020,9,17,22,2087,3109,2100,-1009
2020,9,17,23,2113,3166,2142,-1024
2020,9,18,0,2157,3153,2161,-992
2020,9,18,1,2155,3173,2151,-1022
2020,9,18,2,2155,3199,2204,-995
2020,9,18,3,2164,3210,2252,-958
2020,9,18,4,2104,3104,2303,-801
2020,9,18,5,1850,2890,2125,-765
2020,9,18,6,1917,2694,2169,-525
2020,9,18,7,1768,2390,2047,-343
2020,9,18,8,1601,2274,1850,-424
2020,9,18,9,1663,2165,1669,-496
2020,9,18,10,1655,2124,1740,-384
2020,9,18,11,1573,2096,1664,-432
2020,9,18,12,1574,2151,1728,-423
2020,9,18,13,1518,2281,1689,-592
2020,9,18,14,1609,2444,1721,-723
2020,9,18,15,1972,2641,1812,-829
2020,9,18,16,1917,2841,1990,-851
2020,9,18,17,1996,2890,1983,-907
2020,9,18,18,2039,2967,2044,-923
2020,9,18,19,2064,3075,2104,-971
2020,9,18,20,2069,3084,2133,-951
2020,9,18,21,2038,3058,2119,-939
2020,9,18,22,2002,3053,2149,-904
2020,9,18,23,2030,3026,2057,-969
2020,9,19,0,2035,3021,2040,-981
2020,9,19,1,2102,3013,2125,-888
2020,9,19,2,2110,3003,2285,-718
2020,9,19,3,1983,3026,2277,-749
2020,9,19,4,2000,2913,2020,-893
2020,9,19,5,1840,2748,1943,-805
2020,9,19,6,1917,2577,1910,-667
2020,9,19,7,1681,2340,1675,-665
2020,9,19,8,1371,2187,1605,-582
2020,9,19,9,1310,2078,1681,-397
2020,9,19,10,1261,2040,1682,-358
2020,9,19,11,1283,2018,1629,-389
2020,9,19,12,1286,1992,1637,-355
2020,9,19,13,1361,2041,1619,-422
2020,9,19,14,1271,2136,1522,-614
2020,9,19,15,1455,2247,1579,-668
2020,9,19,16,1594,2409,1467,-942
2020,9,19,17,1750,2590,1594,-996
2020,9,19,18,1826,2691,1633,-1058
2020,9,19,19,1861,2737,1730,-1007
2020,9,19,20,1640,2750,1779,-971
2020,9,19,21,1858,2766,1829,-937
2020,9,19,22,1613,2758,1817,-941
2020,9,19,23,1634,2779,1801,-978
2020,9,20,0,1676,2808,1767,-1041
2020,9,20,1,1975,2863,1850,-1013
2020,9,20,2,1819,2888,1939,-949
2020,9,20,3,1980,2907,1944,-963
2020,9,20,4,1788,2844,1999,-845
2020,9,20,5,1841,2705,1909,-796
2020,9,20,6,1652,2533,1938,-595
2020,9,20,7,1580,2369,1958,-411
2020,9,20,8,1280,2173,1717,-456
2020,9,20,9,1215,2050,1655,-395
2020,9,20,10,1210,1969,1634,-335
2020,9,20,11,1216,1898,1450,-448
2020,9,20,12,1275,1903,1466,-437
2020,9,20,13,1255,1879,1322,-557
2020,9,20,14,1282,1994,1359,-635
2020,9,20,15,1181,2132,1373,-759
2020,9,20,16,1341,2265,1313,-952
2020,9,20,17,1443,2506,1413,-1093
2020,9,20,18,1575,2620,1418,-1202
2020,9,20,19,1663,2703,1480,-1223
2020,9,20,20,1478,2736,1540,-1196
2020,9,20,21,1496,2757,1568,-1189
2020,9,20,22,1727,2759,1555,-1204
2020,9,20,23,1526,2827,1591,-1236
2020,9,21,0,1673,2857,1758,-1099
2020,9,21,1,1763,2895,1773,-1122
2020,9,21,2,1788,2889,1851,-1038
2020,9,21,3,1968,2912,1857,-1055
2020,9,21,4,1750,2966,1950,-1016
2020,9,21,5,1564,2655,1688,-967
2020,9,21,6,1639,2433,1689,-744
2020,9,21,7,1567,2222,1577,-645
2020,9,21,8,1561,2096,1554,-542
2020,9,21,9,1382,2007,1435,-572
2020,9,21,10,1454,1967,1435,-532
2020,9,21,11,1398,1973,1461,-512
2020,9,21,12,1600,2053,1528,-525
2020,9,21,13,1545,2329,1725,-604
2020,9,21,14,1606,2470,1687,-783
2020,9,21,15,1883,2676,1835,-841
2020,9,21,16,1956,2810,1876,-934
2020,9,21,17,1849,2810,1860,-950
2020,9,21,18,1936,2843,1907,-936
2020,9,21,19,2060,2873,1956,-917
2020,9,21,20,1970,2948,2011,-937
2020,9,21,21,2009,2978,2088,-890
2020,9,21,22,2003,2955,2102,-853
2020,9,21,23,1988,2953,2067,-886
2020,9,22,0,2026,2951,2038,-913
2020,9,22,1,2086,3012,2022,-990
2020,9,22,2,2105,3034,2064,-970
2020,9,22,3,2154,3106,2078,-1028
2020,9,22,4,2036,3026,2115,-911
2020,9,22,5,1775,2840,2030,-810
2020,9,22,6,1676,2604,1875,-729
2020,9,22,7,1427,2394,1850,-544
2020,9,22,8,1761,2244,1930,-314
2020,9,22,9,1734,2131,1873,-258
2020,9,22,10,1624,1996,1804,-192
2020,9,22,11,1599,1982,1783,-199
2020,9,22,12,1495,1983,1738,-245
2020,9,22,13,1618,2158,1777,-381
2020,9,22,14,1671,2343,1698,-645
2020,9,22,15,1938,2656,2060,-596
2020,9,22,16,1936,2787,2057,-730
2020,9,22,17,2166,2787,2042,-745
2020,9,22,18,2167,2818,2081,-737
2020,9,22,19,2219,2896,2200,-696
2020,9,22,20,2231,2950,2203,-747
2020,9,22,21,2289,2921,2170,-751
2020,9,22,22,2286,2954,2204,-750
2020,9,22,23,2341,2954,2158,-796
2020,9,23,0,2376,2976,2132,-844
2020,9,23,1,2428,3022,2180,-842
2020,9,23,2,2435,3034,2197,-837
2020,9,23,3,2486,3057,2213,-844
2020,9,23,4,2451,2971,2254,-717
2020,9,23,5,2217,2782,2255,-527
2020,9,23,6,2132,2565,2125,-440
2020,9,23,7,2009,2318,1923,-395
2020,9,23,8,1674,2042,1727,-315
2020,9,23,9,1678,1958,1666,-292
2020,9,23,10,1472,1900,1600,-300
2020,9,23,11,1463,1896,1619,-277
2020,9,23,12,1689,2078,1789,-289
2020,9,23,13,1736,2241,1863,-378
2020,9,23,14,1689,2455,1906,-549
2020,9,23,15,1847,2686,2106,-580
2020,9,23,16,1844,2906,2199,-707
2020,9,23,17,1876,2969,2012,-957
2020,9,23,18,1969,3047,2036,-1011
2020,9,23,19,2058,3110,2198,-912
2020,9,23,20,2030,3035,2066,-969
2020,9,23,21,2015,3003,2046,-957
2020,9,23,22,1993,2970,2047,-923
2020,9,23,23,1977,2951,2073,-878
2020,9,24,0,2010,2975,1999,-976
2020,9,24,1,2073,3067,2100,-967
2020,9,24,2,2136,3051,2112,-939
2020,9,24,3,2221,2994,2115,-879
2020,9,24,4,2192,2907,2075,-832
2020,9,24,5,1976,2787,2121,-666
2020,9,24,6,1936,2591,2054,-537
2020,9,24,7,1645,2258,1949,-309
2020,9,24,8,1697,2083,1934,-149
2020,9,24,9,1754,2000,1815,-185
2020,9,24,10,1624,1957,1761,-196
2020,9,24,11,1543,1945,1686,-259
2020,9,24,12,1607,1969,1627,-342
2020,9,24,13,1634,2100,1672,-428
2020,9,24,14,1504,2366,1812,-554
2020,9,24,15,1726,2688,1936,-752
2020,9,24,16,1704,2831,1923,-908
2020,9,24,17,1764,2889,1808,-1081
2020,9,24,18,1818,2931,1746,-1185
2020,9,24,19,1870,2974,1915,-1059
2020,9,24,20,1792,2971,1854,-1117
2020,9,24,21,1906,2950,1838,-1112
2020,9,24,22,1738,2926,1814,-1112
2020,9,24,23,1739,2896,1830,-1066
2020,9,25,0,1755,2902,1847,-1055
2020,9,25,1,1848,2971,1822,-1149
2020,9,25,2,1930,2980,1950,-1030
2020,9,25,3,2018,3012,1895,-1117
2020,9,25,4,2009,2925,1960,-965
2020,9,25,5,1793,2738,1976,-762
2020,9,25,6,1980,2549,1954,-595
2020,9,25,7,1844,2358,1962,-396
2020,9,25,8,1790,2222,1881,-341
2020,9,25,9,1721,2131,1792,-339
2020,9,25,10,1707,2091,1684,-407
2020,9,25,11,1722,2067,1631,-436
2020,9,25,12,1728,2113,1665,-448
2020,9,25,13,1871,2282,1793,-489
2020,9,25,14,1656,2526,1850,-676
2020,9,25,15,1827,2721,1947,-774
2020,9,25,16,1904,2868,1979,-889
2020,9,25,17,1953,2923,1898,-1025
2020,9,25,18,1966,2940,1826,-1114
2020,9,25,19,1960,2984,1976,-1008
2020,9,25,20,1910,3012,1981,-1031
2020,9,25,21,1834,3014,1939,-1075
2020,9,25,22,1864,2954,1951,-1003
2020,9,25,23,1816,2880,2024,-856
2020,9,26,0,1784,2808,1957,-851
2020,9,26,1,1786,2875,1976,-899
2020,9,26,2,1790,2950,2044,-906
2020,9,26,3,1837,2914,1967,-947
2020,9,26,4,1763,2781,1888,-893
2020,9,26,5,1764,2655,1913,-742
2020,9,26,6,1908,2485,1973,-512
2020,9,26,7,1766,2280,1861,-419
2020,9,26,8,1512,2280,1861,-9999
2020,9,26,9,1500,2131,1792,-9999
2020,9,26,10,1457,2091,1684,-9999
2020,9,26,11,1540,2067,1631,-9999
2020,9,26,12,1547,2113,1665,-9999
2020,9,26,13,1536,2282,1793,-9999
2020,9,26,14,1426,2526,1850,-9999
2020,9,26,15,1539,2721,1947,-9999
2020,9,26,16,1718,2868,1979,-9999
2020,9,26,17,1843,2923,1898,-9999
2020,9,26,18,1897,2940,1826,-9999
2020,9,26,19,1922,2984,1976,-9999
2020,9,26,20,2028,3012,1981,-9999
2020,9,26,21,1876,3014,1939,-9999
2020,9,26,22,1859,2954,1951,-9999
2020,9,26,23,1783,2880,2024,-9999
2020,9,27,0,1957,2808,1957,-9999
2020,9,27,1,1859,2875,1976,-9999
2020,9,27,2,1911,2950,2044,-9999
2020,9,27,3,2002,2914,1967,-9999
2020,9,27,4,1916,2781,1888,-9999
2020,9,27,5,1769,2655,1913,-9999
2020,9,27,6,1913,2485,1973,-9999
2020,9,27,7,1795,2280,1861,-9999
2020,9,27,8,-9999,2096,1662,-434
2020,9,27,9,-9999,1995,1621,-374
2020,9,27,10,-9999,1908,1622,-286
2020,9,27,11,-9999,1964,1659,-305
2020,9,27,12,-9999,1972,1580,-392
2020,9,27,13,-9999,2034,1570,-464
2020,9,27,14,-9999,2154,1658,-496
2020,9,27,15,-9999,2292,1719,-573
2020,9,27,16,-9999,2524,1685,-839
2020,9,27,17,-9999,2607,1473,-1134
2020,9,27,18,-9999,2679,1544,-1135
2020,9,27,19,-9999,2714,1587,-1127
2020,9,27,20,-9999,2748,1705,-1043
2020,9,27,21,-9999,2765,1698,-1067
2020,9,27,22,-9999,2744,1730,-1014
2020,9,27,23,-9999,2755,1740,-1015
2020,9,28,0,-9999,2762,1746,-1016
2020,9,28,1,-9999,2875,1818,-1057
2020,9,28,2,-9999,2911,1817,-1094
2020,9,28,3,-9999,3019,1910,-1109
2020,9,28,4,-9999,2972,1964,-1008
2020,9,28,5,-9999,2817,1943,-874
2020,9,28,6,-9999,2602,1909,-693
2020,9,28,7,-9999,2279,1645,-634
2020,9,28,8,1566,2155,1616,-539
2020,9,28,9,1473,2085,1604,-481
2020,9,28,10,1507,2068,1637,-431
2020,9,28,11,1550,2067,1611,-456
2020,9,28,12,1737,2157,1719,-438
2020,9,28,13,1643,2440,1865,-575
2020,9,28,14,1679,2680,1839,-841
2020,9,28,15,1719,2847,1854,-993
2020,9,28,16,1771,2966,1852,-1114
2020,9,28,17,1770,2972,1899,-1073
2020,9,28,18,1793,2987,1900,-1087
2020,9,28,19,1772,2993,1887,-1106
2020,9,28,20,1861,3002,1957,-1045
2020,9,28,21,1846,3011,1995,-1016
2020,9,28,22,1828,2993,2028,-965
2020,9,28,23,1850,3006,2069,-937
2020,9,29,0,1868,3051,2111,-940
2020,9,29,1,1915,3116,2132,-984
2020,9,29,2,1972,3108,2105,-1003
2020,9,29,3,2039,3140,2207,-933
2020,9,29,4,1829,3030,2118,-912
2020,9,29,5,1654,2855,2097,-758
2020,9,29,6,1681,2649,2113,-536
2020,9,29,7,1539,2394,2018,-376
2020,9,29,8,1741,2253,1858,-395
2020,9,29,9,1647,2121,1731,-390
2020,9,29,10,1581,2064,1649,-415
2020,9,29,11,1618,2036,1543,-493
2020,9,29,12,1552,2087,1551,-536
2020,9,29,13,1741,2273,1755,-518
2020,9,29,14,1658,2529,1758,-771
2020,9,29,15,1911,2715,1717,-998
2020,9,29,16,1943,2822,1727,-1095
2020,9,29,17,1865,2841,1718,-1123
2020,9,29,18,1914,2849,1743,-1106
2020,9,29,19,1957,2868,1756,-1112
2020,9,29,20,2058,2956,1932,-1024
2020,9,29,21,2111,3013,1970,-1043
2020,9,29,22,2100,3078,2053,-1025
2020,9,29,23,2193,3152,2047,-1105
2020,9,30,0,2198,3205,2213,-992
2020,9,30,1,2308,3284,2231,-1053
2020,9,30,2,2321,3216,2263,-953
2020,9,30,3,2332,3186,2279,-907
2020,9,30,4,2236,3163,2448,-715
2020,9,30,5,1865,2957,2270,-687
2020,9,30,6,1986,2733,2253,-480
2020,9,30,7,1753,2482,2056,-426
2020,9,30,8,1710,2280,1896,-384
2020,9,30,9,1661,2176,1875,-301
2020,9,30,10,1669,2081,1807,-274
2020,9,30,11,1641,2082,1778,-304
2020,9,30,12,1669,2126,1741,-385
2020,9,30,13,1785,2328,1875,-453
2020,9,30,14,1617,2521,1791,-730
2020,9,30,15,1922,2756,1962,-794
2020,9,30,16,2019,2852,1868,-984
2020,9,30,17,2089,2932,2063,-869
2020,9,30,18,2148,2971,2206,-765
2020,9,30,19,2191,3015,2251,-764
2020,9,30,20,2215,3037,2284,-753
2020,9,30,21,2216,3040,2268,-772
2020,9,30,22,2205,3079,2313,-766
2020,9,30,23,2205,3125,2393,-732
2020,10,1,0,2203,3164,2388,-776
2020,10,1,1,2233,3208,2384,-824
2020,10,1,2,2257,3211,2366,-845
2020,10,1,3,2278,3208,2352,-856
2020,10,1,4,2278,3101,2447,-654
2020,10,1,5,1933,2914,2236,-678
2020,10,1,6,2041,2701,2246,-455
2020,10,1,7,1817,2472,2188,-284
2020,10,1,8,1761,2293,1954,-339
2020,10,1,9,1671,2206,1941,-265
2020,10,1,10,1626,2132,1844,-288
2020,10,1,11,1624,2021,1711,-310
2020,10,1,12,1752,2029,1649,-380
2020,10,1,13,1780,2212,1653,-559
2020,10,1,14,1812,2450,1846,-604
2020,10,1,15,2054,2705,2089,-616
2020,10,1,16,2105,2844,2176,-668
2020,10,1,17,2121,2952,2271,-681
2020,10,1,18,2129,3015,2372,-643
2020,10,1,19,2086,3029,2420,-609
2020,10,1,20,2216,3042,2384,-658
2020,10,1,21,2179,3015,2384,-631
2020,10,1,22,2170,3008,2389,-619
2020,10,1,23,2221,3040,2384,-656
2020,10,2,0,2238,3067,2379,-688
2020,10,2,1,2239,3124,2398,-726
2020,10,2,2,2289,3116,2355,-761
2020,10,2,3,2328,3165,2373,-792
2020,10,2,4,2211,3073,2324,-749
2020,10,2,5,1971,2876,2256,-620
2020,10,2,6,1984,2682,2134,-548
2020,10,2,7,1759,2477,1995,-482
2020,10,2,8,1663,2279,1916,-363
2020,10,2,9,1633,2182,1888,-294
2020,10,2,10,1612,2075,1788,-287
2020,10,2,11,1619,2072,1807,-265
2020,10,2,12,1640,2114,1800,-314
2020,10,2,13,1770,2341,1941,-400
2020,10,2,14,1652,2586,1927,-659
2020,10,2,15,1874,2788,2013,-775
2020,10,2,16,1987,2844,1962,-882
2020,10,2,17,2016,2961,2033,-928
2020,10,2,18,2064,2960,1989,-971
2020,10,2,19,2012,2992,2060,-932
2020,10,2,20,2082,2962,2077,-885
2020,10,2,21,2066,2955,2076,-879
2020,10,2,22,2099,2959,2065,-894
2020,10,2,23,2101,2973,2068,-905
2020,10,3,0,2101,3024,2187,-837
2020,10,3,1,2147,3057,2190,-867
2020,10,3,2,2173,3071,2202,-869
2020,10,3,3,2150,3070,2298,-772
2020,10,3,4,1919,2939,2271,-668
2020,10,3,5,1734,2795,2166,-629
2020,10,3,6,1902,2639,2192,-447
2020,10,3,7,1682,2399,2014,-385
2020,10,3,8,1699,2174,1721,-453
2020,10,3,9,1677,2078,1735,-343
2020,10,3,10,1658,2038,1769,-269
2020,10,3,11,1602,2040,1752,-288
2020,10,3,12,1493,2073,1734,-339
2020,10,3,13,1507,2121,1678,-443
2020,10,3,14,1466,2208,1599,-609
2020,10,3,15,1508,2348,1577,-771
2020,10,3,16,1672,2458,1690,-768
2020,10,3,17,1822,2589,1598,-991
2020,10,3,18,1891,2707,1765,-942
2020,10,3,19,1927,2761,1834,-927
2020,10,3,20,1991,2753,1911,-842
2020,10,3,21,1949,2754,1943,-811
2020,10,3,22,1903,2749,1986,-763
2020,10,3,23,1893,2754,2059,-695
2020,10,4,0,1981,2789,2043,-746
2020,10,4,1,1984,2861,2188,-673
2020,10,4,2,2071,2911,2167,-744
2020,10,4,3,2052,2927,2165,-762
2020,10,4,4,1848,2837,2162,-675
2020,10,4,5,1674,2709,2117,-592
2020,10,4,6,1801,2556,2207,-349
2020,10,4,7,1676,2353,2070,-283
2020,10,4,8,1718,2203,1876,-327
2020,10,4,9,1639,2097,1886,-211
2020,10,4,10,1572,2074,1939,-135
2020,10,4,11,1521,1995,1861,-134
2020,10,4,12,1601,1975,1906,-69
2020,10,4,13,1390,2026,1948,-78
2020,10,4,14,1385,2108,1859,-249
2020,10,4,15,1501,2265,1952,-313
2020,10,4,16,1593,2454,1939,-515
2020,10,4,17,1684,2628,1941,-687
2020,10,4,18,1848,2746,2073,-673
2020,10,4,19,1722,2786,2111,-675
2020,10,4,20,1839,2799,2202,-597
2020,10,4,21,1665,2812,2218,-594
2020,10,4,22,1622,2749,2104,-645
2020,10,4,23,1633,2746,2124,-622
2020,10,5,0,1846,2811,2146,-665
2020,10,5,1,1795,2935,2277,-658
2020,10,5,2,1986,3017,2281,-736
2020,10,5,3,1982,3055,2353,-702
2020,10,5,4,1820,2938,2368,-570
2020,10,5,5,1633,2779,2309,-470
2020,10,5,6,1621,2550,2230,-320
2020,10,5,7,1533,2274,2054,-220
2020,10,5,8,1332,1965,1689,-276
2020,10,5,9,1256,1885,1647,-238
2020,10,5,10,1365,1850,1635,-215
2020,10,5,11,1403,1863,1649,-214
2020,10,5,12,1550,2088,1777,-311
2020,10,5,13,1788,2321,1880,-441
2020,10,5,14,1717,2584,1883,-701
2020,10,5,15,1956,2759,1932,-827
2020,10,5,16,2137,2918,2117,-801
2020,10,5,17,2124,2931,2070,-861
2020,10,5,18,2151,2967,2156,-811
2020,10,5,19,2205,2999,2141,-858
2020,10,5,20,2210,3059,2149,-910
2020,10,5,21,2192,2995,2084,-911
2020,10,5,22,2117,2956,2119,-837
2020,10,5,23,2122,2935,2101,-834
2020,10,6,0,2176,2941,2196,-745
2020,10,6,1,2250,3114,2404,-710
2020,10,6,2,2269,3126,2366,-760
2020,10,6,3,2286,3164,2330,-834
2020,10,6,4,2263,3010,2389,-621
2020,10,6,5,1990,2801,2372,-429
2020,10,6,6,1961,2625,2406,-219
2020,10,6,7,1750,2383,2170,-213
2020,10,6,8,1514,2229,1783,-446
2020,10,6,9,1495,2144,1669,-475
2020,10,6,10,1493,2068,1588,-480
2020,10,6,11,1521,2074,1558,-516
2020,10,6,12,1414,2125,1416,-709
2020,10,6,13,1586,2292,1502,-790
2020,10,6,14,1574,2567,1522,-1045
2020,10,6,15,1726,2768,1645,-1123
2020,10,6,16,1733,2871,1747,-1124
2020,10,6,17,1737,2959,1821,-1138
2020,10,6,18,1734,2918,1651,-1267
2020,10,6,19,1737,2913,1762,-1151
2020,10,6,20,1727,2893,1779,-1114
2020,10,6,21,1706,2865,1597,-1268
2020,10,6,22,1691,2847,1540,-1307
2020,10,6,23,1756,2873,1648,-1225
2020,10,7,0,1731,2908,1649,-1259
2020,10,7,1,1838,3002,1826,-1176
2020,10,7,2,1883,3047,1730,-1317
2020,10,7,3,1894,3045,1667,-1378
2020,10,7,4,1796,2936,1645,-1291
2020,10,7,5,1549,2797,1834,-963
2020,10,7,6,1833,2576,1880,-696
2020,10,7,7,1521,2361,1632,-729
2020,10,7,8,1160,2178,1335,-843
2020,10,7,9,1019,2086,1214,-872
2020,10,7,10,929,2041,1196,-845
2020,10,7,11,994,2043,1129,-914
2020,10,7,12,1067,2104,1112,-992
2020,10,7,13,1114,2286,1139,-1147
2020,10,7,14,1379,2566,1228,-1338
2020,10,7,15,1626,2766,1390,-1376
2020,10,7,16,1620,2918,1599,-1319
2020,10,7,17,1638,2971,1614,-1357
2020,10,7,18,1703,2999,1736,-1263
2020,10,7,19,1649,3027,1778,-1249
2020,10,7,20,1662,3070,1836,-1234
2020,10,7,21,1636,3022,1834,-1188
2020,10,7,22,1618,2984,1829,-1155
2020,10,7,23,1619,2950,1826,-1124
2020,10,8,0,1676,2990,1856,-1134
2020,10,8,1,1744,3072,1861,-1211
2020,10,8,2,1773,3099,1833,-1266
2020,10,8,3,1783,3062,1722,-1340
2020,10,8,4,1695,3028,1790,-1238
2020,10,8,5,1411,2842,1785,-1057
2020,10,8,6,1313,2607,1743,-864
2020,10,8,7,1199,2356,1607,-749
2020,10,8,8,1593,2172,1595,-577
2020,10,8,9,1513,2079,1562,-517
2020,10,8,10,1444,2019,1618,-401
2020,10,8,11,1419,2005,1603,-402
2020,10,8,12,1365,2066,1585,-481
2020,10,8,13,1462,2229,1628,-601
2020,10,8,14,1603,2500,1723,-777
2020,10,8,15,1893,2738,1848,-890
2020,10,8,16,1867,2888,1880,-1008
2020,10,8,17,1898,2945,1909,-1036
2020,10,8,18,1919,2957,1935,-1022
2020,10,8,19,1938,3003,1938,-1065
2020,10,8,20,1951,3007,1959,-1048
2020,10,8,21,1942,2978,1915,-1063
2020,10,8,22,1927,2933,1908,-1025
2020,10,8,23,1951,2795,1755,-1040
2020,10,9,0,1944,2851,1705,-1146
2020,10,9,1,2046,2964,1933,-1031
2020,10,9,2,2130,3025,2021,-1004
2020,10,9,3,2134,3090,2150,-940
2020,10,9,4,2062,2977,2097,-880
2020,10,9,5,1821,2788,1978,-810
2020,10,9,6,1706,2595,2033,-562
2020,10,9,7,1556,2363,2027,-336
2020,10,9,8,1413,2167,1848,-319
2020,10,9,9,1501,2075,1802,-273
2020,10,9,10,1448,2032,1744,-288
2020,10,9,11,1472,2025,1729,-296
2020,10,9,12,1430,2087,1720,-367
2020,10,9,13,1566,2233,1700,-533
2020,10,9,14,1352,2478,1715,-763
2020,10,9,15,1602,2724,1974,-750
2020,10,9,16,1653,2852,1948,-904
2020,10,9,17,1604,2893,1821,-1072
2020,10,9,18,1621,2936,1862,-1074
2020,10,9,19,1715,2920,1768,-1152
2020,10,9,20,1592,2956,1833,-1123
2020,10,9,21,1565,2930,1844,-1086
2020,10,9,22,1536,2946,1846,-1100
2020,10,9,23,1562,2868,1626,-1242
2020,10,10,0,1609,2940,1787,-1153
2020,10,10,1,1735,3057,2012,-1045
2020,10,10,2,1747,3132,2009,-1123
2020,10,10,3,1709,3077,2011,-1066
2020,10,10,4,1575,2953,1967,-986
2020,10,10,5,1395,2748,1765,-983
2020,10,10,6,1577,2606,1908,-698
2020,10,10,7,1403,2415,1873,-542
2020,10,10,8,1436,2195,1647,-548
2020,10,10,9,1348,2102,1678,-424
2020,10,10,10,1346,2034,1666,-368
2020,10,10,11,1267,1994,1550,-444
2020,10,10,12,1274,1996,1476,-520
2020,10,10,13,1352,2057,1544,-513
2020,10,10,14,1229,2178,1553,-625
2020,10,10,15,1355,2398,1717,-681
2020,10,10,16,1538,2571,1822,-749
2020,10,10,17,1660,2736,1842,-894
2020,10,10,18,1705,2813,1850,-963
2020,10,10,19,1715,2836,1817,-1019
2020,10,10,20,1699,2829,1858,-971
2020,10,10,21,1652,2750,1859,-891
2020,10,10,22,1595,2736,1884,-852
2020,10,10,23,1565,2708,1840,-868
2020,10,11,0,1590,2734,1885,-849
2020,10,11,1,1658,2800,1977,-823
2020,10,11,2,1737,2878,1877,-1001
2020,10,11,3,1772,2917,1922,-995
2020,10,11,4,1664,2841,1893,-948
2020,10,11,5,1535,2704,1775,-929
2020,10,11,6,1573,2546,1817,-729
2020,10,11,7,1434,2383,1698,-685
2020,10,11,8,1405,2203,1503,-700
2020,10,11,9,1274,2106,1575,-531
2020,10,11,10,1366,2070,1601,-469
2020,10,11,11,1370,2076,1683,-393
2020,10,11,12,1370,2112,1764,-348
2020,10,11,13,1522,2197,1767,-430
2020,10,11,14,1138,2353,1827,-526
2020,10,11,15,1305,2325,1740,-585
2020,10,11,16,1426,2472,1657,-815
2020,10,11,17,1550,2644,1673,-971
2020,10,11,18,1619,2717,1660,-1057
2020,10,11,19,1667,2789,1695,-1094
2020,10,11,20,1588,2826,1649,-1177
2020,10,11,21,1542,2845,1694,-1151
2020,10,11,22,1475,2860,1899,-961
2020,10,11,23,1494,2870,1936,-934
2020,10,12,0,1565,2908,1895,-1013
2020,10,12,1,1700,3055,2151,-904
2020,10,12,2,1801,3066,2239,-827
2020,10,12,3,1750,2934,2149,-785
2020,10,12,4,1597,2821,2136,-685
2020,10,12,5,1502,2623,1840,-783
2020,10,12,6,1609,2399,1856,-543
2020,10,12,7,1578,2181,1779,-402
2020,10,12,8,1370,2010,1750,-260
2020,10,12,9,1414,1927,1741,-186
2020,10,12,10,1409,1901,1737,-164
2020,10,12,11,1428,1922,1715,-207
2020,10,12,12,1488,1977,1674,-303
2020,10,12,13,1567,2201,1709,-492
2020,10,12,14,1369,2448,1570,-878
2020,10,12,15,1520,2723,1591,-1132
2020,10,12,16,1593,2872,1541,-1331
2020,10,12,17,1656,2905,1514,-1391
2020,10,12,18,1677,2916,1739,-1177
2020,10,12,19,1708,2901,1780,-1121
2020,10,12,20,1732,2868,1760,-1108
2020,10,12,21,1709,2801,1725,-1076
2020,10,12,22,1690,2732,1722,-1010
2020,10,12,23,1712,2705,1730,-975
2020,10,13,0,1701,2725,1732,-993
2020,10,13,1,1863,2837,1875,-962
2020,10,13,2,2008,2966,1889,-1077
2020,10,13,3,1980,2990,1945,-1045
2020,10,13,4,1939,2867,1937,-930
2020,10,13,5,1709,2688,1908,-780
2020,10,13,6,1907,2464,1842,-622
2020,10,13,7,1887,2250,1698,-552
2020,10,13,8,1358,2117,1517,-600
2020,10,13,9,1303,2045,1524,-521
2020,10,13,10,1283,2036,1518,-518
2020,10,13,11,1357,2053,1561,-492
2020,10,13,12,1312,2144,1509,-635
2020,10,13,13,1438,2353,1762,-591
2020,10,13,14,1626,2633,1801,-832
2020,10,13,15,1639,2873,1813,-1060
2020,10,13,16,1648,2946,1835,-1111
2020,10,13,17,1641,2917,1921,-996
2020,10,13,18,1700,2938,1968,-970
2020,10,13,19,1750,2896,1899,-997
2020,10,13,20,1800,2798,1890,-908
2020,10,13,21,1881,2679,1878,-801
2020,10,13,22,1832,2600,1881,-719
2020,10,13,23,1863,2581,1807,-774
2020,10,14,0,1782,2645,1827,-818
2020,10,14,1,1962,2737,1882,-855
2020,10,14,2,1966,2845,1874,-971
2020,10,14,3,1971,2980,2015,-965
2020,10,14,4,1931,2899,2033,-866
2020,10,14,5,1789,2728,2039,-689
2020,10,14,6,1577,2539,1957,-582
2020,10,14,7,1566,2315,1783,-532
2020,10,14,8,1605,2179,1934,-245
2020,10,14,9,1631,2110,1889,-221
2020,10,14,10,1561,2047,1840,-207
2020,10,14,11,1657,2047,1845,-202
2020,10,14,12,1647,2154,1806,-348
2020,10,14,13,1871,2354,1830,-524
2020,10,14,14,1632,2591,1786,-805
2020,10,14,15,1745,2789,1681,-1108
2020,10,14,16,1771,2891,1701,-1190
2020,10,14,17,1774,2911,1706,-1205
2020,10,14,18,1773,2912,1719,-1193
2020,10,14,19,1702,2893,1728,-1165
2020,10,14,20,1696,2899,1786,-1113
2020,10,14,21,1737,2845,1691,-1154
2020,10,14,22,1733,2786,1598,-1188
2020,10,14,23,1764,2763,1564,-1199
2020,10,15,0,1801,2847,1665,-1182
2020,10,15,1,1882,3021,1811,-1210
2020,10,15,2,1931,3191,1957,-1234
2020,10,15,3,1987,3178,2077,-1101
2020,10,15,4,1958,3068,2125,-943
2020,10,15,5,1766,2874,2054,-820
2020,10,15,6,2062,2667,2106,-561
2020,10,15,7,2042,2449,2006,-443
2020,10,15,8,1390,2316,1416,-900
2020,10,15,9,1377,2262,1438,-824
2020,10,15,10,1181,2237,1426,-811
2020,10,15,11,1325,2216,1333,-883
2020,10,15,12,1314,2347,1310,-1037
2020,10,15,13,1338,2533,1260,-1273
2020,10,15,14,1389,2781,1227,-1554
2020,10,15,15,1563,3117,1508,-1609
2020,10,15,16,1616,3208,1591,-1617
2020,10,15,17,1635,3146,1561,-1585
2020,10,15,18,1606,3078,1657,-1421
2020,10,15,19,1598,3008,1600,-1408
2020,10,15,20,1585,2997,1545,-1452
2020,10,15,21,1464,2918,1527,-1391
2020,10,15,22,1420,2873,1549,-1324
2020,10,15,23,1467,2846,1497,-1349
2020,10,16,0,1510,2869,1515,-1354
2020,10,16,1,1627,3011,1693,-1318
2020,10,16,2,1654,3179,1791,-1388
2020,10,16,3,1696,3229,1926,-1303
2020,10,16,4,1697,3094,1875,-1219
2020,10,16,5,1492,2912,1875,-1037
2020,10,16,6,1797,2653,1965,-688
2020,10,16,7,1613,2418,1836,-582
2020,10,16,8,1616,2336,1902,-434
2020,10,16,9,1474,2207,1756,-451
2020,10,16,10,1438,2187,1816,-371
2020,10,16,11,1366,2186,1790,-396
2020,10,16,12,1411,2270,1755,-515
2020,10,16,13,1468,2483,1813,-670
2020,10,16,14,1612,2705,1775,-930
2020,10,16,15,1732,2931,1845,-1086
2020,10,16,16,1734,3041,1679,-1362
2020,10,16,17,1738,3092,1611,-1481
2020,10,16,18,1717,3085,1653,-1432
2020,10,16,19,1626,3119,1686,-1433
2020,10,16,20,1700,3096,1764,-1332
2020,10,16,21,1666,3033,1771,-1262
2020,10,16,22,1624,2973,1800,-1173
2020,10,16,23,1606,2969,1862,-1107
2020,10,17,0,1648,3003,1823,-1180
2020,10,17,1,1698,3039,1818,-1221
2020,10,17,2,1779,3070,1891,-1179
2020,10,17,3,1715,3025,2010,-1015
2020,10,17,4,1627,2896,1944,-952
2020,10,17,5,1465,2799,1896,-903
2020,10,17,6,1396,2596,1705,-891
2020,10,17,7,1336,2340,1610,-730
2020,10,17,8,979,2075,1436,-639
2020,10,17,9,971,1969,1383,-586
2020,10,17,10,960,1901,1356,-545
2020,10,17,11,1035,1886,1320,-566
2020,10,17,12,1014,1916,1312,-604
2020,10,17,13,1020,2006,1274,-732
2020,10,17,14,969,2146,1293,-853
2020,10,17,15,1081,2393,1417,-976
2020,10,17,16,1205,2590,1367,-1223
2020,10,17,17,1395,2728,1456,-1272
2020,10,17,18,1416,2827,1591,-1236
2020,10,17,19,1466,2846,1642,-1204
2020,10,17,20,1468,2808,1502,-1306
2020,10,17,21,1447,2769,1515,-1254
2020,10,17,22,1412,2731,1527,-1204
2020,10,17,23,1437,2679,1443,-1236
2020,10,18,0,1515,2745,1490,-1255
2020,10,18,1,1628,2868,1592,-1276
2020,10,18,2,1636,2964,1618,-1346
2020,10,18,3,1662,3001,1678,-1323
2020,10,18,4,1537,2897,1650,-1247
2020,10,18,5,1333,2755,1550,-1205
2020,10,18,6,1638,2602,1775,-827
2020,10,18,7,1415,2411,1690,-721
2020,10,18,8,1096,2253,1524,-729
2020,10,18,9,1068,2140,1228,-912
2020,10,18,10,1016,2065,1356,-709
2020,10,18,11,956,2068,1291,-777
2020,10,18,12,1023,2110,1396,-714
2020,10,18,13,1090,2211,1431,-780
2020,10,18,14,969,2354,1404,-950
2020,10,18,15,969,2504,1496,-1008
2020,10,18,16,978,2651,1476,-1175
2020,10,18,17,1145,2790,1321,-1469
2020,10,18,18,1230,2888,1437,-1451
2020,10,18,19,1235,2918,1471,-1447
2020,10,18,20,1244,2893,1449,-1444
2020,10,18,21,1210,2865,1480,-1385
2020,10,18,22,1221,2814,1495,-1319
2020,10,18,23,1238,2797,1513,-1284
2020,10,19,0,1251,2843,1520,-1323
2020,10,19,1,1386,2924,1578,-1346
2020,10,19,2,1506,3023,1591,-1432
2020,10,19,3,1481,3061,1855,-1206
2020,10,19,4,1296,2811,1578,-1233
2020,10,19,5,1225,2638,1501,-1137
2020,10,19,6,1384,2433,1580,-853
2020,10,19,7,1261,2213,1508,-705
2020,10,19,8,1089,2026,1430,-596
2020,10,19,9,1032,1974,1409,-565
2020,10,19,10,1029,1930,1303,-627
2020,10,19,11,1000,1929,1287,-642
2020,10,19,12,1000,2023,1325,-698
2020,10,19,13,1210,2348,1529,-819
2020,10,19,14,996,2631,1458,-1173
2020,10,19,15,1215,2958,1675,-1283
2020,10,19,16,1240,3032,1686,-1346
2020,10,19,17,1258,3074,1750,-1324
2020,10,19,18,1284,3079,1732,-1347
2020,10,19,19,1287,3089,1737,-1352
2020,10,19,20,1416,3078,1665,-1413
2020,10,19,21,1382,3036,1649,-1387
2020,10,19,22,1346,3014,1576,-1438
2020,10,19,23,1288,3007,1545,-1462
2020,10,20,0,1395,3042,1515,-1527
2020,10,20,1,1494,3173,1588,-1585
2020,10,20,2,1532,3261,1505,-1756
2020,10,20,3,1520,3187,1525,-1662
2020,10,20,4,1465,3059,1541,-1518
2020,10,20,5,1280,2827,1344,-1483
2020,10,20,6,1527,2616,1433,-1183
2020,10,20,7,1376,2295,1133,-1162
2020,10,20,8,1128,2202,1249,-953
2020,10,20,9,1227,2164,1252,-912
2020,10,20,10,1238,2156,1293,-863
2020,10,20,11,1204,2176,1304,-872
2020,10,20,12,1356,2283,1298,-985
2020,10,20,13,1452,2587,1501,-1086
2020,10,20,14,1471,2847,1488,-1359
2020,10,20,15,1623,3088,1606,-1482
2020,10,20,16,1615,3196,1511,-1685
2020,10,20,17,1641,3206,1441,-1765
2020,10,20,18,1567,3154,1511,-1643
2020,10,20,19,1644,3107,1530,-1577
2020,10,20,20,1658,3071,1515,-1556
2020,10,20,21,1605,3061,1598,-1463
2020,10,20,22,1547,2994,1616,-1378
2020,10,20,23,1538,2928,1567,-1361
2020,10,21,0,1593,2969,1652,-1317
2020,10,21,1,1767,3164,1808,-1356
2020,10,21,2,1834,3327,1935,-1392
2020,10,21,3,1863,3189,1800,-1389
2020,10,21,4,1771,3071,1776,-1295
2020,10,21,5,1580,2889,1467,-1422
2020,10,21,6,1830,2672,1452,-1220
2020,10,21,7,1609,2456,1151,-1305
2020,10,21,8,1112,2351,1205,-1146
2020,10,21,9,1069,2294,1225,-1069
2020,10,21,10,1029,2227,1178,-1049
2020,10,21,11,1025,2239,1129,-1110
2020,10,21,12,1099,2347,1147,-1200
2020,10,21,13,1198,2582,1170,-1412
2020,10,21,14,947,2914,1160,-1754
2020,10,21,15,1162,3186,1315,-1871
2020,10,21,16,1188,3321,1390,-1931
2020,10,21,17,1138,3261,1318,-1943
2020,10,21,18,1112,3227,1348,-1879
2020,10,21,19,1095,3247,1391,-1856
2020,10,21,20,1102,3235,1300,-1935
2020,10,21,21,1063,3152,1252,-1900
2020,10,21,22,1035,3083,1212,-1871
2020,10,21,23,1046,3071,1194,-1877
2020,10,22,0,1004,3243,1193,-2050
2020,10,22,1,1154,3336,1164,-2172
2020,10,22,2,1327,3503,1150,-2353
2020,10,22,3,1353,3538,1304,-2234
2020,10,22,4,1259,3386,1275,-2111
2020,10,22,5,1151,3214,1327,-1887
2020,10,22,6,1348,2980,1408,-1572
2020,10,22,7,1161,2767,1433,-1334
2020,10,22,8,881,2519,1020,-1499
2020,10,22,9,840,2456,882,-1574
2020,10,22,10,874,2431,907,-1524
2020,10,22,11,876,2460,950,-1510
2020,10,22,12,979,2600,1002,-1598
2020,10,22,13,1257,2955,1255,-1700
2020,10,22,14,1337,3289,1250,-2039
2020,10,22,15,1348,3654,1558,-2096
2020,10,22,16,1361,3731,1516,-2215
2020,10,22,17,1357,3683,1385,-2298
2020,10,22,18,1355,3648,1388,-2260
2020,10,22,19,1311,3450,1304,-2146
2020,10,22,20,1265,3357,1292,-2065
2020,10,22,21,1249,3242,1254,-1988
2020,10,22,22,1145,3138,1217,-1921
2020,10,22,23,1086,3128,1235,-1893
2020,10,23,0,1040,3190,1251,-1939
2020,10,23,1,1212,3336,1345,-1991
2020,10,23,2,1397,3487,1378,-2109
2020,10,23,3,1401,3486,1381,-2105
2020,10,23,4,1341,3443,1324,-2119
2020,10,23,5,1142,3309,1420,-1889
2020,10,23,6,1188,3059,1405,-1654
2020,10,23,7,972,2856,1258,-1598
2020,10,23,8,1006,2665,1157,-1508
2020,10,23,9,988,2605,1163,-1442
2020,10,23,10,944,2594,1225,-1369
2020,10,23,11,901,2596,1217,-1379
2020,10,23,12,1026,2702,1254,-1448
2020,10,23,13,1199,3036,1486,-1550
2020,10,23,14,1304,3342,1495,-1847
2020,10,23,15,1227,3603,1369,-2234
2020,10,23,16,1278,3731,1409,-2322
2020,10,23,17,1264,3726,1176,-2550
2020,10,23,18,1250,3751,1147,-2604
2020,10,23,19,1161,3781,1142,-2639
2020,10,23,20,1434,3739,1204,-2535
2020,10,23,21,1402,3668,1335,-2333
2020,10,23,22,1253,3632,1325,-2307
2020,10,23,23,1191,3588,1478,-2110
2020,10,24,0,1191,3600,1539,-2061
2020,10,24,1,1285,3664,1571,-2093
2020,10,24,2,1348,3599,1487,-2112
2020,10,24,3,1383,3506,1575,-1931
2020,10,24,4,1254,3379,1483,-1896
2020,10,24,5,1002,3159,1405,-1754
2020,10,24,6,1034,3047,1449,-1598
2020,10,24,7,854,2810,1264,-1546
2020,10,24,8,914,2667,1136,-1531
2020,10,24,9,820,2499,1017,-1482
2020,10,24,10,783,2454,1001,-1453
2020,10,24,11,817,2414,985,-1429
2020,10,24,12,801,2471,987,-1484
2020,10,24,13,749,2592,992,-1600
2020,10,24,14,824,2795,1105,-1690
2020,10,24,15,884,3070,1217,-1853
2020,10,24,16,1122,3302,1413,-1889
2020,10,24,17,1223,3384,1347,-2037
2020,10,24,18,1284,3389,1314,-2075
2020,10,24,19,1268,3337,1241,-2096
2020,10,24,20,1265,3282,1255,-2027
2020,10,24,21,1088,3180,1104,-2076
2020,10,24,22,983,3103,1012,-2091
2020,10,24,23,970,3083,987,-2096
2020,10,25,0,1018,3172,1112,-2060
2020,10,25,1,1191,3320,1268,-2052
2020,10,25,2,1302,3561,1403,-2158
2020,10,25,3,1292,3551,1416,-2135
2020,10,25,4,1167,3432,1252,-2180
2020,10,25,5,962,3291,1201,-2090
2020,10,25,6,1052,3099,1348,-1751
2020,10,25,7,1045,2925,1226,-1699
2020,10,25,8,872,2804,1071,-1733
2020,10,25,9,810,2748,1062,-1686
2020,10,25,10,819,2639,1032,-1607
2020,10,25,11,829,2657,1085,-1572
2020,10,25,12,828,2729,1044,-1685
2020,10,25,13,846,2931,1028,-1903
2020,10,25,14,846,3213,1092,-2121
2020,10,25,15,864,3418,1226,-2192
2020,10,25,16,1036,3617,1405,-2212
2020,10,25,17,1176,3733,1460,-2273
2020,10,25,18,1135,3707,1445,-2262
2020,10,25,19,1102,3635,1421,-2214
2020,10,25,20,1084,3464,1256,-2208
2020,10,25,21,992,3319,1122,-2197
2020,10,25,22,873,3213,1079,-2134
2020,10,25,23,842,3221,1133,-2088
2020,10,26,0,925,3288,1162,-2126
2020,10,26,1,1126,3519,1326,-2193
2020,10,26,2,1324,3701,1380,-2321
2020,10,26,3,1344,3727,1389,-2338
2020,10,26,4,1235,3634,1353,-2281
2020,10,26,5,1055,3510,1307,-2203
2020,10,26,6,994,3281,1309,-1972
2020,10,26,7,825,3000,1091,-1909
2020,10,26,8,876,2929,1024,-1905
2020,10,26,9,882,2833,932,-1901
2020,10,26,10,834,2784,877,-1907
2020,10,26,11,869,2811,880,-1931
2020,10,26,12,964,2949,884,-2065
2020,10,26,13,1219,3346,1357,-1989
2020,10,26,14,1475,3685,1462,-2223
2020,10,26,15,1506,3955,1567,-2388
2020,10,26,16,1572,4066,1649,-2417
2020,10,26,17,1576,4046,1650,-2396
2020,10,26,18,1498,3919,1599,-2320
2020,10,26,19,1408,3811,1599,-2212
2020,10,26,20,1466,3742,1645,-2097
2020,10,26,21,1398,3620,1645,-1975
2020,10,26,22,1382,3524,1627,-1897
2020,10,26,23,1337,3468,1593,-1875
2020,10,27,0,1296,3514,1708,-1806
2020,10,27,1,1485,3663,1770,-1893
2020,10,27,2,1647,3819,1752,-2067
2020,10,27,3,1626,3767,1718,-2049
2020,10,27,4,1507,3620,1770,-1850
2020,10,27,5,1265,3397,1739,-1658
2020,10,27,6,1143,3132,1567,-1565
2020,10,27,7,1035,2859,1331,-1528
2020,10,27,8,1201,2734,1481,-1253
2020,10,27,9,1097,2603,1458,-1145
2020,10,27,10,1086,2570,1384,-1186
2020,10,27,11,1130,2581,1429,-1152
2020,10,27,12,1236,2696,1458,-1238
2020,10,27,13,1260,2951,1479,-1472
2020,10,27,14,1144,3355,1568,-1787
2020,10,27,15,1509,3650,1759,-1891
2020,10,27,16,1563,3745,1784,-1961
2020,10,27,17,1497,3715,1687,-2028
2020,10,27,18,1415,3630,1717,-1913
2020,10,27,19,1410,3516,1667,-1849
2020,10,27,20,1349,3421,1740,-1681
2020,10,27,21,1210,3318,1657,-1661
2020,10,27,22,1113,3214,1539,-1675
2020,10,27,23,1097,3182,1567,-1615
2020,10,28,0,1148,3158,1470,-1688
2020,10,28,1,1335,3225,1462,-1763
2020,10,28,2,1543,3374,1488,-1886
2020,10,28,3,1514,3474,1689,-1785
2020,10,28,4,1522,3368,1746,-1622
2020,10,28,5,1386,3115,1660,-1455
2020,10,28,6,1290,2772,1644,-1128
2020,10,28,7,1108,2556,1496,-1060
2020,10,28,8,1155,2362,1500,-862
2020,10,28,9,1111,2235,1374,-861
2020,10,28,10,1129,2206,1334,-872
2020,10,28,11,1128,2225,1307,-918
2020,10,28,12,1210,2348,1376,-972
2020,10,28,13,1489,2686,1645,-1041
2020,10,28,14,1419,2980,1535,-1445
2020,10,28,15,1598,3202,1570,-1632
2020,10,28,16,1586,3277,1522,-1755
2020,10,28,17,1575,3304,1534,-1770
2020,10,28,18,1499,3190,1453,-1737
2020,10,28,19,1411,3173,1545,-1628
2020,10,28,20,1342,3132,1565,-1567
2020,10,28,21,1275,3078,1535,-1543
2020,10,28,22,1126,2950,1371,-1579
2020,10,28,23,1129,2887,1420,-1467
2020,10,29,0,1150,2957,1522,-1435
2020,10,29,1,1313,3111,1665,-1446
2020,10,29,2,1453,3288,1731,-1557
2020,10,29,3,1475,3245,1670,-1575
2020,10,29,4,1311,3075,1641,-1434
2020,10,29,5,1172,2795,1538,-1257
2020,10,29,6,1329,2533,1633,-900
2020,10,29,7,1255,2294,1465,-829
2020,10,29,8,1169,2235,1516,-719
2020,10,29,9,1180,2158,1424,-734
2020,10,29,10,1141,2030,1355,-675
2020,10,29,11,1129,2027,1344,-683
2020,10,29,12,1194,2119,1311,-808
2020,10,29,13,1392,2401,1505,-896
2020,10,29,14,1307,2621,1406,-1215
2020,10,29,15,1534,2951,1629,-1322
2020,10,29,16,1544,3067,1587,-1480
2020,10,29,17,1564,3090,1563,-1527
2020,10,29,18,1577,2962,1380,-1582
2020,10,29,19,1538,2990,1463,-1527
2020,10,29,20,1468,2974,1412,-1562
2020,10,29,21,1353,2880,1354,-1526
2020,10,29,22,1309,2822,1329,-1493
2020,10,29,23,1361,2781,1228,-1553
2020,10,30,0,1377,2814,1235,-1579
2020,10,30,1,1415,2949,1352,-1597
2020,10,30,2,1574,3097,1285,-1812
2020,10,30,3,1564,3177,1485,-1692
2020,10,30,4,1479,3073,1556,-1517
2020,10,30,5,1365,2829,1464,-1365
2020,10,30,6,1487,2702,1558,-1144
2020,10,30,7,1257,2502,1232,-1270
2020,10,30,8,886,2292,1056,-1236
2020,10,30,9,763,2195,958,-1237
2020,10,30,10,720,2131,939,-1192
2020,10,30,11,714,2125,965,-1160
2020,10,30,12,858,2262,1109,-1153
2020,10,30,13,1026,2499,1189,-1310
2020,10,30,14,1174,2801,1203,-1598
2020,10,30,15,1259,3072,1331,-1741
2020,10,30,16,1208,3178,1275,-1903
2020,10,30,17,1310,3175,1330,-1845
2020,10,30,18,1211,3120,1462,-1658
2020,10,30,19,1168,3060,1446,-1614
2020,10,30,20,1207,3002,1289,-1713
2020,10,30,21,1019,2934,1133,-1801
2020,10,30,22,957,2862,893,-1969
2020,10,30,23,945,2829,942,-1887
2020,10,31,0,1042,2833,1093,-1740
2020,10,31,1,1160,2980,1241,-1739
2020,10,31,2,1226,3128,1261,-1867
2020,10,31,3,1225,3125,1262,-1863
2020,10,31,4,1089,3060,1190,-1870
2020,10,31,5,1035,2904,1152,-1752
2020,10,31,6,909,2744,1157,-1587
2020,10,31,7,989,2501,980,-1521
2020,10,31,8,770,2344,1013,-1331
2020,10,31,9,814,2248,894,-1354
2020,10,31,10,820,2220,859,-1361
2020,10,31,11,852,2236,927,-1309
2020,10,31,12,888,2294,1020,-1274
2020,10,31,13,1035,2480,1214,-1266
2020,10,31,14,905,2756,1337,-1419
2020,10,31,15,1230,2960,1318,-1642
2020,10,31,16,1308,3171,1324,-1847
2020,10,31,17,1396,3253,1321,-1932
2020,10,31,18,1350,3218,1318,-1900
2020,10,31,19,1294,3167,1379,-1788
2020,10,31,20,1258,3031,1362,-1669
2020,10,31,21,1201,2930,1351,-1579
2020,10,31,22,1039,2871,1377,-1494
2020,10,31,23,1129,2837,1379,-1458
2020,11,1,0,1035,2882,1401,-1481
2020,11,1,1,1164,2973,1411,-1562
2020,11,1,2,1307,3097,1484,-1613
2020,11,1,3,1311,3055,1418,-1637
2020,11,1,4,1276,3000,1458,-1542
2020,11,1,5,1219,2932,1511,-1421
2020,11,1,6,1380,2801,1555,-1246
2020,11,1,7,1253,2652,1527,-1125
2020,11,1,8,1213,2480,1334,-1146
2020,11,1,9,1102,2413,1325,-1088
2020,11,1,10,1120,2407,1343,-1064
2020,11,1,11,965,2364,1218,-1146
2020,11,1,12,993,2369,1137,-1232
2020,11,1,13,1095,2427,1079,-1348
2020,11,1,14,1213,2633,1283,-1350
2020,11,1,15,1059,2852,1258,-1594
2020,11,1,16,1256,3125,1302,-1823
2020,11,1,17,1380,3243,1396,-1847
2020,11,1,18,1388,3238,1372,-1866
2020,11,1,19,1309,3146,1314,-1832
2020,11,1,20,1212,3027,1369,-1658
2020,11,1,21,1213,2903,1279,-1624
2020,11,1,22,1182,2826,1285,-1541
2020,11,1,23,989,2782,1295,-1487
2020,11,2,0,1152,2795,1328,-1467
2020,11,2,1,1299,2927,1340,-1587
2020,11,2,2,1420,3270,1367,-1903
2020,11,2,3,1452,3282,1292,-1990
2020,11,2,4,1331,3183,1374,-1809
2020,11,2,5,1279,3062,1334,-1728
2020,11,2,6,1150,2826,1271,-1555
2020,11,2,7,1285,2590,1249,-1341
2020,11,2,8,1121,2403,1219,-1184
2020,11,2,9,994,2303,1103,-1200
2020,11,2,10,962,2265,1083,-1182
2020,11,2,11,964,2282,1096,-1186
2020,11,2,12,932,2350,1153,-1197
2020,11,2,13,1042,2595,1235,-1360
2020,11,2,14,1293,2932,1337,-1595
2020,11,2,15,1285,3322,1273,-2049
2020,11,2,16,1434,3606,1518,-2088
2020,11,2,17,1430,3599,1574,-2025
2020,11,2,18,1440,3449,1532,-1917
2020,11,2,19,1314,3314,1522,-1792
2020,11,2,20,1267,3220,1426,-1794
2020,11,2,21,1223,3134,1393,-1741
2020,11,2,22,1192,3078,1395,-1683
2020,11,2,23,1186,3049,1405,-1644
2020,11,3,0,1224,3044,1431,-1613
2020,11,3,1,1409,3253,1431,-1822
2020,11,3,2,1607,3554,1566,-1988
2020,11,3,3,1605,3531,1581,-1950
2020,11,3,4,1524,3418,1608,-1810
2020,11,3,5,1427,3281,1579,-1702
2020,11,3,6,1199,3085,1513,-1572
2020,11,3,7,1247,2852,1554,-1298
2020,11,3,8,1131,2633,1442,-1191
2020,11,3,9,1059,2524,1553,-971
2020,11,3,10,1061,2446,1540,-906
2020,11,3,11,1053,2443,1542,-901
2020,11,3,12,1087,2476,1496,-980
2020,11,3,13,1243,2656,1599,-1057
2020,11,3,14,1389,2893,1608,-1285
2020,11,3,15,1239,3200,1538,-1662
2020,11,3,16,1345,3470,1698,-1772
2020,11,3,17,1257,3585,1752,-1833
2020,11,3,18,1235,3632,1643,-1989
2020,11,3,19,1101,3661,1750,-1911
2020,11,3,20,1026,3641,1691,-1950
2020,11,3,21,972,3611,1709,-1902
2020,11,3,22,921,3524,1710,-1814
2020,11,3,23,901,3463,1647,-1816
2020,11,4,0,872,3461,1665,-1796
2020,11,4,1,1012,3526,1574,-1952
2020,11,4,2,1158,3676,1552,-2124
2020,11,4,3,1148,3577,1423,-2154
2020,11,4,4,1032,3412,1241,-2171
2020,11,4,5,832,3220,1161,-2059
2020,11,4,6,614,3026,1070,-1956
2020,11,4,7,1024,2825,1152,-1673
2020,11,4,8,866,2476,978,-1498
2020,11,4,9,776,2419,1112,-1307
2020,11,4,10,756,2327,1090,-1237
2020,11,4,11,804,2263,1138,-1125
2020,11,4,12,739,2255,1122,-1133
2020,11,4,13,844,2345,1130,-1215
2020,11,4,14,1049,2584,1191,-1393
2020,11,4,15,913,2796,1009,-1787
2020,11,4,16,978,3011,1105,-1906
2020,11,4,17,886,3116,1081,-2035
2020,11,4,18,882,3138,1132,-2006
2020,11,4,19,888,3136,1121,-2015
2020,11,4,20,894,3170,1135,-2035
2020,11,4,21,895,3166,1126,-2040
2020,11,4,22,906,3160,1194,-1966
2020,11,4,23,906,3118,1255,-1863
2020,11,5,0,993,3147,1178,-1969
2020,11,5,1,1050,3268,1156,-2112
2020,11,5,2,1232,3411,1190,-2221
2020,11,5,3,1182,3320,1305,-2015
2020,11,5,4,1045,3218,1341,-1877
2020,11,5,5,1033,3037,1308,-1729
2020,11,5,6,757,2887,1401,-1486
2020,11,5,7,1092,2691,1460,-1231
2020,11,5,8,841,2324,1289,-1035
2020,11,5,9,832,2192,1267,-925
2020,11,5,10,807,2110,1151,-959
2020,11,5,11,720,2053,1072,-981
2020,11,5,12,742,2076,1092,-984
2020,11,5,13,781,2152,1117,-1035
2020,11,5,14,1005,2488,1309,-1179
2020,11,5,15,805,2810,1194,-1616
2020,11,5,16,1015,2988,1015,-1973
2020,11,5,17,965,3088,1007,-2081
2020,11,5,18,966,3155,1119,-2036
2020,11,5,19,998,3223,1099,-2124
2020,11,5,20,1043,3276,1249,-2027
2020,11,5,21,1116,3302,1202,-2100
2020,11,5,22,1188,3301,1283,-2018
2020,11,5,23,1250,3338,1419,-1919
2020,11,6,0,1310,3368,1377,-1991
2020,11,6,1,1214,3518,1471,-2047
2020,11,6,2,1357,3705,1577,-2128
2020,11,6,3,1354,3645,1559,-2086
2020,11,6,4,1274,3519,1478,-2041
2020,11,6,5,1206,3378,1451,-1927
2020,11,6,6,985,3173,1349,-1824
2020,11,6,7,1192,2957,1409,-1548
2020,11,6,8,1156,2672,1396,-1276
2020,11,6,9,1130,2527,1430,-1097
2020,11,6,10,1145,2473,1463,-1010
2020,11,6,11,1124,2435,1613,-822
2020,11,6,12,1207,2494,1646,-848
2020,11,6,13,1305,2619,1746,-873
2020,11,6,14,1481,2858,1749,-1109
2020,11,6,15,1414,3149,1658,-1491
2020,11,6,16,1553,3434,1914,-1520
2020,11,6,17,1473,3562,1966,-1596
2020,11,6,18,1451,3601,1959,-1642
2020,11,6,19,1373,3557,1912,-1645
2020,11,6,20,1378,3520,1915,-1605
2020,11,6,21,1398,3488,1957,-1531
2020,11,6,22,1338,3405,1904,-1501
2020,11,6,23,1341,3383,1800,-1583
2020,11,7,0,1339,3396,1695,-1701
2020,11,7,1,1424,3517,1859,-1658
2020,11,7,2,1630,3752,1940,-1812
2020,11,7,3,1566,3724,1842,-1882
2020,11,7,4,1429,3617,1797,-1820
2020,11,7,5,1306,3528,1753,-1775
2020,11,7,6,1139,3365,1622,-1743
2020,11,7,7,1462,3181,1718,-1463
2020,11,7,8,1334,2995,1642,-1353
2020,11,7,9,1158,2877,1535,-1342
2020,11,7,10,1120,2818,1518,-1300
2020,11,7,11,1210,2803,1483,-1320
2020,11,7,12,1225,2813,1506,-1307
2020,11,7,13,1314,2881,1485,-1396
2020,11,7,14,1272,3033,1470,-1563
2020,11,7,15,1328,3235,1381,-1854
2020,11,7,16,1409,3440,1455,-1985
2020,11,7,17,1568,3584,1488,-2096
2020,11,7,18,1553,3681,1524,-2157
2020,11,7,19,1476,3689,1479,-2210
2020,11,7,20,1425,3670,1435,-2235
2020,11,7,21,1260,3659,1414,-2245
2020,11,7,22,1177,3613,1518,-2095
2020,11,7,23,1238,3558,1368,-2190
2020,11,8,0,1272,3617,1529,-2088
2020,11,8,1,1465,3729,1555,-2174
2020,11,8,2,1580,3866,1666,-2200
2020,11,8,3,1557,3828,1679,-2149
2020,11,8,4,1446,3724,1697,-2027
2020,11,8,5,1446,3611,1754,-1857
2020,11,8,6,1386,3473,1717,-1756
2020,11,8,7,1625,3279,1744,-1535
2020,11,8,8,1473,3112,1701,-1411
2020,11,8,9,1223,2996,1603,-1393
2020,11,8,10,1166,2959,1550,-1409
2020,11,8,11,1022,2946,1557,-1389
2020,11,8,12,1079,2978,1587,-1391
2020,11,8,13,1186,3052,1645,-1407
2020,11,8,14,1311,3197,1720,-1477
2020,11,8,15,1301,3388,1816,-1572
2020,11,8,16,1478,3518,1691,-1827
2020,11,8,17,1565,3705,1729,-1976
2020,11,8,18,1668,3730,1717,-2013
2020,11,8,19,1572,3671,1781,-1890
2020,11,8,20,1478,3577,1811,-1766
2020,11,8,21,1426,3485,1716,-1769
2020,11,8,22,1387,3403,1720,-1683
2020,11,8,23,1366,3350,1725,-1625
2020,11,9,0,1425,3399,1698,-1701
2020,11,9,1,1674,3645,1780,-1865
2020,11,9,2,1933,3953,1850,-2103
2020,11,9,3,1954,3939,1859,-2080
2020,11,9,4,1886,3896,1913,-1983
2020,11,9,5,1762,3786,1922,-1864
2020,11,9,6,1574,3617,1886,-1731
2020,11,9,7,1458,3377,1872,-1505
2020,11,9,8,1298,3109,1648,-1461
2020,11,9,9,1297,3007,1551,-1456
2020,11,9,10,1334,2980,1516,-1464
2020,11,9,11,1337,2992,1474,-1518
2020,11,9,12,1460,3105,1494,-1611
2020,11,9,13,1654,3311,1596,-1715
2020,11,9,14,1693,3612,1788,-1824
2020,11,9,15,1961,3986,2106,-1880
2020,11,9,16,1919,4248,2295,-1953
2020,11,9,17,2037,4345,2339,-2006
2020,11,9,18,1888,4332,2344,-1988
2020,11,9,19,1804,4274,2203,-2071
2020,11,9,20,1690,4200,2056,-2144
2020,11,9,21,1735,4117,2047,-2070
2020,11,9,22,1653,4020,2056,-1964
2020,11,9,23,1578,3981,2153,-1828
2020,11,10,0,1586,4014,2209,-1805
2020,11,10,1,1781,4166,2199,-1967
2020,11,10,2,1946,4314,2161,-2153
2020,11,10,3,1858,4227,2129,-2098
2020,11,10,4,1705,4091,2095,-1996
2020,11,10,5,1479,3914,2004,-1910
2020,11,10,6,1231,3657,1687,-1970
2020,11,10,7,1168,3378,1752,-1626
2020,11,10,8,1155,3124,1473,-1651
2020,11,10,9,1096,2996,1358,-1638
2020,11,10,10,1012,2910,1294,-1616
2020,11,10,11,915,2886,1433,-1453
2020,11,10,12,967,2910,1419,-1491
2020,11,10,13,1046,3057,1453,-1604
2020,11,10,14,1091,3317,1454,-1863
2020,11,10,15,1150,3631,1464,-2167
2020,11,10,16,1179,3876,1515,-2361
2020,11,10,17,1247,3957,1533,-2424
2020,11,10,18,1195,3932,1506,-2426
2020,11,10,19,1205,3895,1462,-2433
2020,11,10,20,1170,3857,1413,-2444
2020,11,10,21,1134,3813,1383,-2430
2020,11,10,22,1111,3738,1330,-2408
2020,11,10,23,1112,3716,1364,-2352
2020,11,11,0,1211,3782,1505,-2277
2020,11,11,1,1266,3938,1575,-2363
2020,11,11,2,1542,4098,1681,-2417
2020,11,11,3,1582,4023,1658,-2365
2020,11,11,4,1508,3895,1673,-2222
2020,11,11,5,1381,3744,1641,-2103
2020,11,11,6,1215,3522,1622,-1900
2020,11,11,7,1379,3286,1645,-1641
2020,11,11,8,1251,3071,1641,-1430
2020,11,11,9,1281,2959,1503,-1456
2020,11,11,10,1260,2902,1556,-1346
2020,11,11,11,1172,2891,1583,-1308
2020,11,11,12,1275,2938,1616,-1322
2020,11,11,13,1349,3071,1659,-1412
2020,11,11,14,1505,3318,1699,-1619
2020,11,11,15,1378,3630,1674,-1956
2020,11,11,16,1516,3832,1673,-2159
2020,11,11,17,1563,3946,1599,-2347
2020,11,11,18,1563,3939,1616,-2323
2020,11,11,19,1532,3907,1747,-2160
2020,11,11,20,1446,3851,1645,-2206
2020,11,11,21,1410,3790,1523,-2267
2020,11,11,22,1388,3711,1467,-2244
2020,11,11,23,1283,3681,1521,-2160
2020,11,12,0,1378,3728,1580,-2148
2020,11,12,1,1574,3902,1751,-2151
2020,11,12,2,1847,4086,1946,-2140
2020,11,12,3,1846,4032,2060,-1972
2020,11,12,4,1761,3918,2029,-1889
2020,11,12,5,1676,3774,1988,-1786
2020,11,12,6,1521,3558,1953,-1605
2020,11,12,7,1616,3298,1963,-1335
2020,11,12,8,1472,3068,1875,-1193
2020,11,12,9,1533,2935,1824,-1111
2020,11,12,10,1468,2871,1836,-1035
2020,11,12,11,1414,2849,1752,-1097
2020,11,12,12,1442,2900,1713,-1187
2020,11,12,13,1534,3041,1738,-1303
2020,11,12,14,1627,3317,1927,-1390
2020,11,12,15,1725,3651,1941,-1710
2020,11,12,16,1915,3892,2058,-1834
2020,11,12,17,1870,3964,2066,-1898
2020,11,12,18,1805,3923,1991,-1932
2020,11,12,19,1722,3883,1976,-1907
2020,11,12,20,1591,3842,1940,-1902
2020,11,12,21,1521,3796,1942,-1854
2020,11,12,22,1442,3735,1820,-1915
2020,11,12,23,1424,3724,1776,-1948
2020,11,13,0,1482,3792,1887,-1905
2020,11,13,1,1708,3969,2134,-1835
2020,11,13,2,1884,4099,2292,-1807
2020,11,13,3,1818,4010,2142,-1868
2020,11,13,4,1671,3882,2169,-1713
2020,11,13,5,1559,3717,2070,-1647
2020,11,13,6,1365,3487,1905,-1582
2020,11,13,7,1221,3225,1853,-1372
2020,11,13,8,1128,3008,1574,-1434
2020,11,13,9,1190,2861,1367,-1494
2020,11,13,10,1139,2775,1361,-1414
2020,11,13,11,1169,2750,1293,-1457
2020,11,13,12,1202,2784,1239,-1545
2020,11,13,13,1261,2906,1292,-1614
2020,11,13,14,1102,3132,1593,-1539
2020,11,13,15,1126,3416,1567,-1849
2020,11,13,16,1158,3633,1563,-2070
2020,11,13,17,1190,3737,1640,-2097
2020,11,13,18,1121,3723,1639,-2084
2020,11,13,19,1074,3679,1588,-2091
2020,11,13,20,1014,3630,1495,-2135
2020,11,13,21,992,3517,1395,-2122
2020,11,13,22,960,3431,1312,-2119
2020,11,13,23,976,3415,1427,-1988
2020,11,14,0,1005,3430,1470,-1960
2020,11,14,1,1166,3563,1496,-2067
2020,11,14,2,1358,3729,1508,-2221
2020,11,14,3,1327,3677,1498,-2179
2020,11,14,4,1189,3579,1472,-2107
2020,11,14,5,1194,3424,1476,-1948
2020,11,14,6,1027,3296,1347,-1949
2020,11,14,7,1206,3005,1376,-1629
2020,11,14,8,1088,2872,1312,-1560
2020,11,14,9,1051,2904,1449,-1455
2020,11,14,10,1018,2840,1424,-1416
2020,11,14,11,1006,2760,1357,-1403
2020,11,14,12,939,2797,1369,-1428
2020,11,14,13,1007,2811,1345,-1466
2020,11,14,14,1150,2967,1399,-1568
2020,11,14,15,903,3093,1300,-1793
2020,11,14,16,1033,3375,1406,-1969
2020,11,14,17,1212,3521,1396,-2125
2020,11,14,18,1268,3608,1377,-2231
2020,11,14,19,1208,3602,1404,-2198
2020,11,14,20,1170,3591,1437,-2154
2020,11,14,21,1139,3592,1358,-2234
2020,11,14,22,1108,3549,1255,-2294
2020,11,14,23,1176,3548,1386,-2162
2020,11,15,0,1163,3626,1507,-2119
2020,11,15,1,1394,3824,1849,-1975
2020,11,15,2,1561,3922,1847,-2075
2020,11,15,3,1543,3859,1739,-2120
2020,11,15,4,1421,3720,1797,-1923
2020,11,15,5,1287,3572,1695,-1877
2020,11,15,6,1164,3403,1683,-1720
2020,11,15,7,1420,3192,1670,-1522
2020,11,15,8,1224,2988,1624,-1364
2020,11,15,9,1367,2819,1529,-1290
2020,11,15,10,1289,2720,1444,-1276
2020,11,15,11,1019,2660,1195,-1465
2020,11,15,12,845,2650,1082,-1568
2020,11,15,13,889,2690,1099,-1591
2020,11,15,14,798,2796,1114,-1682
2020,11,15,15,748,2949,1204,-1745
2020,11,15,16,803,3125,1200,-1925
2020,11,15,17,870,3293,1211,-2082
2020,11,15,18,1016,3406,1218,-2188
2020,11,15,19,1044,3446,1243,-2203
2020,11,15,20,1070,3409,1273,-2136
2020,11,15,21,993,3430,1314,-2116
2020,11,15,22,924,3385,1403,-1982
2020,11,15,23,911,3285,1238,-2047
2020,11,16,0,993,3314,1342,-1972
2020,11,16,1,1184,3559,1507,-2052
2020,11,16,2,1426,3763,1589,-2174
2020,11,16,3,1426,3699,1567,-2132
2020,11,16,4,1355,3587,1524,-2063
2020,11,16,5,1259,3442,1354,-2088
2020,11,16,6,1121,3253,1297,-1956
2020,11,16,7,1125,3023,1312,-1711
2020,11,16,8,964,2763,1164,-1599
2020,11,16,9,1159,2634,1215,-1419
2020,11,16,10,1178,2548,1209,-1339
2020,11,16,11,1216,2535,1313,-1222
2020,11,16,12,1201,2570,1291,-1279
2020,11,16,13,1267,2713,1324,-1389
2020,11,16,14,1517,2998,1516,-1482
2020,11,16,15,1358,3300,1411,-1889
2020,11,16,16,1497,3585,1492,-2093
2020,11,16,17,1510,3717,1457,-2260
2020,11,16,18,1495,3772,1531,-2241
2020,11,16,19,1415,3784,1511,-2273
2020,11,16,20,1378,3798,1561,-2237
2020,11,16,21,1315,3802,1538,-2264
2020,11,16,22,1313,3790,1523,-2267
2020,11,16,23,1253,3760,1485,-2275
2020,11,17,0,1287,3753,1542,-2211
2020,11,17,1,1400,3868,1716,-2152
2020,11,17,2,1531,3975,1753,-2222
2020,11,17,3,1530,3864,1697,-2167
2020,11,17,4,1397,3705,1656,-2049
2020,11,17,5,1205,3544,1574,-1970
2020,11,17,6,1027,3346,1473,-1873
2020,11,17,7,1246,3104,1556,-1548
2020,11,17,8,1043,2856,1271,-1585
2020,11,17,9,1013,2632,1124,-1508
2020,11,17,10,888,2559,1137,-1422
2020,11,17,11,891,2504,1114,-1390
2020,11,17,12,941,2568,1190,-1378
2020,11,17,13,935,2718,1252,-1466
2020,11,17,14,1031,2978,1315,-1663
2020,11,17,15,1033,3278,1303,-1975
2020,11,17,16,1223,3553,1439,-2114
2020,11,17,17,1170,3642,1421,-2221
2020,11,17,18,1050,3631,1407,-2224
2020,11,17,19,982,3540,1327,-2213
2020,11,17,20,908,3501,1292,-2209
2020,11,17,21,889,3503,1350,-2153
2020,11,17,22,882,3474,1420,-2054
2020,11,17,23,922,3434,1413,-2021
2020,11,18,0,958,3443,1461,-1982
2020,11,18,1,1094,3604,1596,-2008
2020,11,18,2,1341,3790,1709,-2081
2020,11,18,3,1363,3734,1717,-2017
2020,11,18,4,1327,3562,1610,-1952
2020,11,18,5,1173,3344,1466,-1878
2020,11,18,6,950,3119,1402,-1717
2020,11,18,7,1182,2910,1425,-1485
2020,11,18,8,1115,2626,1211,-1415
2020,11,18,9,1100,2578,1130,-1448
2020,11,18,10,1051,2532,1133,-1399
2020,11,18,11,1016,2517,1114,-1403
2020,11,18,12,1057,2541,1150,-1391
2020,11,18,13,1178,2679,1110,-1569
2020,11,18,14,1339,2950,1189,-1761
2020,11,18,15,1104,3294,1237,-2057
2020,11,18,16,1173,3568,1369,-2199
2020,11,18,17,1217,3673,1401,-2272
2020,11,18,18,1139,3717,1436,-2281
2020,11,18,19,1121,3744,1419,-2325
2020,11,18,20,1098,3759,1428,-2331
2020,11,18,21,1161,3755,1507,-2248
2020,11,18,22,1098,3734,1540,-2194
2020,11,18,23,1057,3733,1579,-2154
2020,11,19,0,1111,3771,1665,-2106
2020,11,19,1,1349,3924,1657,-2267
2020,11,19,2,1509,4072,1763,-2309
2020,11,19,3,1513,3986,1722,-2264
2020,11,19,4,1396,3835,1704,-2131
2020,11,19,5,1231,3681,1628,-2053
2020,11,19,6,1104,3468,1555,-1913
2020,11,19,7,1346,3197,1503,-1694
2020,11,19,8,1237,2964,1382,-1582
2020,11,19,9,756,2816,1208,-1608
2020,11,19,10,700,2684,1179,-1505
2020,11,19,11,715,2679,1148,-1531
2020,11,19,12,724,2717,1011,-1706
2020,11,19,13,873,2876,1100,-1776
2020,11,19,14,1061,3159,1250,-1909
2020,11,19,15,904,3484,1313,-2171
2020,11,19,16,1119,3754,1455,-2299
2020,11,19,17,1104,3826,1511,-2315
2020,11,19,18,1035,3730,1467,-2263
2020,11,19,19,990,3731,1512,-2219
2020,11,19,20,946,3696,1472,-2224
2020,11,19,21,910,3707,1417,-2290
2020,11,19,22,846,3619,1328,-2291
2020,11,19,23,827,3628,1260,-2368
2020,11,20,0,900,3686,1263,-2423
2020,11,20,1,1052,3880,1356,-2524
2020,11,20,2,1227,4063,1553,-2510
2020,11,20,3,1213,3957,1579,-2378
2020,11,20,4,1101,3831,1481,-2350
2020,11,20,5,1033,3686,1448,-2238
2020,11,20,6,805,3475,1195,-2280
2020,11,20,7,942,3216,1210,-2006
2020,11,20,8,836,2937,1047,-1890
2020,11,20,9,965,2761,1151,-1610
2020,11,20,10,906,2666,1162,-1504
2020,11,20,11,892,2640,1320,-1320
2020,11,20,12,908,2653,1419,-1234
2020,11,20,13,1087,2864,1570,-1294
2020,11,20,14,1195,3109,1673,-1436
2020,11,20,15,1263,3396,1739,-1657
2020,11,20,16,1432,3654,1830,-1824
2020,11,20,17,1493,3754,1846,-1908
2020,11,20,18,1528,3743,1822,-1921
2020,11,20,19,1503,3716,1786,-1930
2020,11,20,20,1423,3685,1774,-1911
2020,11,20,21,1388,3676,1753,-1923
2020,11,20,22,1319,3598,1658,-1940
2020,11,20,23,1272,3584,1743,-1841
2020,11,21,0,1321,3605,1757,-1848
2020,11,21,1,1516,3731,1898,-1833
2020,11,21,2,1693,3883,1951,-1932
2020,11,21,3,1650,3788,1942,-1846
2020,11,21,4,1581,3665,1978,-1687
2020,11,21,5,1412,3530,1860,-1670
2020,11,21,6,1209,3345,1745,-1600
2020,11,21,7,1294,3156,1781,-1375
2020,11,21,8,1230,2944,1624,-1320
2020,11,21,9,1151,2796,1527,-1269
2020,11,21,10,1076,2710,1489,-1221
2020,11,21,11,1033,2670,1531,-1139
2020,11,21,12,1071,2602,1495,-1107
2020,11,21,13,1045,2657,1420,-1237
2020,11,21,14,1056,2812,1461,-1351
2020,11,21,15,943,3019,1429,-1590
2020,11,21,16,978,3238,1310,-1928
2020,11,21,17,1090,3388,1295,-2093
2020,11,21,18,1108,3449,1275,-2174
2020,11,21,19,1127,3428,1354,-2074
2020,11,21,20,1106,3319,1255,-2064
2020,11,21,21,1055,3294,1320,-1974
2020,11,21,22,986,3178,1271,-1907
2020,11,21,23,995,3122,1252,-1870
2020,11,22,0,1022,3246,1368,-1878
2020,11,22,1,1140,3506,1511,-1995
2020,11,22,2,1325,3728,1675,-2053
2020,11,22,3,1305,3704,1736,-1968
2020,11,22,4,1208,3644,1753,-1891
2020,11,22,5,1103,3533,1661,-1872
2020,11,22,6,1055,3386,1563,-1823
2020,11,22,7,1245,3212,1676,-1536
2020,11,22,8,1112,3034,1640,-1394
2020,11,22,9,1302,2905,1689,-1216
2020,11,22,10,1192,2835,1655,-1180
2020,11,22,11,1180,2747,1560,-1187
2020,11,22,12,1218,2723,1504,-1219
2020,11,22,13,1265,2826,1596,-1230
2020,11,22,14,1310,2995,1668,-1327
2020,11,22,15,1075,3135,1545,-1590
2020,11,22,16,1297,3383,1701,-1682
2020,11,22,17,1417,3569,1805,-1764
2020,11,22,18,1519,3699,1900,-1799
2020,11,22,19,1572,3745,1911,-1834
2020,11,22,20,1570,3782,1935,-1847
2020,11,22,21,1436,3744,1920,-1824
2020,11,22,22,1383,3691,1900,-1791
2020,11,22,23,1290,3735,2013,-1722
2020,11,23,0,1355,3781,1974,-1807
2020,11,23,1,1530,3957,2084,-1873
2020,11,23,2,1690,4074,2183,-1891
2020,11,23,3,1635,3974,2123,-1851
2020,11,23,4,1562,3831,2088,-1743
2020,11,23,5,1365,3665,1940,-1725
2020,11,23,6,1266,3471,1971,-1500
2020,11,23,7,1510,3220,1935,-1285
2020,11,23,8,1386,2995,1798,-1197
2020,11,23,9,1185,2850,1549,-1301
2020,11,23,10,1148,2737,1504,-1233
2020,11,23,11,1113,2739,1517,-1222
2020,11,23,12,1140,2756,1613,-1143
2020,11,23,13,1217,2900,1584,-1316
2020,11,23,14,1319,3162,1595,-1567
2020,11,23,15,1249,3492,1564,-1928
2020,11,23,16,1479,3763,1744,-2019
2020,11,23,17,1557,3876,1784,-2092
2020,11,23,18,1571,3874,1731,-2143
2020,11,23,19,1536,3865,1731,-2134
2020,11,23,20,1479,3870,1653,-2217
2020,11,23,21,1456,3855,1616,-2239
2020,11,23,22,1407,3787,1577,-2210
2020,11,23,23,1361,3739,1551,-2188
2020,11,24,0,1431,3751,1704,-2047
2020,11,24,1,1632,3917,1834,-2083
2020,11,24,2,1687,4072,1851,-2221
2020,11,24,3,1647,3994,1863,-2131
2020,11,24,4,1682,3854,1886,-1968
2020,11,24,5,1466,3710,1801,-1909
2020,11,24,6,1276,3483,1819,-1664
2020,11,24,7,1471,3214,1853,-1361
2020,11,24,8,1358,2988,1742,-1246
2020,11,24,9,1078,2833,1641,-1192
2020,11,24,10,1005,2751,1575,-1176
2020,11,24,11,978,2720,1553,-1167
2020,11,24,12,1049,2749,1521,-1228
2020,11,24,13,1471,2886,1670,-1216
2020,11,24,14,1340,3138,1638,-1500
2020,11,24,15,1442,3452,1785,-1667
2020,11,24,16,1528,3697,1921,-1776
2020,11,24,17,1555,3777,1970,-1807
2020,11,24,18,1547,3699,1865,-1834
2020,11,24,19,1529,3752,1845,-1907
2020,11,24,20,1506,3764,1873,-1891
2020,11,24,21,1491,3775,1863,-1912
2020,11,24,22,1495,3736,1815,-1921
2020,11,24,23,1456,3767,1883,-1884
2020,11,25,0,1566,3820,1898,-1922
2020,11,25,1,1776,3988,2114,-1874
2020,11,25,2,2072,4104,2265,-1839
2020,11,25,3,2097,4042,2322,-1720
2020,11,25,4,1954,3897,2235,-1662
2020,11,25,5,1765,3748,1990,-1758
2020,11,25,6,1496,3579,1688,-1891
2020,11,25,7,1343,3327,1714,-1613
2020,11,25,8,1153,3108,1593,-1515
2020,11,25,9,1186,2959,1505,-1454
2020,11,25,10,1116,2879,1549,-1330
2020,11,25,11,1064,2849,1570,-1279
2020,11,25,12,1040,2855,1598,-1257
2020,11,25,13,1212,2981,1557,-1424
2020,11,25,14,1261,3243,1611,-1632
2020,11,25,15,1217,3539,1532,-2007
2020,11,25,16,1438,3833,1662,-2171
2020,11,25,17,1501,3962,1633,-2329
2020,11,25,18,1478,4002,1662,-2340
2020,11,25,19,1426,4022,1759,-2263
2020,11,25,20,1378,3959,1675,-2284
2020,11,25,21,1377,3889,1641,-2248
2020,11,25,22,1303,3809,1610,-2199
2020,11,25,23,1113,3775,1648,-2127
2020,11,26,0,1181,3779,1633,-2146
2020,11,26,1,1479,4001,1842,-2159
2020,11,26,2,1673,4129,1853,-2276
2020,11,26,3,1665,4047,1794,-2253
2020,11,26,4,1654,3927,1754,-2173
2020,11,26,5,1424,3785,1710,-2075
2020,11,26,6,1168,3597,1645,-1952
2020,11,26,7,1297,3364,1728,-1636
2020,11,26,8,1241,3089,1561,-1528
2020,11,26,9,1144,2946,1467,-1479
2020,11,26,10,996,2791,1339,-1452
2020,11,26,11,908,2740,1330,-1410
2020,11,26,12,937,2849,1448,-1401
2020,11,26,13,968,2947,1477,-1470
2020,11,26,14,1042,3096,1542,-1554
2020,11,26,15,893,3266,1516,-1750
2020,11,26,16,970,3459,1571,-1888
2020,11,26,17,1182,3614,1541,-2073
2020,11,26,18,1350,3807,1607,-2200
2020,11,26,19,1387,3934,1676,-2258
2020,11,26,20,1406,3961,1578,-2383
2020,11,26,21,1371,3919,1590,-2329
2020,11,26,22,1301,3909,1605,-2304
2020,11,26,23,1303,3893,1670,-2223
2020,11,27,0,1346,3843,1851,-1992
2020,11,27,1,1395,3880,1861,-2019
2020,11,27,2,1421,3806,1840,-1966
2020,11,27,3,1364,3680,1756,-1924
2020,11,27,4,1317,3582,1694,-1888
2020,11,27,5,1294,3512,1701,-1811
2020,11,27,6,1257,3396,1707,-1689
2020,11,27,7,1426,3234,1665,-1569
2020,11,27,8,1328,3031,1499,-1532
2020,11,27,9,1172,2908,1501,-1407
2020,11,27,10,1194,2858,1663,-1195
2020,11,27,11,1230,2817,1626,-1191
2020,11,27,12,1250,2850,1622,-1228
2020,11,27,13,1424,2936,1552,-1384
2020,11,27,14,1296,3112,1580,-1532
2020,11,27,15,911,3280,1515,-1765
2020,11,27,16,932,3448,1443,-2005
2020,11,27,17,1082,3561,1468,-2093
2020,11,27,18,1202,3599,1467,-2132
2020,11,27,19,1210,3594,1453,-2141
2020,11,27,20,1197,3481,1372,-2109
2020,11,27,21,1167,3429,1439,-1990
2020,11,27,22,1122,3378,1465,-1913
2020,11,27,23,1030,3288,1228,-2060
2020,11,28,0,1127,3402,1426,-1976
2020,11,28,1,1297,3720,1662,-2058
2020,11,28,2,1400,3920,1652,-2268
2020,11,28,3,1320,3885,1718,-2167
2020,11,28,4,1189,3779,1722,-2057
2020,11,28,5,1056,3674,1679,-1995
2020,11,28,6,919,3489,1696,-1793
2020,11,28,7,1299,3304,1863,-1441
2020,11,28,8,1096,3044,1620,-1424
2020,11,28,9,1234,2886,1659,-1227
2020,11,28,10,1081,2747,1503,-1244
2020,11,28,11,1074,2743,1459,-1284
2020,11,28,12,1091,2750,1542,-1208
2020,11,28,13,1117,2800,1510,-1290
2020,11,28,14,1019,2939,1545,-1394
2020,11,28,15,946,3098,1372,-1726
2020,11,28,16,935,3279,1503,-1776
2020,11,28,17,903,3437,1509,-1928
2020,11,28,18,1124,3546,1461,-2085
2020,11,28,19,1261,3619,1365,-2254
2020,11,28,20,1223,3645,1355,-2290
2020,11,28,21,1187,3638,1328,-2310
2020,11,28,22,1251,3581,1310,-2271
2020,11,28,23,1124,3553,1314,-2239
2020,11,29,0,1143,3579,1463,-2116
2020,11,29,1,1443,3800,1665,-2135
2020,11,29,2,1529,3987,1809,-2178
2020,11,29,3,1530,3975,1846,-2129
2020,11,29,4,1467,3889,1865,-2024
2020,11,29,5,1306,3798,1763,-2035
2020,11,29,6,1156,3656,1757,-1899
2020,11,29,7,1543,3451,1687,-1764
2020,11,29,8,1396,3211,1679,-1532
2020,11,29,9,1462,3058,1593,-1465
2020,11,29,10,1346,2982,1592,-1390
2020,11,29,11,1330,2951,1573,-1378
2020,11,29,12,1342,2961,1597,-1364
2020,11,29,13,1428,3062,1617,-1445
2020,11,29,14,1454,3208,1641,-1567
2020,11,29,15,1074,3423,1702,-1721
2020,11,29,16,1288,3629,1741,-1888
2020,11,29,17,1463,3812,1818,-1994
2020,11,29,18,1586,3925,1827,-2098
2020,11,29,19,1587,3944,1818,-2126
2020,11,29,20,1515,3907,1801,-2106
2020,11,29,21,1474,3854,1718,-2136
2020,11,29,22,1397,3769,1692,-2077
2020,11,29,23,1343,3719,1721,-1998
2020,11,30,0,1396,3774,1756,-2018
2020,11,30,1,1588,4042,1961,-2081
2020,11,30,2,1758,4242,2128,-2114
2020,11,30,3,1715,4187,2141,-2046
2020,11,30,4,1589,4052,1950,-2102
2020,11,30,5,1459,3861,1842,-2019
2020,11,30,6,1196,3656,1825,-1831
2020,11,30,7,1464,3399,1885,-1514
2020,11,30,8,1238,3231,1741,-1490
2020,11,30,9,1346,3081,1684,-1397
2020,11,30,10,1403,2990,1678,-1312
2020,11,30,11,1401,2953,1663,-1290
2020,11,30,12,1428,2962,1680,-1282
2020,11,30,13,1437,3119,1753,-1366
2020,11,30,14,1461,3373,1832,-1541
2020,11,30,15,1314,3665,1677,-1988
2020,11,30,16,1486,3969,1985,-1984
2020,11,30,17,1472,4065,1967,-2098
2020,11,30,18,1422,4058,1828,-2230
2020,11,30,19,1435,3998,1862,-2136
2020,11,30,20,1474,3954,1853,-2101
2020,11,30,21,1498,3905,1791,-2114
2020,11,30,22,1508,3803,1692,-2111
2020,11,30,23,1514,3517,1378,-2139
2020,12,1,0,1515,3678,1528,-2150
2020,12,1,1,1512,4005,1747,-2258
2020,12,1,2,1581,4204,1962,-2242
2020,12,1,3,1543,4134,1964,-2170
2020,12,1,4,1492,4023,1884,-2139
2020,12,1,5,1373,3973,1711,-2262
2020,12,1,6,1319,3721,1595,-2126
2020,12,1,7,1433,3556,1697,-1859
2020,12,1,8,1301,3308,1483,-1825
2020,12,1,9,1417,3152,1674,-1478
2020,12,1,10,1431,3046,1527,-1519
2020,12,1,11,1365,3087,1588,-1499
2020,12,1,12,1366,3153,1656,-1497
2020,12,1,13,1585,3320,1767,-1553
2020,12,1,14,1762,3558,1807,-1751
2020,12,1,15,1692,3914,1949,-1965
2020,12,1,16,1974,4208,2094,-2114
2020,12,1,17,1964,4296,2108,-2188
2020,12,1,18,1898,4289,2094,-2195
2020,12,1,19,1829,4185,2084,-2101
2020,12,1,20,1784,4088,1976,-2112
2020,12,1,21,1737,3995,1940,-2055
2020,12,1,22,1639,3891,1867,-2024
2020,12,1,23,1641,3836,1679,-2157
2020,12,2,0,1735,3889,1928,-1961
2020,12,2,1,1981,4153,2172,-1981
2020,12,2,2,2182,4415,2310,-2105
2020,12,2,3,2182,4381,2326,-2055
2020,12,2,4,2085,4278,2275,-2003
2020,12,2,5,1940,4136,2135,-2001
2020,12,2,6,1701,3920,2001,-1919
2020,12,2,7,2033,3635,2163,-1472
2020,12,2,8,1823,3405,2066,-1339
2020,12,2,9,1765,3269,2000,-1269
2020,12,2,10,1763,3213,2014,-1199
2020,12,2,11,1781,3216,2068,-1148
2020,12,2,12,1838,3271,2203,-1068
2020,12,2,13,1979,3442,2244,-1198
2020,12,2,14,2364,3742,2499,-1243
2020,12,2,15,2288,4082,2468,-1614
2020,12,2,16,2349,4337,2474,-1863
2020,12,2,17,2363,4410,2570,-1840
2020,12,2,18,2267,4314,2510,-1804
2020,12,2,19,2160,4140,2376,-1764
2020,12,2,20,2084,4019,2174,-1845
2020,12,2,21,2023,3904,2226,-1678
2020,12,2,22,1965,3777,2090,-1687
2020,12,2,23,1928,3713,2054,-1659
2020,12,3,0,2013,3765,2185,-1580
2020,12,3,1,2284,4028,2302,-1726
2020,12,3,2,2501,4300,2510,-1790
2020,12,3,3,2503,4282,2517,-1765
2020,12,3,4,2417,4183,2345,-1838
2020,12,3,5,2274,4060,2077,-1983
2020,12,3,6,2064,3850,2053,-1797
2020,12,3,7,2289,3589,2175,-1414
2020,12,3,8,2038,3357,2136,-1221
2020,12,3,9,1866,3229,2189,-1040
2020,12,3,10,1854,3178,2177,-1001
2020,12,3,11,1860,3166,2166,-1000
2020,12,3,12,1912,3226,2156,-1070
2020,12,3,13,2042,3372,2133,-1239
2020,12,3,14,2219,3663,2262,-1401
2020,12,3,15,2051,4021,2238,-1783
2020,12,3,16,2249,4285,2319,-1966
2020,12,3,17,2200,4379,2308,-2071
2020,12,3,18,2094,4301,2226,-2075
2020,12,3,19,2001,4206,2131,-2075
2020,12,3,20,1928,4145,2158,-1987
2020,12,3,21,1886,4115,2144,-1971
2020,12,3,22,1834,4032,2156,-1876
2020,12,3,23,1759,3989,2169,-1820
2020,12,4,0,1868,4016,2234,-1782
2020,12,4,1,2079,4200,2250,-1950
2020,12,4,2,2264,4362,2386,-1976
2020,12,4,3,2234,4288,2368,-1920
2020,12,4,4,2123,4151,2361,-1790
2020,12,4,5,1986,3986,2112,-1874
2020,12,4,6,1775,3765,2043,-1722
2020,12,4,7,2109,3499,2204,-1295
2020,12,4,8,1893,3256,2145,-1111
2020,12,4,9,1680,3114,2031,-1083
2020,12,4,10,1692,3036,2007,-1029
2020,12,4,11,1635,3030,2046,-984
2020,12,4,12,1706,3074,2067,-1007
2020,12,4,13,1868,3246,2049,-1197
2020,12,4,14,1976,3529,2096,-1433
2020,12,4,15,1804,3889,2063,-1826
2020,12,4,16,2019,4189,2144,-2045
2020,12,4,17,2033,4295,2127,-2168
2020,12,4,18,1987,4231,2097,-2134
2020,12,4,19,1928,4075,2105,-1970
2020,12,4,20,1887,3969,2113,-1856
2020,12,4,21,1797,3856,1982,-1874
2020,12,4,22,1746,3736,1956,-1780
2020,12,4,23,1685,3658,1900,-1758
2020,12,5,0,1756,3708,1983,-1725
2020,12,5,1,2008,3992,2052,-1940
2020,12,5,2,2179,4233,2198,-2035
2020,12,5,3,2134,4193,2201,-1992
2020,12,5,4,2015,4119,2175,-1944
2020,12,5,5,1886,4007,2167,-1840
2020,12,5,6,1716,3860,2214,-1646
2020,12,5,7,2039,3625,2287,-1338
2020,12,5,8,1779,3425,2181,-1244
2020,12,5,9,1677,3295,1974,-1321
2020,12,5,10,1611,3231,1981,-1250
2020,12,5,11,1609,3203,2000,-1203
2020,12,5,12,1704,3219,2023,-1196
2020,12,5,13,1782,3290,2025,-1265
2020,12,5,14,1949,3420,1852,-1568
2020,12,5,15,1569,3608,1734,-1874
2020,12,5,16,1555,3847,1890,-1957
2020,12,5,17,1767,4005,2037,-1968
2020,12,5,18,1829,4037,2034,-2003
2020,12,5,19,1727,3950,1993,-1957
2020,12,5,20,1613,3819,1867,-1952
2020,12,5,21,1597,3697,1842,-1855
2020,12,5,22,1483,3571,1855,-1716
2020,12,5,23,1456,3491,1928,-1563
2020,12,6,0,1520,3546,1952,-1594
2020,12,6,1,1709,3804,2128,-1676
2020,12,6,2,1889,4061,2271,-1790
2020,12,6,3,1788,4032,2181,-1851
2020,12,6,4,1707,3931,2156,-1775
2020,12,6,5,1653,3808,2173,-1635
2020,12,6,6,1443,3629,2107,-1522
2020,12,6,7,1688,3386,2221,-1165
2020,12,6,8,1616,3145,2112,-1033
2020,12,6,9,1727,2949,1971,-978
2020,12,6,10,1636,2838,1942,-896
2020,12,6,11,1704,2787,1959,-828
2020,12,6,12,1730,2776,1937,-839
2020,12,6,13,1570,2815,1965,-850
2020,12,6,14,1570,2957,1981,-976
2020,12,6,15,1470,3120,2030,-1090
2020,12,6,16,1494,3299,2032,-1267
2020,12,6,17,1581,3458,2012,-1446
2020,12,6,18,1762,3535,2016,-1519
2020,12,6,19,1809,3589,2030,-1559
2020,12,6,20,1809,3601,1998,-1603
2020,12,6,21,1803,3578,1998,-1580
2020,12,6,22,1673,3558,1963,-1595
2020,12,6,23,1691,3495,1973,-1522
2020,12,7,0,1718,3532,2027,-1505
2020,12,7,1,1913,3796,2075,-1721
2020,12,7,2,2068,3980,2077,-1903
2020,12,7,3,2068,3949,2174,-1775
2020,12,7,4,2014,3850,2238,-1612
2020,12,7,5,1918,3728,2204,-1524
2020,12,7,6,1690,3557,2103,-1454
2020,12,7,7,1784,3311,2148,-1163
2020,12,7,8,1569,3083,2003,-1080
2020,12,7,9,1689,2927,1949,-978
2020,12,7,10,1642,2851,1900,-951
2020,12,7,11,1725,2753,1826,-927
2020,12,7,12,1739,2844,1934,-910
2020,12,7,13,1780,2983,2102,-881
2020,12,7,14,1891,3303,2208,-1095
2020,12,7,15,1752,3628,2174,-1454
2020,12,7,16,1944,3889,2268,-1621
2020,12,7,17,1916,3997,2298,-1699
2020,12,7,18,1812,4014,2303,-1711
2020,12,7,19,1755,4002,2304,-1698
2020,12,7,20,1703,3936,2272,-1664
2020,12,7,21,1666,3879,2237,-1642
2020,12,7,22,1580,3794,2188,-1606
2020,12,7,23,1529,3766,2185,-1581
2020,12,8,0,1571,3816,2229,-1587
2020,12,8,1,1904,4045,2273,-1772
2020,12,8,2,2005,4196,2310,-1886
2020,12,8,3,2002,4111,2310,-1801
2020,12,8,4,1926,3958,2222,-1736
2020,12,8,5,1788,3789,2148,-1641
2020,12,8,6,1544,3552,1925,-1627
2020,12,8,7,1872,3265,1928,-1337
2020,12,8,8,1633,3029,1877,-1152
2020,12,8,9,1368,2790,1714,-1076
2020,12,8,10,1293,2656,1628,-1028
2020,12,8,11,1291,2614,1648,-966
2020,12,8,12,1321,2628,1628,-1000
2020,12,8,13,1371,2738,1640,-1098
2020,12,8,14,1543,3047,1801,-1246
2020,12,8,15,1411,3267,1716,-1551
2020,12,8,16,1492,3634,1905,-1729
2020,12,8,17,1570,3757,1987,-1770
2020,12,8,18,1523,3780,1893,-1887
2020,12,8,19,1505,3767,1873,-1894
2020,12,8,20,1514,3802,1870,-1932
2020,12,8,21,1549,3805,1859,-1946
2020,12,8,22,1605,3767,1854,-1913
2020,12,8,23,1612,3766,1871,-1895
2020,12,9,0,1547,3802,1958,-1844
2020,12,9,1,1920,4007,2162,-1845
2020,12,9,2,2025,4143,2270,-1873
2020,12,9,3,2028,4069,2237,-1832
2020,12,9,4,1858,3925,2122,-1803
2020,12,9,5,1670,3772,1904,-1868
2020,12,9,6,1470,3555,1870,-1685
2020,12,9,7,1758,3289,1948,-1341
2020,12,9,8,1662,3040,1948,-1092
2020,12,9,9,1579,2861,1764,-1097
2020,12,9,10,1540,2714,1915,-799
2020,12,9,11,1644,2681,1932,-749
2020,12,9,12,1591,2696,1922,-774
2020,12,9,13,1678,2785,1884,-901
2020,12,9,14,1902,3040,1938,-1102
2020,12,9,15,1606,3362,1845,-1517
2020,12,9,16,1750,3691,2005,-1686
2020,12,9,17,1736,3789,2026,-1763
2020,12,9,18,1732,3824,2037,-1787
2020,12,9,19,1692,3835,2030,-1805
2020,12,9,20,1684,3819,2000,-1819
2020,12,9,21,1706,3791,1955,-1836
2020,12,9,22,1700,3745,1989,-1756
2020,12,9,23,1741,3704,1927,-1777
2020,12,10,0,1818,3719,1990,-1729
2020,12,10,1,1895,3969,2077,-1892
2020,12,10,2,2114,4197,2139,-2058
2020,12,10,3,2065,4188,2123,-2065
2020,12,10,4,2052,4081,1957,-2124
2020,12,10,5,1939,3915,1953,-1962
2020,12,10,6,1781,3682,2006,-1676
2020,12,10,7,1848,3470,1957,-1513
2020,12,10,8,1765,3200,1727,-1473
2020,12,10,9,1568,3057,1726,-1331
2020,12,10,10,1554,3006,1723,-1283
2020,12,10,11,1608,3038,1816,-1222
2020,12,10,12,1744,3087,1961,-1126
2020,12,10,13,1928,3236,2129,-1107
2020,12,10,14,2000,3515,2241,-1274
2020,12,10,15,1920,3863,2252,-1611
2020,12,10,16,2145,4157,2333,-1824
2020,12,10,17,2155,4261,2346,-1915
2020,12,10,18,2096,4274,2337,-1937
2020,12,10,19,2037,4275,2343,-1932
2020,12,10,20,1971,4265,2299,-1966
2020,12,10,21,1925,4220,2193,-2027
2020,12,10,22,1873,4126,2214,-1912
2020,12,10,23,1771,4069,2288,-1781
2020,12,11,0,1883,4082,2367,-1715
2020,12,11,1,2126,4332,2627,-1705
2020,12,11,2,2291,4504,2594,-1910
2020,12,11,3,2235,4425,2541,-1884
2020,12,11,4,2088,4285,2413,-1872
2020,12,11,5,1903,4126,2259,-1867
2020,12,11,6,1710,3891,2135,-1756
2020,12,11,7,1752,3603,2188,-1415
2020,12,11,8,1509,3346,2137,-1209
2020,12,11,9,1729,3167,2046,-1121
2020,12,11,10,1636,3065,2008,-1057
2020,12,11,11,1614,3025,1983,-1042
2020,12,11,12,1636,3030,1926,-1104
2020,12,11,13,1689,3159,1954,-1205
2020,12,11,14,2008,3447,2076,-1371
2020,12,11,15,1657,3776,1963,-1813
2020,12,11,16,1914,4063,2054,-2009
2020,12,11,17,1989,4176,2056,-2120
2020,12,11,18,1992,4181,2119,-2062
2020,12,11,19,1971,4148,2161,-1987
2020,12,11,20,1955,4096,2232,-1864
2020,12,11,21,1945,4035,2223,-1812
2020,12,11,22,1916,3975,2171,-1804
2020,12,11,23,1936,3936,2150,-1786
2020,12,12,0,2017,4000,2251,-1749
2020,12,12,1,2260,4213,2293,-1920
2020,12,12,2,2270,4405,2407,-1998
2020,12,12,3,2240,4364,2444,-1920
2020,12,12,4,2215,4272,2395,-1877
2020,12,12,5,2072,4161,2318,-1843
2020,12,12,6,2005,3931,2232,-1699
2020,12,12,7,2195,3748,2382,-1366
2020,12,12,8,2080,3521,2263,-1258
2020,12,12,9,1857,3360,2097,-1263
2020,12,12,10,1886,3273,2045,-1228
2020,12,12,11,1849,3212,2021,-1191
2020,12,12,12,1916,3227,2076,-1151
2020,12,12,13,1906,3294,2119,-1175
2020,12,12,14,1981,3467,2192,-1275
2020,12,12,15,1653,3668,2012,-1656
2020,12,12,16,1753,3918,2188,-1730
2020,12,12,17,1951,4106,2188,-1918
2020,12,12,18,2121,4229,2279,-1950
2020,12,12,19,2108,4197,2252,-1945
2020,12,12,20,2066,4105,2264,-1841
2020,12,12,21,2017,4004,2278,-1726
2020,12,12,22,1924,3870,2074,-1796
2020,12,12,23,1828,3789,2031,-1758
2020,12,13,0,1880,3890,2165,-1725
2020,12,13,1,2098,4230,2351,-1879
2020,12,13,2,2060,4445,2445,-2000
2020,12,13,3,2140,4426,2475,-1951
2020,12,13,4,2049,4337,2458,-1879
2020,12,13,5,2001,4206,2411,-1795
2020,12,13,6,1881,4004,2329,-1675
2020,12,13,7,2156,3747,2393,-1354
2020,12,13,8,1978,3506,2376,-1130
2020,12,13,9,1688,3327,2004,-1323
2020,12,13,10,1611,3224,1916,-1308
2020,12,13,11,1516,3168,1829,-1339
2020,12,13,12,1535,3043,1767,-1276
2020,12,13,13,1635,3183,1990,-1193
2020,12,13,14,1709,3311,2048,-1263
2020,12,13,15,1455,3474,1930,-1544
2020,12,13,16,1412,3647,1873,-1774
2020,12,13,17,1492,3809,1989,-1820
2020,12,13,18,1617,3948,1867,-2081
2020,12,13,19,1646,4096,1936,-2160
2020,12,13,20,1632,4132,2038,-2094
2020,12,13,21,1690,4123,2022,-2101
2020,12,13,22,1558,4060,2161,-1899
2020,12,13,23,1501,3990,2135,-1855
2020,12,14,0,1555,4007,2114,-1893
2020,12,14,1,1834,4219,2309,-1910
2020,12,14,2,1971,4348,2353,-1995
2020,12,14,3,1966,4258,2336,-1922
2020,12,14,4,1853,4160,2244,-1916
2020,12,14,5,1651,4010,2159,-1851
2020,12,14,6,1482,3808,2073,-1735
2020,12,14,7,1905,3510,2088,-1422
2020,12,14,8,1649,3250,1979,-1271
2020,12,14,9,1686,3065,1792,-1273
2020,12,14,10,1643,2922,1676,-1246
2020,12,14,11,1597,2913,1649,-1264
2020,12,14,12,1649,2951,1752,-1199
2020,12,14,13,1721,3136,1882,-1254
2020,12,14,14,1815,3427,1926,-1501
2020,12,14,15,1600,3749,1852,-1897
2020,12,14,16,1850,4017,1852,-2165
2020,12,14,17,1902,4129,1910,-2219
2020,12,14,18,1929,4138,1944,-2194
2020,12,14,19,1854,4084,2084,-2000
2020,12,14,20,1809,4055,2012,-2043
2020,12,14,21,1784,4001,2030,-1971
2020,12,14,22,1707,3888,1995,-1893
2020,12,14,23,1683,3847,2003,-1844
2020,12,15,0,1823,3917,2004,-1913
2020,12,15,1,2126,4178,2301,-1877
2020,12,15,2,2191,4401,2482,-1919
2020,12,15,3,2195,4344,2510,-1834
2020,12,15,4,2170,4231,2464,-1767
2020,12,15,5,1916,4073,2440,-1633
2020,12,15,6,1788,3771,2149,-1622
2020,12,15,7,1887,3478,2184,-1294
2020,12,15,8,1615,3173,1934,-1239
2020,12,15,9,1509,2992,1731,-1261
2020,12,15,10,1388,2907,1630,-1277
2020,12,15,11,1448,2880,1613,-1267
2020,12,15,12,1458,2966,1779,-1187
2020,12,15,13,1606,3154,1882,-1272
2020,12,15,14,1810,3462,2054,-1408
2020,12,15,15,1779,3785,2072,-1713
2020,12,15,16,1919,4025,2127,-1898
2020,12,15,17,2009,4161,2205,-1956
2020,12,15,18,2031,4173,2188,-1985
2020,12,15,19,1911,4163,2132,-2031
2020,12,15,20,1801,4159,2049,-2110
2020,12,15,21,1696,4136,2012,-2124
2020,12,15,22,1582,4029,2002,-2027
2020,12,15,23,1590,3939,1931,-2008
2020,12,16,0,1602,3979,1981,-1998
2020,12,16,1,1859,4210,2129,-2081
2020,12,16,2,2066,4339,2232,-2107
2020,12,16,3,2033,4245,2130,-2115
2020,12,16,4,2012,4155,2242,-1913
2020,12,16,5,1721,3999,2206,-1793
2020,12,16,6,1463,3757,2085,-1672
2020,12,16,7,1521,3417,2019,-1398
2020,12,16,8,1497,3148,1939,-1209
2020,12,16,9,1614,2976,2057,-919
2020,12,16,10,1513,2875,1955,-920
2020,12,16,11,1491,2834,1970,-864
2020,12,16,12,1554,2856,1903,-953
2020,12,16,13,1605,2992,1919,-1073
2020,12,16,14,1815,3275,2104,-1171
2020,12,16,15,1535,3568,1944,-1624
2020,12,16,16,1698,3864,1959,-1905
2020,12,16,17,1849,3966,1998,-1968
2020,12,16,18,1876,3987,2073,-1914
2020,12,16,19,1918,3996,2101,-1895
2020,12,16,20,1906,4004,2088,-1916
2020,12,16,21,1758,4029,2126,-1903
2020,12,16,22,1747,4021,2128,-1893
2020,12,16,23,1714,4044,2094,-1950
2020,12,17,0,1792,4107,2134,-1973
2020,12,17,1,1990,4286,2455,-1831
2020,12,17,2,2124,4384,2589,-1795
2020,12,17,3,2058,4273,2455,-1818
2020,12,17,4,1869,4025,2096,-1929
2020,12,17,5,1684,3848,2010,-1838
2020,12,17,6,1530,3582,1877,-1705
2020,12,17,7,1868,3355,2131,-1224
2020,12,17,8,1541,2967,1878,-1089
2020,12,17,9,1112,2740,1360,-1380
2020,12,17,10,1117,2655,1215,-1440
2020,12,17,11,1066,2633,1283,-1350
2020,12,17,12,1158,2660,1309,-1351
2020,12,17,13,1249,2823,1419,-1404
2020,12,17,14,1440,3190,1625,-1565
2020,12,17,15,1291,3460,1528,-1932
2020,12,17,16,1445,3701,1598,-2103
2020,12,17,17,1457,3795,1628,-2167
2020,12,17,18,1441,3855,1709,-2146
2020,12,17,19,1415,3823,1615,-2208
2020,12,17,20,1406,3787,1492,-2295
2020,12,17,21,1393,3694,1549,-2145
2020,12,17,22,1349,3586,1446,-2140
2020,12,17,23,1351,3558,1465,-2093
2020,12,18,0,1478,3607,1493,-2114
2020,12,18,1,1688,3889,1826,-2063
2020,12,18,2,1821,4112,1915,-2197
2020,12,18,3,1805,4058,1872,-2186
2020,12,18,4,1691,3865,1780,-2085
2020,12,18,5,1629,3714,1712,-2002
2020,12,18,6,1292,3430,1435,-1995
2020,12,18,7,1627,3279,1682,-1597
2020,12,18,8,1339,3026,1630,-1396
2020,12,18,9,1106,2813,1560,-1253
2020,12,18,10,1018,2771,1549,-1222
2020,12,18,11,1087,2713,1543,-1170
2020,12,18,12,1057,2747,1555,-1192
2020,12,18,13,1141,2858,1729,-1129
2020,12,18,14,1180,3168,1802,-1366
2020,12,18,15,1077,3469,1837,-1632
2020,12,18,16,1287,3736,1907,-1829
2020,12,18,17,1362,3882,1872,-2010
2020,12,18,18,1182,3925,1725,-2200
2020,12,18,19,1233,3961,1777,-2184
2020,12,18,20,1274,3962,1811,-2151
2020,12,18,21,1348,3940,1734,-2206
2020,12,18,22,1328,3855,1625,-2230
2020,12,18,23,1275,3790,1699,-2091
2020,12,19,0,1347,3817,1751,-2066
2020,12,19,1,1587,3976,1837,-2139
2020,12,19,2,1595,4081,1854,-2227
2020,12,19,3,1585,3992,1871,-2121
2020,12,19,4,1369,3858,1894,-1964
2020,12,19,5,1145,3728,1709,-2019
2020,12,19,6,882,3488,1524,-1964
2020,12,19,7,1287,3283,1699,-1584
2020,12,19,8,1083,3043,1567,-1476
2020,12,19,9,1102,2747,1382,-1365
2020,12,19,10,1008,2704,1461,-1243
2020,12,19,11,984,2649,1429,-1220
2020,12,19,12,1013,2642,1365,-1277
2020,12,19,13,860,2670,1372,-1298
2020,12,19,14,1099,2794,1516,-1278
2020,12,19,15,732,3005,1445,-1560
2020,12,19,16,750,3200,1427,-1773
2020,12,19,17,946,3348,1252,-2096
2020,12,19,18,1104,3477,1205,-2272
2020,12,19,19,1176,3549,1220,-2329
2020,12,19,20,1200,3588,1192,-2396
2020,12,19,21,1179,3624,1186,-2438
2020,12,19,22,1100,3682,1217,-2465
2020,12,19,23,1074,3722,1212,-2510
2020,12,20,0,1087,3751,1347,-2404
2020,12,20,1,1083,3912,1449,-2463
2020,12,20,2,1187,4019,1558,-2461
2020,12,20,3,985,3938,1715,-2223
2020,12,20,4,859,3809,1717,-2092
2020,12,20,5,792,3631,1316,-2315
2020,12,20,6,774,3434,1229,-2205
2020,12,20,7,932,3201,1475,-1726
2020,12,20,8,883,2966,1477,-1489
2020,12,20,9,854,2771,1393,-1378
2020,12,20,10,800,2606,1248,-1358
2020,12,20,11,833,2521,1225,-1296
2020,12,20,12,824,2493,1184,-1309
2020,12,20,13,810,2531,1211,-1320
2020,12,20,14,933,2603,1120,-1483
2020,12,20,15,646,2754,1131,-1623
2020,12,20,16,849,3016,1225,-1791
2020,12,20,17,869,3196,1166,-2030
2020,12,20,18,1023,3354,1179,-2175
2020,12,20,19,1003,3395,1110,-2285
2020,12,20,20,1054,3427,1135,-2292
2020,12,20,21,1146,3417,1104,-2313
2020,12,20,22,1137,3463,1191,-2272
2020,12,20,23,1172,3445,1179,-2266
2020,12,21,0,1192,3496,1180,-2316
2020,12,21,1,956,3705,1328,-2377
2020,12,21,2,1175,3841,1348,-2493
2020,12,21,3,1141,3783,1358,-2425
2020,12,21,4,1045,3696,1336,-2360
2020,12,21,5,917,3590,1309,-2281
2020,12,21,6,1090,3451,1311,-2140
2020,12,21,7,1230,3253,1292,-1961
2020,12,21,8,1111,3035,1222,-1813
2020,12,21,9,1112,2931,1188,-1743
2020,12,21,10,1137,2818,1145,-1673
2020,12,21,11,981,2782,1050,-1732
2020,12,21,12,1012,2801,1074,-1727
2020,12,21,13,1114,2918,1178,-1740
2020,12,21,14,1285,3167,1370,-1797
2020,12,21,15,1020,3465,1428,-2037
2020,12,21,16,1266,3740,1478,-2262
2020,12,21,17,1276,3848,1561,-2287
2020,12,21,18,1325,3907,1550,-2357
2020,12,21,19,1295,3880,1598,-2282
2020,12,21,20,1242,3864,1632,-2232
2020,12,21,21,1156,3836,1532,-2304
2020,12,21,22,1184,3806,1481,-2325
2020,12,21,23,1267,3801,1442,-2359
2020,12,22,0,1311,3889,1476,-2413
2020,12,22,1,1576,4198,1828,-2370
2020,12,22,2,1746,4369,1894,-2475
2020,12,22,3,1673,4351,1867,-2484
2020,12,22,4,1479,4259,1898,-2361
2020,12,22,5,1380,4162,1772,-2390
2020,12,22,6,1170,3946,1700,-2246
2020,12,22,7,1412,3656,1660,-1996
2020,12,22,8,1323,3336,1490,-1846
2020,12,22,9,1254,3201,1411,-1790
2020,12,22,10,1185,3100,1509,-1591
2020,12,22,11,1336,3069,1582,-1487
2020,12,22,12,1233,3067,1394,-1673
2020,12,22,13,1588,3212,1534,-1678
2020,12,22,14,1847,3498,1561,-1937
2020,12,22,15,1445,3836,1608,-2228
2020,12,22,16,1561,4230,1735,-2495
2020,12,22,17,1651,4366,1789,-2577
2020,12,22,18,1677,4320,1690,-2630
2020,12,22,19,1691,4212,1658,-2554
2020,12,22,20,1691,4114,1636,-2478
2020,12,22,21,1671,4044,1669,-2375
2020,12,22,22,1633,3969,1534,-2435
2020,12,22,23,1629,3941,1457,-2484
2020,12,23,0,1739,4048,1778,-2270
2020,12,23,1,2003,4324,2104,-2220
2020,12,23,2,2169,4584,2240,-2344
2020,12,23,3,2182,4563,2257,-2306
2020,12,23,4,2171,4501,2248,-2253
2020,12,23,5,2048,4398,2146,-2252
2020,12,23,6,1940,4209,2030,-2179
2020,12,23,7,2226,3948,2085,-1863
2020,12,23,8,2015,3715,1983,-1732
2020,12,23,9,1802,3554,1989,-1565
2020,12,23,10,1792,3372,1774,-1598
2020,12,23,11,1829,3351,1872,-1479
2020,12,23,12,1934,3398,1895,-1503
2020,12,23,13,2036,3601,2109,-1492
2020,12,23,14,2216,3935,2305,-1630
2020,12,23,15,1869,4239,2222,-2017
2020,12,23,16,2101,4498,2247,-2251
2020,12,23,17,2182,4621,2270,-2351
2020,12,23,18,2160,4639,2239,-2400
2020,12,23,19,2105,4587,2223,-2364
2020,12,23,20,2031,4428,2171,-2257
2020,12,23,21,1983,4290,2153,-2137
2020,12,23,22,1888,4164,2050,-2114
2020,12,23,23,1786,4102,2018,-2084
2020,12,24,0,1887,4146,2119,-2027
2020,12,24,1,2146,4426,2172,-2254
2020,12,24,2,2350,4703,2285,-2418
2020,12,24,3,2294,4670,2286,-2384
2020,12,24,4,2223,4591,2275,-2316
2020,12,24,5,2090,4494,2241,-2253
2020,12,24,6,1878,4290,2221,-2069
2020,12,24,7,2265,4038,2269,-1769
2020,12,24,8,2135,3795,2311,-1484
2020,12,24,9,1898,3591,2118,-1473
2020,12,24,10,1770,3510,1907,-1603
2020,12,24,11,1744,3476,1895,-1581
2020,12,24,12,1955,3516,1866,-1650
2020,12,24,13,1857,3624,1900,-1724
2020,12,24,14,1964,3867,1921,-1946
2020,12,24,15,1675,4130,1989,-2141
2020,12,24,16,1866,4366,2043,-2323
2020,12,24,17,1980,4566,2132,-2434
2020,12,24,18,2084,4631,2224,-2407
2020,12,24,19,2016,4569,2242,-2327
2020,12,24,20,1904,4436,2230,-2206
2020,12,24,21,1728,4310,2161,-2149
2020,12,24,22,1578,4207,2148,-2059
2020,12,24,23,1509,4145,2122,-2023
2020,12,25,0,1596,4171,2103,-2068
2020,12,25,1,1868,4389,2163,-2226
2020,12,25,2,1971,4529,2186,-2343
2020,12,25,3,1866,4411,2118,-2293
2020,12,25,4,1668,4285,2031,-2254
2020,12,25,5,1563,4193,2024,-2169
2020,12,25,6,1496,4038,1992,-2046
2020,12,25,7,1997,3816,2020,-1796
2020,12,25,8,1775,3581,1887,-1694
2020,12,25,9,1661,3398,1888,-1510
2020,12,25,10,1673,3285,1925,-1360
2020,12,25,11,1648,3235,1918,-1317
2020,12,25,12,1668,3224,1877,-1347
2020,12,25,13,1736,3271,1852,-1419
2020,12,25,14,1872,3413,1791,-1622
2020,12,25,15,1628,3636,1941,-1695
2020,12,25,16,1684,3805,1946,-1859
2020,12,25,17,1825,3961,1985,-1976
2020,12,25,18,1918,4042,2093,-1949
2020,12,25,19,1899,4081,2056,-2025
2020,12,25,20,1843,4066,2004,-2062
2020,12,25,21,1759,4038,1977,-2061
2020,12,25,22,1656,3984,1967,-2017
2020,12,25,23,1622,3984,1918,-2066
2020,12,26,0,1634,4035,1905,-2130
2020,12,26,1,1775,4156,2084,-2072
2020,12,26,2,1894,4169,2164,-2005
2020,12,26,3,1827,4039,2049,-1990
2020,12,26,4,1711,3936,2129,-1807
2020,12,26,5,1601,3831,2084,-1747
2020,12,26,6,1452,3701,2015,-1686
2020,12,26,7,1622,3459,1994,-1465
2020,12,26,8,1422,3267,1684,-1583
2020,12,26,9,1315,3108,1661,-1447
2020,12,26,10,1319,3000,1664,-1336
2020,12,26,11,1311,2944,1654,-1290
2020,12,26,12,1301,2928,1705,-1223
2020,12,26,13,1318,2945,1711,-1234
2020,12,26,14,1330,3061,1722,-1339
2020,12,26,15,1154,3156,1493,-1663
2020,12,26,16,1169,3328,1529,-1799
2020,12,26,17,1196,3482,1414,-2068
2020,12,26,18,1233,3648,1518,-2130
2020,12,26,19,1206,3750,1394,-2356
2020,12,26,20,1211,3749,1284,-2465
2020,12,26,21,1219,3735,1309,-2426
2020,12,26,22,1196,3639,1216,-2423
2020,12,26,23,1204,3492,1169,-2323
2020,12,27,0,1222,3565,1372,-2193
2020,12,27,1,1270,3909,1726,-2183
2020,12,27,2,1401,4150,1850,-2300
2020,12,27,3,1324,4115,1864,-2251
2020,12,27,4,1263,4012,1730,-2282
2020,12,27,5,1225,3881,1608,-2273
2020,12,27,6,1208,3655,1580,-2075
2020,12,27,7,1392,3416,1681,-1735
2020,12,27,8,1233,3206,1639,-1567
2020,12,27,9,1054,3049,1631,-1418
2020,12,27,10,1027,2963,1639,-1324
2020,12,27,11,1057,2910,1639,-1271
2020,12,27,12,1094,2876,1586,-1290
2020,12,27,13,1135,2920,1559,-1361
2020,12,27,14,1316,3022,1546,-1476
2020,12,27,15,947,3191,1462,-1729
2020,12,27,16,1017,3376,1507,-1869
2020,12,27,17,1234,3575,1550,-2025
2020,12,27,18,1405,3753,1663,-2090
2020,12,27,19,1474,3850,1709,-2141
2020,12,27,20,1488,3757,1573,-2184
2020,12,27,21,1481,3679,1534,-2145
2020,12,27,22,1447,3577,1579,-1998
2020,12,27,23,1381,3539,1678,-1861
2020,12,28,0,1415,3571,1737,-1834
2020,12,28,1,1696,3759,1945,-1814
2020,12,28,2,1826,4015,2051,-1964
2020,12,28,3,1806,3986,2039,-1947
2020,12,28,4,1708,3902,1989,-1913
2020,12,28,5,1641,3800,1940,-1860
2020,12,28,6,1435,3639,1855,-1784
2020,12,28,7,1700,3405,1976,-1429
2020,12,28,8,1489,3204,1837,-1367
2020,12,28,9,1621,3055,1755,-1300
2020,12,28,10,1654,2950,1711,-1239
2020,12,28,11,1672,2949,1733,-1216
2020,12,28,12,1713,3030,1798,-1232
2020,12,28,13,1835,3201,1880,-1321
2020,12,28,14,1864,3484,2009,-1475
2020,12,28,15,1543,3793,1925,-1868
2020,12,28,16,1697,4044,2077,-1967
2020,12,28,17,1810,4167,2223,-1944
2020,12,28,18,1907,4199,2213,-1986
2020,12,28,19,1874,4159,2129,-2030
2020,12,28,20,1911,4067,2082,-1985
2020,12,28,21,1829,3975,2019,-1956
2020,12,28,22,1763,3892,2019,-1873
2020,12,28,23,1680,3823,2004,-1819
2020,12,29,0,1701,3873,2028,-1845
2020,12,29,1,2022,4128,2295,-1833
2020,12,29,2,2173,4336,2470,-1866
2020,12,29,3,2119,4282,2477,-1805
2020,12,29,4,2011,4171,2318,-1853
2020,12,29,5,1848,4021,2201,-1820
2020,12,29,6,1627,3816,2137,-1679
2020,12,29,7,1919,3550,2189,-1361
2020,12,29,8,1759,3304,2134,-1170
2020,12,29,9,1785,3138,2139,-999
2020,12,29,10,1746,3050,2147,-903
2020,12,29,11,1754,3042,2116,-926
2020,12,29,12,1801,3089,2147,-942
2020,12,29,13,1966,3210,2017,-1193
2020,12,29,14,2052,3476,2201,-1275
2020,12,29,15,1768,3797,2264,-1533
2020,12,29,16,1797,4033,2366,-1667
2020,12,29,17,1902,4158,2353,-1805
2020,12,29,18,1963,4172,2290,-1882
2020,12,29,19,1986,4199,2240,-1959
2020,12,29,20,1987,4215,2311,-1904
2020,12,29,21,1972,4230,2317,-1913
2020,12,29,22,1906,4196,2266,-1930
2020,12,29,23,1868,4160,2168,-1992
2020,12,30,0,1882,4173,2241,-1932
2020,12,30,1,2181,4334,2582,-1752
2020,12,30,2,2289,4477,2549,-1928
2020,12,30,3,2212,4366,2557,-1809
2020,12,30,4,1965,4232,2459,-1773
2020,12,30,5,1863,4057,2332,-1725
2020,12,30,6,1680,3842,2114,-1728
2020,12,30,7,1958,3545,2272,-1273
2020,12,30,8,1831,3295,1948,-1347
2020,12,30,9,1646,3107,2054,-1053
2020,12,30,10,1564,2991,1821,-1170
2020,12,30,11,1527,2960,1888,-1072
2020,12,30,12,1606,2947,1896,-1051
2020,12,30,13,1748,3011,1940,-1071
2020,12,30,14,1777,3251,2036,-1215
2020,12,30,15,1609,3551,2044,-1507
2020,12,30,16,1598,3738,1986,-1752
2020,12,30,17,1717,3942,2012,-1930
2020,12,30,18,1794,4015,1847,-2168
2020,12,30,19,1789,4112,1991,-2121
2020,12,30,20,1786,4100,1954,-2146
2020,12,30,21,1724,4074,1901,-2173
2020,12,30,22,1696,4006,1868,-2138
2020,12,30,23,1650,3957,1971,-1986
2020,12,31,0,1686,3931,1996,-1935
2020,12,31,1,1883,4087,2191,-1896
2020,12,31,2,1943,4223,2294,-1929
2020,12,31,3,1922,4091,2162,-1929
2020,12,31,4,1750,3962,2124,-1838
2020,12,31,5,1561,3803,2101,-1702
2020,12,31,6,1324,3612,2039,-1573
2020,12,31,7,1624,3336,2074,-1262
2020,12,31,8,1374,3073,1883,-1190
2020,12,31,9,1506,2870,1648,-1222
2020,12,31,10,1215,2765,1464,-1301
2020,12,31,11,1186,2714,1425,-1289
2020,12,31,12,1180,2707,1472,-1235
2020,12,31,13,1139,2782,1355,-1427
2020,12,31,14,1226,2996,1458,-1538
2020,12,31,15,1096,3236,1428,-1808
2020,12,31,16,1150,3422,1563,-1859
2020,12,31,17,1173,3563,1562,-2001
2020,12,31,18,1169,3686,1778,-1908
2020,12,31,19,1217,3743,1827,-1916
2020,12,31,20,1258,3774,1817,-1957
2020,12,31,21,1339,3751,1516,-2235
2020,12,31,22,1325,3739,1596,-2143
2020,12,31,23,1358,3736,1648,-2088
2021,1,1,0,1450,3781,1833,-1948
2021,1,1,1,1731,4021,2077,-1944
2021,1,1,2,1740,4173,2139,-2034
2021,1,1,3,1735,4023,2082,-1941
2021,1,1,4,1630,3826,1994,-1832
2021,1,1,5,1390,3676,1834,-1842
2021,1,1,6,1363,3481,1660,-1821
2021,1,1,7,1549,3316,1962,-1354
2021,1,1,8,1460,3153,1850,-1303
2021,1,1,9,1246,3019,1812,-1207
2021,1,1,10,1351,2922,1774,-1148
2021,1,1,11,1328,2867,1772,-1095
2021,1,1,12,1335,2875,1668,-1207
2021,1,1,13,1350,2919,1645,-1274
2021,1,1,14,1254,3034,1591,-1443
2021,1,1,15,868,3172,1592,-1580
2021,1,1,16,860,3206,1554,-1652
2021,1,1,17,865,3277,1497,-1780
2021,1,1,18,1106,3409,1414,-1995
2021,1,1,19,1173,3509,1445,-2064
2021,1,1,20,1255,3555,1439,-2116
2021,1,1,21,1243,3561,1476,-2085
2021,1,1,22,1194,3559,1484,-2075
2021,1,1,23,1131,3589,1408,-2181
2021,1,2,0,1153,3673,1431,-2242
2021,1,2,1,1352,3878,1580,-2298
2021,1,2,2,1501,3959,1728,-2231
2021,1,2,3,1422,3864,1668,-2196
2021,1,2,4,1322,3706,1602,-2104
2021,1,2,5,1150,3621,1717,-1904
2021,1,2,6,911,3474,1547,-1927
2021,1,2,7,1059,3155,1507,-1648
2021,1,2,8,814,2960,1517,-1443
2021,1,2,9,774,2777,1437,-1340
2021,1,2,10,724,2646,1346,-1300
2021,1,2,11,658,2517,1267,-1250
2021,1,2,12,839,2445,1242,-1203
2021,1,2,13,699,2494,1135,-1359
2021,1,2,14,648,2651,1148,-1503
2021,1,2,15,605,2783,1100,-1683
2021,1,2,16,913,2998,1186,-1812
2021,1,2,17,1107,3178,1203,-1975
2021,1,2,18,1288,3453,1390,-2063
2021,1,2,19,1350,3589,1435,-2154
2021,1,2,20,1345,3512,1365,-2147
2021,1,2,21,1333,3562,1383,-2179
2021,1,2,22,1274,3514,1223,-2291
2021,1,2,23,1148,3512,1303,-2209
2021,1,3,0,1205,3594,1485,-2109
2021,1,3,1,1201,4019,1838,-2181
2021,1,3,2,1364,4102,1981,-2121
2021,1,3,3,1277,4008,1871,-2137
2021,1,3,4,1242,3873,1866,-2007
2021,1,3,5,1143,3720,1725,-1995
2021,1,3,6,1038,3476,1666,-1810
2021,1,3,7,1278,3181,1566,-1615
2021,1,3,8,1046,2959,1413,-1546
2021,1,3,9,832,2727,1302,-1425
2021,1,3,10,825,2746,1386,-1360
2021,1,3,11,891,2709,1299,-1410
2021,1,3,12,801,2715,1363,-1352
2021,1,3,13,856,2764,1221,-1543
2021,1,3,14,876,2888,1392,-1496
2021,1,3,15,948,3046,1474,-1572
2021,1,3,16,1115,3223,1566,-1657
2021,1,3,17,1327,3632,1859,-1773
2021,1,3,18,1438,3814,1921,-1893
2021,1,3,19,1520,3829,1881,-1948
2021,1,3,20,1571,3860,1925,-1935
2021,1,3,21,1565,3894,1922,-1972
2021,1,3,22,1517,3877,1813,-2064
2021,1,3,23,1505,3783,1722,-2061
2021,1,4,0,1619,3792,2019,-1773
2021,1,4,1,1551,4006,2143,-1863
2021,1,4,2,1616,4198,2301,-1897
2021,1,4,3,1681,4140,2250,-1890
2021,1,4,4,1639,4025,2143,-1882
2021,1,4,5,1751,3886,2056,-1830
2021,1,4,6,1512,3695,2045,-1650
2021,1,4,7,1645,3421,1971,-1450
2021,1,4,8,1446,3201,1878,-1323
2021,1,4,9,1386,3058,1751,-1307
2021,1,4,10,1296,2964,1738,-1226
2021,1,4,11,1285,2937,1742,-1195
2021,1,4,12,1349,2954,1753,-1201
2021,1,4,13,1436,3082,1842,-1240
2021,1,4,14,1567,3354,1994,-1360
2021,1,4,15,1475,3613,2026,-1587
2021,1,4,16,1650,3790,2068,-1722
2021,1,4,17,1666,3947,2086,-1861
2021,1,4,18,1662,3978,2098,-1880
2021,1,4,19,1645,4077,2176,-1901
2021,1,4,20,1618,4107,2280,-1827
2021,1,4,21,1561,4118,2258,-1860
2021,1,4,22,1567,4092,2168,-1924
2021,1,4,23,1593,3970,2122,-1848
2021,1,5,0,1595,3940,2136,-1804
2021,1,5,1,1657,4094,2277,-1817
2021,1,5,2,1676,4284,2457,-1827
2021,1,5,3,1701,4265,2443,-1822
2021,1,5,4,1697,3892,2232,-1660
2021,1,5,5,1660,3724,2126,-1598
2021,1,5,6,1629,3450,1868,-1582
2021,1,5,7,1630,3196,2091,-1105
2021,1,5,8,1602,2927,1812,-1115
2021,1,5,9,1391,2778,1713,-1065
2021,1,5,10,1334,2696,1626,-1070
2021,1,5,11,1283,2639,1584,-1055
2021,1,5,12,1437,2816,1700,-1116
2021,1,5,13,1570,2991,1745,-1246
2021,1,5,14,1685,3435,1977,-1458
2021,1,5,15,1334,3778,1844,-1934
2021,1,5,16,1555,4004,1945,-2059
2021,1,5,17,1626,4123,1958,-2165
2021,1,5,18,1646,4124,1936,-2188
2021,1,5,19,1682,4177,1879,-2298
2021,1,5,20,1736,4196,1982,-2214
2021,1,5,21,1754,4231,1945,-2286
2021,1,5,22,1740,4218,1872,-2346
2021,1,5,23,1705,4204,1901,-2303
2021,1,6,0,1731,4227,1993,-2234
2021,1,6,1,1640,4339,2017,-2322
2021,1,6,2,1753,4442,2100,-2342
2021,1,6,3,1756,4337,2129,-2208
2021,1,6,4,1742,4174,2154,-2020
2021,1,6,5,1506,3965,2016,-1949
2021,1,6,6,1543,3752,2040,-1712
2021,1,6,7,1704,3476,2009,-1467
2021,1,6,8,1730,3202,1938,-1264
2021,1,6,9,1520,3013,1813,-1200
2021,1,6,10,1482,2932,1768,-1164
2021,1,6,11,1396,2886,1726,-1160
2021,1,6,12,1508,2911,1855,-1056
2021,1,6,13,1559,3047,1832,-1215
2021,1,6,14,1684,3393,1858,-1535
2021,1,6,15,1620,3700,1830,-1870
2021,1,6,16,1833,3889,1907,-1982
2021,1,6,17,1845,4023,1786,-2237
2021,1,6,18,1789,4038,1833,-2205
2021,1,6,19,1790,3970,1875,-2095
2021,1,6,20,1768,3931,1884,-2047
2021,1,6,21,1698,3879,1874,-2005
2021,1,6,22,1712,3828,1884,-1944
2021,1,6,23,1702,3795,1923,-1872
2021,1,7,0,1719,3824,1939,-1885
2021,1,7,1,1658,4016,1953,-2063
2021,1,7,2,1748,4224,1981,-2243
2021,1,7,3,1825,4177,2002,-2175
2021,1,7,4,1770,4082,1979,-2103
2021,1,7,5,1657,3943,1929,-2014
2021,1,7,6,1595,3732,1917,-1815
2021,1,7,7,1644,3494,1918,-1576
2021,1,7,8,1711,3257,1912,-1345
2021,1,7,9,1638,3079,1775,-1304
2021,1,7,10,1599,3004,1726,-1278
2021,1,7,11,1550,3003,1676,-1327
2021,1,7,12,1530,3071,1744,-1327
2021,1,7,13,1562,3206,1766,-1440
2021,1,7,14,1692,3462,1872,-1590
2021,1,7,15,1652,3777,1826,-1951
2021,1,7,16,1852,4047,2000,-2047
2021,1,7,17,1911,4109,2021,-2088
2021,1,7,18,1812,4084,2064,-2020
2021,1,7,19,1749,4040,2105,-1935
2021,1,7,20,1710,4010,2071,-1939
2021,1,7,21,1776,3979,2033,-1946
2021,1,7,22,1745,3944,2024,-1920
2021,1,7,23,1716,3904,2010,-1894
2021,1,8,0,1691,3925,2070,-1855
2021,1,8,1,1686,4068,2081,-1987
2021,1,8,2,1757,4319,2153,-2166
2021,1,8,3,1718,4287,2192,-2095
2021,1,8,4,1719,4186,2192,-1994
2021,1,8,5,1587,4035,2084,-1951
2021,1,8,6,1467,3807,2041,-1766
2021,1,8,7,1828,3542,2094,-1448
2021,1,8,8,1613,3299,2044,-1255
2021,1,8,9,1618,3134,1894,-1240
2021,1,8,10,1490,3057,1872,-1185
2021,1,8,11,1510,3008,1870,-1138
2021,1,8,12,1560,3033,1832,-1201
2021,1,8,13,1555,3143,1811,-1332
2021,1,8,14,1696,3384,2006,-1378
2021,1,8,15,1520,3686,1953,-1733
2021,1,8,16,1674,3929,1861,-2068
2021,1,8,17,1745,4083,1911,-2172
2021,1,8,18,1658,4094,1860,-2234
2021,1,8,19,1560,4102,1894,-2208
2021,1,8,20,1571,4099,1888,-2211
2021,1,8,21,1601,4075,1821,-2254
2021,1,8,22,1524,3981,1629,-2352
2021,1,8,23,1459,3918,1520,-2398
2021,1,9,0,1464,3918,1532,-2386
2021,1,9,1,1635,4054,1789,-2265
2021,1,9,2,1672,4229,1843,-2386
2021,1,9,3,1744,4176,1848,-2328
2021,1,9,4,1635,4069,1876,-2193
2021,1,9,5,1553,3903,1796,-2107
2021,1,9,6,1383,3742,1758,-1984
2021,1,9,7,1685,3541,1847,-1694
2021,1,9,8,1586,3362,1781,-1581
2021,1,9,9,1453,3224,1775,-1449
2021,1,9,10,1506,3170,1829,-1341
2021,1,9,11,1467,3150,1803,-1347
2021,1,9,12,1503,3189,1811,-1378
2021,1,9,13,1556,3275,1781,-1494
2021,1,9,14,1606,3426,1836,-1590
2021,1,9,15,1413,3646,1848,-1798
2021,1,9,16,1540,3868,1814,-2054
2021,1,9,17,1687,4072,1899,-2173
2021,1,9,18,1698,4201,1931,-2270
2021,1,9,19,1693,4214,1927,-2287
2021,1,9,20,1652,4158,1897,-2261
2021,1,9,21,1696,4057,1872,-2185
2021,1,9,22,1591,3974,1707,-2267
2021,1,9,23,1521,3930,1779,-2151
2021,1,10,0,1490,3949,1840,-2109
2021,1,10,1,1576,4073,1945,-2128
2021,1,10,2,1647,4242,1987,-2255
2021,1,10,3,1663,4186,1964,-2222
2021,1,10,4,1570,4042,1896,-2146
2021,1,10,5,1388,3926,1848,-2078
2021,1,10,6,1365,3759,1810,-1949
2021,1,10,7,1682,3565,2011,-1554
2021,1,10,8,1650,3351,2005,-1346
2021,1,10,9,1429,3184,1908,-1276
2021,1,10,10,1336,3060,1799,-1261
2021,1,10,11,1266,2963,1669,-1294
2021,1,10,12,1270,2991,1780,-1211
2021,1,10,13,1533,3052,1835,-1217
2021,1,10,14,1625,3157,1915,-1242
2021,1,10,15,1492,3310,1894,-1416
2021,1,10,16,1492,3489,1880,-1609
2021,1,10,17,1685,3660,1771,-1889
2021,1,10,18,1811,3790,1763,-2027
2021,1,10,19,1795,3843,1837,-2006
2021,1,10,20,1782,3818,1832,-1986
2021,1,10,21,1728,3786,1736,-2050
2021,1,10,22,1657,3720,1704,-2016
2021,1,10,23,1581,3661,1747,-1914
2021,1,11,0,1613,3714,1948,-1766
2021,1,11,1,1782,3891,2116,-1775
2021,1,11,2,2017,4095,2222,-1873
2021,1,11,3,1992,4046,2224,-1822
2021,1,11,4,1889,3940,2180,-1760
2021,1,11,5,1722,3798,2056,-1742
2021,1,11,6,1513,3557,1991,-1566
2021,1,11,7,1732,3305,1957,-1348
2021,1,11,8,1498,3077,1734,-1343
2021,1,11,9,1458,2951,1734,-1217
2021,1,11,10,1450,2855,1725,-1130
2021,1,11,11,1451,2805,1639,-1166
2021,1,11,12,1424,2791,1602,-1189
2021,1,11,13,1331,3014,1641,-1373
2021,1,11,14,1540,3344,1847,-1497
2021,1,11,15,1605,3654,1855,-1799
2021,1,11,16,1656,3940,2048,-1892
2021,1,11,17,1733,4072,2200,-1872
2021,1,11,18,1735,4124,2236,-1888
2021,1,11,19,1745,4152,2212,-1940
2021,1,11,20,1728,4160,2178,-1982
2021,1,11,21,1639,4174,2183,-1991
2021,1,11,22,1686,4122,2198,-1924
2021,1,11,23,1692,4068,2134,-1934
2021,1,12,0,1676,4081,2180,-1901
2021,1,12,1,1737,4204,2248,-1956
2021,1,12,2,1748,4328,2288,-2040
2021,1,12,3,1746,4231,2238,-1993
2021,1,12,4,1746,4090,2236,-1854
2021,1,12,5,1640,3868,2141,-1727
2021,1,12,6,1369,3584,2030,-1554
2021,1,12,7,1570,3309,2062,-1247
2021,1,12,8,1325,3068,1800,-1268
2021,1,12,9,1058,2968,1490,-1478
2021,1,12,10,1008,2938,1245,-1693
2021,1,12,11,867,2899,1156,-1743
2021,1,12,12,802,2921,1224,-1697
2021,1,12,13,984,3038,1381,-1657
2021,1,12,14,1057,3253,1511,-1742
2021,1,12,15,1066,3552,1492,-2060
2021,1,12,16,1168,3775,1552,-2223
2021,1,12,17,1191,3888,1555,-2333
2021,1,12,18,1119,3906,1593,-2313
2021,1,12,19,1125,3899,1639,-2260
2021,1,12,20,1079,3874,1669,-2205
2021,1,12,21,1024,3848,1675,-2173
2021,1,12,22,980,3801,1620,-2181
2021,1,12,23,937,3739,1563,-2176
2021,1,13,0,1055,3738,1605,-2133
2021,1,13,1,1042,3857,1519,-2338
2021,1,13,2,1083,4023,1544,-2479
2021,1,13,3,1179,3963,1494,-2469
2021,1,13,4,1115,3824,1537,-2287
2021,1,13,5,1184,3660,1594,-2066
2021,1,13,6,915,3340,1383,-1957
2021,1,13,7,1009,3019,1452,-1567
2021,1,13,8,1028,2607,1336,-1271
2021,1,13,9,942,2073,1212,-861
2021,1,13,10,870,1867,906,-961
2021,1,13,11,652,1935,1195,-740
2021,1,13,12,690,1997,1213,-784
2021,1,13,13,901,2176,1198,-978
2021,1,13,14,1078,2646,1414,-1232
2021,1,13,15,1243,2951,1552,-1399
2021,1,13,16,1547,3245,1665,-1580
2021,1,13,17,1545,3407,1743,-1664
2021,1,13,18,1624,3456,1700,-1756
2021,1,13,19,1673,3278,1594,-1684
2021,1,13,20,1673,3146,1558,-1588
2021,1,13,21,1671,3112,1516,-1596
2021,1,13,22,1644,3012,1400,-1612
2021,1,13,23,1644,3009,1456,-1553
2021,1,14,0,1684,3074,1498,-1576
2021,1,14,1,1621,3339,1545,-1794
2021,1,14,2,1684,3625,1421,-2204
2021,1,14,3,1664,3708,1399,-2309
2021,1,14,4,1628,3643,1462,-2181
2021,1,14,5,1630,3533,1554,-1979
2021,1,14,6,1588,3396,1502,-1894
2021,1,14,7,1558,3192,1590,-1602
2021,1,14,8,1549,3003,1504,-1499
2021,1,14,9,1357,2907,1516,-1391
2021,1,14,10,1316,2893,1529,-1364
2021,1,14,11,1351,2937,1522,-1415
2021,1,14,12,1420,2988,1646,-1342
2021,1,14,13,1640,3195,1858,-1337
2021,1,14,14,1690,3436,1835,-1601
2021,1,14,15,1652,3746,1814,-1932
2021,1,14,16,1755,4015,1985,-2030
2021,1,14,17,1835,4148,1915,-2233
2021,1,14,18,1712,4155,1904,-2251
2021,1,14,19,1571,4076,1874,-2202
2021,1,14,20,1453,3956,1914,-2042
2021,1,14,21,1380,3861,1692,-2169
2021,1,14,22,1331,3759,1542,-2217
2021,1,14,23,1331,3722,1435,-2287
2021,1,15,0,1334,3751,1573,-2178
2021,1,15,1,1382,3878,1832,-2046
2021,1,15,2,1504,4131,1836,-2295
2021,1,15,3,1511,4114,1859,-2255
2021,1,15,4,1421,4007,1874,-2133
2021,1,15,5,1378,3858,1796,-2062
2021,1,15,6,1320,3637,1742,-1895
2021,1,15,7,1547,3344,1760,-1584
2021,1,15,8,1408,3129,1748,-1381
2021,1,15,9,1297,2986,1723,-1263
2021,1,15,10,1225,2898,1680,-1218
2021,1,15,11,1232,2859,1689,-1170
2021,1,15,12,1355,2873,1766,-1107
2021,1,15,13,1338,2975,1746,-1229
2021,1,15,14,1582,3200,1718,-1482
2021,1,15,15,1539,3486,1687,-1799
2021,1,15,16,1703,3733,1761,-1972
2021,1,15,17,1746,3859,1863,-1996
2021,1,15,18,1768,3881,1851,-2030
2021,1,15,19,1716,3821,1774,-2047
2021,1,15,20,1643,3768,1722,-2046
2021,1,15,21,1600,3705,1643,-2062
2021,1,15,22,1539,3631,1597,-2034
2021,1,15,23,1480,3564,1575,-1989
2021,1,16,0,1510,3578,1668,-1910
2021,1,16,1,1646,3730,1841,-1889
2021,1,16,2,1763,3972,1907,-2065
2021,1,16,3,1751,3963,1905,-2058
2021,1,16,4,1729,3874,1855,-2019
2021,1,16,5,1594,3761,1795,-1966
2021,1,16,6,1447,3613,1821,-1792
2021,1,16,7,1720,3415,1982,-1433
2021,1,16,8,1687,3240,1798,-1442
2021,1,16,9,1265,3111,1536,-1575
2021,1,16,10,1220,3032,1464,-1568
2021,1,16,11,1213,2998,1454,-1544
2021,1,16,12,1220,3013,1418,-1595
2021,1,16,13,1215,3074,1414,-1660
2021,1,16,14,1062,3203,1372,-1831
2021,1,16,15,867,3399,1340,-2059
2021,1,16,16,1043,3607,1415,-2192
2021,1,16,17,1224,3797,1408,-2389
2021,1,16,18,1296,3922,1433,-2489
2021,1,16,19,1305,3913,1294,-2619
2021,1,16,20,1236,3870,1243,-2627
2021,1,16,21,1191,3829,1115,-2714
2021,1,16,22,1104,3768,1291,-2477
2021,1,16,23,1008,3726,1263,-2463
2021,1,17,0,991,3771,1370,-2401
2021,1,17,1,983,3896,1388,-2508
2021,1,17,2,1140,4082,1454,-2628
2021,1,17,3,1139,4042,1366,-2676
2021,1,17,4,1003,3917,1468,-2449
2021,1,17,5,1000,3794,1520,-2274
2021,1,17,6,903,3608,1550,-2058
2021,1,17,7,1376,3388,1600,-1788
2021,1,17,8,1178,3194,1628,-1566
2021,1,17,9,1031,3050,1677,-1373
2021,1,17,10,1045,2953,1518,-1435
2021,1,17,11,975,2900,1496,-1404
2021,1,17,12,955,2889,1529,-1360
2021,1,17,13,1046,2926,1516,-1410
2021,1,17,14,1162,3022,1412,-1610
2021,1,17,15,818,3123,1348,-1775
2021,1,17,16,825,3320,1318,-2002
2021,1,17,17,925,3475,1228,-2247
2021,1,17,18,975,3580,1205,-2375
2021,1,17,19,1038,3635,1211,-2424
2021,1,17,20,980,3665,1112,-2553
2021,1,17,21,1022,3698,1096,-2602
2021,1,17,22,940,3593,1107,-2486
2021,1,17,23,908,3455,1025,-2430
2021,1,18,0,993,3596,1337,-2259
2021,1,18,1,1147,3758,1440,-2318
2021,1,18,2,1413,3981,1573,-2408
2021,1,18,3,1430,3963,1545,-2418
2021,1,18,4,1376,3867,1581,-2286
2021,1,18,5,1326,3747,1684,-2063
2021,1,18,6,1210,3585,1647,-1938
2021,1,18,7,1368,3364,1655,-1709
2021,1,18,8,1182,3162,1578,-1584
2021,1,18,9,1248,3023,1672,-1351
2021,1,18,10,1252,2959,1633,-1326
2021,1,18,11,1086,2948,1591,-1357
2021,1,18,12,1168,2983,1617,-1366
2021,1,18,13,1299,3047,1551,-1496
2021,1,18,14,1450,3283,1683,-1600
2021,1,18,15,1362,3560,1598,-1962
2021,1,18,16,1494,3872,1792,-2080
2021,1,18,17,1591,4027,1834,-2193
2021,1,18,18,1687,4080,1831,-2249
2021,1,18,19,1710,4070,1859,-2211
2021,1,18,20,1698,4036,1864,-2172
2021,1,18,21,1660,3945,1786,-2159
2021,1,18,22,1616,3856,1773,-2083
2021,1,18,23,1568,3799,1750,-2049
2021,1,19,0,1599,3796,1774,-2022
2021,1,19,1,1728,4000,1872,-2128
2021,1,19,2,1974,4307,1830,-2477
2021,1,19,3,1971,4304,1905,-2399
2021,1,19,4,1874,4207,1876,-2331
2021,1,19,5,1728,4059,1973,-2086
2021,1,19,6,1476,3861,1883,-1978
2021,1,19,7,1826,3608,1834,-1774
2021,1,19,8,1603,3385,2007,-1378
2021,1,19,9,1509,3266,2031,-1235
2021,1,19,10,1505,3172,1814,-1358
2021,1,19,11,1547,3158,1831,-1327
2021,1,19,12,1750,3183,1892,-1291
2021,1,19,13,1939,3404,2003,-1401
2021,1,19,14,2047,3660,2061,-1599
2021,1,19,15,1909,4039,1961,-2078
2021,1,19,16,1960,4335,2143,-2192
2021,1,19,17,1977,4458,2141,-2317
2021,1,19,18,1986,4445,2194,-2251
2021,1,19,19,1946,4368,2162,-2206
2021,1,19,20,1852,4269,2125,-2144
2021,1,19,21,1770,4179,2151,-2028
2021,1,19,22,1660,4021,2134,-1887
2021,1,19,23,1590,3912,2053,-1859
2021,1,20,0,1550,3913,2086,-1827
2021,1,20,1,1764,4104,2112,-1992
2021,1,20,2,1943,4410,2251,-2159
2021,1,20,3,1998,4396,2127,-2269
2021,1,20,4,2010,4271,2026,-2245
2021,1,20,5,1829,4125,2142,-1983
2021,1,20,6,1605,3889,2050,-1839
2021,1,20,7,1849,3557,2104,-1453
2021,1,20,8,1662,3382,1926,-1456
2021,1,20,9,1776,3268,1962,-1306
2021,1,20,10,1706,3208,1991,-1217
2021,1,20,11,1721,3186,1992,-1194
2021,1,20,12,1724,3235,1995,-1240
2021,1,20,13,1898,3237,1981,-1256
2021,1,20,14,1987,3530,2050,-1480
2021,1,20,15,2111,4035,2141,-1894
2021,1,20,16,2217,4305,2358,-1947
2021,1,20,17,2214,4397,2345,-2052
2021,1,20,18,2098,4369,2294,-2075
2021,1,20,19,2098,4311,2288,-2023
2021,1,20,20,2067,4197,2233,-1964
2021,1,20,21,2050,4128,2157,-1971
2021,1,20,22,1929,4071,2067,-2004
2021,1,20,23,1878,3997,2030,-1967
2021,1,21,0,1877,3984,2061,-1923
2021,1,21,1,2036,4106,2255,-1851
2021,1,21,2,2128,4352,2310,-2042
2021,1,21,3,2151,4298,2265,-2033
2021,1,21,4,2135,4161,2222,-1939
2021,1,21,5,2087,4010,2159,-1851
2021,1,21,6,1832,3773,2025,-1748
2021,1,21,7,2036,3496,2088,-1408
2021,1,21,8,1954,3224,2034,-1190
2021,1,21,9,1798,3091,2032,-1059
2021,1,21,10,1828,3008,2043,-965
2021,1,21,11,1755,3022,2011,-1011
2021,1,21,12,1747,3071,2014,-1057
2021,1,21,13,1860,3212,2127,-1085
2021,1,21,14,2037,3485,2273,-1212
2021,1,21,15,1834,3793,2152,-1641
2021,1,21,16,1972,4067,2197,-1870
2021,1,21,17,2080,4163,2267,-1896
2021,1,21,18,2014,4197,2300,-1897
2021,1,21,19,1996,4109,2189,-1920
2021,1,21,20,1990,4062,2157,-1905
2021,1,21,21,1948,4025,2148,-1877
2021,1,21,22,1863,3945,2036,-1909
2021,1,21,23,1825,3901,2053,-1848
2021,1,22,0,1839,3951,2137,-1814
2021,1,22,1,2020,4081,2323,-1758
2021,1,22,2,2050,4301,2351,-1950
2021,1,22,3,2113,4272,2379,-1893
2021,1,22,4,2076,4126,2341,-1785
2021,1,22,5,1941,3972,2339,-1633
2021,1,22,6,1712,3738,2166,-1572
2021,1,22,7,2058,3487,2243,-1244
2021,1,22,8,2005,3264,2174,-1090
2021,1,22,9,1774,3125,2023,-1102
2021,1,22,10,1703,3052,1986,-1066
2021,1,22,11,1732,3042,2008,-1034
2021,1,22,12,1660,3078,1960,-1118
2021,1,22,13,1809,3226,2023,-1203
2021,1,22,14,1889,3511,2143,-1368
2021,1,22,15,1800,3838,1991,-1847
2021,1,22,16,2087,4126,2325,-1801
2021,1,22,17,2113,4247,2342,-1905
2021,1,22,18,2053,4261,2338,-1923
2021,1,22,19,2073,4179,2275,-1904
2021,1,22,20,2101,4103,2266,-1837
2021,1,22,21,2024,3998,2198,-1800
2021,1,22,22,1926,3889,2090,-1799
2021,1,22,23,1878,3828,2141,-1687
2021,1,23,0,1893,3841,2182,-1659
2021,1,23,1,1921,3995,2150,-1845
2021,1,23,2,2035,4296,2303,-1993
2021,1,23,3,2111,4325,2300,-2025
2021,1,23,4,2080,4243,2306,-1937
2021,1,23,5,2017,4134,2306,-1828
2021,1,23,6,1807,3978,2202,-1776
2021,1,23,7,2017,3779,2283,-1496
2021,1,23,8,1870,3599,2165,-1434
2021,1,23,9,1850,3484,2109,-1375
2021,1,23,10,1782,3433,1988,-1445
2021,1,23,11,1874,3397,1992,-1405
2021,1,23,12,1826,3447,1986,-1461
2021,1,23,13,1867,3570,2041,-1529
2021,1,23,14,1926,3729,2072,-1657
2021,1,23,15,1749,3947,1948,-1999
2021,1,23,16,1881,4197,2005,-2192
2021,1,23,17,2041,4382,2078,-2304
2021,1,23,18,2039,4452,2139,-2313
2021,1,23,19,2044,4322,2181,-2141
2021,1,23,20,2040,4214,2218,-1996
2021,1,23,21,2032,4047,2047,-2000
2021,1,23,22,1856,3889,1933,-1956
2021,1,23,23,1812,3823,2011,-1812
2021,1,24,0,1843,3857,2135,-1722
2021,1,24,1,2006,4038,2135,-1903
2021,1,24,2,2085,4316,2101,-2215
2021,1,24,3,2092,4320,2032,-2288
2021,1,24,4,2087,4194,2036,-2158
2021,1,24,5,1901,4055,1960,-2095
2021,1,24,6,1744,3852,1936,-1916
2021,1,24,7,2061,3651,2069,-1582
2021,1,24,8,1828,3435,1703,-1732
2021,1,24,9,1487,3290,1747,-1543
2021,1,24,10,1321,3199,1806,-1393
2021,1,24,11,1268,3144,1806,-1338
2021,1,24,12,1277,3113,1755,-1358
2021,1,24,13,1334,3167,1598,-1569
2021,1,24,14,1533,3275,1756,-1519
2021,1,24,15,1419,3463,1763,-1700
2021,1,24,16,1321,3669,1630,-2039
2021,1,24,17,1462,3872,1754,-2118
2021,1,24,18,1626,4037,1887,-2150
2021,1,24,19,1688,4135,2000,-2135
2021,1,24,20,1684,4192,1964,-2228
2021,1,24,21,1668,4200,2066,-2134
2021,1,24,22,1757,4167,2152,-2015
2021,1,24,23,1769,4124,2115,-2009
2021,1,25,0,1858,4115,2212,-1903
2021,1,25,1,1911,4207,2220,-1987
2021,1,25,2,1988,4384,2405,-1979
2021,1,25,3,1982,4346,2397,-1949
2021,1,25,4,1944,4160,2261,-1899
2021,1,25,5,1957,4075,2264,-1811
2021,1,25,6,1735,3860,2103,-1757
2021,1,25,7,1882,3595,2109,-1486
2021,1,25,8,1680,3359,2018,-1341
2021,1,25,9,1663,3221,1945,-1276
2021,1,25,10,1589,3138,1918,-1220
2021,1,25,11,1587,3139,1879,-1260
2021,1,25,12,1647,3201,1927,-1274
2021,1,25,13,1803,3381,2023,-1358
2021,1,25,14,1934,3682,2159,-1523
2021,1,25,15,1841,4038,2089,-1949
2021,1,25,16,2000,4337,2296,-2041
2021,1,25,17,2070,4439,2293,-2146
2021,1,25,18,2066,4423,2223,-2200
2021,1,25,19,2047,4343,2194,-2149
2021,1,25,20,2007,4268,2202,-2066
2021,1,25,21,1958,4213,2181,-2032
2021,1,25,22,1892,4140,2062,-2078
2021,1,25,23,1865,4053,2094,-1959
2021,1,26,0,1900,4047,2127,-1920
2021,1,26,1,2012,4170,2169,-2001
2021,1,26,2,2141,4474,2273,-2201
2021,1,26,3,2119,4480,2266,-2214
2021,1,26,4,2073,4359,2279,-2080
2021,1,26,5,2005,4175,2154,-2021
2021,1,26,6,1855,3942,1955,-1987
2021,1,26,7,2150,3542,1902,-1640
2021,1,26,8,1835,3410,1951,-1459
2021,1,26,9,1567,3278,1872,-1406
2021,1,26,10,1602,3219,1872,-1347
2021,1,26,11,1529,3223,1862,-1361
2021,1,26,12,1601,3295,1877,-1418
2021,1,26,13,1845,3478,1994,-1484
2021,1,26,14,1905,3781,2106,-1675
2021,1,26,15,1907,4153,2117,-2036
2021,1,26,16,1973,4441,2272,-2169
2021,1,26,17,1941,4556,2257,-2299
2021,1,26,18,1857,4518,2213,-2305
2021,1,26,19,1819,4424,2161,-2263
2021,1,26,20,1889,4336,2176,-2160
2021,1,26,21,1831,4305,2152,-2153
2021,1,26,22,1781,4249,2151,-2098
2021,1,26,23,1677,4234,2150,-2084
2021,1,27,0,1687,4282,2208,-2074
2021,1,27,1,1853,4406,2407,-1999
2021,1,27,2,2016,4615,2522,-2093
2021,1,27,3,2007,4541,2503,-2038
2021,1,27,4,1985,4394,2377,-2017
2021,1,27,5,1807,4212,2256,-1956
2021,1,27,6,1571,3946,2154,-1792
2021,1,27,7,1805,3654,2153,-1501
2021,1,27,8,1617,3428,2003,-1425
2021,1,27,9,1240,3428,2003,-9999
2021,1,27,10,1196,3219,1872,-9999
2021,1,27,11,1142,3223,1862,-9999
2021,1,27,12,1250,3295,1877,-9999
2021,1,27,13,1431,3478,1994,-9999
2021,1,27,14,1650,3781,2106,-9999
2021,1,27,15,1522,4153,2117,-9999
2021,1,27,16,1588,4441,2272,-9999
2021,1,27,17,1593,4556,2257,-9999
2021,1,27,18,1569,4518,2213,-9999
2021,1,27,19,1443,4424,2161,-9999
2021,1,27,20,1487,4336,2176,-9999
2021,1,27,21,1438,4305,2152,-9999
2021,1,27,22,1480,4249,2151,-9999
2021,1,27,23,1457,4234,2150,-9999
2021,1,28,0,1484,4282,2208,-9999
2021,1,28,1,1630,4406,2407,-9999
2021,1,28,2,1733,4615,2522,-9999
2021,1,28,3,1743,4541,2503,-9999
2021,1,28,4,1762,4394,2377,-9999
2021,1,28,5,1598,4212,2256,-9999
2021,1,28,6,1375,3946,2154,-9999
2021,1,28,7,1632,3654,2153,-9999
2021,1,28,8,1510,3428,2003,-9999
2021,1,28,9,-9999,3127,1682,-1445
2021,1,28,10,-9999,3118,1674,-1444
2021,1,28,11,-9999,3098,1654,-1444
2021,1,28,12,-9999,3140,1770,-1370
2021,1,28,13,-9999,3288,1758,-1530
2021,1,28,14,-9999,3517,1945,-1572
2021,1,28,15,-9999,3887,1863,-2024
2021,1,28,16,-9999,4164,1936,-2228
2021,1,28,17,-9999,4250,2059,-2191
2021,1,28,18,-9999,4247,2064,-2183
2021,1,28,19,-9999,4214,2057,-2157
2021,1,28,20,-9999,4121,2003,-2118
2021,1,28,21,-9999,4056,1990,-2066
2021,1,28,22,-9999,3960,1923,-2037
2021,1,28,23,-9999,3918,1949,-1969
2021,1,29,0,-9999,3981,1997,-1984
2021,1,29,1,-9999,4060,2012,-2048
2021,1,29,2,-9999,4281,2045,-2236
2021,1,29,3,-9999,4279,2080,-2199
2021,1,29,4,-9999,4146,2066,-2080
2021,1,29,5,-9999,4000,1937,-2063
2021,1,29,6,-9999,3777,1895,-1882
2021,1,29,7,-9999,3514,1955,-1559
2021,1,29,8,-9999,3277,1826,-1451
2021,1,29,9,1430,3083,1722,-1361
2021,1,29,10,1398,3008,1772,-1236
2021,1,29,11,1397,2992,1737,-1255
2021,1,29,12,1426,3025,1736,-1289
2021,1,29,13,1530,3177,1791,-1386
2021,1,29,14,1699,3480,1911,-1569
2021,1,29,15,1476,3811,1898,-1913
2021,1,29,16,1529,4091,1963,-2128
2021,1,29,17,1575,4204,2024,-2180
2021,1,29,18,1561,4195,2021,-2174
2021,1,29,19,1492,4143,2054,-2089
2021,1,29,20,1569,4091,2101,-1990
2021,1,29,21,1506,4005,2038,-1967
2021,1,29,22,1432,3887,1993,-1894
2021,1,29,23,1433,3821,1903,-1918
2021,1,30,0,1432,3866,2000,-1866
2021,1,30,1,1547,3982,2082,-1900
2021,1,30,2,1687,4196,2120,-2076
2021,1,30,3,1716,4184,2153,-2031
2021,1,30,4,1586,4062,2041,-2021
2021,1,30,5,1430,3918,2012,-1906
2021,1,30,6,1394,3733,1931,-1802
2021,1,30,7,1611,3508,2018,-1490
2021,1,30,8,1387,3293,1846,-1447
2021,1,30,9,1341,3150,1827,-1323
2021,1,30,10,1298,3056,1829,-1227
2021,1,30,11,1294,3017,1800,-1217
2021,1,30,12,1290,3023,1723,-1300
2021,1,30,13,1352,3075,1723,-1352
2021,1,30,14,1361,3217,1699,-1518
2021,1,30,15,969,3404,1654,-1750
2021,1,30,16,1184,3607,1729,-1878
2021,1,30,17,1412,3791,1801,-1990
2021,1,30,18,1524,3885,1727,-2158
2021,1,30,19,1531,3985,1738,-2247
2021,1,30,20,1530,3990,1773,-2217
2021,1,30,21,1508,3956,1701,-2255
2021,1,30,22,1398,3876,1582,-2294
2021,1,30,23,1354,3814,1534,-2280
2021,1,31,0,1305,3780,1469,-2311
2021,1,31,1,1414,3859,1716,-2143
2021,1,31,2,1543,4018,1819,-2199
2021,1,31,3,1452,3992,1702,-2290
2021,1,31,4,1287,3855,1649,-2206
2021,1,31,5,1078,3729,1637,-2092
2021,1,31,6,968,3561,1638,-1923
2021,1,31,7,1265,3354,1659,-1695
2021,1,31,8,1049,3154,1582,-1572
2021,1,31,9,971,2992,1548,-1444
2021,1,31,10,977,2890,1551,-1339
2021,1,31,11,945,2836,1551,-1285
2021,1,31,12,936,2829,1532,-1297
2021,1,31,13,1091,2859,1410,-1449
2021,1,31,14,1059,2943,1280,-1663
2021,1,31,15,1044,3084,1280,-1804
2021,1,31,16,1173,3274,1608,-1666
2021,1,31,17,1378,3451,1551,-1900
2021,1,31,18,1522,3608,1703,-1905
2021,1,31,19,1563,3700,1718,-1982
2021,1,31,20,1579,3755,1721,-2034
2021,1,31,21,1598,3798,1695,-2103
2021,1,31,22,1556,3826,1784,-2042
2021,1,31,23,1483,3808,1842,-1966
2021,2,1,0,1505,3825,1796,-2029
2021,2,1,1,1610,3926,1862,-2064
2021,2,1,2,1746,4103,1755,-2348
2021,2,1,3,1736,4087,1776,-2311
2021,2,1,4,1638,3974,1790,-2184
2021,2,1,5,1503,3830,1674,-2156
2021,2,1,6,1362,3620,1716,-1904
2021,2,1,7,1339,3379,1697,-1682
2021,2,1,8,1125,3140,1592,-1548
2021,2,1,9,1385,3018,1762,-1256
2021,2,1,10,1264,2947,1694,-1253
2021,2,1,11,1173,2927,1709,-1218
2021,2,1,12,1303,2961,1793,-1168
2021,2,1,13,1571,3095,1851,-1244
2021,2,1,14,1664,3342,1900,-1442
2021,2,1,15,1494,3670,1814,-1856
2021,2,1,16,1705,3928,1860,-2068
2021,2,1,17,1709,4018,1891,-2127
2021,2,1,18,1670,3988,1807,-2181
2021,2,1,19,1602,3964,1792,-2172
2021,2,1,20,1659,3977,1835,-2142
2021,2,1,21,1617,3984,1880,-2104
2021,2,1,22,1481,3908,1766,-2142
2021,2,1,23,1447,3910,1808,-2102
2021,2,2,0,1443,3857,1678,-2179
2021,2,2,1,1481,3955,1845,-2110
2021,2,2,2,1733,4117,1812,-2305
2021,2,2,3,1742,4078,1773,-2305
2021,2,2,4,1586,3929,1778,-2151
2021,2,2,5,1440,3786,1677,-2109
2021,2,2,6,1203,3568,1663,-1905
2021,2,2,7,1644,3314,1845,-1469
2021,2,2,8,1467,3097,1865,-1232
2021,2,2,9,1411,2980,1701,-1279
2021,2,2,10,1261,2893,1691,-1202
2021,2,2,11,1428,2864,1788,-1076
2021,2,2,12,1610,2901,1772,-1129
2021,2,2,13,1534,3082,1845,-1237
2021,2,2,14,1735,3381,1986,-1395
2021,2,2,15,1431,3729,1908,-1821
2021,2,2,16,1603,4009,1986,-2023
2021,2,2,17,1513,4084,1948,-2136
2021,2,2,18,1449,4107,1960,-2147
2021,2,2,19,1479,4097,1981,-2116
2021,2,2,20,1447,4087,1961,-2126
2021,2,2,21,1428,4067,1886,-2181
2021,2,2,22,1397,4026,1771,-2255
2021,2,2,23,1385,3994,1771,-2223
2021,2,3,0,1444,4015,1836,-2179
2021,2,3,1,1523,4116,2001,-2115
2021,2,3,2,1676,4368,2135,-2233
2021,2,3,3,1734,4348,2029,-2319
2021,2,3,4,1684,4202,2001,-2201
2021,2,3,5,1690,4042,1962,-2080
2021,2,3,6,1471,3782,1905,-1877
2021,2,3,7,1724,3569,2080,-1489
2021,2,3,8,1659,3332,1971,-1361
2021,2,3,9,1468,3185,1844,-1341
2021,2,3,10,1509,3119,1812,-1307
2021,2,3,11,1499,3090,1797,-1293
2021,2,3,12,1461,3141,1797,-1344
2021,2,3,13,1598,3283,1811,-1472
2021,2,3,14,1632,3552,1795,-1757
2021,2,3,15,1563,3901,1785,-2116
2021,2,3,16,1745,4171,1862,-2309
2021,2,3,17,1746,4258,1847,-2411
2021,2,3,18,1670,4234,1853,-2381
2021,2,3,19,1646,4106,1823,-2283
2021,2,3,20,1676,4030,1823,-2207
2021,2,3,21,1603,3959,1758,-2201
2021,2,3,22,1518,3870,1590,-2280
2021,2,3,23,1444,3797,1587,-2210
2021,2,4,0,1534,3806,1652,-2154
2021,2,4,1,1546,3919,1792,-2127
2021,2,4,2,1757,4203,1909,-2294
2021,2,4,3,1828,4244,1822,-2422
2021,2,4,4,1685,4122,1853,-2269
2021,2,4,5,1504,3971,1772,-2199
2021,2,4,6,1317,3749,1639,-2110
2021,2,4,7,1664,3471,1806,-1665
2021,2,4,8,1422,3209,1543,-1666
2021,2,4,9,1150,-9999,-9999,-9999
2021,2,4,10,1015,-9999,-9999,-9999
2021,2,4,11,1243,-9999,-9999,-9999
2021,2,4,12,1277,-9999,-9999,-9999
2021,2,4,13,1308,-9999,-9999,-9999
2021,2,4,14,1329,-9999,-9999,-9999
2021,2,4,15,1224,-9999,-9999,-9999
2021,2,4,16,1431,-9999,-9999,-9999
2021,2,4,17,1430,-9999,-9999,-9999
2021,2,4,18,1371,-9999,-9999,-9999
2021,2,4,19,1305,-9999,-9999,-9999
2021,2,4,20,1209,-9999,-9999,-9999
2021,2,4,21,1174,-9999,-9999,-9999
2021,2,4,22,1141,-9999,-9999,-9999
2021,2,4,23,1160,-9999,-9999,-9999
2021,2,5,0,1155,-9999,-9999,-9999
2021,2,5,1,1154,-9999,-9999,-9999
2021,2,5,2,1374,-9999,-9999,-9999
2021,2,5,3,1404,-9999,-9999,-9999
2021,2,5,4,1309,-9999,-9999,-9999
2021,2,5,5,1211,-9999,-9999,-9999
2021,2,5,6,1034,-9999,-9999,-9999
2021,2,5,7,1383,-9999,-9999,-9999
2021,2,5,8,1205,-9999,-9999,-9999
